"","FIPS","STNAME","CTYNAME","RACE","ESTIM","MR","NUM_DIFF","PERC_DIFF","COVERAGE"
"1",1001,"Alabama","Autauga County","API_alone",212,217,5,2.33,"overcount"
"2",1001,"Alabama","Autauga County","API_combo",212,323,111,41.5,"overcount"
"3",1003,"Alabama","Baldwin County","API_alone",393,585,192,39.26,"overcount"
"4",1003,"Alabama","Baldwin County","API_combo",393,820,427,70.4,"overcount"
"5",1005,"Alabama","Barbour County","API_alone",58,96,38,49.35,"overcount"
"6",1005,"Alabama","Barbour County","API_combo",58,161,103,94.06,"overcount"
"7",1007,"Alabama","Bibb County","API_alone",20,19,-1,-5.13,"undercount"
"8",1007,"Alabama","Bibb County","API_combo",20,29,9,36.73,"overcount"
"9",1009,"Alabama","Blount County","API_alone",52,94,42,57.53,"overcount"
"10",1009,"Alabama","Blount County","API_combo",52,156,104,100,"overcount"
"11",1011,"Alabama","Bullock County","API_alone",13,23,10,55.56,"overcount"
"12",1011,"Alabama","Bullock County","API_combo",13,43,30,107.14,"overcount"
"13",1013,"Alabama","Butler County","API_alone",20,38,18,62.07,"overcount"
"14",1013,"Alabama","Butler County","API_combo",20,50,30,85.71,"overcount"
"15",1015,"Alabama","Calhoun County","API_alone",1121,738,-383,-41.2,"undercount"
"16",1015,"Alabama","Calhoun County","API_combo",1121,986,-135,-12.81,"undercount"
"17",1017,"Alabama","Chambers County","API_alone",14,70,56,133.33,"overcount"
"18",1017,"Alabama","Chambers County","API_combo",14,112,98,155.56,"overcount"
"19",1019,"Alabama","Cherokee County","API_alone",31,36,5,14.93,"overcount"
"20",1019,"Alabama","Cherokee County","API_combo",31,87,56,94.92,"overcount"
"21",1021,"Alabama","Chilton County","API_alone",53,89,36,50.7,"overcount"
"22",1021,"Alabama","Chilton County","API_combo",53,125,72,80.9,"overcount"
"23",1023,"Alabama","Choctaw County","API_alone",15,7,-8,-72.73,"undercount"
"24",1023,"Alabama","Choctaw County","API_combo",15,17,2,12.5,"overcount"
"25",1025,"Alabama","Clarke County","API_alone",44,47,3,6.59,"overcount"
"26",1025,"Alabama","Clarke County","API_combo",44,69,25,44.25,"overcount"
"27",1027,"Alabama","Clay County","API_alone",16,17,1,6.06,"overcount"
"28",1027,"Alabama","Clay County","API_combo",16,28,12,54.55,"overcount"
"29",1029,"Alabama","Cleburne County","API_alone",19,23,4,19.05,"overcount"
"30",1029,"Alabama","Cleburne County","API_combo",19,36,17,61.82,"overcount"
"31",1031,"Alabama","Coffee County","API_alone",409,476,67,15.14,"overcount"
"32",1031,"Alabama","Coffee County","API_combo",409,660,251,46.96,"overcount"
"33",1033,"Alabama","Colbert County","API_alone",122,148,26,19.26,"overcount"
"34",1033,"Alabama","Colbert County","API_combo",122,216,94,55.62,"overcount"
"35",1035,"Alabama","Conecuh County","API_alone",13,23,10,55.56,"overcount"
"36",1035,"Alabama","Conecuh County","API_combo",13,41,28,103.7,"overcount"
"37",1037,"Alabama","Coosa County","API_alone",5,7,2,33.33,"overcount"
"38",1037,"Alabama","Coosa County","API_combo",5,16,11,104.76,"overcount"
"39",1039,"Alabama","Covington County","API_alone",57,70,13,20.47,"overcount"
"40",1039,"Alabama","Covington County","API_combo",57,107,50,60.98,"overcount"
"41",1041,"Alabama","Crenshaw County","API_alone",12,16,4,28.57,"overcount"
"42",1041,"Alabama","Crenshaw County","API_combo",12,26,14,73.68,"overcount"
"43",1043,"Alabama","Cullman County","API_alone",195,171,-24,-13.11,"undercount"
"44",1043,"Alabama","Cullman County","API_combo",195,270,75,32.26,"overcount"
"45",1045,"Alabama","Dale County","API_alone",954,638,-316,-39.7,"undercount"
"46",1045,"Alabama","Dale County","API_combo",954,953,-1,-0.1,"undercount"
"47",1047,"Alabama","Dallas County","API_alone",153,167,14,8.75,"overcount"
"48",1047,"Alabama","Dallas County","API_combo",153,237,84,43.08,"overcount"
"49",1049,"Alabama","DeKalb County","API_alone",117,169,52,36.36,"overcount"
"50",1049,"Alabama","DeKalb County","API_combo",117,236,119,67.42,"overcount"
"51",1051,"Alabama","Elmore County","API_alone",235,266,31,12.38,"overcount"
"52",1051,"Alabama","Elmore County","API_combo",235,406,171,53.35,"overcount"
"53",1053,"Alabama","Escambia County","API_alone",73,108,35,38.67,"overcount"
"54",1053,"Alabama","Escambia County","API_combo",73,156,83,72.49,"overcount"
"55",1055,"Alabama","Etowah County","API_alone",454,494,40,8.44,"overcount"
"56",1055,"Alabama","Etowah County","API_combo",454,653,199,35.95,"overcount"
"57",1057,"Alabama","Fayette County","API_alone",23,31,8,29.63,"overcount"
"58",1057,"Alabama","Fayette County","API_combo",23,39,16,51.61,"overcount"
"59",1059,"Alabama","Franklin County","API_alone",43,91,48,71.64,"overcount"
"60",1059,"Alabama","Franklin County","API_combo",43,120,77,94.48,"overcount"
"61",1061,"Alabama","Geneva County","API_alone",24,39,15,47.62,"overcount"
"62",1061,"Alabama","Geneva County","API_combo",24,66,42,93.33,"overcount"
"63",1063,"Alabama","Greene County","API_alone",6,10,4,50,"overcount"
"64",1063,"Alabama","Greene County","API_combo",6,18,12,100,"overcount"
"65",1065,"Alabama","Hale County","API_alone",15,31,16,69.57,"overcount"
"66",1065,"Alabama","Hale County","API_combo",15,58,43,117.81,"overcount"
"67",1067,"Alabama","Henry County","API_alone",9,14,5,43.48,"overcount"
"68",1067,"Alabama","Henry County","API_combo",9,39,30,125,"overcount"
"69",1069,"Alabama","Houston County","API_alone",659,575,-84,-13.61,"undercount"
"70",1069,"Alabama","Houston County","API_combo",659,740,81,11.58,"overcount"
"71",1071,"Alabama","Jackson County","API_alone",128,141,13,9.67,"overcount"
"72",1071,"Alabama","Jackson County","API_combo",128,205,77,46.25,"overcount"
"73",1073,"Alabama","Jefferson County","API_alone",3966,6331,2365,45.94,"overcount"
"74",1073,"Alabama","Jefferson County","API_combo",3966,7612,3646,62.98,"overcount"
"75",1075,"Alabama","Lamar County","API_alone",15,11,-4,-30.77,"undercount"
"76",1075,"Alabama","Lamar County","API_combo",15,17,2,12.5,"overcount"
"77",1077,"Alabama","Lauderdale County","API_alone",276,334,58,19.02,"overcount"
"78",1077,"Alabama","Lauderdale County","API_combo",276,422,146,41.83,"overcount"
"79",1079,"Alabama","Lawrence County","API_alone",33,38,5,14.08,"overcount"
"80",1079,"Alabama","Lawrence County","API_combo",33,66,33,66.67,"overcount"
"81",1081,"Alabama","Lee County","API_alone",2200,1918,-282,-13.7,"undercount"
"82",1081,"Alabama","Lee County","API_combo",2200,2270,70,3.13,"overcount"
"83",1083,"Alabama","Limestone County","API_alone",239,254,15,6.09,"overcount"
"84",1083,"Alabama","Limestone County","API_combo",239,339,100,34.6,"overcount"
"85",1085,"Alabama","Lowndes County","API_alone",4,19,15,130.43,"overcount"
"86",1085,"Alabama","Lowndes County","API_combo",4,37,33,160.98,"overcount"
"87",1087,"Alabama","Macon County","API_alone",126,102,-24,-21.05,"undercount"
"88",1087,"Alabama","Macon County","API_combo",126,139,13,9.81,"overcount"
"89",1089,"Alabama","Madison County","API_alone",6240,5393,-847,-14.56,"undercount"
"90",1089,"Alabama","Madison County","API_combo",6240,6676,436,6.75,"overcount"
"91",1091,"Alabama","Marengo County","API_alone",13,44,31,108.77,"overcount"
"92",1091,"Alabama","Marengo County","API_combo",13,63,50,131.58,"overcount"
"93",1093,"Alabama","Marion County","API_alone",53,73,20,31.75,"overcount"
"94",1093,"Alabama","Marion County","API_combo",53,129,76,83.52,"overcount"
"95",1095,"Alabama","Marshall County","API_alone",171,271,100,45.25,"overcount"
"96",1095,"Alabama","Marshall County","API_combo",171,383,212,76.53,"overcount"
"97",1097,"Alabama","Mobile County","API_alone",4450,5840,1390,27.02,"overcount"
"98",1097,"Alabama","Mobile County","API_combo",4450,6851,2401,42.49,"overcount"
"99",1099,"Alabama","Monroe County","API_alone",64,76,12,17.14,"overcount"
"100",1099,"Alabama","Monroe County","API_combo",64,89,25,32.68,"overcount"
"101",1101,"Alabama","Montgomery County","API_alone",1994,2325,331,15.33,"overcount"
"102",1101,"Alabama","Montgomery County","API_combo",1994,3109,1115,43.7,"overcount"
"103",1103,"Alabama","Morgan County","API_alone",536,606,70,12.26,"overcount"
"104",1103,"Alabama","Morgan County","API_combo",536,756,220,34.06,"overcount"
"105",1105,"Alabama","Perry County","API_alone",16,7,-9,-78.26,"undercount"
"106",1105,"Alabama","Perry County","API_combo",16,46,30,96.77,"overcount"
"107",1107,"Alabama","Pickens County","API_alone",35,28,-7,-22.22,"undercount"
"108",1107,"Alabama","Pickens County","API_combo",35,78,43,76.11,"overcount"
"109",1109,"Alabama","Pike County","API_alone",95,116,21,19.91,"overcount"
"110",1109,"Alabama","Pike County","API_combo",95,182,87,62.82,"overcount"
"111",1111,"Alabama","Randolph County","API_alone",26,52,26,66.67,"overcount"
"112",1111,"Alabama","Randolph County","API_combo",26,67,41,88.17,"overcount"
"113",1113,"Alabama","Russell County","API_alone",164,238,74,36.82,"overcount"
"114",1113,"Alabama","Russell County","API_combo",164,405,241,84.71,"overcount"
"115",1115,"Alabama","St. Clair County","API_alone",135,132,-3,-2.25,"undercount"
"116",1115,"Alabama","St. Clair County","API_combo",135,201,66,39.29,"overcount"
"117",1117,"Alabama","Shelby County","API_alone",1138,1536,398,29.77,"overcount"
"118",1117,"Alabama","Shelby County","API_combo",1138,1809,671,45.54,"overcount"
"119",1119,"Alabama","Sumter County","API_alone",39,17,-22,-78.57,"undercount"
"120",1119,"Alabama","Sumter County","API_combo",39,34,-5,-13.7,"undercount"
"121",1121,"Alabama","Talladega County","API_alone",150,186,36,21.43,"overcount"
"122",1121,"Alabama","Talladega County","API_combo",150,300,150,66.67,"overcount"
"123",1123,"Alabama","Tallapoosa County","API_alone",52,83,31,45.93,"overcount"
"124",1123,"Alabama","Tallapoosa County","API_combo",52,125,73,82.49,"overcount"
"125",1125,"Alabama","Tuscaloosa County","API_alone",1596,1598,2,0.13,"overcount"
"126",1125,"Alabama","Tuscaloosa County","API_combo",1596,1949,353,19.92,"overcount"
"127",1127,"Alabama","Walker County","API_alone",155,163,8,5.03,"overcount"
"128",1127,"Alabama","Walker County","API_combo",155,238,83,42.24,"overcount"
"129",1129,"Alabama","Washington County","API_alone",17,16,-1,-6.06,"undercount"
"130",1129,"Alabama","Washington County","API_combo",17,46,29,92.06,"overcount"
"131",1131,"Alabama","Wilcox County","API_alone",4,19,15,130.43,"overcount"
"132",1131,"Alabama","Wilcox County","API_combo",4,25,21,144.83,"overcount"
"133",1133,"Alabama","Winston County","API_alone",43,37,-6,-15,"undercount"
"134",1133,"Alabama","Winston County","API_combo",43,68,25,45.05,"overcount"
"135",2013,"Alaska","Aleutians East Borough","API_alone",401,729,328,58.05,"overcount"
"136",2013,"Alaska","Aleutians East Borough","API_combo",401,763,362,62.2,"overcount"
"137",2016,"Alaska","Aleutians West Census Area","API_alone",696,1387,691,66.35,"overcount"
"138",2016,"Alaska","Aleutians West Census Area","API_combo",696,1481,785,72.12,"overcount"
"139",2020,"Alaska","Anchorage Municipality","API_alone",17024,17319,295,1.72,"overcount"
"140",2020,"Alaska","Anchorage Municipality","API_combo",17024,22190,5166,26.35,"overcount"
"141",2050,"Alaska","Bethel Census Area","API_alone",135,178,43,27.48,"overcount"
"142",2050,"Alaska","Bethel Census Area","API_combo",135,240,105,56,"overcount"
"143",2060,"Alaska","Bristol Bay Borough","API_alone",8,11,3,31.58,"overcount"
"144",2060,"Alaska","Bristol Bay Borough","API_combo",8,25,17,103.03,"overcount"
"145",2068,"Alaska","Denali Borough","API_alone",19,37,18,64.29,"overcount"
"146",2068,"Alaska","Denali Borough","API_combo",19,51,32,91.43,"overcount"
"147",2070,"Alaska","Dillingham Census Area","API_alone",40,33,-7,-19.18,"undercount"
"148",2070,"Alaska","Dillingham Census Area","API_combo",40,73,33,58.41,"overcount"
"149",2090,"Alaska","Fairbanks North Star Borough","API_alone",2942,2039,-903,-36.26,"undercount"
"150",2090,"Alaska","Fairbanks North Star Borough","API_combo",2942,3189,247,8.06,"overcount"
"151",2100,"Alaska","Haines Borough","API_alone",26,19,-7,-31.11,"undercount"
"152",2100,"Alaska","Haines Borough","API_combo",26,31,5,17.54,"overcount"
"153",2110,"Alaska","Juneau City and Borough","API_alone",1766,1590,-176,-10.49,"undercount"
"154",2110,"Alaska","Juneau City and Borough","API_combo",1766,2291,525,25.88,"overcount"
"155",2122,"Alaska","Kenai Peninsula Borough","API_alone",695,576,-119,-18.73,"undercount"
"156",2122,"Alaska","Kenai Peninsula Borough","API_combo",695,1025,330,38.37,"overcount"
"157",2130,"Alaska","Ketchikan Gateway Borough","API_alone",697,632,-65,-9.78,"undercount"
"158",2130,"Alaska","Ketchikan Gateway Borough","API_combo",697,808,111,14.75,"overcount"
"159",2150,"Alaska","Kodiak Island Borough","API_alone",2277,2367,90,3.88,"overcount"
"160",2150,"Alaska","Kodiak Island Borough","API_combo",2277,2644,367,14.92,"overcount"
"161",2164,"Alaska","Lake and Peninsula Borough","API_alone",10,11,1,9.52,"overcount"
"162",2164,"Alaska","Lake and Peninsula Borough","API_combo",10,15,5,40,"overcount"
"163",2170,"Alaska","Matanuska-Susitna Borough","API_alone",600,509,-91,-16.41,"undercount"
"164",2170,"Alaska","Matanuska-Susitna Borough","API_combo",600,1069,469,56.2,"overcount"
"165",2180,"Alaska","Nome Census Area","API_alone",67,64,-3,-4.58,"undercount"
"166",2180,"Alaska","Nome Census Area","API_combo",67,98,31,37.58,"overcount"
"167",2185,"Alaska","North Slope Borough","API_alone",429,500,71,15.29,"overcount"
"168",2185,"Alaska","North Slope Borough","API_combo",429,630,201,37.96,"overcount"
"169",2188,"Alaska","Northwest Arctic Borough","API_alone",71,68,-3,-4.32,"undercount"
"170",2188,"Alaska","Northwest Arctic Borough","API_combo",71,99,28,32.94,"overcount"
"171",2201,"Alaska","Prince of Wales-Outer Ketchikan Census Area","API_alone",39,27,-12,-36.36,"undercount"
"172",2201,"Alaska","Prince of Wales-Outer Ketchikan Census Area","API_combo",39,89,50,78.12,"overcount"
"173",2220,"Alaska","Sitka City and Borough","API_alone",399,382,-17,-4.35,"undercount"
"174",2220,"Alaska","Sitka City and Borough","API_combo",399,525,126,27.27,"overcount"
"175",2232,"Alaska","Skagway-Hoonah-Angoon Census Area","API_alone",28,18,-10,-43.48,"undercount"
"176",2232,"Alaska","Skagway-Hoonah-Angoon Census Area","API_combo",28,50,22,56.41,"overcount"
"177",2240,"Alaska","Southeast Fairbanks Census Area","API_alone",104,53,-51,-64.97,"undercount"
"178",2240,"Alaska","Southeast Fairbanks Census Area","API_combo",104,94,-10,-10.1,"undercount"
"179",2261,"Alaska","Valdez-Cordova Census Area","API_alone",446,399,-47,-11.12,"undercount"
"180",2261,"Alaska","Valdez-Cordova Census Area","API_combo",446,540,94,19.07,"overcount"
"181",2270,"Alaska","Wade Hampton Census Area","API_alone",41,9,-32,-128,"undercount"
"182",2270,"Alaska","Wade Hampton Census Area","API_combo",41,22,-19,-60.32,"undercount"
"183",2280,"Alaska","Wrangell-Petersburg Census Area","API_alone",122,119,-3,-2.49,"undercount"
"184",2280,"Alaska","Wrangell-Petersburg Census Area","API_combo",122,248,126,68.11,"overcount"
"185",2282,"Alaska","Yakutat City and Borough","API_alone",26,16,-10,-47.62,"undercount"
"186",2282,"Alaska","Yakutat City and Borough","API_combo",26,47,21,57.53,"overcount"
"187",2290,"Alaska","Yukon-Koyukuk Census Area","API_alone",40,28,-12,-35.29,"undercount"
"188",2290,"Alaska","Yukon-Koyukuk Census Area","API_combo",40,49,9,20.22,"overcount"
"189",4001,"Arizona","Apache County","API_alone",176,146,-30,-18.63,"undercount"
"190",4001,"Arizona","Apache County","API_combo",176,239,63,30.36,"overcount"
"191",4003,"Arizona","Cochise County","API_alone",3711,2388,-1323,-43.38,"undercount"
"192",4003,"Arizona","Cochise County","API_combo",3711,3567,-144,-3.96,"undercount"
"193",4005,"Arizona","Coconino County","API_alone",1479,1088,-391,-30.46,"undercount"
"194",4005,"Arizona","Coconino County","API_combo",1479,1533,54,3.59,"overcount"
"195",4007,"Arizona","Gila County","API_alone",290,266,-24,-8.63,"undercount"
"196",4007,"Arizona","Gila County","API_combo",290,363,73,22.36,"overcount"
"197",4009,"Arizona","Graham County","API_alone",179,241,62,29.52,"overcount"
"198",4009,"Arizona","Graham County","API_combo",179,333,154,60.16,"overcount"
"199",4011,"Arizona","Greenlee County","API_alone",34,31,-3,-9.23,"undercount"
"200",4011,"Arizona","Greenlee County","API_combo",34,38,4,11.11,"overcount"
"201",4012,"Arizona","La Paz County","API_alone",170,105,-65,-47.27,"undercount"
"202",4012,"Arizona","La Paz County","API_combo",170,147,-23,-14.51,"undercount"
"203",4013,"Arizona","Maricopa County","API_alone",74426,75655,1229,1.64,"overcount"
"204",4013,"Arizona","Maricopa County","API_combo",74426,94584,20158,23.85,"overcount"
"205",4015,"Arizona","Mohave County","API_alone",1380,1442,62,4.39,"overcount"
"206",4015,"Arizona","Mohave County","API_combo",1380,2094,714,41.11,"overcount"
"207",4017,"Arizona","Navajo County","API_alone",538,395,-143,-30.65,"undercount"
"208",4017,"Arizona","Navajo County","API_combo",538,590,52,9.22,"overcount"
"209",4019,"Arizona","Pima County","API_alone",20773,19599,-1174,-5.82,"undercount"
"210",4019,"Arizona","Pima County","API_combo",20773,25022,4249,18.56,"overcount"
"211",4021,"Arizona","Pinal County","API_alone",1089,1484,395,30.7,"overcount"
"212",4021,"Arizona","Pinal County","API_combo",1089,2035,946,60.56,"overcount"
"213",4023,"Arizona","Santa Cruz County","API_alone",302,285,-17,-5.79,"undercount"
"214",4023,"Arizona","Santa Cruz County","API_combo",302,332,30,9.46,"overcount"
"215",4025,"Arizona","Yavapai County","API_alone",1020,1035,15,1.46,"overcount"
"216",4025,"Arizona","Yavapai County","API_combo",1020,1720,700,51.09,"overcount"
"217",4027,"Arizona","Yuma County","API_alone",2685,2068,-617,-25.96,"undercount"
"218",4027,"Arizona","Yuma County","API_combo",2685,2819,134,4.87,"overcount"
"219",5001,"Arkansas","Arkansas County","API_alone",41,75,34,58.62,"overcount"
"220",5001,"Arkansas","Arkansas County","API_combo",41,111,70,92.11,"overcount"
"221",5003,"Arkansas","Ashley County","API_alone",72,64,-8,-11.76,"undercount"
"222",5003,"Arkansas","Ashley County","API_combo",72,97,25,29.59,"overcount"
"223",5005,"Arkansas","Baxter County","API_alone",112,140,28,22.22,"overcount"
"224",5005,"Arkansas","Baxter County","API_combo",112,219,107,64.65,"overcount"
"225",5007,"Arkansas","Benton County","API_alone",989,1907,918,63.4,"overcount"
"226",5007,"Arkansas","Benton County","API_combo",989,2280,1291,78.98,"overcount"
"227",5009,"Arkansas","Boone County","API_alone",90,118,28,26.92,"overcount"
"228",5009,"Arkansas","Boone County","API_combo",90,167,77,59.92,"overcount"
"229",5011,"Arkansas","Bradley County","API_alone",3,17,14,140,"overcount"
"230",5011,"Arkansas","Bradley County","API_combo",3,22,19,152,"overcount"
"231",5013,"Arkansas","Calhoun County","API_alone",11,2,-9,-138.46,"undercount"
"232",5013,"Arkansas","Calhoun County","API_combo",11,13,2,16.67,"overcount"
"233",5015,"Arkansas","Carroll County","API_alone",107,129,22,18.64,"overcount"
"234",5015,"Arkansas","Carroll County","API_combo",107,156,49,37.26,"overcount"
"235",5017,"Arkansas","Chicot County","API_alone",83,65,-18,-24.32,"undercount"
"236",5017,"Arkansas","Chicot County","API_combo",83,112,29,29.74,"overcount"
"237",5019,"Arkansas","Clark County","API_alone",100,159,59,45.56,"overcount"
"238",5019,"Arkansas","Clark County","API_combo",100,220,120,75,"overcount"
"239",5021,"Arkansas","Clay County","API_alone",20,14,-6,-35.29,"undercount"
"240",5021,"Arkansas","Clay County","API_combo",20,35,15,54.55,"overcount"
"241",5023,"Arkansas","Cleburne County","API_alone",41,41,0,0,"equal"
"242",5023,"Arkansas","Cleburne County","API_combo",41,70,29,52.25,"overcount"
"243",5025,"Arkansas","Cleveland County","API_alone",19,15,-4,-23.53,"undercount"
"244",5025,"Arkansas","Cleveland County","API_combo",19,41,22,73.33,"overcount"
"245",5027,"Arkansas","Columbia County","API_alone",73,96,23,27.22,"overcount"
"246",5027,"Arkansas","Columbia County","API_combo",73,135,62,59.62,"overcount"
"247",5029,"Arkansas","Conway County","API_alone",40,57,17,35.05,"overcount"
"248",5029,"Arkansas","Conway County","API_combo",40,84,44,70.97,"overcount"
"249",5031,"Arkansas","Craighead County","API_alone",605,526,-79,-13.97,"undercount"
"250",5031,"Arkansas","Craighead County","API_combo",605,700,95,14.56,"overcount"
"251",5033,"Arkansas","Crawford County","API_alone",709,677,-32,-4.62,"undercount"
"252",5033,"Arkansas","Crawford County","API_combo",709,815,106,13.91,"overcount"
"253",5035,"Arkansas","Crittenden County","API_alone",263,251,-12,-4.67,"undercount"
"254",5035,"Arkansas","Crittenden County","API_combo",263,326,63,21.39,"overcount"
"255",5037,"Arkansas","Cross County","API_alone",56,63,7,11.76,"overcount"
"256",5037,"Arkansas","Cross County","API_combo",56,93,37,49.66,"overcount"
"257",5039,"Arkansas","Dallas County","API_alone",12,24,12,66.67,"overcount"
"258",5039,"Arkansas","Dallas County","API_combo",12,36,24,100,"overcount"
"259",5041,"Arkansas","Desha County","API_alone",41,50,9,19.78,"overcount"
"260",5041,"Arkansas","Desha County","API_combo",41,78,37,62.18,"overcount"
"261",5043,"Arkansas","Drew County","API_alone",40,84,44,70.97,"overcount"
"262",5043,"Arkansas","Drew County","API_combo",40,109,69,92.62,"overcount"
"263",5045,"Arkansas","Faulkner County","API_alone",414,672,258,47.51,"overcount"
"264",5045,"Arkansas","Faulkner County","API_combo",414,866,452,70.62,"overcount"
"265",5047,"Arkansas","Franklin County","API_alone",44,58,14,27.45,"overcount"
"266",5047,"Arkansas","Franklin County","API_combo",44,81,37,59.2,"overcount"
"267",5049,"Arkansas","Fulton County","API_alone",17,25,8,38.1,"overcount"
"268",5049,"Arkansas","Fulton County","API_combo",17,34,17,66.67,"overcount"
"269",5051,"Arkansas","Garland County","API_alone",388,476,88,20.37,"overcount"
"270",5051,"Arkansas","Garland County","API_combo",388,642,254,49.32,"overcount"
"271",5053,"Arkansas","Grant County","API_alone",37,27,-10,-31.25,"undercount"
"272",5053,"Arkansas","Grant County","API_combo",37,48,11,25.88,"overcount"
"273",5055,"Arkansas","Greene County","API_alone",107,72,-35,-39.11,"undercount"
"274",5055,"Arkansas","Greene County","API_combo",107,116,9,8.07,"overcount"
"275",5057,"Arkansas","Hempstead County","API_alone",69,70,1,1.44,"overcount"
"276",5057,"Arkansas","Hempstead County","API_combo",69,101,32,37.65,"overcount"
"277",5059,"Arkansas","Hot Spring County","API_alone",61,80,19,26.95,"overcount"
"278",5059,"Arkansas","Hot Spring County","API_combo",61,120,59,65.19,"overcount"
"279",5061,"Arkansas","Howard County","API_alone",92,73,-19,-23.03,"undercount"
"280",5061,"Arkansas","Howard County","API_combo",92,85,-7,-7.91,"undercount"
"281",5063,"Arkansas","Independence County","API_alone",220,239,19,8.28,"overcount"
"282",5063,"Arkansas","Independence County","API_combo",220,296,76,29.46,"overcount"
"283",5065,"Arkansas","Izard County","API_alone",38,18,-20,-71.43,"undercount"
"284",5065,"Arkansas","Izard County","API_combo",38,33,-5,-14.08,"undercount"
"285",5067,"Arkansas","Jackson County","API_alone",30,34,4,12.5,"overcount"
"286",5067,"Arkansas","Jackson County","API_combo",30,61,31,68.13,"overcount"
"287",5069,"Arkansas","Jefferson County","API_alone",463,615,152,28.2,"overcount"
"288",5069,"Arkansas","Jefferson County","API_combo",463,748,285,47.07,"overcount"
"289",5071,"Arkansas","Johnson County","API_alone",135,88,-47,-42.15,"undercount"
"290",5071,"Arkansas","Johnson County","API_combo",135,120,-15,-11.76,"undercount"
"291",5073,"Arkansas","Lafayette County","API_alone",20,20,0,0,"equal"
"292",5073,"Arkansas","Lafayette County","API_combo",20,34,14,51.85,"overcount"
"293",5075,"Arkansas","Lawrence County","API_alone",35,12,-23,-97.87,"undercount"
"294",5075,"Arkansas","Lawrence County","API_combo",35,45,10,25,"overcount"
"295",5077,"Arkansas","Lee County","API_alone",60,42,-18,-35.29,"undercount"
"296",5077,"Arkansas","Lee County","API_combo",60,59,-1,-1.68,"undercount"
"297",5079,"Arkansas","Lincoln County","API_alone",32,12,-20,-90.91,"undercount"
"298",5079,"Arkansas","Lincoln County","API_combo",32,25,-7,-24.56,"undercount"
"299",5081,"Arkansas","Little River County","API_alone",23,31,8,29.63,"overcount"
"300",5081,"Arkansas","Little River County","API_combo",23,49,26,72.22,"overcount"
"301",5083,"Arkansas","Logan County","API_alone",40,38,-2,-5.13,"undercount"
"302",5083,"Arkansas","Logan County","API_combo",40,70,30,54.55,"overcount"
"303",5085,"Arkansas","Lonoke County","API_alone",244,243,-1,-0.41,"undercount"
"304",5085,"Arkansas","Lonoke County","API_combo",244,415,171,51.9,"overcount"
"305",5087,"Arkansas","Madison County","API_alone",31,22,-9,-33.96,"undercount"
"306",5087,"Arkansas","Madison County","API_combo",31,36,5,14.93,"overcount"
"307",5089,"Arkansas","Marion County","API_alone",49,40,-9,-20.22,"undercount"
"308",5089,"Arkansas","Marion County","API_combo",49,73,24,39.34,"overcount"
"309",5091,"Arkansas","Miller County","API_alone",204,160,-44,-24.18,"undercount"
"310",5091,"Arkansas","Miller County","API_combo",204,217,13,6.18,"overcount"
"311",5093,"Arkansas","Mississippi County","API_alone",421,218,-203,-63.54,"undercount"
"312",5093,"Arkansas","Mississippi County","API_combo",421,336,-85,-22.46,"undercount"
"313",5095,"Arkansas","Monroe County","API_alone",27,17,-10,-45.45,"undercount"
"314",5095,"Arkansas","Monroe County","API_combo",27,42,15,43.48,"overcount"
"315",5097,"Arkansas","Montgomery County","API_alone",14,35,21,85.71,"overcount"
"316",5097,"Arkansas","Montgomery County","API_combo",14,45,31,105.08,"overcount"
"317",5099,"Arkansas","Nevada County","API_alone",6,7,1,15.38,"overcount"
"318",5099,"Arkansas","Nevada County","API_combo",6,16,10,90.91,"overcount"
"319",5101,"Arkansas","Newton County","API_alone",34,15,-19,-77.55,"undercount"
"320",5101,"Arkansas","Newton County","API_combo",34,30,-4,-12.5,"undercount"
"321",5103,"Arkansas","Ouachita County","API_alone",75,80,5,6.45,"overcount"
"322",5103,"Arkansas","Ouachita County","API_combo",75,116,41,42.93,"overcount"
"323",5105,"Arkansas","Perry County","API_alone",27,17,-10,-45.45,"undercount"
"324",5105,"Arkansas","Perry County","API_combo",27,28,1,3.64,"overcount"
"325",5107,"Arkansas","Phillips County","API_alone",102,93,-9,-9.23,"undercount"
"326",5107,"Arkansas","Phillips County","API_combo",102,136,34,28.57,"overcount"
"327",5109,"Arkansas","Pike County","API_alone",11,20,9,58.06,"overcount"
"328",5109,"Arkansas","Pike County","API_combo",11,33,22,100,"overcount"
"329",5111,"Arkansas","Poinsett County","API_alone",68,46,-22,-38.6,"undercount"
"330",5111,"Arkansas","Poinsett County","API_combo",68,74,6,8.45,"overcount"
"331",5113,"Arkansas","Polk County","API_alone",55,56,1,1.8,"overcount"
"332",5113,"Arkansas","Polk County","API_combo",55,74,19,29.46,"overcount"
"333",5115,"Arkansas","Pope County","API_alone",360,390,30,8,"overcount"
"334",5115,"Arkansas","Pope County","API_combo",360,490,130,30.59,"overcount"
"335",5117,"Arkansas","Prairie County","API_alone",5,17,12,109.09,"overcount"
"336",5117,"Arkansas","Prairie County","API_combo",5,22,17,125.93,"overcount"
"337",5119,"Arkansas","Pulaski County","API_alone",3853,4746,893,20.77,"overcount"
"338",5119,"Arkansas","Pulaski County","API_combo",3853,5986,2133,43.36,"overcount"
"339",5121,"Arkansas","Randolph County","API_alone",31,17,-14,-58.33,"undercount"
"340",5121,"Arkansas","Randolph County","API_combo",31,48,17,43.04,"overcount"
"341",5123,"Arkansas","St. Francis County","API_alone",173,171,-2,-1.16,"undercount"
"342",5123,"Arkansas","St. Francis County","API_combo",173,218,45,23.02,"overcount"
"343",5125,"Arkansas","Saline County","API_alone",454,509,55,11.42,"overcount"
"344",5125,"Arkansas","Saline County","API_combo",454,696,242,42.09,"overcount"
"345",5127,"Arkansas","Scott County","API_alone",84,110,26,26.8,"overcount"
"346",5127,"Arkansas","Scott County","API_combo",84,122,38,36.89,"overcount"
"347",5129,"Arkansas","Searcy County","API_alone",21,14,-7,-40,"undercount"
"348",5129,"Arkansas","Searcy County","API_combo",21,26,5,21.28,"overcount"
"349",5131,"Arkansas","Sebastian County","API_alone",5069,4226,-843,-18.14,"undercount"
"350",5131,"Arkansas","Sebastian County","API_combo",5069,4693,-376,-7.7,"undercount"
"351",5133,"Arkansas","Sevier County","API_alone",23,30,7,26.42,"overcount"
"352",5133,"Arkansas","Sevier County","API_combo",23,44,21,62.69,"overcount"
"353",5135,"Arkansas","Sharp County","API_alone",49,26,-23,-61.33,"undercount"
"354",5135,"Arkansas","Sharp County","API_combo",49,34,-15,-36.14,"undercount"
"355",5137,"Arkansas","Stone County","API_alone",36,10,-26,-113.04,"undercount"
"356",5137,"Arkansas","Stone County","API_combo",36,38,2,5.41,"overcount"
"357",5139,"Arkansas","Union County","API_alone",124,189,65,41.53,"overcount"
"358",5139,"Arkansas","Union County","API_combo",124,285,161,78.73,"overcount"
"359",5141,"Arkansas","Van Buren County","API_alone",46,53,7,14.14,"overcount"
"360",5141,"Arkansas","Van Buren County","API_combo",46,82,36,56.25,"overcount"
"361",5143,"Arkansas","Washington County","API_alone",1943,3469,1526,56.39,"overcount"
"362",5143,"Arkansas","Washington County","API_combo",1943,4191,2248,73.3,"overcount"
"363",5145,"Arkansas","White County","API_alone",215,245,30,13.04,"overcount"
"364",5145,"Arkansas","White County","API_combo",215,338,123,44.48,"overcount"
"365",5147,"Arkansas","Woodruff County","API_alone",12,15,3,22.22,"overcount"
"366",5147,"Arkansas","Woodruff County","API_combo",12,19,7,45.16,"overcount"
"367",5149,"Arkansas","Yell County","API_alone",160,182,22,12.87,"overcount"
"368",5149,"Arkansas","Yell County","API_combo",160,219,59,31.13,"overcount"
"369",6001,"California","Alameda County","API_alone",285589,312235,26646,8.91,"overcount"
"370",6001,"California","Alameda County","API_combo",285589,347068,61479,19.44,"overcount"
"371",6003,"California","Alpine County","API_alone",9,5,-4,-57.14,"undercount"
"372",6003,"California","Alpine County","API_combo",9,25,16,94.12,"overcount"
"373",6005,"California","Amador County","API_alone",388,414,26,6.48,"overcount"
"374",6005,"California","Amador County","API_combo",388,605,217,43.71,"overcount"
"375",6007,"California","Butte County","API_alone",8245,7453,-792,-10.09,"undercount"
"376",6007,"California","Butte County","API_combo",8245,9116,871,10.03,"overcount"
"377",6009,"California","Calaveras County","API_alone",405,400,-5,-1.24,"undercount"
"378",6009,"California","Calaveras County","API_combo",405,681,276,50.83,"overcount"
"379",6011,"California","Colusa County","API_alone",583,368,-215,-45.22,"undercount"
"380",6011,"California","Colusa County","API_combo",583,513,-70,-12.77,"undercount"
"381",6013,"California","Contra Costa County","API_alone",126869,111209,-15660,-13.16,"undercount"
"382",6013,"California","Contra Costa County","API_combo",126869,130402,3533,2.75,"overcount"
"383",6015,"California","Del Norte County","API_alone",778,683,-95,-13,"undercount"
"384",6015,"California","Del Norte County","API_combo",778,895,117,13.99,"overcount"
"385",6017,"California","El Dorado County","API_alone",4780,3666,-1114,-26.38,"undercount"
"386",6017,"California","El Dorado County","API_combo",4780,5114,334,6.75,"overcount"
"387",6019,"California","Fresno County","API_alone",86026,70172,-15854,-20.3,"undercount"
"388",6019,"California","Fresno County","API_combo",86026,77420,-8606,-10.53,"undercount"
"389",6021,"California","Glenn County","API_alone",1207,986,-221,-20.16,"undercount"
"390",6021,"California","Glenn County","API_combo",1207,1123,-84,-7.21,"undercount"
"391",6023,"California","Humboldt County","API_alone",3489,2421,-1068,-36.14,"undercount"
"392",6023,"California","Humboldt County","API_combo",3489,3526,37,1.05,"overcount"
"393",6025,"California","Imperial County","API_alone",3953,3704,-249,-6.5,"undercount"
"394",6025,"California","Imperial County","API_combo",3953,4361,408,9.81,"overcount"
"395",6027,"California","Inyo County","API_alone",260,190,-70,-31.11,"undercount"
"396",6027,"California","Inyo County","API_combo",260,266,6,2.28,"overcount"
"397",6029,"California","Kern County","API_alone",31347,25641,-5706,-20.03,"undercount"
"398",6029,"California","Kern County","API_combo",31347,30406,-941,-3.05,"undercount"
"399",6031,"California","Kings County","API_alone",5919,4524,-1395,-26.72,"undercount"
"400",6031,"California","Kings County","API_combo",5919,5895,-24,-0.41,"undercount"
"401",6033,"California","Lake County","API_alone",843,613,-230,-31.59,"undercount"
"402",6033,"California","Lake County","API_combo",843,986,143,15.64,"overcount"
"403",6035,"California","Lassen County","API_alone",543,425,-118,-24.38,"undercount"
"404",6035,"California","Lassen County","API_combo",543,586,43,7.62,"overcount"
"405",6037,"California","Los Angeles County","API_alone",1285291,1207397,-77894,-6.25,"undercount"
"406",6037,"California","Los Angeles County","API_combo",1285291,1311755,26464,2.04,"overcount"
"407",6039,"California","Madera County","API_alone",2403,2167,-236,-10.33,"undercount"
"408",6039,"California","Madera County","API_combo",2403,2973,570,21.21,"overcount"
"409",6041,"California","Marin County","API_alone",14271,11970,-2301,-17.54,"undercount"
"410",6041,"California","Marin County","API_combo",14271,15342,1071,7.23,"overcount"
"411",6043,"California","Mariposa County","API_alone",214,150,-64,-35.16,"undercount"
"412",6043,"California","Mariposa County","API_combo",214,263,49,20.55,"overcount"
"413",6045,"California","Mendocino County","API_alone",1387,1278,-109,-8.18,"undercount"
"414",6045,"California","Mendocino County","API_combo",1387,1867,480,29.5,"overcount"
"415",6047,"California","Merced County","API_alone",22172,15804,-6368,-33.54,"undercount"
"416",6047,"California","Merced County","API_combo",22172,18273,-3899,-19.28,"undercount"
"417",6049,"California","Modoc County","API_alone",53,67,14,23.33,"overcount"
"418",6049,"California","Modoc County","API_combo",53,111,58,70.73,"overcount"
"419",6051,"California","Mono County","API_alone",204,173,-31,-16.45,"undercount"
"420",6051,"California","Mono County","API_combo",204,262,58,24.89,"overcount"
"421",6053,"California","Monterey County","API_alone",39255,28022,-11233,-33.39,"undercount"
"422",6053,"California","Monterey County","API_combo",39255,35289,-3966,-10.64,"undercount"
"423",6055,"California","Napa County","API_alone",5542,4183,-1359,-27.95,"undercount"
"424",6055,"California","Napa County","API_combo",5542,5533,-9,-0.16,"undercount"
"425",6057,"California","Nevada County","API_alone",1135,850,-285,-28.72,"undercount"
"426",6057,"California","Nevada County","API_combo",1135,1461,326,25.12,"overcount"
"427",6059,"California","Orange County","API_alone",386487,405288,18801,4.75,"overcount"
"428",6059,"California","Orange County","API_combo",386487,444171,57684,13.89,"overcount"
"429",6061,"California","Placer County","API_alone",7888,7981,93,1.17,"overcount"
"430",6061,"California","Placer County","API_combo",7888,10868,2980,31.78,"overcount"
"431",6063,"California","Plumas County","API_alone",176,133,-43,-27.83,"undercount"
"432",6063,"California","Plumas County","API_combo",176,231,55,27.03,"overcount"
"433",6065,"California","Riverside County","API_alone",76618,65470,-11148,-15.69,"undercount"
"434",6065,"California","Riverside County","API_combo",76618,81053,4435,5.63,"overcount"
"435",6067,"California","Sacramento County","API_alone",159070,148800,-10270,-6.67,"undercount"
"436",6067,"California","Sacramento County","API_combo",159070,175089,16019,9.59,"overcount"
"437",6069,"California","San Benito County","API_alone",1608,1630,22,1.36,"overcount"
"438",6069,"California","San Benito County","API_combo",1608,2301,693,35.46,"overcount"
"439",6071,"California","San Bernardino County","API_alone",97640,91582,-6058,-6.4,"undercount"
"440",6071,"California","San Bernardino County","API_combo",97640,109272,11632,11.24,"overcount"
"441",6073,"California","San Diego County","API_alone",315229,273457,-41772,-14.19,"undercount"
"442",6073,"California","San Diego County","API_combo",315229,323637,8408,2.63,"overcount"
"443",6075,"California","San Francisco County","API_alone",282556,246867,-35689,-13.48,"undercount"
"444",6075,"California","San Francisco County","API_combo",282556,260957,-21599,-7.95,"undercount"
"445",6077,"California","San Joaquin County","API_alone",93318,71173,-22145,-26.93,"undercount"
"446",6077,"California","San Joaquin County","API_combo",93318,82569,-10749,-12.22,"undercount"
"447",6079,"California","San Luis Obispo County","API_alone",9561,7260,-2301,-27.36,"undercount"
"448",6079,"California","San Luis Obispo County","API_combo",9561,9745,184,1.91,"overcount"
"449",6081,"California","San Mateo County","API_alone",158847,155094,-3753,-2.39,"undercount"
"450",6081,"California","San Mateo County","API_combo",158847,171920,13073,7.9,"overcount"
"451",6083,"California","Santa Barbara County","API_alone",24360,18168,-6192,-29.12,"undercount"
"452",6083,"California","Santa Barbara County","API_combo",24360,22995,-1365,-5.76,"undercount"
"453",6085,"California","Santa Clara County","API_alone",380324,445015,64691,15.68,"overcount"
"454",6085,"California","Santa Clara County","API_combo",380324,477489,97165,22.65,"overcount"
"455",6087,"California","Santa Cruz County","API_alone",13113,9896,-3217,-27.96,"undercount"
"456",6087,"California","Santa Cruz County","API_combo",13113,13282,169,1.28,"overcount"
"457",6089,"California","Shasta County","API_alone",4451,3388,-1063,-27.12,"undercount"
"458",6089,"California","Shasta County","API_combo",4451,4425,-26,-0.59,"undercount"
"459",6091,"California","Sierra County","API_alone",16,9,-7,-56,"undercount"
"460",6091,"California","Sierra County","API_combo",16,31,15,63.83,"overcount"
"461",6093,"California","Siskiyou County","API_alone",555,608,53,9.11,"overcount"
"462",6093,"California","Siskiyou County","API_combo",555,839,284,40.75,"overcount"
"463",6095,"California","Solano County","API_alone",69356,55280,-14076,-22.59,"undercount"
"464",6095,"California","Solano County","API_combo",69356,67395,-1961,-2.87,"undercount"
"465",6097,"California","Sonoma County","API_alone",18057,15937,-2120,-12.47,"undercount"
"466",6097,"California","Sonoma County","API_combo",18057,21528,3471,17.54,"overcount"
"467",6099,"California","Stanislaus County","API_alone",31624,22573,-9051,-33.4,"undercount"
"468",6099,"California","Stanislaus County","API_combo",31624,28767,-2857,-9.46,"undercount"
"469",6101,"California","Sutter County","API_alone",10647,9685,-962,-9.46,"undercount"
"470",6101,"California","Sutter County","API_combo",10647,10699,52,0.49,"overcount"
"471",6103,"California","Tehama County","API_alone",602,544,-58,-10.12,"undercount"
"472",6103,"California","Tehama County","API_combo",602,810,208,29.46,"overcount"
"473",6105,"California","Trinity County","API_alone",140,85,-55,-48.89,"undercount"
"474",6105,"California","Trinity County","API_combo",140,165,25,16.39,"overcount"
"475",6107,"California","Tulare County","API_alone",22439,13871,-8568,-47.19,"undercount"
"476",6107,"California","Tulare County","API_combo",22439,16218,-6221,-32.19,"undercount"
"477",6109,"California","Tuolumne County","API_alone",659,498,-161,-27.83,"undercount"
"478",6109,"California","Tuolumne County","API_combo",659,874,215,28.05,"overcount"
"479",6111,"California","Ventura County","API_alone",53353,44180,-9173,-18.81,"undercount"
"480",6111,"California","Ventura County","API_combo",53353,53491,138,0.26,"overcount"
"481",6113,"California","Yolo County","API_alone",16890,17965,1075,6.17,"overcount"
"482",6113,"California","Yolo County","API_combo",16890,21028,4138,21.83,"overcount"
"483",6115,"California","Yuba County","API_alone",7228,4859,-2369,-39.2,"undercount"
"484",6115,"California","Yuba County","API_combo",7228,5703,-1525,-23.59,"undercount"
"485",8001,"Colorado","Adams County","API_alone",12152,12732,580,4.66,"overcount"
"486",8001,"Colorado","Adams County","API_combo",12152,15126,2974,21.81,"overcount"
"487",8003,"Colorado","Alamosa County","API_alone",204,172,-32,-17.02,"undercount"
"488",8003,"Colorado","Alamosa County","API_combo",204,241,37,16.63,"overcount"
"489",8005,"Colorado","Arapahoe County","API_alone",19436,20376,940,4.72,"overcount"
"490",8005,"Colorado","Arapahoe County","API_combo",19436,24702,5266,23.86,"overcount"
"491",8007,"Colorado","Archuleta County","API_alone",73,34,-39,-72.9,"undercount"
"492",8007,"Colorado","Archuleta County","API_combo",73,46,-27,-45.38,"undercount"
"493",8009,"Colorado","Baca County","API_alone",22,12,-10,-58.82,"undercount"
"494",8009,"Colorado","Baca County","API_combo",22,13,-9,-51.43,"undercount"
"495",8011,"Colorado","Bent County","API_alone",44,46,2,4.44,"overcount"
"496",8011,"Colorado","Bent County","API_combo",44,58,14,27.45,"overcount"
"497",8013,"Colorado","Boulder County","API_alone",9156,9394,238,2.57,"overcount"
"498",8013,"Colorado","Boulder County","API_combo",9156,11436,2280,22.14,"overcount"
"499",8015,"Colorado","Chaffee County","API_alone",72,84,12,15.38,"overcount"
"500",8015,"Colorado","Chaffee County","API_combo",72,109,37,40.88,"overcount"
"501",8017,"Colorado","Cheyenne County","API_alone",3,3,0,0,"equal"
"502",8017,"Colorado","Cheyenne County","API_combo",3,3,0,0,"equal"
"503",8019,"Colorado","Clear Creek County","API_alone",65,37,-28,-54.9,"undercount"
"504",8019,"Colorado","Clear Creek County","API_combo",65,65,0,0,"equal"
"505",8021,"Colorado","Conejos County","API_alone",29,25,-4,-14.81,"undercount"
"506",8021,"Colorado","Conejos County","API_combo",29,43,14,38.89,"overcount"
"507",8023,"Colorado","Costilla County","API_alone",51,50,-1,-1.98,"undercount"
"508",8023,"Colorado","Costilla County","API_combo",51,68,17,28.57,"overcount"
"509",8025,"Colorado","Crowley County","API_alone",52,49,-3,-5.94,"undercount"
"510",8025,"Colorado","Crowley County","API_combo",52,56,4,7.41,"overcount"
"511",8027,"Colorado","Custer County","API_alone",8,15,7,60.87,"overcount"
"512",8027,"Colorado","Custer County","API_combo",8,21,13,89.66,"overcount"
"513",8029,"Colorado","Delta County","API_alone",109,105,-4,-3.74,"undercount"
"514",8029,"Colorado","Delta County","API_combo",109,166,57,41.45,"overcount"
"515",8031,"Colorado","Denver County","API_alone",17027,17360,333,1.94,"overcount"
"516",8031,"Colorado","Denver County","API_combo",17027,20865,3838,20.26,"overcount"
"517",8033,"Colorado","Dolores County","API_alone",1,9,8,160,"overcount"
"518",8033,"Colorado","Dolores County","API_combo",1,13,12,171.43,"overcount"
"519",8035,"Colorado","Douglas County","API_alone",1858,4572,2714,84.42,"overcount"
"520",8035,"Colorado","Douglas County","API_combo",1858,5937,4079,104.66,"overcount"
"521",8037,"Colorado","Eagle County","API_alone",235,402,167,52.43,"overcount"
"522",8037,"Colorado","Eagle County","API_combo",235,507,272,73.32,"overcount"
"523",8039,"Colorado","Elbert County","API_alone",135,99,-36,-30.77,"undercount"
"524",8039,"Colorado","Elbert County","API_combo",135,178,43,27.48,"overcount"
"525",8041,"Colorado","El Paso County","API_alone",18277,14972,-3305,-19.88,"undercount"
"526",8041,"Colorado","El Paso County","API_combo",18277,21333,3056,15.43,"overcount"
"527",8043,"Colorado","Fremont County","API_alone",230,261,31,12.63,"overcount"
"528",8043,"Colorado","Fremont County","API_combo",230,374,144,47.68,"overcount"
"529",8045,"Colorado","Garfield County","API_alone",252,247,-5,-2,"undercount"
"530",8045,"Colorado","Garfield County","API_combo",252,383,131,41.26,"overcount"
"531",8047,"Colorado","Gilpin County","API_alone",26,44,18,51.43,"overcount"
"532",8047,"Colorado","Gilpin County","API_combo",26,53,27,68.35,"overcount"
"533",8049,"Colorado","Grand County","API_alone",67,100,33,39.52,"overcount"
"534",8049,"Colorado","Grand County","API_combo",67,129,62,63.27,"overcount"
"535",8051,"Colorado","Gunnison County","API_alone",83,81,-2,-2.44,"undercount"
"536",8051,"Colorado","Gunnison County","API_combo",83,122,39,38.05,"overcount"
"537",8053,"Colorado","Hinsdale County","API_alone",3,3,0,0,"equal"
"538",8053,"Colorado","Hinsdale County","API_combo",3,3,0,0,"equal"
"539",8055,"Colorado","Huerfano County","API_alone",17,38,21,76.36,"overcount"
"540",8055,"Colorado","Huerfano County","API_combo",17,53,36,102.86,"overcount"
"541",8057,"Colorado","Jackson County","API_alone",1,1,0,0,"equal"
"542",8057,"Colorado","Jackson County","API_combo",1,4,3,120,"overcount"
"543",8059,"Colorado","Jefferson County","API_alone",12700,12740,40,0.31,"overcount"
"544",8059,"Colorado","Jefferson County","API_combo",12700,15968,3268,22.8,"overcount"
"545",8061,"Colorado","Kiowa County","API_alone",0,2,2,200,"overcount"
"546",8061,"Colorado","Kiowa County","API_combo",0,2,2,200,"overcount"
"547",8063,"Colorado","Kit Carson County","API_alone",18,30,12,50,"overcount"
"548",8063,"Colorado","Kit Carson County","API_combo",18,35,17,64.15,"overcount"
"549",8065,"Colorado","Lake County","API_alone",33,40,7,19.18,"overcount"
"550",8065,"Colorado","Lake County","API_combo",33,59,26,56.52,"overcount"
"551",8067,"Colorado","La Plata County","API_alone",314,230,-84,-30.88,"undercount"
"552",8067,"Colorado","La Plata County","API_combo",314,380,66,19.02,"overcount"
"553",8069,"Colorado","Larimer County","API_alone",4920,4249,-671,-14.64,"undercount"
"554",8069,"Colorado","Larimer County","API_combo",4920,5714,794,14.93,"overcount"
"555",8071,"Colorado","Las Animas County","API_alone",84,106,22,23.16,"overcount"
"556",8071,"Colorado","Las Animas County","API_combo",84,152,68,57.63,"overcount"
"557",8073,"Colorado","Lincoln County","API_alone",27,46,19,52.05,"overcount"
"558",8073,"Colorado","Lincoln County","API_combo",27,48,21,56,"overcount"
"559",8075,"Colorado","Logan County","API_alone",65,101,36,43.37,"overcount"
"560",8075,"Colorado","Logan County","API_combo",65,142,77,74.4,"overcount"
"561",8077,"Colorado","Mesa County","API_alone",1165,796,-369,-37.63,"undercount"
"562",8077,"Colorado","Mesa County","API_combo",1165,1246,81,6.72,"overcount"
"563",8079,"Colorado","Mineral County","API_alone",1,0,-1,-200,"undercount"
"564",8079,"Colorado","Mineral County","API_combo",1,3,2,100,"overcount"
"565",8081,"Colorado","Moffat County","API_alone",63,52,-11,-19.13,"undercount"
"566",8081,"Colorado","Moffat County","API_combo",63,78,15,21.28,"overcount"
"567",8083,"Colorado","Montezuma County","API_alone",81,74,-7,-9.03,"undercount"
"568",8083,"Colorado","Montezuma County","API_combo",81,113,32,32.99,"overcount"
"569",8085,"Colorado","Montrose County","API_alone",153,173,20,12.27,"overcount"
"570",8085,"Colorado","Montrose County","API_combo",153,251,98,48.51,"overcount"
"571",8087,"Colorado","Morgan County","API_alone",144,119,-25,-19.01,"undercount"
"572",8087,"Colorado","Morgan County","API_combo",144,188,44,26.51,"overcount"
"573",8089,"Colorado","Otero County","API_alone",194,185,-9,-4.75,"undercount"
"574",8089,"Colorado","Otero County","API_combo",194,242,48,22.02,"overcount"
"575",8091,"Colorado","Ouray County","API_alone",4,15,11,115.79,"overcount"
"576",8091,"Colorado","Ouray County","API_combo",4,31,27,154.29,"overcount"
"577",8093,"Colorado","Park County","API_alone",48,64,16,28.57,"overcount"
"578",8093,"Colorado","Park County","API_combo",48,120,72,85.71,"overcount"
"579",8095,"Colorado","Phillips County","API_alone",13,23,10,55.56,"overcount"
"580",8095,"Colorado","Phillips County","API_combo",13,33,20,86.96,"overcount"
"581",8097,"Colorado","Pitkin County","API_alone",209,182,-27,-13.81,"undercount"
"582",8097,"Colorado","Pitkin County","API_combo",209,249,40,17.47,"overcount"
"583",8099,"Colorado","Prowers County","API_alone",44,74,30,50.85,"overcount"
"584",8099,"Colorado","Prowers County","API_combo",44,90,46,68.66,"overcount"
"585",8101,"Colorado","Pueblo County","API_alone",1168,1165,-3,-0.26,"undercount"
"586",8101,"Colorado","Pueblo County","API_combo",1168,1670,502,35.38,"overcount"
"587",8103,"Colorado","Rio Blanco County","API_alone",29,17,-12,-52.17,"undercount"
"588",8103,"Colorado","Rio Blanco County","API_combo",29,28,-1,-3.51,"undercount"
"589",8105,"Colorado","Rio Grande County","API_alone",19,43,24,77.42,"overcount"
"590",8105,"Colorado","Rio Grande County","API_combo",19,63,44,107.32,"overcount"
"591",8107,"Colorado","Routt County","API_alone",83,100,17,18.58,"overcount"
"592",8107,"Colorado","Routt County","API_combo",83,170,87,68.77,"overcount"
"593",8109,"Colorado","Saguache County","API_alone",21,33,12,44.44,"overcount"
"594",8109,"Colorado","Saguache County","API_combo",21,44,23,70.77,"overcount"
"595",8111,"Colorado","San Juan County","API_alone",2,3,1,40,"overcount"
"596",8111,"Colorado","San Juan County","API_combo",2,3,1,40,"overcount"
"597",8113,"Colorado","San Miguel County","API_alone",24,56,32,80,"overcount"
"598",8113,"Colorado","San Miguel County","API_combo",24,74,50,102.04,"overcount"
"599",8115,"Colorado","Sedgwick County","API_alone",31,27,-4,-13.79,"undercount"
"600",8115,"Colorado","Sedgwick County","API_combo",31,32,1,3.17,"overcount"
"601",8117,"Colorado","Summit County","API_alone",229,236,7,3.01,"overcount"
"602",8117,"Colorado","Summit County","API_combo",229,321,92,33.45,"overcount"
"603",8119,"Colorado","Teller County","API_alone",139,138,-1,-0.72,"undercount"
"604",8119,"Colorado","Teller County","API_combo",139,237,98,52.13,"overcount"
"605",8121,"Colorado","Washington County","API_alone",8,6,-2,-28.57,"undercount"
"606",8121,"Colorado","Washington County","API_combo",8,21,13,89.66,"overcount"
"607",8123,"Colorado","Weld County","API_alone",2009,1823,-186,-9.71,"undercount"
"608",8123,"Colorado","Weld County","API_combo",2009,2711,702,29.75,"overcount"
"609",8125,"Colorado","Yuma County","API_alone",16,14,-2,-13.33,"undercount"
"610",8125,"Colorado","Yuma County","API_combo",16,25,9,43.9,"overcount"
"611",9001,"Connecticut","Fairfield County","API_alone",30250,30579,329,1.08,"overcount"
"612",9001,"Connecticut","Fairfield County","API_combo",30250,34287,4037,12.51,"overcount"
"613",9003,"Connecticut","Hartford County","API_alone",22670,22639,-31,-0.14,"undercount"
"614",9003,"Connecticut","Hartford County","API_combo",22670,25734,3064,12.66,"overcount"
"615",9005,"Connecticut","Litchfield County","API_alone",2654,2232,-422,-17.27,"undercount"
"616",9005,"Connecticut","Litchfield County","API_combo",2654,2674,20,0.75,"overcount"
"617",9007,"Connecticut","Middlesex County","API_alone",2733,2580,-153,-5.76,"undercount"
"618",9007,"Connecticut","Middlesex County","API_combo",2733,3105,372,12.74,"overcount"
"619",9009,"Connecticut","New Haven County","API_alone",17537,20417,2880,15.18,"overcount"
"620",9009,"Connecticut","New Haven County","API_combo",17537,23045,5508,27.15,"overcount"
"621",9011,"Connecticut","New London County","API_alone",6002,5388,-614,-10.78,"undercount"
"622",9011,"Connecticut","New London County","API_combo",6002,6895,893,13.85,"overcount"
"623",9013,"Connecticut","Tolland County","API_alone",3952,3249,-703,-19.53,"undercount"
"624",9013,"Connecticut","Tolland County","API_combo",3952,3717,-235,-6.13,"undercount"
"625",9015,"Connecticut","Windham County","API_alone",1350,1017,-333,-28.14,"undercount"
"626",9015,"Connecticut","Windham County","API_combo",1350,1294,-56,-4.24,"undercount"
"627",10001,"Delaware","Kent County","API_alone",2734,2242,-492,-19.77,"undercount"
"628",10001,"Delaware","Kent County","API_combo",2734,2976,242,8.48,"overcount"
"629",10003,"Delaware","New Castle County","API_alone",12638,13478,840,6.43,"overcount"
"630",10003,"Delaware","New Castle County","API_combo",12638,15134,2496,17.97,"overcount"
"631",10005,"Delaware","Sussex County","API_alone",1261,1286,25,1.96,"overcount"
"632",10005,"Delaware","Sussex County","API_combo",1261,1612,351,24.43,"overcount"
"633",11001,"District of Columbia ","District of Columbia","API_alone",16983,16174,-809,-4.88,"undercount"
"634",11001,"District of Columbia ","District of Columbia","API_combo",16983,18950,1967,10.95,"overcount"
"635",12001,"Florida","Alachua County","API_alone",7928,7918,-10,-0.13,"undercount"
"636",12001,"Florida","Alachua County","API_combo",7928,9155,1227,14.37,"overcount"
"637",12003,"Florida","Baker County","API_alone",115,101,-14,-12.96,"undercount"
"638",12003,"Florida","Baker County","API_combo",115,139,24,18.9,"overcount"
"639",12005,"Florida","Bay County","API_alone",4430,2748,-1682,-46.87,"undercount"
"640",12005,"Florida","Bay County","API_combo",4430,3705,-725,-17.82,"undercount"
"641",12007,"Florida","Bradford County","API_alone",189,195,6,3.12,"overcount"
"642",12007,"Florida","Bradford County","API_combo",189,269,80,34.93,"overcount"
"643",12009,"Florida","Brevard County","API_alone",10689,7759,-2930,-31.76,"undercount"
"644",12009,"Florida","Brevard County","API_combo",10689,10307,-382,-3.64,"undercount"
"645",12011,"Florida","Broward County","API_alone",35600,39927,4327,11.46,"overcount"
"646",12011,"Florida","Broward County","API_combo",35600,49423,13823,32.52,"overcount"
"647",12013,"Florida","Calhoun County","API_alone",23,78,55,108.91,"overcount"
"648",12013,"Florida","Calhoun County","API_combo",23,118,95,134.75,"overcount"
"649",12015,"Florida","Charlotte County","API_alone",1728,1299,-429,-28.34,"undercount"
"650",12015,"Florida","Charlotte County","API_combo",1728,1685,-43,-2.52,"undercount"
"651",12017,"Florida","Citrus County","API_alone",894,955,61,6.6,"overcount"
"652",12017,"Florida","Citrus County","API_combo",894,1209,315,29.96,"overcount"
"653",12019,"Florida","Clay County","API_alone",4238,3032,-1206,-33.18,"undercount"
"654",12019,"Florida","Clay County","API_combo",4238,4012,-226,-5.48,"undercount"
"655",12021,"Florida","Collier County","API_alone",1440,1888,448,26.92,"overcount"
"656",12021,"Florida","Collier County","API_combo",1440,2449,1009,51.89,"overcount"
"657",12023,"Florida","Columbia County","API_alone",562,417,-145,-29.62,"undercount"
"658",12023,"Florida","Columbia County","API_combo",562,568,6,1.06,"overcount"
"659",12027,"Florida","DeSoto County","API_alone",193,157,-36,-20.57,"undercount"
"660",12027,"Florida","DeSoto County","API_combo",193,212,19,9.38,"overcount"
"661",12029,"Florida","Dixie County","API_alone",46,39,-7,-16.47,"undercount"
"662",12029,"Florida","Dixie County","API_combo",46,58,12,23.08,"overcount"
"663",12031,"Florida","Duval County","API_alone",24712,22303,-2409,-10.25,"undercount"
"664",12031,"Florida","Duval County","API_combo",24712,27297,2585,9.94,"overcount"
"665",12033,"Florida","Escambia County","API_alone",9251,7027,-2224,-27.33,"undercount"
"666",12033,"Florida","Escambia County","API_combo",9251,9287,36,0.39,"overcount"
"667",12035,"Florida","Flagler County","API_alone",844,611,-233,-32.03,"undercount"
"668",12035,"Florida","Flagler County","API_combo",844,779,-65,-8.01,"undercount"
"669",12037,"Florida","Franklin County","API_alone",44,26,-18,-51.43,"undercount"
"670",12037,"Florida","Franklin County","API_combo",44,45,1,2.25,"overcount"
"671",12039,"Florida","Gadsden County","API_alone",186,137,-49,-30.34,"undercount"
"672",12039,"Florida","Gadsden County","API_combo",186,201,15,7.75,"overcount"
"673",12041,"Florida","Gilchrist County","API_alone",41,27,-14,-41.18,"undercount"
"674",12041,"Florida","Gilchrist County","API_combo",41,44,3,7.06,"overcount"
"675",12043,"Florida","Glades County","API_alone",34,47,13,32.1,"overcount"
"676",12043,"Florida","Glades County","API_combo",34,72,38,71.7,"overcount"
"677",12045,"Florida","Gulf County","API_alone",58,63,5,8.26,"overcount"
"678",12045,"Florida","Gulf County","API_combo",58,104,46,56.79,"overcount"
"679",12047,"Florida","Hamilton County","API_alone",35,39,4,10.81,"overcount"
"680",12047,"Florida","Hamilton County","API_combo",35,74,39,71.56,"overcount"
"681",12049,"Florida","Hardee County","API_alone",83,130,47,44.13,"overcount"
"682",12049,"Florida","Hardee County","API_combo",83,166,83,66.67,"overcount"
"683",12051,"Florida","Hendry County","API_alone",216,213,-3,-1.4,"undercount"
"684",12051,"Florida","Hendry County","API_combo",216,274,58,23.67,"overcount"
"685",12053,"Florida","Hernando County","API_alone",964,913,-51,-5.43,"undercount"
"686",12053,"Florida","Hernando County","API_combo",964,1220,256,23.44,"overcount"
"687",12055,"Florida","Highlands County","API_alone",752,1000,248,28.31,"overcount"
"688",12055,"Florida","Highlands County","API_combo",752,1179,427,44.23,"overcount"
"689",12057,"Florida","Hillsborough County","API_alone",20648,23896,3248,14.58,"overcount"
"690",12057,"Florida","Hillsborough County","API_combo",20648,29202,8554,34.32,"overcount"
"691",12059,"Florida","Holmes County","API_alone",112,82,-30,-30.93,"undercount"
"692",12059,"Florida","Holmes County","API_combo",112,114,2,1.77,"overcount"
"693",12061,"Florida","Indian River County","API_alone",903,899,-4,-0.44,"undercount"
"694",12061,"Florida","Indian River County","API_combo",903,1191,288,27.51,"overcount"
"695",12063,"Florida","Jackson County","API_alone",147,186,39,23.42,"overcount"
"696",12063,"Florida","Jackson County","API_combo",147,302,155,69.04,"overcount"
"697",12065,"Florida","Jefferson County","API_alone",46,47,1,2.15,"overcount"
"698",12065,"Florida","Jefferson County","API_combo",46,73,27,45.38,"overcount"
"699",12067,"Florida","Lafayette County","API_alone",22,19,-3,-14.63,"undercount"
"700",12067,"Florida","Lafayette County","API_combo",22,34,12,42.86,"overcount"
"701",12069,"Florida","Lake County","API_alone",1375,1859,484,29.93,"overcount"
"702",12069,"Florida","Lake County","API_combo",1375,2284,909,49.69,"overcount"
"703",12071,"Florida","Lee County","API_alone",4054,3902,-152,-3.82,"undercount"
"704",12071,"Florida","Lee County","API_combo",4054,5141,1087,23.64,"overcount"
"705",12073,"Florida","Leon County","API_alone",4976,4774,-202,-4.14,"undercount"
"706",12073,"Florida","Leon County","API_combo",4976,5811,835,15.48,"overcount"
"707",12075,"Florida","Levy County","API_alone",341,151,-190,-77.24,"undercount"
"708",12075,"Florida","Levy County","API_combo",341,216,-125,-44.88,"undercount"
"709",12077,"Florida","Liberty County","API_alone",31,11,-20,-95.24,"undercount"
"710",12077,"Florida","Liberty County","API_combo",31,25,-6,-21.43,"undercount"
"711",12079,"Florida","Madison County","API_alone",17,65,48,117.07,"overcount"
"712",12079,"Florida","Madison County","API_combo",17,99,82,141.38,"overcount"
"713",12081,"Florida","Manatee County","API_alone",2448,2642,194,7.62,"overcount"
"714",12081,"Florida","Manatee County","API_combo",2448,3344,896,30.94,"overcount"
"715",12083,"Florida","Marion County","API_alone",2080,1970,-110,-5.43,"undercount"
"716",12083,"Florida","Marion County","API_combo",2080,2556,476,20.53,"overcount"
"717",12085,"Florida","Martin County","API_alone",1206,939,-267,-24.9,"undercount"
"718",12085,"Florida","Martin County","API_combo",1206,1224,18,1.48,"overcount"
"719",12086,"Florida","Miami-Dade County","API_alone",41138,35053,-6085,-15.97,"undercount"
"720",12086,"Florida","Miami-Dade County","API_combo",41138,45142,4004,9.28,"overcount"
"721",12087,"Florida","Monroe County","API_alone",1023,729,-294,-33.56,"undercount"
"722",12087,"Florida","Monroe County","API_combo",1023,972,-51,-5.11,"undercount"
"723",12089,"Florida","Nassau County","API_alone",313,297,-16,-5.25,"undercount"
"724",12089,"Florida","Nassau County","API_combo",313,419,106,28.96,"overcount"
"725",12091,"Florida","Okaloosa County","API_alone",7451,4653,-2798,-46.23,"undercount"
"726",12091,"Florida","Okaloosa County","API_combo",7451,6905,-546,-7.61,"undercount"
"727",12093,"Florida","Okeechobee County","API_alone",275,285,10,3.57,"overcount"
"728",12093,"Florida","Okeechobee County","API_combo",275,365,90,28.12,"overcount"
"729",12095,"Florida","Orange County","API_alone",28318,32883,4565,14.92,"overcount"
"730",12095,"Florida","Orange County","API_combo",28318,38807,10489,31.25,"overcount"
"731",12097,"Florida","Osceola County","API_alone",3954,4368,414,9.95,"overcount"
"732",12097,"Florida","Osceola County","API_combo",3954,5285,1331,28.81,"overcount"
"733",12099,"Florida","Palm Beach County","API_alone",18234,18919,685,3.69,"overcount"
"734",12099,"Florida","Palm Beach County","API_combo",18234,23632,5398,25.79,"overcount"
"735",12101,"Florida","Pasco County","API_alone",3407,3532,125,3.6,"overcount"
"736",12101,"Florida","Pasco County","API_combo",3407,4504,1097,27.73,"overcount"
"737",12103,"Florida","Pinellas County","API_alone",17773,20026,2253,11.92,"overcount"
"738",12103,"Florida","Pinellas County","API_combo",17773,23497,5724,27.74,"overcount"
"739",12105,"Florida","Polk County","API_alone",4871,4964,93,1.89,"overcount"
"740",12105,"Florida","Polk County","API_combo",4871,6289,1418,25.41,"overcount"
"741",12107,"Florida","Putnam County","API_alone",628,382,-246,-48.71,"undercount"
"742",12107,"Florida","Putnam County","API_combo",628,493,-135,-24.09,"undercount"
"743",12109,"Florida","St. Johns County","API_alone",1304,1298,-6,-0.46,"undercount"
"744",12109,"Florida","St. Johns County","API_combo",1304,1644,340,23.07,"overcount"
"745",12111,"Florida","St. Lucie County","API_alone",2192,2034,-158,-7.48,"undercount"
"746",12111,"Florida","St. Lucie County","API_combo",2192,2633,441,18.28,"overcount"
"747",12113,"Florida","Santa Rosa County","API_alone",2579,1673,-906,-42.62,"undercount"
"748",12113,"Florida","Santa Rosa County","API_combo",2579,2516,-63,-2.47,"undercount"
"749",12115,"Florida","Sarasota County","API_alone",2779,2715,-64,-2.33,"undercount"
"750",12115,"Florida","Sarasota County","API_combo",2779,3491,712,22.71,"overcount"
"751",12117,"Florida","Seminole County","API_alone",10263,9689,-574,-5.75,"undercount"
"752",12117,"Florida","Seminole County","API_combo",10263,11646,1383,12.62,"overcount"
"753",12119,"Florida","Sumter County","API_alone",139,288,149,69.79,"overcount"
"754",12119,"Florida","Sumter County","API_combo",139,410,271,98.72,"overcount"
"755",12121,"Florida","Suwannee County","API_alone",144,194,50,29.59,"overcount"
"756",12121,"Florida","Suwannee County","API_combo",144,263,119,58.48,"overcount"
"757",12123,"Florida","Taylor County","API_alone",71,89,18,22.5,"overcount"
"758",12123,"Florida","Taylor County","API_combo",71,134,63,61.46,"overcount"
"759",12125,"Florida","Union County","API_alone",81,52,-29,-43.61,"undercount"
"760",12125,"Florida","Union County","API_combo",81,90,9,10.53,"overcount"
"761",12127,"Florida","Volusia County","API_alone",5591,4830,-761,-14.61,"undercount"
"762",12127,"Florida","Volusia County","API_combo",5591,6079,488,8.36,"overcount"
"763",12129,"Florida","Wakulla County","API_alone",78,66,-12,-16.67,"undercount"
"764",12129,"Florida","Wakulla County","API_combo",78,99,21,23.73,"overcount"
"765",12131,"Florida","Walton County","API_alone",327,228,-99,-35.68,"undercount"
"766",12131,"Florida","Walton County","API_combo",327,354,27,7.93,"overcount"
"767",12133,"Florida","Washington County","API_alone",166,98,-68,-51.52,"undercount"
"768",12133,"Florida","Washington County","API_combo",166,168,2,1.2,"overcount"
"769",13001,"Georgia","Appling County","API_alone",81,60,-21,-29.79,"undercount"
"770",13001,"Georgia","Appling County","API_combo",81,70,-11,-14.57,"undercount"
"771",13003,"Georgia","Atkinson County","API_alone",10,27,17,91.89,"overcount"
"772",13003,"Georgia","Atkinson County","API_combo",10,29,19,97.44,"overcount"
"773",13005,"Georgia","Bacon County","API_alone",47,30,-17,-44.16,"undercount"
"774",13005,"Georgia","Bacon County","API_combo",47,47,0,0,"equal"
"775",13007,"Georgia","Baker County","API_alone",4,2,-2,-66.67,"undercount"
"776",13007,"Georgia","Baker County","API_combo",4,4,0,0,"equal"
"777",13009,"Georgia","Baldwin County","API_alone",516,465,-51,-10.4,"undercount"
"778",13009,"Georgia","Baldwin County","API_combo",516,553,37,6.92,"overcount"
"779",13011,"Georgia","Banks County","API_alone",77,114,37,38.74,"overcount"
"780",13011,"Georgia","Banks County","API_combo",77,122,45,45.23,"overcount"
"781",13013,"Georgia","Barrow County","API_alone",641,1091,450,51.96,"overcount"
"782",13013,"Georgia","Barrow County","API_combo",641,1215,574,61.85,"overcount"
"783",13015,"Georgia","Bartow County","API_alone",366,421,55,13.98,"overcount"
"784",13015,"Georgia","Bartow County","API_combo",366,586,220,46.22,"overcount"
"785",13017,"Georgia","Ben Hill County","API_alone",70,54,-16,-25.81,"undercount"
"786",13017,"Georgia","Ben Hill County","API_combo",70,68,-2,-2.9,"undercount"
"787",13019,"Georgia","Berrien County","API_alone",84,65,-19,-25.5,"undercount"
"788",13019,"Georgia","Berrien County","API_combo",84,81,-3,-3.64,"undercount"
"789",13021,"Georgia","Bibb County","API_alone",1439,1788,349,21.63,"overcount"
"790",13021,"Georgia","Bibb County","API_combo",1439,2107,668,37.68,"overcount"
"791",13023,"Georgia","Bleckley County","API_alone",158,114,-44,-32.35,"undercount"
"792",13023,"Georgia","Bleckley County","API_combo",158,124,-34,-24.11,"undercount"
"793",13025,"Georgia","Brantley County","API_alone",11,15,4,30.77,"overcount"
"794",13025,"Georgia","Brantley County","API_combo",11,34,23,102.22,"overcount"
"795",13027,"Georgia","Brooks County","API_alone",49,56,7,13.33,"overcount"
"796",13027,"Georgia","Brooks County","API_combo",49,113,64,79.01,"overcount"
"797",13029,"Georgia","Bryan County","API_alone",237,208,-29,-13.03,"undercount"
"798",13029,"Georgia","Bryan County","API_combo",237,350,113,38.5,"overcount"
"799",13031,"Georgia","Bulloch County","API_alone",438,484,46,9.98,"overcount"
"800",13031,"Georgia","Bulloch County","API_combo",438,626,188,35.34,"overcount"
"801",13033,"Georgia","Burke County","API_alone",58,65,7,11.38,"overcount"
"802",13033,"Georgia","Burke County","API_combo",58,137,79,81.03,"overcount"
"803",13035,"Georgia","Butts County","API_alone",102,55,-47,-59.87,"undercount"
"804",13035,"Georgia","Butts County","API_combo",102,92,-10,-10.31,"undercount"
"805",13037,"Georgia","Calhoun County","API_alone",2,6,4,100,"overcount"
"806",13037,"Georgia","Calhoun County","API_combo",2,14,12,150,"overcount"
"807",13039,"Georgia","Camden County","API_alone",1227,514,-713,-81.91,"undercount"
"808",13039,"Georgia","Camden County","API_combo",1227,787,-440,-43.69,"undercount"
"809",13043,"Georgia","Candler County","API_alone",31,36,5,14.93,"overcount"
"810",13043,"Georgia","Candler County","API_combo",31,47,16,41.03,"overcount"
"811",13045,"Georgia","Carroll County","API_alone",520,567,47,8.65,"overcount"
"812",13045,"Georgia","Carroll County","API_combo",520,732,212,33.87,"overcount"
"813",13047,"Georgia","Catoosa County","API_alone",386,404,18,4.56,"overcount"
"814",13047,"Georgia","Catoosa County","API_combo",386,516,130,28.82,"overcount"
"815",13049,"Georgia","Charlton County","API_alone",25,41,16,48.48,"overcount"
"816",13049,"Georgia","Charlton County","API_combo",25,62,37,85.06,"overcount"
"817",13051,"Georgia","Chatham County","API_alone",4461,4284,-177,-4.05,"undercount"
"818",13051,"Georgia","Chatham County","API_combo",4461,5246,785,16.17,"overcount"
"819",13053,"Georgia","Chattahoochee County","API_alone",778,366,-412,-72.03,"undercount"
"820",13053,"Georgia","Chattahoochee County","API_combo",778,544,-234,-35.4,"undercount"
"821",13055,"Georgia","Chattooga County","API_alone",49,50,1,2.02,"overcount"
"822",13055,"Georgia","Chattooga County","API_combo",49,81,32,49.23,"overcount"
"823",13057,"Georgia","Cherokee County","API_alone",908,1245,337,31.31,"overcount"
"824",13057,"Georgia","Cherokee County","API_combo",908,1655,747,58.29,"overcount"
"825",13059,"Georgia","Clarke County","API_alone",3907,3293,-614,-17.06,"undercount"
"826",13059,"Georgia","Clarke County","API_combo",3907,3753,-154,-4.02,"undercount"
"827",13061,"Georgia","Clay County","API_alone",5,11,6,75,"overcount"
"828",13061,"Georgia","Clay County","API_combo",5,13,8,88.89,"overcount"
"829",13063,"Georgia","Clayton County","API_alone",10789,11136,347,3.17,"overcount"
"830",13063,"Georgia","Clayton County","API_combo",10789,12302,1513,13.1,"overcount"
"831",13065,"Georgia","Clinch County","API_alone",13,8,-5,-47.62,"undercount"
"832",13065,"Georgia","Clinch County","API_combo",13,10,-3,-26.09,"undercount"
"833",13067,"Georgia","Cobb County","API_alone",19405,19569,164,0.84,"overcount"
"834",13067,"Georgia","Cobb County","API_combo",19405,22216,2811,13.51,"overcount"
"835",13069,"Georgia","Coffee County","API_alone",264,239,-25,-9.94,"undercount"
"836",13069,"Georgia","Coffee County","API_combo",264,302,38,13.43,"overcount"
"837",13071,"Georgia","Colquitt County","API_alone",90,215,125,81.97,"overcount"
"838",13071,"Georgia","Colquitt County","API_combo",90,299,209,107.46,"overcount"
"839",13073,"Georgia","Columbia County","API_alone",4224,3144,-1080,-29.32,"undercount"
"840",13073,"Georgia","Columbia County","API_combo",4224,3754,-470,-11.78,"undercount"
"841",13075,"Georgia","Cook County","API_alone",74,72,-2,-2.74,"undercount"
"842",13075,"Georgia","Cook County","API_combo",74,104,30,33.71,"overcount"
"843",13077,"Georgia","Coweta County","API_alone",458,664,206,36.72,"overcount"
"844",13077,"Georgia","Coweta County","API_combo",458,863,405,61.32,"overcount"
"845",13079,"Georgia","Crawford County","API_alone",35,23,-12,-41.38,"undercount"
"846",13079,"Georgia","Crawford County","API_combo",35,47,12,29.27,"overcount"
"847",13081,"Georgia","Crisp County","API_alone",52,156,104,100,"overcount"
"848",13081,"Georgia","Crisp County","API_combo",52,208,156,120,"overcount"
"849",13083,"Georgia","Dade County","API_alone",56,62,6,10.17,"overcount"
"850",13083,"Georgia","Dade County","API_combo",56,76,20,30.3,"overcount"
"851",13085,"Georgia","Dawson County","API_alone",36,58,22,46.81,"overcount"
"852",13085,"Georgia","Dawson County","API_combo",36,76,40,71.43,"overcount"
"853",13087,"Georgia","Decatur County","API_alone",84,104,20,21.28,"overcount"
"854",13087,"Georgia","Decatur County","API_combo",84,150,66,56.41,"overcount"
"855",13089,"Georgia","DeKalb County","API_alone",30572,27973,-2599,-8.88,"undercount"
"856",13089,"Georgia","DeKalb County","API_combo",30572,30900,328,1.07,"overcount"
"857",13091,"Georgia","Dodge County","API_alone",77,46,-31,-50.41,"undercount"
"858",13091,"Georgia","Dodge County","API_combo",77,56,-21,-31.58,"undercount"
"859",13093,"Georgia","Dooly County","API_alone",78,69,-9,-12.24,"undercount"
"860",13093,"Georgia","Dooly County","API_combo",78,103,25,27.62,"overcount"
"861",13095,"Georgia","Dougherty County","API_alone",771,601,-170,-24.78,"undercount"
"862",13095,"Georgia","Dougherty County","API_combo",771,807,36,4.56,"overcount"
"863",13097,"Georgia","Douglas County","API_alone",986,1142,156,14.66,"overcount"
"864",13097,"Georgia","Douglas County","API_combo",986,1414,428,35.67,"overcount"
"865",13099,"Georgia","Early County","API_alone",26,30,4,14.29,"overcount"
"866",13099,"Georgia","Early County","API_combo",26,64,38,84.44,"overcount"
"867",13101,"Georgia","Echols County","API_alone",4,5,1,22.22,"overcount"
"868",13101,"Georgia","Echols County","API_combo",4,6,2,40,"overcount"
"869",13103,"Georgia","Effingham County","API_alone",186,184,-2,-1.08,"undercount"
"870",13103,"Georgia","Effingham County","API_combo",186,309,123,49.7,"overcount"
"871",13105,"Georgia","Elbert County","API_alone",91,57,-34,-45.95,"undercount"
"872",13105,"Georgia","Elbert County","API_combo",91,74,-17,-20.61,"undercount"
"873",13107,"Georgia","Emanuel County","API_alone",81,55,-26,-38.24,"undercount"
"874",13107,"Georgia","Emanuel County","API_combo",81,94,13,14.86,"overcount"
"875",13109,"Georgia","Evans County","API_alone",42,53,11,23.16,"overcount"
"876",13109,"Georgia","Evans County","API_combo",42,63,21,40,"overcount"
"877",13111,"Georgia","Fannin County","API_alone",33,50,17,40.96,"overcount"
"878",13111,"Georgia","Fannin County","API_combo",33,72,39,74.29,"overcount"
"879",13113,"Georgia","Fayette County","API_alone",2898,2278,-620,-23.96,"undercount"
"880",13113,"Georgia","Fayette County","API_combo",2898,2693,-205,-7.33,"undercount"
"881",13115,"Georgia","Floyd County","API_alone",823,984,161,17.82,"overcount"
"882",13115,"Georgia","Floyd County","API_combo",823,1152,329,33.32,"overcount"
"883",13117,"Georgia","Forsyth County","API_alone",332,821,489,84.82,"overcount"
"884",13117,"Georgia","Forsyth County","API_combo",332,1029,697,102.42,"overcount"
"885",13119,"Georgia","Franklin County","API_alone",63,56,-7,-11.76,"undercount"
"886",13119,"Georgia","Franklin County","API_combo",63,82,19,26.21,"overcount"
"887",13121,"Georgia","Fulton County","API_alone",16178,25855,9677,46.04,"overcount"
"888",13121,"Georgia","Fulton County","API_combo",16178,28782,12604,56.07,"overcount"
"889",13123,"Georgia","Gilmer County","API_alone",62,130,68,70.83,"overcount"
"890",13123,"Georgia","Gilmer County","API_combo",62,161,99,88.79,"overcount"
"891",13125,"Georgia","Glascock County","API_alone",0,0,0,0,"equal"
"892",13125,"Georgia","Glascock County","API_combo",0,12,12,200,"overcount"
"893",13127,"Georgia","Glynn County","API_alone",627,457,-170,-31.37,"undercount"
"894",13127,"Georgia","Glynn County","API_combo",627,654,27,4.22,"overcount"
"895",13129,"Georgia","Gordon County","API_alone",288,310,22,7.36,"overcount"
"896",13129,"Georgia","Gordon County","API_combo",288,374,86,25.98,"overcount"
"897",13131,"Georgia","Grady County","API_alone",48,77,29,46.4,"overcount"
"898",13131,"Georgia","Grady County","API_combo",48,101,53,71.14,"overcount"
"899",13133,"Georgia","Greene County","API_alone",2,51,49,184.91,"overcount"
"900",13133,"Georgia","Greene County","API_combo",2,63,61,187.69,"overcount"
"901",13135,"Georgia","Gwinnett County","API_alone",29721,43836,14115,38.38,"overcount"
"902",13135,"Georgia","Gwinnett County","API_combo",29721,47023,17302,45.09,"overcount"
"903",13137,"Georgia","Habersham County","API_alone",1123,785,-338,-35.43,"undercount"
"904",13137,"Georgia","Habersham County","API_combo",1123,865,-258,-25.96,"undercount"
"905",13139,"Georgia","Hall County","API_alone",1754,2240,486,24.34,"overcount"
"906",13139,"Georgia","Hall County","API_combo",1754,2487,733,34.57,"overcount"
"907",13141,"Georgia","Hancock County","API_alone",1,11,10,166.67,"overcount"
"908",13141,"Georgia","Hancock County","API_combo",1,16,15,176.47,"overcount"
"909",13143,"Georgia","Haralson County","API_alone",111,88,-23,-23.12,"undercount"
"910",13143,"Georgia","Haralson County","API_combo",111,124,13,11.06,"overcount"
"911",13145,"Georgia","Harris County","API_alone",98,126,28,25,"overcount"
"912",13145,"Georgia","Harris County","API_combo",98,177,79,57.45,"overcount"
"913",13147,"Georgia","Hart County","API_alone",77,129,52,50.49,"overcount"
"914",13147,"Georgia","Hart County","API_combo",77,151,74,64.91,"overcount"
"915",13149,"Georgia","Heard County","API_alone",52,20,-32,-88.89,"undercount"
"916",13149,"Georgia","Heard County","API_combo",52,27,-25,-63.29,"undercount"
"917",13151,"Georgia","Henry County","API_alone",1207,2208,1001,58.62,"overcount"
"918",13151,"Georgia","Henry County","API_combo",1207,2577,1370,72.41,"overcount"
"919",13153,"Georgia","Houston County","API_alone",2307,1876,-431,-20.61,"undercount"
"920",13153,"Georgia","Houston County","API_combo",2307,2590,283,11.56,"overcount"
"921",13155,"Georgia","Irwin County","API_alone",28,33,5,16.39,"overcount"
"922",13155,"Georgia","Irwin County","API_combo",28,48,20,52.63,"overcount"
"923",13157,"Georgia","Jackson County","API_alone",140,420,280,100,"overcount"
"924",13157,"Georgia","Jackson County","API_combo",140,499,359,112.36,"overcount"
"925",13159,"Georgia","Jasper County","API_alone",25,20,-5,-22.22,"undercount"
"926",13159,"Georgia","Jasper County","API_combo",25,30,5,18.18,"overcount"
"927",13161,"Georgia","Jeff Davis County","API_alone",54,65,11,18.49,"overcount"
"928",13161,"Georgia","Jeff Davis County","API_combo",54,81,27,40,"overcount"
"929",13163,"Georgia","Jefferson County","API_alone",29,38,9,26.87,"overcount"
"930",13163,"Georgia","Jefferson County","API_combo",29,55,26,61.9,"overcount"
"931",13165,"Georgia","Jenkins County","API_alone",29,27,-2,-7.14,"undercount"
"932",13165,"Georgia","Jenkins County","API_combo",29,35,6,18.75,"overcount"
"933",13167,"Georgia","Johnson County","API_alone",15,12,-3,-22.22,"undercount"
"934",13167,"Georgia","Johnson County","API_combo",15,16,1,6.45,"overcount"
"935",13169,"Georgia","Jones County","API_alone",108,134,26,21.49,"overcount"
"936",13169,"Georgia","Jones County","API_combo",108,171,63,45.16,"overcount"
"937",13171,"Georgia","Lamar County","API_alone",25,62,37,85.06,"overcount"
"938",13171,"Georgia","Lamar County","API_combo",25,70,45,94.74,"overcount"
"939",13173,"Georgia","Lanier County","API_alone",52,31,-21,-50.6,"undercount"
"940",13173,"Georgia","Lanier County","API_combo",52,58,6,10.91,"overcount"
"941",13175,"Georgia","Laurens County","API_alone",299,379,80,23.6,"overcount"
"942",13175,"Georgia","Laurens County","API_combo",299,461,162,42.63,"overcount"
"943",13177,"Georgia","Lee County","API_alone",122,223,101,58.55,"overcount"
"944",13177,"Georgia","Lee County","API_combo",122,264,142,73.58,"overcount"
"945",13179,"Georgia","Liberty County","API_alone",2511,1426,-1085,-55.12,"undercount"
"946",13179,"Georgia","Liberty County","API_combo",2511,2033,-478,-21.04,"undercount"
"947",13181,"Georgia","Lincoln County","API_alone",23,17,-6,-30,"undercount"
"948",13181,"Georgia","Lincoln County","API_combo",23,27,4,16,"overcount"
"949",13183,"Georgia","Long County","API_alone",112,94,-18,-17.48,"undercount"
"950",13183,"Georgia","Long County","API_combo",112,147,35,27.03,"overcount"
"951",13185,"Georgia","Lowndes County","API_alone",1323,1198,-125,-9.92,"undercount"
"952",13185,"Georgia","Lowndes County","API_combo",1323,1612,289,19.69,"overcount"
"953",13187,"Georgia","Lumpkin County","API_alone",112,95,-17,-16.43,"undercount"
"954",13187,"Georgia","Lumpkin County","API_combo",112,127,15,12.55,"overcount"
"955",13189,"Georgia","McDuffie County","API_alone",54,78,24,36.36,"overcount"
"956",13189,"Georgia","McDuffie County","API_combo",54,134,80,85.11,"overcount"
"957",13191,"Georgia","McIntosh County","API_alone",19,36,17,61.82,"overcount"
"958",13191,"Georgia","McIntosh County","API_combo",19,42,23,75.41,"overcount"
"959",13193,"Georgia","Macon County","API_alone",42,92,50,74.63,"overcount"
"960",13193,"Georgia","Macon County","API_combo",42,116,74,93.67,"overcount"
"961",13195,"Georgia","Madison County","API_alone",135,97,-38,-32.76,"undercount"
"962",13195,"Georgia","Madison County","API_combo",135,161,26,17.57,"overcount"
"963",13197,"Georgia","Marion County","API_alone",24,31,7,25.45,"overcount"
"964",13197,"Georgia","Marion County","API_combo",24,48,24,66.67,"overcount"
"965",13199,"Georgia","Meriwether County","API_alone",25,70,45,94.74,"overcount"
"966",13199,"Georgia","Meriwether County","API_combo",25,94,69,115.97,"overcount"
"967",13201,"Georgia","Miller County","API_alone",6,8,2,28.57,"overcount"
"968",13201,"Georgia","Miller County","API_combo",6,12,6,66.67,"overcount"
"969",13205,"Georgia","Mitchell County","API_alone",31,84,53,92.17,"overcount"
"970",13205,"Georgia","Mitchell County","API_combo",31,127,96,121.52,"overcount"
"971",13207,"Georgia","Monroe County","API_alone",90,84,-6,-6.9,"undercount"
"972",13207,"Georgia","Monroe County","API_combo",90,132,42,37.84,"overcount"
"973",13209,"Georgia","Montgomery County","API_alone",44,20,-24,-75,"undercount"
"974",13209,"Georgia","Montgomery County","API_combo",44,36,-8,-20,"undercount"
"975",13211,"Georgia","Morgan County","API_alone",59,52,-7,-12.61,"undercount"
"976",13211,"Georgia","Morgan County","API_combo",59,87,28,38.36,"overcount"
"977",13213,"Georgia","Murray County","API_alone",163,105,-58,-43.28,"undercount"
"978",13213,"Georgia","Murray County","API_combo",163,151,-12,-7.64,"undercount"
"979",13215,"Georgia","Muscogee County","API_alone",4645,3257,-1388,-35.13,"undercount"
"980",13215,"Georgia","Muscogee County","API_combo",4645,4298,-347,-7.76,"undercount"
"981",13217,"Georgia","Newton County","API_alone",259,485,226,60.75,"overcount"
"982",13217,"Georgia","Newton County","API_combo",259,575,316,75.78,"overcount"
"983",13219,"Georgia","Oconee County","API_alone",247,399,152,47.06,"overcount"
"984",13219,"Georgia","Oconee County","API_combo",247,460,213,60.25,"overcount"
"985",13221,"Georgia","Oglethorpe County","API_alone",17,36,19,71.7,"overcount"
"986",13221,"Georgia","Oglethorpe County","API_combo",17,61,44,112.82,"overcount"
"987",13223,"Georgia","Paulding County","API_alone",277,377,100,30.58,"overcount"
"988",13223,"Georgia","Paulding County","API_combo",277,562,285,67.94,"overcount"
"989",13225,"Georgia","Peach County","API_alone",153,88,-65,-53.94,"undercount"
"990",13225,"Georgia","Peach County","API_combo",153,139,-14,-9.59,"undercount"
"991",13227,"Georgia","Pickens County","API_alone",54,59,5,8.85,"overcount"
"992",13227,"Georgia","Pickens County","API_combo",54,80,26,38.81,"overcount"
"993",13229,"Georgia","Pierce County","API_alone",24,36,12,40,"overcount"
"994",13229,"Georgia","Pierce County","API_combo",24,63,39,89.66,"overcount"
"995",13231,"Georgia","Pike County","API_alone",51,56,5,9.35,"overcount"
"996",13231,"Georgia","Pike County","API_combo",51,77,26,40.62,"overcount"
"997",13233,"Georgia","Polk County","API_alone",187,163,-24,-13.71,"undercount"
"998",13233,"Georgia","Polk County","API_combo",187,215,28,13.93,"overcount"
"999",13235,"Georgia","Pulaski County","API_alone",42,45,3,6.9,"overcount"
"1000",13235,"Georgia","Pulaski County","API_combo",42,63,21,40,"overcount"
"1001",13237,"Georgia","Putnam County","API_alone",97,143,46,38.33,"overcount"
"1002",13237,"Georgia","Putnam County","API_combo",97,170,73,54.68,"overcount"
"1003",13239,"Georgia","Quitman County","API_alone",5,1,-4,-133.33,"undercount"
"1004",13239,"Georgia","Quitman County","API_combo",5,1,-4,-133.33,"undercount"
"1005",13241,"Georgia","Rabun County","API_alone",39,66,27,51.43,"overcount"
"1006",13241,"Georgia","Rabun County","API_combo",39,89,50,78.12,"overcount"
"1007",13243,"Georgia","Randolph County","API_alone",60,23,-37,-89.16,"undercount"
"1008",13243,"Georgia","Randolph County","API_combo",60,42,-18,-35.29,"undercount"
"1009",13245,"Georgia","Richmond County","API_alone",6083,3381,-2702,-57.1,"undercount"
"1010",13245,"Georgia","Richmond County","API_combo",6083,4552,-1531,-28.79,"undercount"
"1011",13247,"Georgia","Rockdale County","API_alone",1277,1430,153,11.3,"overcount"
"1012",13247,"Georgia","Rockdale County","API_combo",1277,1585,308,21.52,"overcount"
"1013",13249,"Georgia","Schley County","API_alone",0,9,9,200,"overcount"
"1014",13249,"Georgia","Schley County","API_combo",0,26,26,200,"overcount"
"1015",13251,"Georgia","Screven County","API_alone",28,53,25,61.73,"overcount"
"1016",13251,"Georgia","Screven County","API_combo",28,68,40,83.33,"overcount"
"1017",13253,"Georgia","Seminole County","API_alone",23,17,-6,-30,"undercount"
"1018",13253,"Georgia","Seminole County","API_combo",23,21,-2,-9.09,"undercount"
"1019",13255,"Georgia","Spalding County","API_alone",459,426,-33,-7.46,"undercount"
"1020",13255,"Georgia","Spalding County","API_combo",459,576,117,22.61,"overcount"
"1021",13257,"Georgia","Stephens County","API_alone",205,174,-31,-16.36,"undercount"
"1022",13257,"Georgia","Stephens County","API_combo",205,224,19,8.86,"overcount"
"1023",13259,"Georgia","Stewart County","API_alone",28,9,-19,-102.7,"undercount"
"1024",13259,"Georgia","Stewart County","API_combo",28,27,-1,-3.64,"undercount"
"1025",13261,"Georgia","Sumter County","API_alone",189,211,22,11,"overcount"
"1026",13261,"Georgia","Sumter County","API_combo",189,253,64,28.96,"overcount"
"1027",13263,"Georgia","Talbot County","API_alone",6,19,13,104,"overcount"
"1028",13263,"Georgia","Talbot County","API_combo",6,27,21,127.27,"overcount"
"1029",13265,"Georgia","Taliaferro County","API_alone",5,1,-4,-133.33,"undercount"
"1030",13265,"Georgia","Taliaferro County","API_combo",5,6,1,18.18,"overcount"
"1031",13267,"Georgia","Tattnall County","API_alone",116,84,-32,-32,"undercount"
"1032",13267,"Georgia","Tattnall County","API_combo",116,111,-5,-4.41,"undercount"
"1033",13269,"Georgia","Taylor County","API_alone",28,22,-6,-24,"undercount"
"1034",13269,"Georgia","Taylor County","API_combo",28,31,3,10.17,"overcount"
"1035",13271,"Georgia","Telfair County","API_alone",13,23,10,55.56,"overcount"
"1036",13271,"Georgia","Telfair County","API_combo",13,41,28,103.7,"overcount"
"1037",13273,"Georgia","Terrell County","API_alone",28,46,18,48.65,"overcount"
"1038",13273,"Georgia","Terrell County","API_combo",28,67,39,82.11,"overcount"
"1039",13275,"Georgia","Thomas County","API_alone",147,202,55,31.52,"overcount"
"1040",13275,"Georgia","Thomas County","API_combo",147,280,133,62.3,"overcount"
"1041",13277,"Georgia","Tift County","API_alone",357,416,59,15.27,"overcount"
"1042",13277,"Georgia","Tift County","API_combo",357,457,100,24.57,"overcount"
"1043",13279,"Georgia","Toombs County","API_alone",390,127,-263,-101.74,"undercount"
"1044",13279,"Georgia","Toombs County","API_combo",390,165,-225,-81.08,"undercount"
"1045",13281,"Georgia","Towns County","API_alone",6,30,24,133.33,"overcount"
"1046",13281,"Georgia","Towns County","API_combo",6,35,29,141.46,"overcount"
"1047",13283,"Georgia","Treutlen County","API_alone",0,18,18,200,"overcount"
"1048",13283,"Georgia","Treutlen County","API_combo",0,30,30,200,"overcount"
"1049",13285,"Georgia","Troup County","API_alone",560,388,-172,-36.29,"undercount"
"1050",13285,"Georgia","Troup County","API_combo",560,496,-64,-12.12,"undercount"
"1051",13287,"Georgia","Turner County","API_alone",40,32,-8,-22.22,"undercount"
"1052",13287,"Georgia","Turner County","API_combo",40,40,0,0,"equal"
"1053",13289,"Georgia","Twiggs County","API_alone",9,19,10,71.43,"overcount"
"1054",13289,"Georgia","Twiggs County","API_combo",9,31,22,110,"overcount"
"1055",13291,"Georgia","Union County","API_alone",57,47,-10,-19.23,"undercount"
"1056",13291,"Georgia","Union County","API_combo",57,71,14,21.88,"overcount"
"1057",13293,"Georgia","Upson County","API_alone",139,113,-26,-20.63,"undercount"
"1058",13293,"Georgia","Upson County","API_combo",139,171,32,20.65,"overcount"
"1059",13295,"Georgia","Walker County","API_alone",290,194,-96,-39.67,"undercount"
"1060",13295,"Georgia","Walker County","API_combo",290,288,-2,-0.69,"undercount"
"1061",13297,"Georgia","Walton County","API_alone",413,457,44,10.11,"overcount"
"1062",13297,"Georgia","Walton County","API_combo",413,551,138,28.63,"overcount"
"1063",13299,"Georgia","Ware County","API_alone",235,184,-51,-24.34,"undercount"
"1064",13299,"Georgia","Ware County","API_combo",235,242,7,2.94,"overcount"
"1065",13301,"Georgia","Warren County","API_alone",10,9,-1,-10.53,"undercount"
"1066",13301,"Georgia","Warren County","API_combo",10,12,2,18.18,"overcount"
"1067",13303,"Georgia","Washington County","API_alone",45,59,14,26.92,"overcount"
"1068",13303,"Georgia","Washington County","API_combo",45,112,67,85.35,"overcount"
"1069",13305,"Georgia","Wayne County","API_alone",99,128,29,25.55,"overcount"
"1070",13305,"Georgia","Wayne County","API_combo",99,168,69,51.69,"overcount"
"1071",13307,"Georgia","Webster County","API_alone",0,0,0,0,"equal"
"1072",13307,"Georgia","Webster County","API_combo",0,0,0,0,"equal"
"1073",13309,"Georgia","Wheeler County","API_alone",8,7,-1,-13.33,"undercount"
"1074",13309,"Georgia","Wheeler County","API_combo",8,20,12,85.71,"overcount"
"1075",13311,"Georgia","White County","API_alone",181,139,-42,-26.25,"undercount"
"1076",13311,"Georgia","White County","API_combo",181,170,-11,-6.27,"undercount"
"1077",13313,"Georgia","Whitfield County","API_alone",729,878,149,18.54,"overcount"
"1078",13313,"Georgia","Whitfield County","API_combo",729,1030,301,34.22,"overcount"
"1079",13315,"Georgia","Wilcox County","API_alone",5,16,11,104.76,"overcount"
"1080",13315,"Georgia","Wilcox County","API_combo",5,22,17,125.93,"overcount"
"1081",13317,"Georgia","Wilkes County","API_alone",20,29,9,36.73,"overcount"
"1082",13317,"Georgia","Wilkes County","API_combo",20,43,23,73.02,"overcount"
"1083",13319,"Georgia","Wilkinson County","API_alone",14,7,-7,-66.67,"undercount"
"1084",13319,"Georgia","Wilkinson County","API_combo",14,26,12,60,"overcount"
"1085",13321,"Georgia","Worth County","API_alone",83,51,-32,-47.76,"undercount"
"1086",13321,"Georgia","Worth County","API_combo",83,72,-11,-14.19,"undercount"
"1087",15001,"Hawaii","Hawaii County","API_alone",85521,57506,-28015,-39.17,"undercount"
"1088",15001,"Hawaii","Hawaii County","API_combo",85521,117331,31810,31.36,"overcount"
"1089",15003,"Hawaii","Honolulu County","API_alone",571953,487688,-84265,-15.9,"undercount"
"1090",15003,"Hawaii","Honolulu County","API_combo",571953,730492,158539,24.34,"overcount"
"1091",15005,"Hawaii","Kalawao County","API_alone",20,97,77,131.62,"overcount"
"1092",15005,"Hawaii","Kalawao County","API_combo",20,102,82,134.43,"overcount"
"1093",15007,"Hawaii","Kauai County","API_alone",36864,26819,-10045,-31.55,"undercount"
"1094",15007,"Hawaii","Kauai County","API_combo",36864,46029,9165,22.11,"overcount"
"1095",15009,"Hawaii","Maui County","API_alone",74302,54698,-19604,-30.39,"undercount"
"1096",15009,"Hawaii","Maui County","API_combo",74302,94461,20159,23.89,"overcount"
"1097",16001,"Idaho","Ada County","API_alone",4885,5856,971,18.08,"overcount"
"1098",16001,"Idaho","Ada County","API_combo",4885,8155,3270,50.15,"overcount"
"1099",16003,"Idaho","Adams County","API_alone",3,6,3,66.67,"overcount"
"1100",16003,"Idaho","Adams County","API_combo",3,11,8,114.29,"overcount"
"1101",16005,"Idaho","Bannock County","API_alone",1047,895,-152,-15.65,"undercount"
"1102",16005,"Idaho","Bannock County","API_combo",1047,1369,322,26.66,"overcount"
"1103",16007,"Idaho","Bear Lake County","API_alone",17,9,-8,-61.54,"undercount"
"1104",16007,"Idaho","Bear Lake County","API_combo",17,14,-3,-19.35,"undercount"
"1105",16009,"Idaho","Benewah County","API_alone",34,20,-14,-51.85,"undercount"
"1106",16009,"Idaho","Benewah County","API_combo",34,38,4,11.11,"overcount"
"1107",16011,"Idaho","Bingham County","API_alone",391,264,-127,-38.78,"undercount"
"1108",16011,"Idaho","Bingham County","API_combo",391,421,30,7.39,"overcount"
"1109",16013,"Idaho","Blaine County","API_alone",191,163,-28,-15.82,"undercount"
"1110",16013,"Idaho","Blaine County","API_combo",191,246,55,25.17,"overcount"
"1111",16015,"Idaho","Boise County","API_alone",35,30,-5,-15.38,"undercount"
"1112",16015,"Idaho","Boise County","API_combo",35,65,30,60,"overcount"
"1113",16017,"Idaho","Bonner County","API_alone",137,123,-14,-10.77,"undercount"
"1114",16017,"Idaho","Bonner County","API_combo",137,249,112,58.03,"overcount"
"1115",16019,"Idaho","Bonneville County","API_alone",975,773,-202,-23.11,"undercount"
"1116",16019,"Idaho","Bonneville County","API_combo",975,1070,95,9.29,"overcount"
"1117",16021,"Idaho","Boundary County","API_alone",45,66,21,37.84,"overcount"
"1118",16021,"Idaho","Boundary County","API_combo",45,87,42,63.64,"overcount"
"1119",16023,"Idaho","Butte County","API_alone",5,7,2,33.33,"overcount"
"1120",16023,"Idaho","Butte County","API_combo",5,21,16,123.08,"overcount"
"1121",16025,"Idaho","Camas County","API_alone",5,2,-3,-85.71,"undercount"
"1122",16025,"Idaho","Camas County","API_combo",5,9,4,57.14,"overcount"
"1123",16027,"Idaho","Canyon County","API_alone",1829,1361,-468,-29.34,"undercount"
"1124",16027,"Idaho","Canyon County","API_combo",1829,2155,326,16.37,"overcount"
"1125",16029,"Idaho","Caribou County","API_alone",17,19,2,11.11,"overcount"
"1126",16029,"Idaho","Caribou County","API_combo",17,54,37,104.23,"overcount"
"1127",16031,"Idaho","Cassia County","API_alone",119,104,-15,-13.45,"undercount"
"1128",16031,"Idaho","Cassia County","API_combo",119,208,89,54.43,"overcount"
"1129",16033,"Idaho","Clark County","API_alone",0,3,3,200,"overcount"
"1130",16033,"Idaho","Clark County","API_combo",0,3,3,200,"overcount"
"1131",16035,"Idaho","Clearwater County","API_alone",36,40,4,10.53,"overcount"
"1132",16035,"Idaho","Clearwater County","API_combo",36,73,37,67.89,"overcount"
"1133",16037,"Idaho","Custer County","API_alone",25,2,-23,-170.37,"undercount"
"1134",16037,"Idaho","Custer County","API_combo",25,6,-19,-122.58,"undercount"
"1135",16039,"Idaho","Elmore County","API_alone",711,560,-151,-23.76,"undercount"
"1136",16039,"Idaho","Elmore County","API_combo",711,903,192,23.79,"overcount"
"1137",16041,"Idaho","Franklin County","API_alone",27,21,-6,-25,"undercount"
"1138",16041,"Idaho","Franklin County","API_combo",27,31,4,13.79,"overcount"
"1139",16043,"Idaho","Fremont County","API_alone",71,52,-19,-30.89,"undercount"
"1140",16043,"Idaho","Fremont County","API_combo",71,85,14,17.95,"overcount"
"1141",16045,"Idaho","Gem County","API_alone",87,64,-23,-30.46,"undercount"
"1142",16045,"Idaho","Gem County","API_combo",87,138,51,45.33,"overcount"
"1143",16047,"Idaho","Gooding County","API_alone",42,42,0,0,"equal"
"1144",16047,"Idaho","Gooding County","API_combo",42,89,47,71.76,"overcount"
"1145",16049,"Idaho","Idaho County","API_alone",41,49,8,17.78,"overcount"
"1146",16049,"Idaho","Idaho County","API_combo",41,94,53,78.52,"overcount"
"1147",16051,"Idaho","Jefferson County","API_alone",63,82,19,26.21,"overcount"
"1148",16051,"Idaho","Jefferson County","API_combo",63,145,82,78.85,"overcount"
"1149",16053,"Idaho","Jerome County","API_alone",86,68,-18,-23.38,"undercount"
"1150",16053,"Idaho","Jerome County","API_combo",86,96,10,10.99,"overcount"
"1151",16055,"Idaho","Kootenai County","API_alone",624,631,7,1.12,"overcount"
"1152",16055,"Idaho","Kootenai County","API_combo",624,1110,486,56.06,"overcount"
"1153",16057,"Idaho","Latah County","API_alone",926,775,-151,-17.75,"undercount"
"1154",16057,"Idaho","Latah County","API_combo",926,994,68,7.08,"overcount"
"1155",16059,"Idaho","Lemhi County","API_alone",36,17,-19,-71.7,"undercount"
"1156",16059,"Idaho","Lemhi County","API_combo",36,45,9,22.22,"overcount"
"1157",16061,"Idaho","Lewis County","API_alone",39,19,-20,-68.97,"undercount"
"1158",16061,"Idaho","Lewis County","API_combo",39,22,-17,-55.74,"undercount"
"1159",16063,"Idaho","Lincoln County","API_alone",17,20,3,16.22,"overcount"
"1160",16063,"Idaho","Lincoln County","API_combo",17,26,9,41.86,"overcount"
"1161",16065,"Idaho","Madison County","API_alone",344,216,-128,-45.71,"undercount"
"1162",16065,"Idaho","Madison County","API_combo",344,343,-1,-0.29,"undercount"
"1163",16067,"Idaho","Minidoka County","API_alone",184,100,-84,-59.15,"undercount"
"1164",16067,"Idaho","Minidoka County","API_combo",184,161,-23,-13.33,"undercount"
"1165",16069,"Idaho","Nez Perce County","API_alone",281,273,-8,-2.89,"undercount"
"1166",16069,"Idaho","Nez Perce County","API_combo",281,412,131,37.81,"overcount"
"1167",16071,"Idaho","Oneida County","API_alone",30,9,-21,-107.69,"undercount"
"1168",16071,"Idaho","Oneida County","API_combo",30,23,-7,-26.42,"undercount"
"1169",16073,"Idaho","Owyhee County","API_alone",119,74,-45,-46.63,"undercount"
"1170",16073,"Idaho","Owyhee County","API_combo",119,95,-24,-22.43,"undercount"
"1171",16075,"Idaho","Payette County","API_alone",229,187,-42,-20.19,"undercount"
"1172",16075,"Idaho","Payette County","API_combo",229,301,72,27.17,"overcount"
"1173",16077,"Idaho","Power County","API_alone",93,30,-63,-102.44,"undercount"
"1174",16077,"Idaho","Power County","API_combo",93,43,-50,-73.53,"undercount"
"1175",16079,"Idaho","Shoshone County","API_alone",55,42,-13,-26.8,"undercount"
"1176",16079,"Idaho","Shoshone County","API_combo",55,103,48,60.76,"overcount"
"1177",16081,"Idaho","Teton County","API_alone",3,25,22,157.14,"overcount"
"1178",16081,"Idaho","Teton County","API_combo",3,31,28,164.71,"overcount"
"1179",16083,"Idaho","Twin Falls County","API_alone",791,580,-211,-30.78,"undercount"
"1180",16083,"Idaho","Twin Falls County","API_combo",791,761,-30,-3.87,"undercount"
"1181",16085,"Idaho","Valley County","API_alone",68,28,-40,-83.33,"undercount"
"1182",16085,"Idaho","Valley County","API_combo",68,53,-15,-24.79,"undercount"
"1183",16087,"Idaho","Washington County","API_alone",196,128,-68,-41.98,"undercount"
"1184",16087,"Idaho","Washington County","API_combo",196,163,-33,-18.38,"undercount"
"1185",17001,"Illinois","Adams County","API_alone",382,287,-95,-28.4,"undercount"
"1186",17001,"Illinois","Adams County","API_combo",382,385,3,0.78,"overcount"
"1187",17003,"Illinois","Alexander County","API_alone",64,38,-26,-50.98,"undercount"
"1188",17003,"Illinois","Alexander County","API_combo",64,48,-16,-28.57,"undercount"
"1189",17005,"Illinois","Bond County","API_alone",25,54,29,73.42,"overcount"
"1190",17005,"Illinois","Bond County","API_combo",25,79,54,103.85,"overcount"
"1191",17007,"Illinois","Boone County","API_alone",310,218,-92,-34.85,"undercount"
"1192",17007,"Illinois","Boone County","API_combo",310,349,39,11.84,"overcount"
"1193",17009,"Illinois","Brown County","API_alone",9,17,8,61.54,"overcount"
"1194",17009,"Illinois","Brown County","API_combo",9,29,20,105.26,"overcount"
"1195",17011,"Illinois","Bureau County","API_alone",275,208,-67,-27.74,"undercount"
"1196",17011,"Illinois","Bureau County","API_combo",275,250,-25,-9.52,"undercount"
"1197",17013,"Illinois","Calhoun County","API_alone",15,9,-6,-50,"undercount"
"1198",17013,"Illinois","Calhoun County","API_combo",15,10,-5,-40,"undercount"
"1199",17015,"Illinois","Carroll County","API_alone",88,75,-13,-15.95,"undercount"
"1200",17015,"Illinois","Carroll County","API_combo",88,132,44,40,"overcount"
"1201",17017,"Illinois","Cass County","API_alone",26,43,17,49.28,"overcount"
"1202",17017,"Illinois","Cass County","API_combo",26,61,35,80.46,"overcount"
"1203",17019,"Illinois","Champaign County","API_alone",10918,11837,919,8.08,"overcount"
"1204",17019,"Illinois","Champaign County","API_combo",10918,13033,2115,17.66,"overcount"
"1205",17021,"Illinois","Christian County","API_alone",136,147,11,7.77,"overcount"
"1206",17021,"Illinois","Christian County","API_combo",136,174,38,24.52,"overcount"
"1207",17023,"Illinois","Clark County","API_alone",60,28,-32,-72.73,"undercount"
"1208",17023,"Illinois","Clark County","API_combo",60,47,-13,-24.3,"undercount"
"1209",17025,"Illinois","Clay County","API_alone",40,78,38,64.41,"overcount"
"1210",17025,"Illinois","Clay County","API_combo",40,82,42,68.85,"overcount"
"1211",17027,"Illinois","Clinton County","API_alone",163,131,-32,-21.77,"undercount"
"1212",17027,"Illinois","Clinton County","API_combo",163,200,37,20.39,"overcount"
"1213",17029,"Illinois","Coles County","API_alone",520,454,-66,-13.55,"undercount"
"1214",17029,"Illinois","Coles County","API_combo",520,552,32,5.97,"overcount"
"1215",17031,"Illinois","Cook County","API_alone",271713,272907,1194,0.44,"overcount"
"1216",17031,"Illinois","Cook County","API_combo",271713,297638,25925,9.11,"overcount"
"1217",17033,"Illinois","Crawford County","API_alone",79,73,-6,-7.89,"undercount"
"1218",17033,"Illinois","Crawford County","API_combo",79,109,30,31.91,"overcount"
"1219",17035,"Illinois","Cumberland County","API_alone",38,19,-19,-66.67,"undercount"
"1220",17035,"Illinois","Cumberland County","API_combo",38,34,-4,-11.11,"undercount"
"1221",17037,"Illinois","DeKalb County","API_alone",2714,2199,-515,-20.96,"undercount"
"1222",17037,"Illinois","DeKalb County","API_combo",2714,2495,-219,-8.41,"undercount"
"1223",17039,"Illinois","De Witt County","API_alone",65,51,-14,-24.14,"undercount"
"1224",17039,"Illinois","De Witt County","API_combo",65,80,15,20.69,"overcount"
"1225",17041,"Illinois","Douglas County","API_alone",56,54,-2,-3.64,"undercount"
"1226",17041,"Illinois","Douglas County","API_combo",56,78,22,32.84,"overcount"
"1227",17043,"Illinois","DuPage County","API_alone",66051,72912,6861,9.87,"overcount"
"1228",17043,"Illinois","DuPage County","API_combo",66051,77995,11944,16.58,"overcount"
"1229",17045,"Illinois","Edgar County","API_alone",30,39,9,26.09,"overcount"
"1230",17045,"Illinois","Edgar County","API_combo",30,54,24,57.14,"overcount"
"1231",17047,"Illinois","Edwards County","API_alone",23,32,9,32.73,"overcount"
"1232",17047,"Illinois","Edwards County","API_combo",23,41,18,56.25,"overcount"
"1233",17049,"Illinois","Effingham County","API_alone",160,121,-39,-27.76,"undercount"
"1234",17049,"Illinois","Effingham County","API_combo",160,153,-7,-4.47,"undercount"
"1235",17051,"Illinois","Fayette County","API_alone",65,41,-24,-45.28,"undercount"
"1236",17051,"Illinois","Fayette County","API_combo",65,68,3,4.51,"overcount"
"1237",17053,"Illinois","Ford County","API_alone",57,46,-11,-21.36,"undercount"
"1238",17053,"Illinois","Ford County","API_combo",57,66,9,14.63,"overcount"
"1239",17055,"Illinois","Franklin County","API_alone",125,75,-50,-50,"undercount"
"1240",17055,"Illinois","Franklin County","API_combo",125,140,15,11.32,"overcount"
"1241",17057,"Illinois","Fulton County","API_alone",153,103,-50,-39.06,"undercount"
"1242",17057,"Illinois","Fulton County","API_combo",153,135,-18,-12.5,"undercount"
"1243",17059,"Illinois","Gallatin County","API_alone",12,6,-6,-66.67,"undercount"
"1244",17059,"Illinois","Gallatin County","API_combo",12,12,0,0,"equal"
"1245",17061,"Illinois","Greene County","API_alone",25,19,-6,-27.27,"undercount"
"1246",17061,"Illinois","Greene County","API_combo",25,44,19,55.07,"overcount"
"1247",17063,"Illinois","Grundy County","API_alone",210,122,-88,-53.01,"undercount"
"1248",17063,"Illinois","Grundy County","API_combo",210,185,-25,-12.66,"undercount"
"1249",17065,"Illinois","Hamilton County","API_alone",32,14,-18,-78.26,"undercount"
"1250",17065,"Illinois","Hamilton County","API_combo",32,35,3,8.96,"overcount"
"1251",17067,"Illinois","Hancock County","API_alone",49,51,2,4,"overcount"
"1252",17067,"Illinois","Hancock County","API_combo",49,89,40,57.97,"overcount"
"1253",17069,"Illinois","Hardin County","API_alone",17,30,13,55.32,"overcount"
"1254",17069,"Illinois","Hardin County","API_combo",17,33,16,64,"overcount"
"1255",17071,"Illinois","Henderson County","API_alone",16,11,-5,-37.04,"undercount"
"1256",17071,"Illinois","Henderson County","API_combo",16,31,15,63.83,"overcount"
"1257",17073,"Illinois","Henry County","API_alone",189,138,-51,-31.19,"undercount"
"1258",17073,"Illinois","Henry County","API_combo",189,206,17,8.61,"overcount"
"1259",17075,"Illinois","Iroquois County","API_alone",102,106,4,3.85,"overcount"
"1260",17075,"Illinois","Iroquois County","API_combo",102,144,42,34.15,"overcount"
"1261",17077,"Illinois","Jackson County","API_alone",2996,1876,-1120,-45.98,"undercount"
"1262",17077,"Illinois","Jackson County","API_combo",2996,2128,-868,-33.88,"undercount"
"1263",17079,"Illinois","Jasper County","API_alone",26,21,-5,-21.28,"undercount"
"1264",17079,"Illinois","Jasper County","API_combo",26,31,5,17.54,"overcount"
"1265",17081,"Illinois","Jefferson County","API_alone",200,208,8,3.92,"overcount"
"1266",17081,"Illinois","Jefferson County","API_combo",200,282,82,34.02,"overcount"
"1267",17083,"Illinois","Jersey County","API_alone",47,64,17,30.63,"overcount"
"1268",17083,"Illinois","Jersey County","API_combo",47,88,41,60.74,"overcount"
"1269",17085,"Illinois","Jo Daviess County","API_alone",38,37,-1,-2.67,"undercount"
"1270",17085,"Illinois","Jo Daviess County","API_combo",38,59,21,43.3,"overcount"
"1271",17087,"Illinois","Johnson County","API_alone",24,23,-1,-4.26,"undercount"
"1272",17087,"Illinois","Johnson County","API_combo",24,44,20,58.82,"overcount"
"1273",17089,"Illinois","Kane County","API_alone",8195,7949,-246,-3.05,"undercount"
"1274",17089,"Illinois","Kane County","API_combo",8195,9276,1081,12.37,"overcount"
"1275",17091,"Illinois","Kankakee County","API_alone",1049,769,-280,-30.8,"undercount"
"1276",17091,"Illinois","Kankakee County","API_combo",1049,1019,-30,-2.9,"undercount"
"1277",17093,"Illinois","Kendall County","API_alone",469,527,58,11.65,"overcount"
"1278",17093,"Illinois","Kendall County","API_combo",469,652,183,32.65,"overcount"
"1279",17095,"Illinois","Knox County","API_alone",462,394,-68,-15.89,"undercount"
"1280",17095,"Illinois","Knox County","API_combo",462,483,21,4.44,"overcount"
"1281",17097,"Illinois","Lake County","API_alone",22127,26148,4021,16.66,"overcount"
"1282",17097,"Illinois","Lake County","API_combo",22127,29764,7637,29.43,"overcount"
"1283",17099,"Illinois","La Salle County","API_alone",829,647,-182,-24.66,"undercount"
"1284",17099,"Illinois","La Salle County","API_combo",829,838,9,1.08,"overcount"
"1285",17101,"Illinois","Lawrence County","API_alone",30,18,-12,-50,"undercount"
"1286",17101,"Illinois","Lawrence County","API_combo",30,27,-3,-10.53,"undercount"
"1287",17103,"Illinois","Lee County","API_alone",291,218,-73,-28.68,"undercount"
"1288",17103,"Illinois","Lee County","API_combo",291,287,-4,-1.38,"undercount"
"1289",17105,"Illinois","Livingston County","API_alone",208,130,-78,-46.15,"undercount"
"1290",17105,"Illinois","Livingston County","API_combo",208,198,-10,-4.93,"undercount"
"1291",17107,"Illinois","Logan County","API_alone",207,175,-32,-16.75,"undercount"
"1292",17107,"Illinois","Logan County","API_combo",207,227,20,9.22,"overcount"
"1293",17109,"Illinois","McDonough County","API_alone",1135,681,-454,-50,"undercount"
"1294",17109,"Illinois","McDonough County","API_combo",1135,762,-373,-39.33,"undercount"
"1295",17111,"Illinois","McHenry County","API_alone",2702,3962,1260,37.82,"overcount"
"1296",17111,"Illinois","McHenry County","API_combo",2702,4750,2048,54.97,"overcount"
"1297",17113,"Illinois","McLean County","API_alone",2651,3168,517,17.77,"overcount"
"1298",17113,"Illinois","McLean County","API_combo",2651,3635,984,31.31,"overcount"
"1299",17115,"Illinois","Macon County","API_alone",707,700,-7,-1,"undercount"
"1300",17115,"Illinois","Macon County","API_combo",707,920,213,26.18,"overcount"
"1301",17117,"Illinois","Macoupin County","API_alone",139,103,-36,-29.75,"undercount"
"1302",17117,"Illinois","Macoupin County","API_combo",139,174,35,22.36,"overcount"
"1303",17119,"Illinois","Madison County","API_alone",2219,1666,-553,-28.47,"undercount"
"1304",17119,"Illinois","Madison County","API_combo",2219,2304,85,3.76,"overcount"
"1305",17121,"Illinois","Marion County","API_alone",343,260,-83,-27.53,"undercount"
"1306",17121,"Illinois","Marion County","API_combo",343,315,-28,-8.51,"undercount"
"1307",17123,"Illinois","Marshall County","API_alone",39,34,-5,-13.7,"undercount"
"1308",17123,"Illinois","Marshall County","API_combo",39,54,15,32.26,"overcount"
"1309",17125,"Illinois","Mason County","API_alone",63,34,-29,-59.79,"undercount"
"1310",17125,"Illinois","Mason County","API_combo",63,50,-13,-23.01,"undercount"
"1311",17127,"Illinois","Massac County","API_alone",55,39,-16,-34.04,"undercount"
"1312",17127,"Illinois","Massac County","API_combo",55,62,7,11.97,"overcount"
"1313",17129,"Illinois","Menard County","API_alone",24,21,-3,-13.33,"undercount"
"1314",17129,"Illinois","Menard County","API_combo",24,32,8,28.57,"overcount"
"1315",17131,"Illinois","Mercer County","API_alone",49,31,-18,-45,"undercount"
"1316",17131,"Illinois","Mercer County","API_combo",49,62,13,23.42,"overcount"
"1317",17133,"Illinois","Monroe County","API_alone",117,93,-24,-22.86,"undercount"
"1318",17133,"Illinois","Monroe County","API_combo",117,125,8,6.61,"overcount"
"1319",17135,"Illinois","Montgomery County","API_alone",97,79,-18,-20.45,"undercount"
"1320",17135,"Illinois","Montgomery County","API_combo",97,119,22,20.37,"overcount"
"1321",17137,"Illinois","Morgan County","API_alone",175,181,6,3.37,"overcount"
"1322",17137,"Illinois","Morgan County","API_combo",175,237,62,30.1,"overcount"
"1323",17139,"Illinois","Moultrie County","API_alone",21,21,0,0,"equal"
"1324",17139,"Illinois","Moultrie County","API_combo",21,34,13,47.27,"overcount"
"1325",17141,"Illinois","Ogle County","API_alone",259,242,-17,-6.79,"undercount"
"1326",17141,"Illinois","Ogle County","API_combo",259,344,85,28.19,"overcount"
"1327",17143,"Illinois","Peoria County","API_alone",3139,3164,25,0.79,"overcount"
"1328",17143,"Illinois","Peoria County","API_combo",3139,3650,511,15.05,"overcount"
"1329",17145,"Illinois","Perry County","API_alone",87,75,-12,-14.81,"undercount"
"1330",17145,"Illinois","Perry County","API_combo",87,113,26,26,"overcount"
"1331",17147,"Illinois","Piatt County","API_alone",18,24,6,28.57,"overcount"
"1332",17147,"Illinois","Piatt County","API_combo",18,39,21,73.68,"overcount"
"1333",17149,"Illinois","Pike County","API_alone",42,46,4,9.09,"overcount"
"1334",17149,"Illinois","Pike County","API_combo",42,68,26,47.27,"overcount"
"1335",17151,"Illinois","Pope County","API_alone",12,13,1,8,"overcount"
"1336",17151,"Illinois","Pope County","API_combo",12,16,4,28.57,"overcount"
"1337",17153,"Illinois","Pulaski County","API_alone",9,68,59,153.25,"overcount"
"1338",17153,"Illinois","Pulaski County","API_combo",9,75,66,157.14,"overcount"
"1339",17155,"Illinois","Putnam County","API_alone",9,16,7,56,"overcount"
"1340",17155,"Illinois","Putnam County","API_combo",9,25,16,94.12,"overcount"
"1341",17157,"Illinois","Randolph County","API_alone",121,98,-23,-21,"undercount"
"1342",17157,"Illinois","Randolph County","API_combo",121,148,27,20.07,"overcount"
"1343",17159,"Illinois","Richland County","API_alone",64,99,35,42.94,"overcount"
"1344",17159,"Illinois","Richland County","API_combo",64,134,70,70.71,"overcount"
"1345",17161,"Illinois","Rock Island County","API_alone",1475,1621,146,9.43,"overcount"
"1346",17161,"Illinois","Rock Island County","API_combo",1475,1988,513,29.63,"overcount"
"1347",17163,"Illinois","St. Clair County","API_alone",2884,2516,-368,-13.63,"undercount"
"1348",17163,"Illinois","St. Clair County","API_combo",2884,3559,675,20.95,"overcount"
"1349",17165,"Illinois","Saline County","API_alone",56,60,4,6.9,"overcount"
"1350",17165,"Illinois","Saline County","API_combo",56,87,31,43.36,"overcount"
"1351",17167,"Illinois","Sangamon County","API_alone",2264,2190,-74,-3.32,"undercount"
"1352",17167,"Illinois","Sangamon County","API_combo",2264,2651,387,15.75,"overcount"
"1353",17169,"Illinois","Schuyler County","API_alone",6,9,3,40,"overcount"
"1354",17169,"Illinois","Schuyler County","API_combo",6,12,6,66.67,"overcount"
"1355",17171,"Illinois","Scott County","API_alone",3,7,4,80,"overcount"
"1356",17171,"Illinois","Scott County","API_combo",3,7,4,80,"overcount"
"1357",17173,"Illinois","Shelby County","API_alone",43,50,7,15.05,"overcount"
"1358",17173,"Illinois","Shelby County","API_combo",43,77,34,56.67,"overcount"
"1359",17175,"Illinois","Stark County","API_alone",25,12,-13,-70.27,"undercount"
"1360",17175,"Illinois","Stark County","API_combo",25,20,-5,-22.22,"undercount"
"1361",17177,"Illinois","Stephenson County","API_alone",453,361,-92,-22.6,"undercount"
"1362",17177,"Illinois","Stephenson County","API_combo",453,502,49,10.26,"overcount"
"1363",17179,"Illinois","Tazewell County","API_alone",668,692,24,3.53,"overcount"
"1364",17179,"Illinois","Tazewell County","API_combo",668,850,182,23.98,"overcount"
"1365",17181,"Illinois","Union County","API_alone",83,54,-29,-42.34,"undercount"
"1366",17181,"Illinois","Union County","API_combo",83,85,2,2.38,"overcount"
"1367",17183,"Illinois","Vermilion County","API_alone",727,528,-199,-31.71,"undercount"
"1368",17183,"Illinois","Vermilion County","API_combo",727,641,-86,-12.57,"undercount"
"1369",17185,"Illinois","Wabash County","API_alone",96,64,-32,-40,"undercount"
"1370",17185,"Illinois","Wabash County","API_combo",96,91,-5,-5.35,"undercount"
"1371",17187,"Illinois","Warren County","API_alone",127,83,-44,-41.9,"undercount"
"1372",17187,"Illinois","Warren County","API_combo",127,114,-13,-10.79,"undercount"
"1373",17189,"Illinois","Washington County","API_alone",37,32,-5,-14.49,"undercount"
"1374",17189,"Illinois","Washington County","API_combo",37,46,9,21.69,"overcount"
"1375",17191,"Illinois","Wayne County","API_alone",61,59,-2,-3.33,"undercount"
"1376",17191,"Illinois","Wayne County","API_combo",61,77,16,23.19,"overcount"
"1377",17193,"Illinois","White County","API_alone",41,26,-15,-44.78,"undercount"
"1378",17193,"Illinois","White County","API_combo",41,52,11,23.66,"overcount"
"1379",17195,"Illinois","Whiteside County","API_alone",278,272,-6,-2.18,"undercount"
"1380",17195,"Illinois","Whiteside County","API_combo",278,365,87,27.06,"overcount"
"1381",17197,"Illinois","Will County","API_alone",9348,11674,2326,22.13,"overcount"
"1382",17197,"Illinois","Will County","API_combo",9348,13535,4187,36.59,"overcount"
"1383",17199,"Illinois","Williamson County","API_alone",434,334,-100,-26.04,"undercount"
"1384",17199,"Illinois","Williamson County","API_combo",434,447,13,2.95,"overcount"
"1385",17201,"Illinois","Winnebago County","API_alone",4634,5066,432,8.91,"overcount"
"1386",17201,"Illinois","Winnebago County","API_combo",4634,5875,1241,23.62,"overcount"
"1387",17203,"Illinois","Woodford County","API_alone",167,115,-52,-36.88,"undercount"
"1388",17203,"Illinois","Woodford County","API_combo",167,180,13,7.49,"overcount"
"1389",18001,"Indiana","Adams County","API_alone",110,81,-29,-30.37,"undercount"
"1390",18001,"Indiana","Adams County","API_combo",110,115,5,4.44,"overcount"
"1391",18003,"Indiana","Allen County","API_alone",4239,4981,742,16.1,"overcount"
"1392",18003,"Indiana","Allen County","API_combo",4239,5996,1757,34.33,"overcount"
"1393",18005,"Indiana","Bartholomew County","API_alone",1018,1407,389,32.08,"overcount"
"1394",18005,"Indiana","Bartholomew County","API_combo",1018,1545,527,41.12,"overcount"
"1395",18007,"Indiana","Benton County","API_alone",2,8,6,120,"overcount"
"1396",18007,"Indiana","Benton County","API_combo",2,22,20,166.67,"overcount"
"1397",18009,"Indiana","Blackford County","API_alone",19,22,3,14.63,"overcount"
"1398",18009,"Indiana","Blackford County","API_combo",19,30,11,44.9,"overcount"
"1399",18011,"Indiana","Boone County","API_alone",176,219,43,21.77,"overcount"
"1400",18011,"Indiana","Boone County","API_combo",176,293,117,49.89,"overcount"
"1401",18013,"Indiana","Brown County","API_alone",40,34,-6,-16.22,"undercount"
"1402",18013,"Indiana","Brown County","API_combo",40,64,24,46.15,"overcount"
"1403",18015,"Indiana","Carroll County","API_alone",9,13,4,36.36,"overcount"
"1404",18015,"Indiana","Carroll County","API_combo",9,32,23,112.2,"overcount"
"1405",18017,"Indiana","Cass County","API_alone",188,253,65,29.48,"overcount"
"1406",18017,"Indiana","Cass County","API_combo",188,324,136,53.12,"overcount"
"1407",18019,"Indiana","Clark County","API_alone",606,645,39,6.24,"overcount"
"1408",18019,"Indiana","Clark County","API_combo",606,862,256,34.88,"overcount"
"1409",18021,"Indiana","Clay County","API_alone",25,34,9,30.51,"overcount"
"1410",18021,"Indiana","Clay County","API_combo",25,70,45,94.74,"overcount"
"1411",18023,"Indiana","Clinton County","API_alone",100,94,-6,-6.19,"undercount"
"1412",18023,"Indiana","Clinton County","API_combo",100,116,16,14.81,"overcount"
"1413",18025,"Indiana","Crawford County","API_alone",18,30,12,50,"overcount"
"1414",18025,"Indiana","Crawford County","API_combo",18,40,22,75.86,"overcount"
"1415",18027,"Indiana","Daviess County","API_alone",33,83,50,86.21,"overcount"
"1416",18027,"Indiana","Daviess County","API_combo",33,113,80,109.59,"overcount"
"1417",18029,"Indiana","Dearborn County","API_alone",159,134,-25,-17.06,"undercount"
"1418",18029,"Indiana","Dearborn County","API_combo",159,200,41,22.84,"overcount"
"1419",18031,"Indiana","Decatur County","API_alone",218,180,-38,-19.1,"undercount"
"1420",18031,"Indiana","Decatur County","API_combo",218,212,-6,-2.79,"undercount"
"1421",18033,"Indiana","DeKalb County","API_alone",174,158,-16,-9.64,"undercount"
"1422",18033,"Indiana","DeKalb County","API_combo",174,216,42,21.54,"overcount"
"1423",18035,"Indiana","Delaware County","API_alone",939,884,-55,-6.03,"undercount"
"1424",18035,"Indiana","Delaware County","API_combo",939,1180,241,22.75,"overcount"
"1425",18037,"Indiana","Dubois County","API_alone",88,98,10,10.75,"overcount"
"1426",18037,"Indiana","Dubois County","API_combo",88,131,43,39.27,"overcount"
"1427",18039,"Indiana","Elkhart County","API_alone",1708,1977,269,14.6,"overcount"
"1428",18039,"Indiana","Elkhart County","API_combo",1708,2410,702,34.09,"overcount"
"1429",18041,"Indiana","Fayette County","API_alone",99,77,-22,-25,"undercount"
"1430",18041,"Indiana","Fayette County","API_combo",99,104,5,4.93,"overcount"
"1431",18043,"Indiana","Floyd County","API_alone",317,374,57,16.5,"overcount"
"1432",18043,"Indiana","Floyd County","API_combo",317,524,207,49.23,"overcount"
"1433",18045,"Indiana","Fountain County","API_alone",53,34,-19,-43.68,"undercount"
"1434",18045,"Indiana","Fountain County","API_combo",53,56,3,5.5,"overcount"
"1435",18047,"Indiana","Franklin County","API_alone",44,52,8,16.67,"overcount"
"1436",18047,"Indiana","Franklin County","API_combo",44,75,31,52.1,"overcount"
"1437",18049,"Indiana","Fulton County","API_alone",81,81,0,0,"equal"
"1438",18049,"Indiana","Fulton County","API_combo",81,109,28,29.47,"overcount"
"1439",18051,"Indiana","Gibson County","API_alone",161,172,11,6.61,"overcount"
"1440",18051,"Indiana","Gibson County","API_combo",161,196,35,19.61,"overcount"
"1441",18053,"Indiana","Grant County","API_alone",592,445,-147,-28.35,"undercount"
"1442",18053,"Indiana","Grant County","API_combo",592,600,8,1.34,"overcount"
"1443",18055,"Indiana","Greene County","API_alone",125,77,-48,-47.52,"undercount"
"1444",18055,"Indiana","Greene County","API_combo",125,99,-26,-23.21,"undercount"
"1445",18057,"Indiana","Hamilton County","API_alone",2902,4574,1672,44.73,"overcount"
"1446",18057,"Indiana","Hamilton County","API_combo",2902,5253,2351,57.66,"overcount"
"1447",18059,"Indiana","Hancock County","API_alone",355,229,-126,-43.15,"undercount"
"1448",18059,"Indiana","Hancock County","API_combo",355,319,-36,-10.68,"undercount"
"1449",18061,"Indiana","Harrison County","API_alone",71,77,6,8.11,"overcount"
"1450",18061,"Indiana","Harrison County","API_combo",71,133,62,60.78,"overcount"
"1451",18063,"Indiana","Hendricks County","API_alone",568,739,171,26.17,"overcount"
"1452",18063,"Indiana","Hendricks County","API_combo",568,1017,449,56.66,"overcount"
"1453",18065,"Indiana","Henry County","API_alone",122,104,-18,-15.93,"undercount"
"1454",18065,"Indiana","Henry County","API_combo",122,151,29,21.25,"overcount"
"1455",18067,"Indiana","Howard County","API_alone",709,884,175,21.97,"overcount"
"1456",18067,"Indiana","Howard County","API_combo",709,1083,374,41.74,"overcount"
"1457",18069,"Indiana","Huntington County","API_alone",219,130,-89,-51,"undercount"
"1458",18069,"Indiana","Huntington County","API_combo",219,168,-51,-26.36,"undercount"
"1459",18071,"Indiana","Jackson County","API_alone",328,352,24,7.06,"overcount"
"1460",18071,"Indiana","Jackson County","API_combo",328,424,96,25.53,"overcount"
"1461",18073,"Indiana","Jasper County","API_alone",76,57,-19,-28.57,"undercount"
"1462",18073,"Indiana","Jasper County","API_combo",76,106,30,32.97,"overcount"
"1463",18075,"Indiana","Jay County","API_alone",107,84,-23,-24.08,"undercount"
"1464",18075,"Indiana","Jay County","API_combo",107,124,17,14.72,"overcount"
"1465",18077,"Indiana","Jefferson County","API_alone",191,195,4,2.07,"overcount"
"1466",18077,"Indiana","Jefferson County","API_combo",191,276,85,36.4,"overcount"
"1467",18079,"Indiana","Jennings County","API_alone",108,75,-33,-36.07,"undercount"
"1468",18079,"Indiana","Jennings County","API_combo",108,117,9,8,"overcount"
"1469",18081,"Indiana","Johnson County","API_alone",1060,1010,-50,-4.83,"undercount"
"1470",18081,"Indiana","Johnson County","API_combo",1060,1265,205,17.63,"overcount"
"1471",18083,"Indiana","Knox County","API_alone",221,222,1,0.45,"overcount"
"1472",18083,"Indiana","Knox County","API_combo",221,271,50,20.33,"overcount"
"1473",18085,"Indiana","Kosciusko County","API_alone",551,437,-114,-23.08,"undercount"
"1474",18085,"Indiana","Kosciusko County","API_combo",551,544,-7,-1.28,"undercount"
"1475",18087,"Indiana","LaGrange County","API_alone",172,99,-73,-53.87,"undercount"
"1476",18087,"Indiana","LaGrange County","API_combo",172,145,-27,-17.03,"undercount"
"1477",18089,"Indiana","Lake County","API_alone",4165,4413,248,5.78,"overcount"
"1478",18089,"Indiana","Lake County","API_combo",4165,5597,1432,29.34,"overcount"
"1479",18091,"Indiana","LaPorte County","API_alone",666,559,-107,-17.47,"undercount"
"1480",18091,"Indiana","LaPorte County","API_combo",666,747,81,11.46,"overcount"
"1481",18093,"Indiana","Lawrence County","API_alone",132,135,3,2.25,"overcount"
"1482",18093,"Indiana","Lawrence County","API_combo",132,217,85,48.71,"overcount"
"1483",18095,"Indiana","Madison County","API_alone",631,505,-126,-22.18,"undercount"
"1484",18095,"Indiana","Madison County","API_combo",631,725,94,13.86,"overcount"
"1485",18097,"Indiana","Marion County","API_alone",11704,13143,1439,11.58,"overcount"
"1486",18097,"Indiana","Marion County","API_combo",11704,16164,4460,32.01,"overcount"
"1487",18099,"Indiana","Marshall County","API_alone",283,171,-112,-49.34,"undercount"
"1488",18099,"Indiana","Marshall County","API_combo",283,254,-29,-10.8,"undercount"
"1489",18101,"Indiana","Martin County","API_alone",23,18,-5,-24.39,"undercount"
"1490",18101,"Indiana","Martin County","API_combo",23,30,7,26.42,"overcount"
"1491",18103,"Indiana","Miami County","API_alone",293,130,-163,-77.07,"undercount"
"1492",18103,"Indiana","Miami County","API_combo",293,222,-71,-27.57,"undercount"
"1493",18105,"Indiana","Monroe County","API_alone",4048,4204,156,3.78,"overcount"
"1494",18105,"Indiana","Monroe County","API_combo",4048,4891,843,18.86,"overcount"
"1495",18107,"Indiana","Montgomery County","API_alone",219,178,-41,-20.65,"undercount"
"1496",18107,"Indiana","Montgomery County","API_combo",219,241,22,9.57,"overcount"
"1497",18109,"Indiana","Morgan County","API_alone",183,178,-5,-2.77,"undercount"
"1498",18109,"Indiana","Morgan County","API_combo",183,257,74,33.64,"overcount"
"1499",18111,"Indiana","Newton County","API_alone",41,43,2,4.76,"overcount"
"1500",18111,"Indiana","Newton County","API_combo",41,62,21,40.78,"overcount"
"1501",18113,"Indiana","Noble County","API_alone",169,187,18,10.11,"overcount"
"1502",18113,"Indiana","Noble County","API_combo",169,254,85,40.19,"overcount"
"1503",18115,"Indiana","Ohio County","API_alone",13,9,-4,-36.36,"undercount"
"1504",18115,"Indiana","Ohio County","API_combo",13,16,3,20.69,"overcount"
"1505",18117,"Indiana","Orange County","API_alone",39,39,0,0,"equal"
"1506",18117,"Indiana","Orange County","API_combo",39,56,17,35.79,"overcount"
"1507",18119,"Indiana","Owen County","API_alone",40,41,1,2.47,"overcount"
"1508",18119,"Indiana","Owen County","API_combo",40,71,31,55.86,"overcount"
"1509",18121,"Indiana","Parke County","API_alone",25,37,12,38.71,"overcount"
"1510",18121,"Indiana","Parke County","API_combo",25,62,37,85.06,"overcount"
"1511",18123,"Indiana","Perry County","API_alone",45,29,-16,-43.24,"undercount"
"1512",18123,"Indiana","Perry County","API_combo",45,48,3,6.45,"overcount"
"1513",18125,"Indiana","Pike County","API_alone",27,23,-4,-16,"undercount"
"1514",18125,"Indiana","Pike County","API_combo",27,30,3,10.53,"overcount"
"1515",18127,"Indiana","Porter County","API_alone",1672,1418,-254,-16.44,"undercount"
"1516",18127,"Indiana","Porter County","API_combo",1672,1834,162,9.24,"overcount"
"1517",18129,"Indiana","Posey County","API_alone",47,43,-4,-8.89,"undercount"
"1518",18129,"Indiana","Posey County","API_combo",47,75,28,45.9,"overcount"
"1519",18131,"Indiana","Pulaski County","API_alone",35,34,-1,-2.9,"undercount"
"1520",18131,"Indiana","Pulaski County","API_combo",35,53,18,40.91,"overcount"
"1521",18133,"Indiana","Putnam County","API_alone",270,204,-66,-27.85,"undercount"
"1522",18133,"Indiana","Putnam County","API_combo",270,300,30,10.53,"overcount"
"1523",18135,"Indiana","Randolph County","API_alone",62,52,-10,-17.54,"undercount"
"1524",18135,"Indiana","Randolph County","API_combo",62,98,36,45,"overcount"
"1525",18137,"Indiana","Ripley County","API_alone",69,95,26,31.71,"overcount"
"1526",18137,"Indiana","Ripley County","API_combo",69,133,64,63.37,"overcount"
"1527",18139,"Indiana","Rush County","API_alone",83,89,6,6.98,"overcount"
"1528",18139,"Indiana","Rush County","API_combo",83,114,31,31.47,"overcount"
"1529",18141,"Indiana","St. Joseph County","API_alone",3948,3861,-87,-2.23,"undercount"
"1530",18141,"Indiana","St. Joseph County","API_combo",3948,4818,870,19.85,"overcount"
"1531",18143,"Indiana","Scott County","API_alone",99,47,-52,-71.23,"undercount"
"1532",18143,"Indiana","Scott County","API_combo",99,69,-30,-35.71,"undercount"
"1533",18145,"Indiana","Shelby County","API_alone",238,267,29,11.49,"overcount"
"1534",18145,"Indiana","Shelby County","API_combo",238,334,96,33.57,"overcount"
"1535",18147,"Indiana","Spencer County","API_alone",56,44,-12,-24,"undercount"
"1536",18147,"Indiana","Spencer County","API_combo",56,66,10,16.39,"overcount"
"1537",18149,"Indiana","Starke County","API_alone",78,59,-19,-27.74,"undercount"
"1538",18149,"Indiana","Starke County","API_combo",78,98,20,22.73,"overcount"
"1539",18151,"Indiana","Steuben County","API_alone",216,146,-70,-38.67,"undercount"
"1540",18151,"Indiana","Steuben County","API_combo",216,185,-31,-15.46,"undercount"
"1541",18153,"Indiana","Sullivan County","API_alone",28,36,8,25,"overcount"
"1542",18153,"Indiana","Sullivan County","API_combo",28,65,37,79.57,"overcount"
"1543",18155,"Indiana","Switzerland County","API_alone",23,9,-14,-87.5,"undercount"
"1544",18155,"Indiana","Switzerland County","API_combo",23,10,-13,-78.79,"undercount"
"1545",18157,"Indiana","Tippecanoe County","API_alone",7153,6808,-345,-4.94,"undercount"
"1546",18157,"Indiana","Tippecanoe County","API_combo",7153,7398,245,3.37,"overcount"
"1547",18159,"Indiana","Tipton County","API_alone",75,52,-23,-36.22,"undercount"
"1548",18159,"Indiana","Tipton County","API_combo",75,87,12,14.81,"overcount"
"1549",18161,"Indiana","Union County","API_alone",28,15,-13,-60.47,"undercount"
"1550",18161,"Indiana","Union County","API_combo",28,27,-1,-3.64,"undercount"
"1551",18163,"Indiana","Vanderburgh County","API_alone",1385,1394,9,0.65,"overcount"
"1552",18163,"Indiana","Vanderburgh County","API_combo",1385,1784,399,25.18,"overcount"
"1553",18165,"Indiana","Vermillion County","API_alone",43,23,-20,-60.61,"undercount"
"1554",18165,"Indiana","Vermillion County","API_combo",43,54,11,22.68,"overcount"
"1555",18167,"Indiana","Vigo County","API_alone",1650,1354,-296,-19.71,"undercount"
"1556",18167,"Indiana","Vigo County","API_combo",1650,1650,0,0,"equal"
"1557",18169,"Indiana","Wabash County","API_alone",183,156,-27,-15.93,"undercount"
"1558",18169,"Indiana","Wabash County","API_combo",183,187,4,2.16,"overcount"
"1559",18171,"Indiana","Warren County","API_alone",21,17,-4,-21.05,"undercount"
"1560",18171,"Indiana","Warren County","API_combo",21,22,1,4.65,"overcount"
"1561",18173,"Indiana","Warrick County","API_alone",319,360,41,12.08,"overcount"
"1562",18173,"Indiana","Warrick County","API_combo",319,438,119,31.44,"overcount"
"1563",18175,"Indiana","Washington County","API_alone",41,46,5,11.49,"overcount"
"1564",18175,"Indiana","Washington County","API_combo",41,67,26,48.15,"overcount"
"1565",18177,"Indiana","Wayne County","API_alone",442,396,-46,-10.98,"undercount"
"1566",18177,"Indiana","Wayne County","API_combo",442,543,101,20.51,"overcount"
"1567",18179,"Indiana","Wells County","API_alone",63,67,4,6.15,"overcount"
"1568",18179,"Indiana","Wells County","API_combo",63,95,32,40.51,"overcount"
"1569",18181,"Indiana","White County","API_alone",80,78,-2,-2.53,"undercount"
"1570",18181,"Indiana","White County","API_combo",80,104,24,26.09,"overcount"
"1571",18183,"Indiana","Whitley County","API_alone",60,71,11,16.79,"overcount"
"1572",18183,"Indiana","Whitley County","API_combo",60,105,45,54.55,"overcount"
"1573",19001,"Iowa","Adair County","API_alone",30,20,-10,-40,"undercount"
"1574",19001,"Iowa","Adair County","API_combo",30,25,-5,-18.18,"undercount"
"1575",19003,"Iowa","Adams County","API_alone",4,8,4,66.67,"overcount"
"1576",19003,"Iowa","Adams County","API_combo",4,10,6,85.71,"overcount"
"1577",19005,"Iowa","Allamakee County","API_alone",53,41,-12,-25.53,"undercount"
"1578",19005,"Iowa","Allamakee County","API_combo",53,83,30,44.12,"overcount"
"1579",19007,"Iowa","Appanoose County","API_alone",46,37,-9,-21.69,"undercount"
"1580",19007,"Iowa","Appanoose County","API_combo",46,49,3,6.32,"overcount"
"1581",19009,"Iowa","Audubon County","API_alone",6,13,7,73.68,"overcount"
"1582",19009,"Iowa","Audubon County","API_combo",6,16,10,90.91,"overcount"
"1583",19011,"Iowa","Benton County","API_alone",91,47,-44,-63.77,"undercount"
"1584",19011,"Iowa","Benton County","API_combo",91,69,-22,-27.5,"undercount"
"1585",19013,"Iowa","Black Hawk County","API_alone",1443,1348,-95,-6.81,"undercount"
"1586",19013,"Iowa","Black Hawk County","API_combo",1443,1701,258,16.41,"overcount"
"1587",19015,"Iowa","Boone County","API_alone",124,57,-67,-74.03,"undercount"
"1588",19015,"Iowa","Boone County","API_combo",124,81,-43,-41.95,"undercount"
"1589",19017,"Iowa","Bremer County","API_alone",200,127,-73,-44.65,"undercount"
"1590",19017,"Iowa","Bremer County","API_combo",200,167,-33,-17.98,"undercount"
"1591",19019,"Iowa","Buchanan County","API_alone",70,89,19,23.9,"overcount"
"1592",19019,"Iowa","Buchanan County","API_combo",70,109,39,43.58,"overcount"
"1593",19021,"Iowa","Buena Vista County","API_alone",564,910,346,46.95,"overcount"
"1594",19021,"Iowa","Buena Vista County","API_combo",564,984,420,54.26,"overcount"
"1595",19023,"Iowa","Butler County","API_alone",39,34,-5,-13.7,"undercount"
"1596",19023,"Iowa","Butler County","API_combo",39,53,14,30.43,"overcount"
"1597",19025,"Iowa","Calhoun County","API_alone",31,23,-8,-29.63,"undercount"
"1598",19025,"Iowa","Calhoun County","API_combo",31,35,4,12.12,"overcount"
"1599",19027,"Iowa","Carroll County","API_alone",101,74,-27,-30.86,"undercount"
"1600",19027,"Iowa","Carroll County","API_combo",101,92,-9,-9.33,"undercount"
"1601",19029,"Iowa","Cass County","API_alone",19,26,7,31.11,"overcount"
"1602",19029,"Iowa","Cass County","API_combo",19,27,8,34.78,"overcount"
"1603",19031,"Iowa","Cedar County","API_alone",80,60,-20,-28.57,"undercount"
"1604",19031,"Iowa","Cedar County","API_combo",80,94,14,16.09,"overcount"
"1605",19033,"Iowa","Cerro Gordo County","API_alone",372,340,-32,-8.99,"undercount"
"1606",19033,"Iowa","Cerro Gordo County","API_combo",372,443,71,17.42,"overcount"
"1607",19035,"Iowa","Cherokee County","API_alone",42,56,14,28.57,"overcount"
"1608",19035,"Iowa","Cherokee County","API_combo",42,78,36,60,"overcount"
"1609",19037,"Iowa","Chickasaw County","API_alone",28,36,8,25,"overcount"
"1610",19037,"Iowa","Chickasaw County","API_combo",28,54,26,63.41,"overcount"
"1611",19039,"Iowa","Clarke County","API_alone",28,36,8,25,"overcount"
"1612",19039,"Iowa","Clarke County","API_combo",28,46,18,48.65,"overcount"
"1613",19041,"Iowa","Clay County","API_alone",127,147,20,14.6,"overcount"
"1614",19041,"Iowa","Clay County","API_combo",127,180,53,34.53,"overcount"
"1615",19043,"Iowa","Clayton County","API_alone",35,21,-14,-50,"undercount"
"1616",19043,"Iowa","Clayton County","API_combo",35,36,1,2.82,"overcount"
"1617",19045,"Iowa","Clinton County","API_alone",308,294,-14,-4.65,"undercount"
"1618",19045,"Iowa","Clinton County","API_combo",308,350,42,12.77,"overcount"
"1619",19047,"Iowa","Crawford County","API_alone",120,89,-31,-29.67,"undercount"
"1620",19047,"Iowa","Crawford County","API_combo",120,109,-11,-9.61,"undercount"
"1621",19049,"Iowa","Dallas County","API_alone",148,324,176,74.58,"overcount"
"1622",19049,"Iowa","Dallas County","API_combo",148,412,264,94.29,"overcount"
"1623",19051,"Iowa","Davis County","API_alone",35,21,-14,-50,"undercount"
"1624",19051,"Iowa","Davis County","API_combo",35,37,2,5.56,"overcount"
"1625",19053,"Iowa","Decatur County","API_alone",109,66,-43,-49.14,"undercount"
"1626",19053,"Iowa","Decatur County","API_combo",109,124,15,12.88,"overcount"
"1627",19055,"Iowa","Delaware County","API_alone",60,28,-32,-72.73,"undercount"
"1628",19055,"Iowa","Delaware County","API_combo",60,39,-21,-42.42,"undercount"
"1629",19057,"Iowa","Des Moines County","API_alone",324,274,-50,-16.72,"undercount"
"1630",19057,"Iowa","Des Moines County","API_combo",324,350,26,7.72,"overcount"
"1631",19059,"Iowa","Dickinson County","API_alone",49,35,-14,-33.33,"undercount"
"1632",19059,"Iowa","Dickinson County","API_combo",49,40,-9,-20.22,"undercount"
"1633",19061,"Iowa","Dubuque County","API_alone",689,608,-81,-12.49,"undercount"
"1634",19061,"Iowa","Dubuque County","API_combo",689,767,78,10.71,"overcount"
"1635",19063,"Iowa","Emmet County","API_alone",33,34,1,2.99,"overcount"
"1636",19063,"Iowa","Emmet County","API_combo",33,44,11,28.57,"overcount"
"1637",19065,"Iowa","Fayette County","API_alone",78,96,18,20.69,"overcount"
"1638",19065,"Iowa","Fayette County","API_combo",78,125,47,46.31,"overcount"
"1639",19067,"Iowa","Floyd County","API_alone",59,89,30,40.54,"overcount"
"1640",19067,"Iowa","Floyd County","API_combo",59,137,78,79.59,"overcount"
"1641",19069,"Iowa","Franklin County","API_alone",23,30,7,26.42,"overcount"
"1642",19069,"Iowa","Franklin County","API_combo",23,38,15,49.18,"overcount"
"1643",19071,"Iowa","Fremont County","API_alone",20,20,0,0,"equal"
"1644",19071,"Iowa","Fremont County","API_combo",20,30,10,40,"overcount"
"1645",19073,"Iowa","Greene County","API_alone",41,26,-15,-44.78,"undercount"
"1646",19073,"Iowa","Greene County","API_combo",41,35,-6,-15.79,"undercount"
"1647",19075,"Iowa","Grundy County","API_alone",34,36,2,5.71,"overcount"
"1648",19075,"Iowa","Grundy County","API_combo",34,55,21,47.19,"overcount"
"1649",19077,"Iowa","Guthrie County","API_alone",31,21,-10,-38.46,"undercount"
"1650",19077,"Iowa","Guthrie County","API_combo",31,37,6,17.65,"overcount"
"1651",19079,"Iowa","Hamilton County","API_alone",135,248,113,59.01,"overcount"
"1652",19079,"Iowa","Hamilton County","API_combo",135,283,148,70.81,"overcount"
"1653",19081,"Iowa","Hancock County","API_alone",35,44,9,22.78,"overcount"
"1654",19081,"Iowa","Hancock County","API_combo",35,62,27,55.67,"overcount"
"1655",19083,"Iowa","Hardin County","API_alone",79,75,-4,-5.19,"undercount"
"1656",19083,"Iowa","Hardin County","API_combo",79,91,12,14.12,"overcount"
"1657",19085,"Iowa","Harrison County","API_alone",82,31,-51,-90.27,"undercount"
"1658",19085,"Iowa","Harrison County","API_combo",82,51,-31,-46.62,"undercount"
"1659",19087,"Iowa","Henry County","API_alone",320,405,85,23.45,"overcount"
"1660",19087,"Iowa","Henry County","API_combo",320,483,163,40.6,"overcount"
"1661",19089,"Iowa","Howard County","API_alone",30,17,-13,-55.32,"undercount"
"1662",19089,"Iowa","Howard County","API_combo",30,32,2,6.45,"overcount"
"1663",19091,"Iowa","Humboldt County","API_alone",32,39,7,19.72,"overcount"
"1664",19091,"Iowa","Humboldt County","API_combo",32,51,19,45.78,"overcount"
"1665",19093,"Iowa","Ida County","API_alone",23,19,-4,-19.05,"undercount"
"1666",19093,"Iowa","Ida County","API_combo",23,35,12,41.38,"overcount"
"1667",19095,"Iowa","Iowa County","API_alone",59,51,-8,-14.55,"undercount"
"1668",19095,"Iowa","Iowa County","API_combo",59,66,7,11.2,"overcount"
"1669",19097,"Iowa","Jackson County","API_alone",38,43,5,12.35,"overcount"
"1670",19097,"Iowa","Jackson County","API_combo",38,66,28,53.85,"overcount"
"1671",19099,"Iowa","Jasper County","API_alone",278,202,-76,-31.67,"undercount"
"1672",19099,"Iowa","Jasper County","API_combo",278,259,-19,-7.08,"undercount"
"1673",19101,"Iowa","Jefferson County","API_alone",211,292,81,32.21,"overcount"
"1674",19101,"Iowa","Jefferson County","API_combo",211,338,127,46.27,"overcount"
"1675",19103,"Iowa","Johnson County","API_alone",5692,4697,-995,-19.15,"undercount"
"1676",19103,"Iowa","Johnson County","API_combo",5692,5253,-439,-8.02,"undercount"
"1677",19105,"Iowa","Jones County","API_alone",42,45,3,6.9,"overcount"
"1678",19105,"Iowa","Jones County","API_combo",42,65,23,42.99,"overcount"
"1679",19107,"Iowa","Keokuk County","API_alone",40,29,-11,-31.88,"undercount"
"1680",19107,"Iowa","Keokuk County","API_combo",40,45,5,11.76,"overcount"
"1681",19109,"Iowa","Kossuth County","API_alone",67,61,-6,-9.38,"undercount"
"1682",19109,"Iowa","Kossuth County","API_combo",67,78,11,15.17,"overcount"
"1683",19111,"Iowa","Lee County","API_alone",212,178,-34,-17.44,"undercount"
"1684",19111,"Iowa","Lee County","API_combo",212,228,16,7.27,"overcount"
"1685",19113,"Iowa","Linn County","API_alone",2256,2795,539,21.34,"overcount"
"1686",19113,"Iowa","Linn County","API_combo",2256,3385,1129,40.03,"overcount"
"1687",19115,"Iowa","Louisa County","API_alone",32,34,2,6.06,"overcount"
"1688",19115,"Iowa","Louisa County","API_combo",32,41,9,24.66,"overcount"
"1689",19117,"Iowa","Lucas County","API_alone",23,30,7,26.42,"overcount"
"1690",19117,"Iowa","Lucas County","API_combo",23,33,10,35.71,"overcount"
"1691",19119,"Iowa","Lyon County","API_alone",57,20,-37,-96.1,"undercount"
"1692",19119,"Iowa","Lyon County","API_combo",57,30,-27,-62.07,"undercount"
"1693",19121,"Iowa","Madison County","API_alone",33,28,-5,-16.39,"undercount"
"1694",19121,"Iowa","Madison County","API_combo",33,56,23,51.69,"overcount"
"1695",19123,"Iowa","Mahaska County","API_alone",283,200,-83,-34.37,"undercount"
"1696",19123,"Iowa","Mahaska County","API_combo",283,250,-33,-12.38,"undercount"
"1697",19125,"Iowa","Marion County","API_alone",444,350,-94,-23.68,"undercount"
"1698",19125,"Iowa","Marion County","API_combo",444,394,-50,-11.93,"undercount"
"1699",19127,"Iowa","Marshall County","API_alone",464,365,-99,-23.88,"undercount"
"1700",19127,"Iowa","Marshall County","API_combo",464,441,-23,-5.08,"undercount"
"1701",19129,"Iowa","Mills County","API_alone",30,45,15,40,"overcount"
"1702",19129,"Iowa","Mills County","API_combo",30,62,32,69.57,"overcount"
"1703",19131,"Iowa","Mitchell County","API_alone",36,22,-14,-48.28,"undercount"
"1704",19131,"Iowa","Mitchell County","API_combo",36,29,-7,-21.54,"undercount"
"1705",19133,"Iowa","Monona County","API_alone",24,16,-8,-40,"undercount"
"1706",19133,"Iowa","Monona County","API_combo",24,23,-1,-4.26,"undercount"
"1707",19135,"Iowa","Monroe County","API_alone",45,32,-13,-33.77,"undercount"
"1708",19135,"Iowa","Monroe County","API_combo",45,41,-4,-9.3,"undercount"
"1709",19137,"Iowa","Montgomery County","API_alone",16,31,15,63.83,"overcount"
"1710",19137,"Iowa","Montgomery County","API_combo",16,42,26,89.66,"overcount"
"1711",19139,"Iowa","Muscatine County","API_alone",434,372,-62,-15.38,"undercount"
"1712",19139,"Iowa","Muscatine County","API_combo",434,454,20,4.5,"overcount"
"1713",19141,"Iowa","O'Brien County","API_alone",64,82,18,24.66,"overcount"
"1714",19141,"Iowa","O'Brien County","API_combo",64,109,45,52.02,"overcount"
"1715",19143,"Iowa","Osceola County","API_alone",17,15,-2,-12.5,"undercount"
"1716",19143,"Iowa","Osceola County","API_combo",17,21,4,21.05,"overcount"
"1717",19145,"Iowa","Page County","API_alone",116,88,-28,-27.45,"undercount"
"1718",19145,"Iowa","Page County","API_combo",116,117,1,0.86,"overcount"
"1719",19147,"Iowa","Palo Alto County","API_alone",18,35,17,64.15,"overcount"
"1720",19147,"Iowa","Palo Alto County","API_combo",18,48,30,90.91,"overcount"
"1721",19149,"Iowa","Plymouth County","API_alone",96,81,-15,-16.95,"undercount"
"1722",19149,"Iowa","Plymouth County","API_combo",96,129,33,29.33,"overcount"
"1723",19151,"Iowa","Pocahontas County","API_alone",18,18,0,0,"equal"
"1724",19151,"Iowa","Pocahontas County","API_combo",18,34,16,61.54,"overcount"
"1725",19153,"Iowa","Polk County","API_alone",9955,10379,424,4.17,"overcount"
"1726",19153,"Iowa","Polk County","API_combo",9955,11787,1832,16.85,"overcount"
"1727",19155,"Iowa","Pottawattamie County","API_alone",465,467,2,0.43,"overcount"
"1728",19155,"Iowa","Pottawattamie County","API_combo",465,681,216,37.7,"overcount"
"1729",19157,"Iowa","Poweshiek County","API_alone",253,214,-39,-16.7,"undercount"
"1730",19157,"Iowa","Poweshiek County","API_combo",253,275,22,8.33,"overcount"
"1731",19159,"Iowa","Ringgold County","API_alone",24,9,-15,-90.91,"undercount"
"1732",19159,"Iowa","Ringgold County","API_combo",24,12,-12,-66.67,"undercount"
"1733",19161,"Iowa","Sac County","API_alone",23,18,-5,-24.39,"undercount"
"1734",19161,"Iowa","Sac County","API_combo",23,42,19,58.46,"overcount"
"1735",19163,"Iowa","Scott County","API_alone",2129,2587,458,19.42,"overcount"
"1736",19163,"Iowa","Scott County","API_combo",2129,3058,929,35.82,"overcount"
"1737",19165,"Iowa","Shelby County","API_alone",25,38,13,41.27,"overcount"
"1738",19165,"Iowa","Shelby County","API_combo",25,55,30,75,"overcount"
"1739",19167,"Iowa","Sioux County","API_alone",368,212,-156,-53.79,"undercount"
"1740",19167,"Iowa","Sioux County","API_combo",368,246,-122,-39.74,"undercount"
"1741",19169,"Iowa","Story County","API_alone",4766,4159,-607,-13.6,"undercount"
"1742",19169,"Iowa","Story County","API_combo",4766,4519,-247,-5.32,"undercount"
"1743",19171,"Iowa","Tama County","API_alone",97,36,-61,-91.73,"undercount"
"1744",19171,"Iowa","Tama County","API_combo",97,49,-48,-65.75,"undercount"
"1745",19173,"Iowa","Taylor County","API_alone",32,26,-6,-20.69,"undercount"
"1746",19173,"Iowa","Taylor County","API_combo",32,33,1,3.08,"overcount"
"1747",19175,"Iowa","Union County","API_alone",63,31,-32,-68.09,"undercount"
"1748",19175,"Iowa","Union County","API_combo",63,45,-18,-33.33,"undercount"
"1749",19177,"Iowa","Van Buren County","API_alone",28,27,-1,-3.64,"undercount"
"1750",19177,"Iowa","Van Buren County","API_combo",28,33,5,16.39,"overcount"
"1751",19179,"Iowa","Wapello County","API_alone",250,252,2,0.8,"overcount"
"1752",19179,"Iowa","Wapello County","API_combo",250,311,61,21.75,"overcount"
"1753",19181,"Iowa","Warren County","API_alone",259,180,-79,-35.99,"undercount"
"1754",19181,"Iowa","Warren County","API_combo",259,246,-13,-5.15,"undercount"
"1755",19183,"Iowa","Washington County","API_alone",92,60,-32,-42.11,"undercount"
"1756",19183,"Iowa","Washington County","API_combo",92,83,-9,-10.29,"undercount"
"1757",19185,"Iowa","Wayne County","API_alone",19,21,2,10,"overcount"
"1758",19185,"Iowa","Wayne County","API_combo",19,33,14,53.85,"overcount"
"1759",19187,"Iowa","Webster County","API_alone",233,280,47,18.32,"overcount"
"1760",19187,"Iowa","Webster County","API_combo",233,343,110,38.19,"overcount"
"1761",19189,"Iowa","Winnebago County","API_alone",116,85,-31,-30.85,"undercount"
"1762",19189,"Iowa","Winnebago County","API_combo",116,114,-2,-1.74,"undercount"
"1763",19191,"Iowa","Winneshiek County","API_alone",287,179,-108,-46.35,"undercount"
"1764",19191,"Iowa","Winneshiek County","API_combo",287,210,-77,-30.99,"undercount"
"1765",19193,"Iowa","Woodbury County","API_alone",1966,2630,664,28.89,"overcount"
"1766",19193,"Iowa","Woodbury County","API_combo",1966,2961,995,40.39,"overcount"
"1767",19195,"Iowa","Worth County","API_alone",16,12,-4,-28.57,"undercount"
"1768",19195,"Iowa","Worth County","API_combo",16,19,3,17.14,"overcount"
"1769",19197,"Iowa","Wright County","API_alone",63,34,-29,-59.79,"undercount"
"1770",19197,"Iowa","Wright County","API_combo",63,48,-15,-27.03,"undercount"
"1771",20001,"Kansas","Allen County","API_alone",60,38,-22,-44.9,"undercount"
"1772",20001,"Kansas","Allen County","API_combo",60,72,12,18.18,"overcount"
"1773",20003,"Kansas","Anderson County","API_alone",17,20,3,16.22,"overcount"
"1774",20003,"Kansas","Anderson County","API_combo",17,33,16,64,"overcount"
"1775",20005,"Kansas","Atchison County","API_alone",154,69,-85,-76.23,"undercount"
"1776",20005,"Kansas","Atchison County","API_combo",154,109,-45,-34.22,"undercount"
"1777",20007,"Kansas","Barber County","API_alone",4,5,1,22.22,"overcount"
"1778",20007,"Kansas","Barber County","API_combo",4,8,4,66.67,"overcount"
"1779",20009,"Kansas","Barton County","API_alone",142,96,-46,-38.66,"undercount"
"1780",20009,"Kansas","Barton County","API_combo",142,127,-15,-11.15,"undercount"
"1781",20011,"Kansas","Bourbon County","API_alone",38,63,25,49.5,"overcount"
"1782",20011,"Kansas","Bourbon County","API_combo",38,84,46,75.41,"overcount"
"1783",20013,"Kansas","Brown County","API_alone",25,23,-2,-8.33,"undercount"
"1784",20013,"Kansas","Brown County","API_combo",25,29,4,14.81,"overcount"
"1785",20015,"Kansas","Butler County","API_alone",318,263,-55,-18.93,"undercount"
"1786",20015,"Kansas","Butler County","API_combo",318,406,88,24.31,"overcount"
"1787",20017,"Kansas","Chase County","API_alone",1,4,3,120,"overcount"
"1788",20017,"Kansas","Chase County","API_combo",1,7,6,150,"overcount"
"1789",20019,"Kansas","Chautauqua County","API_alone",18,5,-13,-113.04,"undercount"
"1790",20019,"Kansas","Chautauqua County","API_combo",18,16,-2,-11.76,"undercount"
"1791",20021,"Kansas","Cherokee County","API_alone",36,60,24,50,"overcount"
"1792",20021,"Kansas","Cherokee County","API_combo",36,85,49,80.99,"overcount"
"1793",20023,"Kansas","Cheyenne County","API_alone",11,11,0,0,"equal"
"1794",20023,"Kansas","Cheyenne County","API_combo",11,26,15,81.08,"overcount"
"1795",20025,"Kansas","Clark County","API_alone",8,2,-6,-120,"undercount"
"1796",20025,"Kansas","Clark County","API_combo",8,4,-4,-66.67,"undercount"
"1797",20027,"Kansas","Clay County","API_alone",36,13,-23,-93.88,"undercount"
"1798",20027,"Kansas","Clay County","API_combo",36,32,-4,-11.76,"undercount"
"1799",20029,"Kansas","Cloud County","API_alone",7,26,19,115.15,"overcount"
"1800",20029,"Kansas","Cloud County","API_combo",7,35,28,133.33,"overcount"
"1801",20031,"Kansas","Coffey County","API_alone",34,31,-3,-9.23,"undercount"
"1802",20031,"Kansas","Coffey County","API_combo",34,41,7,18.67,"overcount"
"1803",20033,"Kansas","Comanche County","API_alone",0,9,9,200,"overcount"
"1804",20033,"Kansas","Comanche County","API_combo",0,11,11,200,"overcount"
"1805",20035,"Kansas","Cowley County","API_alone",484,579,95,17.87,"overcount"
"1806",20035,"Kansas","Cowley County","API_combo",484,659,175,30.62,"overcount"
"1807",20037,"Kansas","Crawford County","API_alone",597,479,-118,-21.93,"undercount"
"1808",20037,"Kansas","Crawford County","API_combo",597,557,-40,-6.93,"undercount"
"1809",20039,"Kansas","Decatur County","API_alone",5,9,4,57.14,"overcount"
"1810",20039,"Kansas","Decatur County","API_combo",5,13,8,88.89,"overcount"
"1811",20041,"Kansas","Dickinson County","API_alone",90,61,-29,-38.41,"undercount"
"1812",20041,"Kansas","Dickinson County","API_combo",90,124,34,31.78,"overcount"
"1813",20043,"Kansas","Doniphan County","API_alone",20,21,1,4.88,"overcount"
"1814",20043,"Kansas","Doniphan County","API_combo",20,31,11,43.14,"overcount"
"1815",20045,"Kansas","Douglas County","API_alone",4037,3257,-780,-21.39,"undercount"
"1816",20045,"Kansas","Douglas County","API_combo",4037,3914,-123,-3.09,"undercount"
"1817",20047,"Kansas","Edwards County","API_alone",8,11,3,31.58,"overcount"
"1818",20047,"Kansas","Edwards County","API_combo",8,16,8,66.67,"overcount"
"1819",20049,"Kansas","Elk County","API_alone",6,8,2,28.57,"overcount"
"1820",20049,"Kansas","Elk County","API_combo",6,16,10,90.91,"overcount"
"1821",20051,"Kansas","Ellis County","API_alone",219,230,11,4.9,"overcount"
"1822",20051,"Kansas","Ellis County","API_combo",219,270,51,20.86,"overcount"
"1823",20053,"Kansas","Ellsworth County","API_alone",15,17,2,12.5,"overcount"
"1824",20053,"Kansas","Ellsworth County","API_combo",15,27,12,57.14,"overcount"
"1825",20055,"Kansas","Finney County","API_alone",1766,1259,-507,-33.52,"undercount"
"1826",20055,"Kansas","Finney County","API_combo",1766,1385,-381,-24.18,"undercount"
"1827",20057,"Kansas","Ford County","API_alone",966,766,-200,-23.09,"undercount"
"1828",20057,"Kansas","Ford County","API_combo",966,814,-152,-17.08,"undercount"
"1829",20059,"Kansas","Franklin County","API_alone",161,83,-78,-63.93,"undercount"
"1830",20059,"Kansas","Franklin County","API_combo",161,108,-53,-39.41,"undercount"
"1831",20061,"Kansas","Geary County","API_alone",1492,1053,-439,-34.5,"undercount"
"1832",20061,"Kansas","Geary County","API_combo",1492,1586,94,6.11,"overcount"
"1833",20063,"Kansas","Gove County","API_alone",2,3,1,40,"overcount"
"1834",20063,"Kansas","Gove County","API_combo",2,8,6,120,"overcount"
"1835",20065,"Kansas","Graham County","API_alone",15,9,-6,-50,"undercount"
"1836",20065,"Kansas","Graham County","API_combo",15,14,-1,-6.9,"undercount"
"1837",20067,"Kansas","Grant County","API_alone",91,46,-45,-65.69,"undercount"
"1838",20067,"Kansas","Grant County","API_combo",91,55,-36,-49.32,"undercount"
"1839",20069,"Kansas","Gray County","API_alone",2,10,8,133.33,"overcount"
"1840",20069,"Kansas","Gray County","API_combo",2,24,22,169.23,"overcount"
"1841",20071,"Kansas","Greeley County","API_alone",12,8,-4,-40,"undercount"
"1842",20071,"Kansas","Greeley County","API_combo",12,8,-4,-40,"undercount"
"1843",20073,"Kansas","Greenwood County","API_alone",0,8,8,200,"overcount"
"1844",20073,"Kansas","Greenwood County","API_combo",0,15,15,200,"overcount"
"1845",20075,"Kansas","Hamilton County","API_alone",37,25,-12,-38.71,"undercount"
"1846",20075,"Kansas","Hamilton County","API_combo",37,29,-8,-24.24,"undercount"
"1847",20077,"Kansas","Harper County","API_alone",5,14,9,94.74,"overcount"
"1848",20077,"Kansas","Harper County","API_combo",5,20,15,120,"overcount"
"1849",20079,"Kansas","Harvey County","API_alone",340,192,-148,-55.64,"undercount"
"1850",20079,"Kansas","Harvey County","API_combo",340,275,-65,-21.14,"undercount"
"1851",20081,"Kansas","Haskell County","API_alone",13,27,14,70,"overcount"
"1852",20081,"Kansas","Haskell County","API_combo",13,37,24,96,"overcount"
"1853",20083,"Kansas","Hodgeman County","API_alone",1,0,-1,-200,"undercount"
"1854",20083,"Kansas","Hodgeman County","API_combo",1,1,0,0,"equal"
"1855",20085,"Kansas","Jackson County","API_alone",14,26,12,60,"overcount"
"1856",20085,"Kansas","Jackson County","API_combo",14,48,34,109.68,"overcount"
"1857",20087,"Kansas","Jefferson County","API_alone",109,33,-76,-107.04,"undercount"
"1858",20087,"Kansas","Jefferson County","API_combo",109,83,-26,-27.08,"undercount"
"1859",20089,"Kansas","Jewell County","API_alone",6,4,-2,-40,"undercount"
"1860",20089,"Kansas","Jewell County","API_combo",6,5,-1,-18.18,"undercount"
"1861",20091,"Kansas","Johnson County","API_alone",10682,13177,2495,20.91,"overcount"
"1862",20091,"Kansas","Johnson County","API_combo",10682,15076,4394,34.12,"overcount"
"1863",20093,"Kansas","Kearny County","API_alone",6,19,13,104,"overcount"
"1864",20093,"Kansas","Kearny County","API_combo",6,20,14,107.69,"overcount"
"1865",20095,"Kansas","Kingman County","API_alone",16,24,8,40,"overcount"
"1866",20095,"Kansas","Kingman County","API_combo",16,42,26,89.66,"overcount"
"1867",20097,"Kansas","Kiowa County","API_alone",12,9,-3,-28.57,"undercount"
"1868",20097,"Kansas","Kiowa County","API_combo",12,17,5,34.48,"overcount"
"1869",20099,"Kansas","Labette County","API_alone",139,76,-63,-58.6,"undercount"
"1870",20099,"Kansas","Labette County","API_combo",139,120,-19,-14.67,"undercount"
"1871",20101,"Kansas","Lane County","API_alone",0,4,4,200,"overcount"
"1872",20101,"Kansas","Lane County","API_combo",0,9,9,200,"overcount"
"1873",20103,"Kansas","Leavenworth County","API_alone",1567,847,-720,-59.65,"undercount"
"1874",20103,"Kansas","Leavenworth County","API_combo",1567,1248,-319,-22.66,"undercount"
"1875",20105,"Kansas","Lincoln County","API_alone",1,4,3,120,"overcount"
"1876",20105,"Kansas","Lincoln County","API_combo",1,9,8,160,"overcount"
"1877",20107,"Kansas","Linn County","API_alone",13,17,4,26.67,"overcount"
"1878",20107,"Kansas","Linn County","API_combo",13,26,13,66.67,"overcount"
"1879",20109,"Kansas","Logan County","API_alone",1,6,5,142.86,"overcount"
"1880",20109,"Kansas","Logan County","API_combo",1,18,17,178.95,"overcount"
"1881",20111,"Kansas","Lyon County","API_alone",998,762,-236,-26.82,"undercount"
"1882",20111,"Kansas","Lyon County","API_combo",998,871,-127,-13.59,"undercount"
"1883",20113,"Kansas","McPherson County","API_alone",195,115,-80,-51.61,"undercount"
"1884",20113,"Kansas","McPherson County","API_combo",195,197,2,1.02,"overcount"
"1885",20115,"Kansas","Marion County","API_alone",49,27,-22,-57.89,"undercount"
"1886",20115,"Kansas","Marion County","API_combo",49,67,18,31.03,"overcount"
"1887",20117,"Kansas","Marshall County","API_alone",17,23,6,30,"overcount"
"1888",20117,"Kansas","Marshall County","API_combo",17,49,32,96.97,"overcount"
"1889",20119,"Kansas","Meade County","API_alone",18,10,-8,-57.14,"undercount"
"1890",20119,"Kansas","Meade County","API_combo",18,11,-7,-48.28,"undercount"
"1891",20121,"Kansas","Miami County","API_alone",61,52,-9,-15.93,"undercount"
"1892",20121,"Kansas","Miami County","API_combo",61,88,27,36.24,"overcount"
"1893",20123,"Kansas","Mitchell County","API_alone",11,23,12,70.59,"overcount"
"1894",20123,"Kansas","Mitchell County","API_combo",11,32,21,97.67,"overcount"
"1895",20125,"Kansas","Montgomery County","API_alone",204,181,-23,-11.95,"undercount"
"1896",20125,"Kansas","Montgomery County","API_combo",204,258,54,23.38,"overcount"
"1897",20127,"Kansas","Morris County","API_alone",17,18,1,5.71,"overcount"
"1898",20127,"Kansas","Morris County","API_combo",17,28,11,48.89,"overcount"
"1899",20129,"Kansas","Morton County","API_alone",52,38,-14,-31.11,"undercount"
"1900",20129,"Kansas","Morton County","API_combo",52,48,-4,-8,"undercount"
"1901",20131,"Kansas","Nemaha County","API_alone",24,17,-7,-34.15,"undercount"
"1902",20131,"Kansas","Nemaha County","API_combo",24,24,0,0,"equal"
"1903",20133,"Kansas","Neosho County","API_alone",50,58,8,14.81,"overcount"
"1904",20133,"Kansas","Neosho County","API_combo",50,99,49,65.77,"overcount"
"1905",20135,"Kansas","Ness County","API_alone",7,3,-4,-80,"undercount"
"1906",20135,"Kansas","Ness County","API_combo",7,8,1,13.33,"overcount"
"1907",20137,"Kansas","Norton County","API_alone",27,27,0,0,"equal"
"1908",20137,"Kansas","Norton County","API_combo",27,40,13,38.81,"overcount"
"1909",20139,"Kansas","Osage County","API_alone",35,45,10,25,"overcount"
"1910",20139,"Kansas","Osage County","API_combo",35,72,37,69.16,"overcount"
"1911",20141,"Kansas","Osborne County","API_alone",7,10,3,35.29,"overcount"
"1912",20141,"Kansas","Osborne County","API_combo",7,16,9,78.26,"overcount"
"1913",20143,"Kansas","Ottawa County","API_alone",15,9,-6,-50,"undercount"
"1914",20143,"Kansas","Ottawa County","API_combo",15,17,2,12.5,"overcount"
"1915",20145,"Kansas","Pawnee County","API_alone",83,44,-39,-61.42,"undercount"
"1916",20145,"Kansas","Pawnee County","API_combo",83,53,-30,-44.12,"undercount"
"1917",20147,"Kansas","Phillips County","API_alone",33,27,-6,-20,"undercount"
"1918",20147,"Kansas","Phillips County","API_combo",33,30,-3,-9.52,"undercount"
"1919",20149,"Kansas","Pottawatomie County","API_alone",112,60,-52,-60.47,"undercount"
"1920",20149,"Kansas","Pottawatomie County","API_combo",112,99,-13,-12.32,"undercount"
"1921",20151,"Kansas","Pratt County","API_alone",39,56,17,35.79,"overcount"
"1922",20151,"Kansas","Pratt County","API_combo",39,69,30,55.56,"overcount"
"1923",20153,"Kansas","Rawlins County","API_alone",9,3,-6,-100,"undercount"
"1924",20153,"Kansas","Rawlins County","API_combo",9,6,-3,-40,"undercount"
"1925",20155,"Kansas","Reno County","API_alone",338,329,-9,-2.7,"undercount"
"1926",20155,"Kansas","Reno County","API_combo",338,478,140,34.31,"overcount"
"1927",20157,"Kansas","Republic County","API_alone",15,11,-4,-30.77,"undercount"
"1928",20157,"Kansas","Republic County","API_combo",15,13,-2,-14.29,"undercount"
"1929",20159,"Kansas","Rice County","API_alone",30,40,10,28.57,"overcount"
"1930",20159,"Kansas","Rice County","API_combo",30,52,22,53.66,"overcount"
"1931",20161,"Kansas","Riley County","API_alone",3222,2186,-1036,-38.31,"undercount"
"1932",20161,"Kansas","Riley County","API_combo",3222,2743,-479,-16.06,"undercount"
"1933",20163,"Kansas","Rooks County","API_alone",7,12,5,52.63,"overcount"
"1934",20163,"Kansas","Rooks County","API_combo",7,19,12,92.31,"overcount"
"1935",20165,"Kansas","Rush County","API_alone",5,4,-1,-22.22,"undercount"
"1936",20165,"Kansas","Rush County","API_combo",5,6,1,18.18,"overcount"
"1937",20167,"Kansas","Russell County","API_alone",11,25,14,77.78,"overcount"
"1938",20167,"Kansas","Russell County","API_combo",11,29,18,90,"overcount"
"1939",20169,"Kansas","Saline County","API_alone",834,963,129,14.36,"overcount"
"1940",20169,"Kansas","Saline County","API_combo",834,1146,312,31.52,"overcount"
"1941",20171,"Kansas","Scott County","API_alone",29,7,-22,-122.22,"undercount"
"1942",20171,"Kansas","Scott County","API_combo",29,13,-16,-76.19,"undercount"
"1943",20173,"Kansas","Sedgwick County","API_alone",13745,15873,2128,14.37,"overcount"
"1944",20173,"Kansas","Sedgwick County","API_combo",13745,18279,4534,28.32,"overcount"
"1945",20175,"Kansas","Seward County","API_alone",670,744,74,10.47,"overcount"
"1946",20175,"Kansas","Seward County","API_combo",670,796,126,17.19,"overcount"
"1947",20177,"Kansas","Shawnee County","API_alone",1945,1793,-152,-8.13,"undercount"
"1948",20177,"Kansas","Shawnee County","API_combo",1945,2398,453,20.86,"overcount"
"1949",20179,"Kansas","Sheridan County","API_alone",7,6,-1,-15.38,"undercount"
"1950",20179,"Kansas","Sheridan County","API_combo",7,6,-1,-15.38,"undercount"
"1951",20181,"Kansas","Sherman County","API_alone",23,24,1,4.26,"overcount"
"1952",20181,"Kansas","Sherman County","API_combo",23,36,13,44.07,"overcount"
"1953",20183,"Kansas","Smith County","API_alone",3,7,4,80,"overcount"
"1954",20183,"Kansas","Smith County","API_combo",3,7,4,80,"overcount"
"1955",20185,"Kansas","Stafford County","API_alone",10,7,-3,-35.29,"undercount"
"1956",20185,"Kansas","Stafford County","API_combo",10,18,8,57.14,"overcount"
"1957",20187,"Kansas","Stanton County","API_alone",30,5,-25,-142.86,"undercount"
"1958",20187,"Kansas","Stanton County","API_combo",30,13,-17,-79.07,"undercount"
"1959",20189,"Kansas","Stevens County","API_alone",33,14,-19,-80.85,"undercount"
"1960",20189,"Kansas","Stevens County","API_combo",33,20,-13,-49.06,"undercount"
"1961",20191,"Kansas","Sumner County","API_alone",123,75,-48,-48.48,"undercount"
"1962",20191,"Kansas","Sumner County","API_combo",123,108,-15,-12.99,"undercount"
"1963",20193,"Kansas","Thomas County","API_alone",47,24,-23,-64.79,"undercount"
"1964",20193,"Kansas","Thomas County","API_combo",47,34,-13,-32.1,"undercount"
"1965",20195,"Kansas","Trego County","API_alone",24,18,-6,-28.57,"undercount"
"1966",20195,"Kansas","Trego County","API_combo",24,20,-4,-18.18,"undercount"
"1967",20197,"Kansas","Wabaunsee County","API_alone",11,16,5,37.04,"overcount"
"1968",20197,"Kansas","Wabaunsee County","API_combo",11,23,12,70.59,"overcount"
"1969",20199,"Kansas","Wallace County","API_alone",6,3,-3,-66.67,"undercount"
"1970",20199,"Kansas","Wallace County","API_combo",6,6,0,0,"equal"
"1971",20201,"Kansas","Washington County","API_alone",0,3,3,200,"overcount"
"1972",20201,"Kansas","Washington County","API_combo",0,13,13,200,"overcount"
"1973",20203,"Kansas","Wichita County","API_alone",13,2,-11,-146.67,"undercount"
"1974",20203,"Kansas","Wichita County","API_combo",13,10,-3,-26.09,"undercount"
"1975",20205,"Kansas","Wilson County","API_alone",31,31,0,0,"equal"
"1976",20205,"Kansas","Wilson County","API_combo",31,51,20,48.78,"overcount"
"1977",20207,"Kansas","Woodson County","API_alone",6,2,-4,-100,"undercount"
"1978",20207,"Kansas","Woodson County","API_combo",6,4,-2,-40,"undercount"
"1979",20209,"Kansas","Wyandotte County","API_alone",2478,2871,393,14.69,"overcount"
"1980",20209,"Kansas","Wyandotte County","API_combo",2478,3334,856,29.46,"overcount"
"1981",21001,"Kentucky","Adair County","API_alone",37,48,11,25.88,"overcount"
"1982",21001,"Kentucky","Adair County","API_combo",37,59,22,45.83,"overcount"
"1983",21003,"Kentucky","Allen County","API_alone",9,23,14,87.5,"overcount"
"1984",21003,"Kentucky","Allen County","API_combo",9,44,35,132.08,"overcount"
"1985",21005,"Kentucky","Anderson County","API_alone",44,25,-19,-55.07,"undercount"
"1986",21005,"Kentucky","Anderson County","API_combo",44,35,-9,-22.78,"undercount"
"1987",21007,"Kentucky","Ballard County","API_alone",8,17,9,72,"overcount"
"1988",21007,"Kentucky","Ballard County","API_combo",8,26,18,105.88,"overcount"
"1989",21009,"Kentucky","Barren County","API_alone",100,167,67,50.19,"overcount"
"1990",21009,"Kentucky","Barren County","API_combo",100,207,107,69.71,"overcount"
"1991",21011,"Kentucky","Bath County","API_alone",12,2,-10,-142.86,"undercount"
"1992",21011,"Kentucky","Bath County","API_combo",12,9,-3,-28.57,"undercount"
"1993",21013,"Kentucky","Bell County","API_alone",114,113,-1,-0.88,"undercount"
"1994",21013,"Kentucky","Bell County","API_combo",114,169,55,38.87,"overcount"
"1995",21015,"Kentucky","Boone County","API_alone",782,1153,371,38.35,"overcount"
"1996",21015,"Kentucky","Boone County","API_combo",782,1371,589,54.71,"overcount"
"1997",21017,"Kentucky","Bourbon County","API_alone",31,30,-1,-3.28,"undercount"
"1998",21017,"Kentucky","Bourbon County","API_combo",31,56,25,57.47,"overcount"
"1999",21019,"Kentucky","Boyd County","API_alone",212,156,-56,-30.43,"undercount"
"2000",21019,"Kentucky","Boyd County","API_combo",212,209,-3,-1.43,"undercount"
"2001",21021,"Kentucky","Boyle County","API_alone",123,175,52,34.9,"overcount"
"2002",21021,"Kentucky","Boyle County","API_combo",123,222,99,57.39,"overcount"
"2003",21023,"Kentucky","Bracken County","API_alone",1,8,7,155.56,"overcount"
"2004",21023,"Kentucky","Bracken County","API_combo",1,9,8,160,"overcount"
"2005",21025,"Kentucky","Breathitt County","API_alone",25,51,26,68.42,"overcount"
"2006",21025,"Kentucky","Breathitt County","API_combo",25,64,39,87.64,"overcount"
"2007",21027,"Kentucky","Breckinridge County","API_alone",26,18,-8,-36.36,"undercount"
"2008",21027,"Kentucky","Breckinridge County","API_combo",26,29,3,10.91,"overcount"
"2009",21029,"Kentucky","Bullitt County","API_alone",208,181,-27,-13.88,"undercount"
"2010",21029,"Kentucky","Bullitt County","API_combo",208,281,73,29.86,"overcount"
"2011",21031,"Kentucky","Butler County","API_alone",20,22,2,9.52,"overcount"
"2012",21031,"Kentucky","Butler County","API_combo",20,36,16,57.14,"overcount"
"2013",21033,"Kentucky","Caldwell County","API_alone",11,23,12,70.59,"overcount"
"2014",21033,"Kentucky","Caldwell County","API_combo",11,42,31,116.98,"overcount"
"2015",21035,"Kentucky","Calloway County","API_alone",226,477,251,71.41,"overcount"
"2016",21035,"Kentucky","Calloway County","API_combo",226,564,338,85.57,"overcount"
"2017",21037,"Kentucky","Campbell County","API_alone",422,501,79,17.12,"overcount"
"2018",21037,"Kentucky","Campbell County","API_combo",422,658,236,43.7,"overcount"
"2019",21039,"Kentucky","Carlisle County","API_alone",3,4,1,28.57,"overcount"
"2020",21039,"Kentucky","Carlisle County","API_combo",3,6,3,66.67,"overcount"
"2021",21041,"Kentucky","Carroll County","API_alone",22,22,0,0,"equal"
"2022",21041,"Kentucky","Carroll County","API_combo",22,38,16,53.33,"overcount"
"2023",21043,"Kentucky","Carter County","API_alone",29,30,1,3.39,"overcount"
"2024",21043,"Kentucky","Carter County","API_combo",29,49,20,51.28,"overcount"
"2025",21045,"Kentucky","Casey County","API_alone",34,18,-16,-61.54,"undercount"
"2026",21045,"Kentucky","Casey County","API_combo",34,36,2,5.71,"overcount"
"2027",21047,"Kentucky","Christian County","API_alone",1447,951,-496,-41.37,"undercount"
"2028",21047,"Kentucky","Christian County","API_combo",1447,1396,-51,-3.59,"undercount"
"2029",21049,"Kentucky","Clark County","API_alone",69,71,2,2.86,"overcount"
"2030",21049,"Kentucky","Clark County","API_combo",69,110,41,45.81,"overcount"
"2031",21051,"Kentucky","Clay County","API_alone",52,33,-19,-44.71,"undercount"
"2032",21051,"Kentucky","Clay County","API_combo",52,68,16,26.67,"overcount"
"2033",21053,"Kentucky","Clinton County","API_alone",14,15,1,6.9,"overcount"
"2034",21053,"Kentucky","Clinton County","API_combo",14,19,5,30.3,"overcount"
"2035",21055,"Kentucky","Crittenden County","API_alone",12,8,-4,-40,"undercount"
"2036",21055,"Kentucky","Crittenden County","API_combo",12,23,11,62.86,"overcount"
"2037",21057,"Kentucky","Cumberland County","API_alone",5,7,2,33.33,"overcount"
"2038",21057,"Kentucky","Cumberland County","API_combo",5,27,22,137.5,"overcount"
"2039",21059,"Kentucky","Daviess County","API_alone",364,422,58,14.76,"overcount"
"2040",21059,"Kentucky","Daviess County","API_combo",364,580,216,45.76,"overcount"
"2041",21061,"Kentucky","Edmonson County","API_alone",10,8,-2,-22.22,"undercount"
"2042",21061,"Kentucky","Edmonson County","API_combo",10,17,7,51.85,"overcount"
"2043",21063,"Kentucky","Elliott County","API_alone",0,1,1,200,"overcount"
"2044",21063,"Kentucky","Elliott County","API_combo",0,12,12,200,"overcount"
"2045",21065,"Kentucky","Estill County","API_alone",3,5,2,50,"overcount"
"2046",21065,"Kentucky","Estill County","API_combo",3,8,5,90.91,"overcount"
"2047",21067,"Kentucky","Fayette County","API_alone",6021,6626,605,9.57,"overcount"
"2048",21067,"Kentucky","Fayette County","API_combo",6021,7503,1482,21.92,"overcount"
"2049",21069,"Kentucky","Fleming County","API_alone",13,23,10,55.56,"overcount"
"2050",21069,"Kentucky","Fleming County","API_combo",13,33,20,86.96,"overcount"
"2051",21071,"Kentucky","Floyd County","API_alone",112,144,32,25,"overcount"
"2052",21071,"Kentucky","Floyd County","API_combo",112,176,64,44.44,"overcount"
"2053",21073,"Kentucky","Franklin County","API_alone",375,365,-10,-2.7,"undercount"
"2054",21073,"Kentucky","Franklin County","API_combo",375,470,95,22.49,"overcount"
"2055",21075,"Kentucky","Fulton County","API_alone",17,24,7,34.15,"overcount"
"2056",21075,"Kentucky","Fulton County","API_combo",17,32,15,61.22,"overcount"
"2057",21077,"Kentucky","Gallatin County","API_alone",15,21,6,33.33,"overcount"
"2058",21077,"Kentucky","Gallatin County","API_combo",15,46,31,101.64,"overcount"
"2059",21079,"Kentucky","Garrard County","API_alone",22,6,-16,-114.29,"undercount"
"2060",21079,"Kentucky","Garrard County","API_combo",22,17,-5,-25.64,"undercount"
"2061",21081,"Kentucky","Grant County","API_alone",41,96,55,80.29,"overcount"
"2062",21081,"Kentucky","Grant County","API_combo",41,113,72,93.51,"overcount"
"2063",21083,"Kentucky","Graves County","API_alone",72,85,13,16.56,"overcount"
"2064",21083,"Kentucky","Graves County","API_combo",72,129,57,56.72,"overcount"
"2065",21085,"Kentucky","Grayson County","API_alone",65,41,-24,-45.28,"undercount"
"2066",21085,"Kentucky","Grayson County","API_combo",65,64,-1,-1.55,"undercount"
"2067",21087,"Kentucky","Green County","API_alone",16,15,-1,-6.45,"undercount"
"2068",21087,"Kentucky","Green County","API_combo",16,27,11,51.16,"overcount"
"2069",21089,"Kentucky","Greenup County","API_alone",158,142,-16,-10.67,"undercount"
"2070",21089,"Kentucky","Greenup County","API_combo",158,181,23,13.57,"overcount"
"2071",21091,"Kentucky","Hancock County","API_alone",35,14,-21,-85.71,"undercount"
"2072",21091,"Kentucky","Hancock County","API_combo",35,23,-12,-41.38,"undercount"
"2073",21093,"Kentucky","Hardin County","API_alone",2880,1944,-936,-38.81,"undercount"
"2074",21093,"Kentucky","Hardin County","API_combo",2880,2669,-211,-7.6,"undercount"
"2075",21095,"Kentucky","Harlan County","API_alone",74,106,32,35.56,"overcount"
"2076",21095,"Kentucky","Harlan County","API_combo",74,136,62,59.05,"overcount"
"2077",21097,"Kentucky","Harrison County","API_alone",28,27,-1,-3.64,"undercount"
"2078",21097,"Kentucky","Harrison County","API_combo",28,45,17,46.58,"overcount"
"2079",21099,"Kentucky","Hart County","API_alone",13,26,13,66.67,"overcount"
"2080",21099,"Kentucky","Hart County","API_combo",13,38,25,98.04,"overcount"
"2081",21101,"Kentucky","Henderson County","API_alone",200,161,-39,-21.61,"undercount"
"2082",21101,"Kentucky","Henderson County","API_combo",200,214,14,6.76,"overcount"
"2083",21103,"Kentucky","Henry County","API_alone",19,56,37,98.67,"overcount"
"2084",21103,"Kentucky","Henry County","API_combo",19,73,54,117.39,"overcount"
"2085",21105,"Kentucky","Hickman County","API_alone",3,3,0,0,"equal"
"2086",21105,"Kentucky","Hickman County","API_combo",3,6,3,66.67,"overcount"
"2087",21107,"Kentucky","Hopkins County","API_alone",190,169,-21,-11.7,"undercount"
"2088",21107,"Kentucky","Hopkins County","API_combo",190,229,39,18.62,"overcount"
"2089",21109,"Kentucky","Jackson County","API_alone",2,3,1,40,"overcount"
"2090",21109,"Kentucky","Jackson County","API_combo",2,12,10,142.86,"overcount"
"2091",21111,"Kentucky","Jefferson County","API_alone",7359,10157,2798,31.95,"overcount"
"2092",21111,"Kentucky","Jefferson County","API_combo",7359,12219,4860,49.65,"overcount"
"2093",21113,"Kentucky","Jessamine County","API_alone",239,239,0,0,"equal"
"2094",21113,"Kentucky","Jessamine County","API_combo",239,321,82,29.29,"overcount"
"2095",21115,"Kentucky","Johnson County","API_alone",110,73,-37,-40.44,"undercount"
"2096",21115,"Kentucky","Johnson County","API_combo",110,106,-4,-3.7,"undercount"
"2097",21117,"Kentucky","Kenton County","API_alone",1005,953,-52,-5.31,"undercount"
"2098",21117,"Kentucky","Kenton County","API_combo",1005,1251,246,21.81,"overcount"
"2099",21119,"Kentucky","Knott County","API_alone",27,29,2,7.14,"overcount"
"2100",21119,"Kentucky","Knott County","API_combo",27,47,20,54.05,"overcount"
"2101",21121,"Kentucky","Knox County","API_alone",46,59,13,24.76,"overcount"
"2102",21121,"Kentucky","Knox County","API_combo",46,127,81,93.64,"overcount"
"2103",21123,"Kentucky","Larue County","API_alone",15,25,10,50,"overcount"
"2104",21123,"Kentucky","Larue County","API_combo",15,40,25,90.91,"overcount"
"2105",21125,"Kentucky","Laurel County","API_alone",144,194,50,29.59,"overcount"
"2106",21125,"Kentucky","Laurel County","API_combo",144,252,108,54.55,"overcount"
"2107",21127,"Kentucky","Lawrence County","API_alone",44,12,-32,-114.29,"undercount"
"2108",21127,"Kentucky","Lawrence County","API_combo",44,26,-18,-51.43,"undercount"
"2109",21129,"Kentucky","Lee County","API_alone",1,9,8,160,"overcount"
"2110",21129,"Kentucky","Lee County","API_combo",1,13,12,171.43,"overcount"
"2111",21131,"Kentucky","Leslie County","API_alone",13,20,7,42.42,"overcount"
"2112",21131,"Kentucky","Leslie County","API_combo",13,24,11,59.46,"overcount"
"2113",21133,"Kentucky","Letcher County","API_alone",41,75,34,58.62,"overcount"
"2114",21133,"Kentucky","Letcher County","API_combo",41,95,54,79.41,"overcount"
"2115",21135,"Kentucky","Lewis County","API_alone",6,4,-2,-40,"undercount"
"2116",21135,"Kentucky","Lewis County","API_combo",6,21,15,111.11,"overcount"
"2117",21137,"Kentucky","Lincoln County","API_alone",23,24,1,4.26,"overcount"
"2118",21137,"Kentucky","Lincoln County","API_combo",23,45,22,64.71,"overcount"
"2119",21139,"Kentucky","Livingston County","API_alone",12,5,-7,-82.35,"undercount"
"2120",21139,"Kentucky","Livingston County","API_combo",12,7,-5,-52.63,"undercount"
"2121",21141,"Kentucky","Logan County","API_alone",53,49,-4,-7.84,"undercount"
"2122",21141,"Kentucky","Logan County","API_combo",53,91,38,52.78,"overcount"
"2123",21143,"Kentucky","Lyon County","API_alone",27,16,-11,-51.16,"undercount"
"2124",21143,"Kentucky","Lyon County","API_combo",27,27,0,0,"equal"
"2125",21145,"Kentucky","McCracken County","API_alone",296,375,79,23.55,"overcount"
"2126",21145,"Kentucky","McCracken County","API_combo",296,504,208,52,"overcount"
"2127",21147,"Kentucky","McCreary County","API_alone",3,5,2,50,"overcount"
"2128",21147,"Kentucky","McCreary County","API_combo",3,19,16,145.45,"overcount"
"2129",21149,"Kentucky","McLean County","API_alone",4,5,1,22.22,"overcount"
"2130",21149,"Kentucky","McLean County","API_combo",4,8,4,66.67,"overcount"
"2131",21151,"Kentucky","Madison County","API_alone",567,545,-22,-3.96,"undercount"
"2132",21151,"Kentucky","Madison County","API_combo",567,702,135,21.28,"overcount"
"2133",21153,"Kentucky","Magoffin County","API_alone",17,10,-7,-51.85,"undercount"
"2134",21153,"Kentucky","Magoffin County","API_combo",17,15,-2,-12.5,"undercount"
"2135",21155,"Kentucky","Marion County","API_alone",33,92,59,94.4,"overcount"
"2136",21155,"Kentucky","Marion County","API_combo",33,117,84,112,"overcount"
"2137",21157,"Kentucky","Marshall County","API_alone",56,48,-8,-15.38,"undercount"
"2138",21157,"Kentucky","Marshall County","API_combo",56,68,12,19.35,"overcount"
"2139",21159,"Kentucky","Martin County","API_alone",15,17,2,12.5,"overcount"
"2140",21159,"Kentucky","Martin County","API_combo",15,25,10,50,"overcount"
"2141",21161,"Kentucky","Mason County","API_alone",29,65,36,76.6,"overcount"
"2142",21161,"Kentucky","Mason County","API_combo",29,83,54,96.43,"overcount"
"2143",21163,"Kentucky","Meade County","API_alone",478,181,-297,-90.14,"undercount"
"2144",21163,"Kentucky","Meade County","API_combo",478,310,-168,-42.64,"undercount"
"2145",21165,"Kentucky","Menifee County","API_alone",4,3,-1,-28.57,"undercount"
"2146",21165,"Kentucky","Menifee County","API_combo",4,10,6,85.71,"overcount"
"2147",21167,"Kentucky","Mercer County","API_alone",138,104,-34,-28.1,"undercount"
"2148",21167,"Kentucky","Mercer County","API_combo",138,129,-9,-6.74,"undercount"
"2149",21169,"Kentucky","Metcalfe County","API_alone",16,7,-9,-78.26,"undercount"
"2150",21169,"Kentucky","Metcalfe County","API_combo",16,11,-5,-37.04,"undercount"
"2151",21171,"Kentucky","Monroe County","API_alone",15,4,-11,-115.79,"undercount"
"2152",21171,"Kentucky","Monroe County","API_combo",15,9,-6,-50,"undercount"
"2153",21173,"Kentucky","Montgomery County","API_alone",27,32,5,16.95,"overcount"
"2154",21173,"Kentucky","Montgomery County","API_combo",27,69,42,87.5,"overcount"
"2155",21175,"Kentucky","Morgan County","API_alone",11,26,15,81.08,"overcount"
"2156",21175,"Kentucky","Morgan County","API_combo",11,36,25,106.38,"overcount"
"2157",21177,"Kentucky","Muhlenberg County","API_alone",48,44,-4,-8.7,"undercount"
"2158",21177,"Kentucky","Muhlenberg County","API_combo",48,76,28,45.16,"overcount"
"2159",21179,"Kentucky","Nelson County","API_alone",144,204,60,34.48,"overcount"
"2160",21179,"Kentucky","Nelson County","API_combo",144,226,82,44.32,"overcount"
"2161",21181,"Kentucky","Nicholas County","API_alone",33,8,-25,-121.95,"undercount"
"2162",21181,"Kentucky","Nicholas County","API_combo",33,16,-17,-69.39,"undercount"
"2163",21183,"Kentucky","Ohio County","API_alone",48,55,7,13.59,"overcount"
"2164",21183,"Kentucky","Ohio County","API_combo",48,77,29,46.4,"overcount"
"2165",21185,"Kentucky","Oldham County","API_alone",285,215,-70,-28,"undercount"
"2166",21185,"Kentucky","Oldham County","API_combo",285,312,27,9.05,"overcount"
"2167",21187,"Kentucky","Owen County","API_alone",9,26,17,97.14,"overcount"
"2168",21187,"Kentucky","Owen County","API_combo",9,45,36,133.33,"overcount"
"2169",21189,"Kentucky","Owsley County","API_alone",2,3,1,40,"overcount"
"2170",21189,"Kentucky","Owsley County","API_combo",2,5,3,85.71,"overcount"
"2171",21191,"Kentucky","Pendleton County","API_alone",19,17,-2,-11.11,"undercount"
"2172",21191,"Kentucky","Pendleton County","API_combo",19,33,14,53.85,"overcount"
"2173",21193,"Kentucky","Perry County","API_alone",96,148,52,42.62,"overcount"
"2174",21193,"Kentucky","Perry County","API_combo",96,166,70,53.44,"overcount"
"2175",21195,"Kentucky","Pike County","API_alone",252,315,63,22.22,"overcount"
"2176",21195,"Kentucky","Pike County","API_combo",252,394,142,43.96,"overcount"
"2177",21197,"Kentucky","Powell County","API_alone",13,7,-6,-60,"undercount"
"2178",21197,"Kentucky","Powell County","API_combo",13,22,9,51.43,"overcount"
"2179",21199,"Kentucky","Pulaski County","API_alone",180,220,40,20,"overcount"
"2180",21199,"Kentucky","Pulaski County","API_combo",180,262,82,37.1,"overcount"
"2181",21201,"Kentucky","Robertson County","API_alone",0,11,11,200,"overcount"
"2182",21201,"Kentucky","Robertson County","API_combo",0,11,11,200,"overcount"
"2183",21203,"Kentucky","Rockcastle County","API_alone",20,22,2,9.52,"overcount"
"2184",21203,"Kentucky","Rockcastle County","API_combo",20,32,12,46.15,"overcount"
"2185",21205,"Kentucky","Rowan County","API_alone",158,202,44,24.44,"overcount"
"2186",21205,"Kentucky","Rowan County","API_combo",158,270,112,52.34,"overcount"
"2187",21207,"Kentucky","Russell County","API_alone",7,26,19,115.15,"overcount"
"2188",21207,"Kentucky","Russell County","API_combo",7,42,35,142.86,"overcount"
"2189",21209,"Kentucky","Scott County","API_alone",217,170,-47,-24.29,"undercount"
"2190",21209,"Kentucky","Scott County","API_combo",217,237,20,8.81,"overcount"
"2191",21211,"Kentucky","Shelby County","API_alone",175,179,4,2.26,"overcount"
"2192",21211,"Kentucky","Shelby County","API_combo",175,230,55,27.16,"overcount"
"2193",21213,"Kentucky","Simpson County","API_alone",49,105,56,72.73,"overcount"
"2194",21213,"Kentucky","Simpson County","API_combo",49,125,76,87.36,"overcount"
"2195",21215,"Kentucky","Spencer County","API_alone",28,10,-18,-94.74,"undercount"
"2196",21215,"Kentucky","Spencer County","API_combo",28,22,-6,-24,"undercount"
"2197",21217,"Kentucky","Taylor County","API_alone",47,47,0,0,"equal"
"2198",21217,"Kentucky","Taylor County","API_combo",47,65,18,32.14,"overcount"
"2199",21219,"Kentucky","Todd County","API_alone",16,25,9,43.9,"overcount"
"2200",21219,"Kentucky","Todd County","API_combo",16,54,38,108.57,"overcount"
"2201",21221,"Kentucky","Trigg County","API_alone",47,37,-10,-23.81,"undercount"
"2202",21221,"Kentucky","Trigg County","API_combo",47,46,-1,-2.15,"undercount"
"2203",21223,"Kentucky","Trimble County","API_alone",3,8,5,90.91,"overcount"
"2204",21223,"Kentucky","Trimble County","API_combo",3,18,15,142.86,"overcount"
"2205",21225,"Kentucky","Union County","API_alone",56,32,-24,-54.55,"undercount"
"2206",21225,"Kentucky","Union County","API_combo",56,66,10,16.39,"overcount"
"2207",21227,"Kentucky","Warren County","API_alone",1119,1362,243,19.59,"overcount"
"2208",21227,"Kentucky","Warren County","API_combo",1119,1660,541,38.93,"overcount"
"2209",21229,"Kentucky","Washington County","API_alone",16,31,15,63.83,"overcount"
"2210",21229,"Kentucky","Washington County","API_combo",16,59,43,114.67,"overcount"
"2211",21231,"Kentucky","Wayne County","API_alone",11,22,11,66.67,"overcount"
"2212",21231,"Kentucky","Wayne County","API_combo",11,32,21,97.67,"overcount"
"2213",21233,"Kentucky","Webster County","API_alone",34,21,-13,-47.27,"undercount"
"2214",21233,"Kentucky","Webster County","API_combo",34,34,0,0,"equal"
"2215",21235,"Kentucky","Whitley County","API_alone",83,80,-3,-3.68,"undercount"
"2216",21235,"Kentucky","Whitley County","API_combo",83,136,53,48.4,"overcount"
"2217",21237,"Kentucky","Wolfe County","API_alone",4,4,0,0,"equal"
"2218",21237,"Kentucky","Wolfe County","API_combo",4,4,0,0,"equal"
"2219",21239,"Kentucky","Woodford County","API_alone",57,77,20,29.85,"overcount"
"2220",21239,"Kentucky","Woodford County","API_combo",57,101,44,55.7,"overcount"
"2221",22001,"Louisiana","Acadia Parish","API_alone",115,97,-18,-16.98,"undercount"
"2222",22001,"Louisiana","Acadia Parish","API_combo",115,148,33,25.1,"overcount"
"2223",22003,"Louisiana","Allen Parish","API_alone",74,151,77,68.44,"overcount"
"2224",22003,"Louisiana","Allen Parish","API_combo",74,189,115,87.45,"overcount"
"2225",22005,"Louisiana","Ascension Parish","API_alone",316,297,-19,-6.2,"undercount"
"2226",22005,"Louisiana","Ascension Parish","API_combo",316,375,59,17.08,"overcount"
"2227",22007,"Louisiana","Assumption Parish","API_alone",93,60,-33,-43.14,"undercount"
"2228",22007,"Louisiana","Assumption Parish","API_combo",93,81,-12,-13.79,"undercount"
"2229",22009,"Louisiana","Avoyelles Parish","API_alone",70,75,5,6.9,"overcount"
"2230",22009,"Louisiana","Avoyelles Parish","API_combo",70,107,37,41.81,"overcount"
"2231",22011,"Louisiana","Beauregard Parish","API_alone",237,218,-19,-8.35,"undercount"
"2232",22011,"Louisiana","Beauregard Parish","API_combo",237,296,59,22.14,"overcount"
"2233",22013,"Louisiana","Bienville Parish","API_alone",17,24,7,34.15,"overcount"
"2234",22013,"Louisiana","Bienville Parish","API_combo",17,51,34,100,"overcount"
"2235",22015,"Louisiana","Bossier Parish","API_alone",1472,1366,-106,-7.47,"undercount"
"2236",22015,"Louisiana","Bossier Parish","API_combo",1472,1864,392,23.5,"overcount"
"2237",22017,"Louisiana","Caddo Parish","API_alone",1519,1847,328,19.49,"overcount"
"2238",22017,"Louisiana","Caddo Parish","API_combo",1519,2428,909,46.06,"overcount"
"2239",22019,"Louisiana","Calcasieu Parish","API_alone",940,1261,321,29.17,"overcount"
"2240",22019,"Louisiana","Calcasieu Parish","API_combo",940,1588,648,51.27,"overcount"
"2241",22021,"Louisiana","Caldwell Parish","API_alone",15,15,0,0,"equal"
"2242",22021,"Louisiana","Caldwell Parish","API_combo",15,27,12,57.14,"overcount"
"2243",22023,"Louisiana","Cameron Parish","API_alone",41,47,6,13.64,"overcount"
"2244",22023,"Louisiana","Cameron Parish","API_combo",41,53,12,25.53,"overcount"
"2245",22025,"Louisiana","Catahoula Parish","API_alone",8,14,6,54.55,"overcount"
"2246",22025,"Louisiana","Catahoula Parish","API_combo",8,31,23,117.95,"overcount"
"2247",22027,"Louisiana","Claiborne Parish","API_alone",17,22,5,25.64,"overcount"
"2248",22027,"Louisiana","Claiborne Parish","API_combo",17,55,38,105.56,"overcount"
"2249",22029,"Louisiana","Concordia Parish","API_alone",40,49,9,20.22,"overcount"
"2250",22029,"Louisiana","Concordia Parish","API_combo",40,86,46,73.02,"overcount"
"2251",22031,"Louisiana","De Soto Parish","API_alone",12,43,31,112.73,"overcount"
"2252",22031,"Louisiana","De Soto Parish","API_combo",12,63,51,136,"overcount"
"2253",22033,"Louisiana","East Baton Rouge Parish","API_alone",7626,8819,1193,14.51,"overcount"
"2254",22033,"Louisiana","East Baton Rouge Parish","API_combo",7626,9857,2231,25.52,"overcount"
"2255",22035,"Louisiana","East Carroll Parish","API_alone",21,31,10,38.46,"overcount"
"2256",22035,"Louisiana","East Carroll Parish","API_combo",21,40,19,62.3,"overcount"
"2257",22037,"Louisiana","East Feliciana Parish","API_alone",35,51,16,37.21,"overcount"
"2258",22037,"Louisiana","East Feliciana Parish","API_combo",35,90,55,88,"overcount"
"2259",22039,"Louisiana","Evangeline Parish","API_alone",49,58,9,16.82,"overcount"
"2260",22039,"Louisiana","Evangeline Parish","API_combo",49,99,50,67.57,"overcount"
"2261",22041,"Louisiana","Franklin Parish","API_alone",36,44,8,20,"overcount"
"2262",22041,"Louisiana","Franklin Parish","API_combo",36,73,37,67.89,"overcount"
"2263",22043,"Louisiana","Grant Parish","API_alone",46,35,-11,-27.16,"undercount"
"2264",22043,"Louisiana","Grant Parish","API_combo",46,70,24,41.38,"overcount"
"2265",22045,"Louisiana","Iberia Parish","API_alone",1259,1488,229,16.67,"overcount"
"2266",22045,"Louisiana","Iberia Parish","API_combo",1259,1674,415,28.3,"overcount"
"2267",22047,"Louisiana","Iberville Parish","API_alone",69,94,25,30.67,"overcount"
"2268",22047,"Louisiana","Iberville Parish","API_combo",69,120,51,53.97,"overcount"
"2269",22049,"Louisiana","Jackson Parish","API_alone",26,34,8,26.67,"overcount"
"2270",22049,"Louisiana","Jackson Parish","API_combo",26,45,19,53.52,"overcount"
"2271",22051,"Louisiana","Jefferson Parish","API_alone",14200,14634,434,3.01,"overcount"
"2272",22051,"Louisiana","Jefferson Parish","API_combo",14200,16321,2121,13.9,"overcount"
"2273",22053,"Louisiana","Jefferson Davis Parish","API_alone",72,69,-3,-4.26,"undercount"
"2274",22053,"Louisiana","Jefferson Davis Parish","API_combo",72,97,25,29.59,"overcount"
"2275",22055,"Louisiana","Lafayette Parish","API_alone",2492,2144,-348,-15.01,"undercount"
"2276",22055,"Louisiana","Lafayette Parish","API_combo",2492,2545,53,2.1,"overcount"
"2277",22057,"Louisiana","Lafourche Parish","API_alone",1008,629,-379,-46.3,"undercount"
"2278",22057,"Louisiana","Lafourche Parish","API_combo",1008,759,-249,-28.18,"undercount"
"2279",22059,"Louisiana","La Salle Parish","API_alone",54,26,-28,-70,"undercount"
"2280",22059,"Louisiana","La Salle Parish","API_combo",54,39,-15,-32.26,"undercount"
"2281",22061,"Louisiana","Lincoln Parish","API_alone",487,565,78,14.83,"overcount"
"2282",22061,"Louisiana","Lincoln Parish","API_combo",487,622,135,24.35,"overcount"
"2283",22063,"Louisiana","Livingston Parish","API_alone",257,180,-77,-35.24,"undercount"
"2284",22063,"Louisiana","Livingston Parish","API_combo",257,269,12,4.56,"overcount"
"2285",22065,"Louisiana","Madison Parish","API_alone",12,105,93,158.97,"overcount"
"2286",22065,"Louisiana","Madison Parish","API_combo",12,119,107,163.36,"overcount"
"2287",22067,"Louisiana","Morehouse Parish","API_alone",54,60,6,10.53,"overcount"
"2288",22067,"Louisiana","Morehouse Parish","API_combo",54,87,33,46.81,"overcount"
"2289",22069,"Louisiana","Natchitoches Parish","API_alone",200,187,-13,-6.72,"undercount"
"2290",22069,"Louisiana","Natchitoches Parish","API_combo",200,245,45,20.22,"overcount"
"2291",22071,"Louisiana","Orleans Parish","API_alone",12054,11255,-799,-6.86,"undercount"
"2292",22071,"Louisiana","Orleans Parish","API_combo",12054,12549,495,4.02,"overcount"
"2293",22073,"Louisiana","Ouachita Parish","API_alone",1037,995,-42,-4.13,"undercount"
"2294",22073,"Louisiana","Ouachita Parish","API_combo",1037,1214,177,15.73,"overcount"
"2295",22075,"Louisiana","Plaquemines Parish","API_alone",715,735,20,2.76,"overcount"
"2296",22075,"Louisiana","Plaquemines Parish","API_combo",715,822,107,13.92,"overcount"
"2297",22077,"Louisiana","Pointe Coupee Parish","API_alone",21,58,37,93.67,"overcount"
"2298",22077,"Louisiana","Pointe Coupee Parish","API_combo",21,81,60,117.65,"overcount"
"2299",22079,"Louisiana","Rapides Parish","API_alone",1220,1163,-57,-4.78,"undercount"
"2300",22079,"Louisiana","Rapides Parish","API_combo",1220,1391,171,13.1,"overcount"
"2301",22081,"Louisiana","Red River Parish","API_alone",9,11,2,20,"overcount"
"2302",22081,"Louisiana","Red River Parish","API_combo",9,36,27,120,"overcount"
"2303",22083,"Louisiana","Richland Parish","API_alone",19,37,18,64.29,"overcount"
"2304",22083,"Louisiana","Richland Parish","API_combo",19,67,48,111.63,"overcount"
"2305",22085,"Louisiana","Sabine Parish","API_alone",41,44,3,7.06,"overcount"
"2306",22085,"Louisiana","Sabine Parish","API_combo",41,86,45,70.87,"overcount"
"2307",22087,"Louisiana","St. Bernard Parish","API_alone",930,920,-10,-1.08,"undercount"
"2308",22087,"Louisiana","St. Bernard Parish","API_combo",930,1296,366,32.88,"overcount"
"2309",22089,"Louisiana","St. Charles Parish","API_alone",323,290,-33,-10.77,"undercount"
"2310",22089,"Louisiana","St. Charles Parish","API_combo",323,379,56,15.95,"overcount"
"2311",22091,"Louisiana","St. Helena Parish","API_alone",2,12,10,142.86,"overcount"
"2312",22091,"Louisiana","St. Helena Parish","API_combo",2,42,40,181.82,"overcount"
"2313",22093,"Louisiana","St. James Parish","API_alone",26,10,-16,-88.89,"undercount"
"2314",22093,"Louisiana","St. James Parish","API_combo",26,22,-4,-16.67,"undercount"
"2315",22095,"Louisiana","St. John the Baptist Parish","API_alone",240,257,17,6.84,"overcount"
"2316",22095,"Louisiana","St. John the Baptist Parish","API_combo",240,357,117,39.2,"overcount"
"2317",22097,"Louisiana","St. Landry Parish","API_alone",244,192,-52,-23.85,"undercount"
"2318",22097,"Louisiana","St. Landry Parish","API_combo",244,319,75,26.64,"overcount"
"2319",22099,"Louisiana","St. Martin Parish","API_alone",496,455,-41,-8.62,"undercount"
"2320",22099,"Louisiana","St. Martin Parish","API_combo",496,514,18,3.56,"overcount"
"2321",22101,"Louisiana","St. Mary Parish","API_alone",1300,893,-407,-37.12,"undercount"
"2322",22101,"Louisiana","St. Mary Parish","API_combo",1300,962,-338,-29.89,"undercount"
"2323",22103,"Louisiana","St. Tammany Parish","API_alone",1512,1503,-9,-0.6,"undercount"
"2324",22103,"Louisiana","St. Tammany Parish","API_combo",1512,2070,558,31.16,"overcount"
"2325",22105,"Louisiana","Tangipahoa Parish","API_alone",399,422,23,5.6,"overcount"
"2326",22105,"Louisiana","Tangipahoa Parish","API_combo",399,589,190,38.46,"overcount"
"2327",22107,"Louisiana","Tensas Parish","API_alone",4,12,8,100,"overcount"
"2328",22107,"Louisiana","Tensas Parish","API_combo",4,24,20,142.86,"overcount"
"2329",22109,"Louisiana","Terrebonne Parish","API_alone",1061,888,-173,-17.75,"undercount"
"2330",22109,"Louisiana","Terrebonne Parish","API_combo",1061,1100,39,3.61,"overcount"
"2331",22111,"Louisiana","Union Parish","API_alone",42,72,30,52.63,"overcount"
"2332",22111,"Louisiana","Union Parish","API_combo",42,92,50,74.63,"overcount"
"2333",22113,"Louisiana","Vermilion Parish","API_alone",991,986,-5,-0.51,"undercount"
"2334",22113,"Louisiana","Vermilion Parish","API_combo",991,1121,130,12.31,"overcount"
"2335",22115,"Louisiana","Vernon Parish","API_alone",1721,1037,-684,-49.6,"undercount"
"2336",22115,"Louisiana","Vernon Parish","API_combo",1721,1610,-111,-6.66,"undercount"
"2337",22117,"Louisiana","Washington Parish","API_alone",73,74,1,1.36,"overcount"
"2338",22117,"Louisiana","Washington Parish","API_combo",73,139,66,62.26,"overcount"
"2339",22119,"Louisiana","Webster Parish","API_alone",79,102,23,25.41,"overcount"
"2340",22119,"Louisiana","Webster Parish","API_combo",79,190,111,82.53,"overcount"
"2341",22121,"Louisiana","West Baton Rouge Parish","API_alone",34,49,15,36.14,"overcount"
"2342",22121,"Louisiana","West Baton Rouge Parish","API_combo",34,73,39,72.9,"overcount"
"2343",22123,"Louisiana","West Carroll Parish","API_alone",7,17,10,83.33,"overcount"
"2344",22123,"Louisiana","West Carroll Parish","API_combo",7,23,16,106.67,"overcount"
"2345",22125,"Louisiana","West Feliciana Parish","API_alone",16,30,14,60.87,"overcount"
"2346",22125,"Louisiana","West Feliciana Parish","API_combo",16,46,30,96.77,"overcount"
"2347",22127,"Louisiana","Winn Parish","API_alone",32,36,4,11.76,"overcount"
"2348",22127,"Louisiana","Winn Parish","API_combo",32,67,35,70.71,"overcount"
"2349",23001,"Maine","Androscoggin County","API_alone",761,631,-130,-18.68,"undercount"
"2350",23001,"Maine","Androscoggin County","API_combo",761,867,106,13.02,"overcount"
"2351",23003,"Maine","Aroostook County","API_alone",474,386,-88,-20.47,"undercount"
"2352",23003,"Maine","Aroostook County","API_combo",474,505,31,6.33,"overcount"
"2353",23005,"Maine","Cumberland County","API_alone",3103,3875,772,22.13,"overcount"
"2354",23005,"Maine","Cumberland County","API_combo",3103,4782,1679,42.59,"overcount"
"2355",23007,"Maine","Franklin County","API_alone",110,139,29,23.29,"overcount"
"2356",23007,"Maine","Franklin County","API_combo",110,184,74,50.34,"overcount"
"2357",23009,"Maine","Hancock County","API_alone",219,218,-1,-0.46,"undercount"
"2358",23009,"Maine","Hancock County","API_combo",219,339,120,43.01,"overcount"
"2359",23011,"Maine","Kennebec County","API_alone",728,731,3,0.41,"overcount"
"2360",23011,"Maine","Kennebec County","API_combo",728,983,255,29.81,"overcount"
"2361",23013,"Maine","Knox County","API_alone",120,151,31,22.88,"overcount"
"2362",23013,"Maine","Knox County","API_combo",120,216,96,57.14,"overcount"
"2363",23015,"Maine","Lincoln County","API_alone",60,133,73,75.65,"overcount"
"2364",23015,"Maine","Lincoln County","API_combo",60,165,105,93.33,"overcount"
"2365",23017,"Maine","Oxford County","API_alone",212,220,8,3.7,"overcount"
"2366",23017,"Maine","Oxford County","API_combo",212,300,88,34.38,"overcount"
"2367",23019,"Maine","Penobscot County","API_alone",1272,1090,-182,-15.41,"undercount"
"2368",23019,"Maine","Penobscot County","API_combo",1272,1430,158,11.7,"overcount"
"2369",23021,"Maine","Piscataquis County","API_alone",71,56,-15,-23.62,"undercount"
"2370",23021,"Maine","Piscataquis County","API_combo",71,75,4,5.48,"overcount"
"2371",23023,"Maine","Sagadahoc County","API_alone",391,253,-138,-42.86,"undercount"
"2372",23023,"Maine","Sagadahoc County","API_combo",391,374,-17,-4.44,"undercount"
"2373",23025,"Maine","Somerset County","API_alone",181,183,2,1.1,"overcount"
"2374",23025,"Maine","Somerset County","API_combo",181,278,97,42.27,"overcount"
"2375",23027,"Maine","Waldo County","API_alone",117,85,-32,-31.68,"undercount"
"2376",23027,"Maine","Waldo County","API_combo",117,152,35,26.02,"overcount"
"2377",23029,"Maine","Washington County","API_alone",118,110,-8,-7.02,"undercount"
"2378",23029,"Maine","Washington County","API_combo",118,164,46,32.62,"overcount"
"2379",23031,"Maine","York County","API_alone",1630,1465,-165,-10.66,"undercount"
"2380",23031,"Maine","York County","API_combo",1630,1843,213,12.27,"overcount"
"2381",24001,"Maryland","Allegany County","API_alone",497,412,-85,-18.7,"undercount"
"2382",24001,"Maryland","Allegany County","API_combo",497,546,49,9.4,"overcount"
"2383",24003,"Maryland","Anne Arundel County","API_alone",13086,11872,-1214,-9.73,"undercount"
"2384",24003,"Maryland","Anne Arundel County","API_combo",13086,14576,1490,10.77,"overcount"
"2385",24005,"Maryland","Baltimore County","API_alone",24319,24778,459,1.87,"overcount"
"2386",24005,"Maryland","Baltimore County","API_combo",24319,27615,3296,12.69,"overcount"
"2387",24009,"Maryland","Calvert County","API_alone",662,690,28,4.14,"overcount"
"2388",24009,"Maryland","Calvert County","API_combo",662,968,306,37.55,"overcount"
"2389",24011,"Maryland","Caroline County","API_alone",136,174,38,24.52,"overcount"
"2390",24011,"Maryland","Caroline County","API_combo",136,233,97,52.57,"overcount"
"2391",24013,"Maryland","Carroll County","API_alone",1477,1193,-284,-21.27,"undercount"
"2392",24013,"Maryland","Carroll County","API_combo",1477,1523,46,3.07,"overcount"
"2393",24015,"Maryland","Cecil County","API_alone",605,626,21,3.41,"overcount"
"2394",24015,"Maryland","Cecil County","API_combo",605,831,226,31.48,"overcount"
"2395",24017,"Maryland","Charles County","API_alone",2371,2294,-77,-3.3,"undercount"
"2396",24017,"Maryland","Charles County","API_combo",2371,3048,677,24.99,"overcount"
"2397",24019,"Maryland","Dorchester County","API_alone",186,213,27,13.53,"overcount"
"2398",24019,"Maryland","Dorchester County","API_combo",186,258,72,32.43,"overcount"
"2399",24021,"Maryland","Frederick County","API_alone",3041,3413,372,11.53,"overcount"
"2400",24021,"Maryland","Frederick County","API_combo",3041,4245,1204,33.05,"overcount"
"2401",24023,"Maryland","Garrett County","API_alone",71,64,-7,-10.37,"undercount"
"2402",24023,"Maryland","Garrett County","API_combo",71,83,12,15.58,"overcount"
"2403",24025,"Maryland","Harford County","API_alone",4668,3513,-1155,-28.24,"undercount"
"2404",24025,"Maryland","Harford County","API_combo",4668,4498,-170,-3.71,"undercount"
"2405",24027,"Maryland","Howard County","API_alone",15628,19404,3776,21.56,"overcount"
"2406",24027,"Maryland","Howard County","API_combo",15628,21226,5598,30.38,"overcount"
"2407",24029,"Maryland","Kent County","API_alone",99,118,19,17.51,"overcount"
"2408",24029,"Maryland","Kent County","API_combo",99,141,42,35,"overcount"
"2409",24031,"Maryland","Montgomery County","API_alone",98338,101347,3009,3.01,"overcount"
"2410",24031,"Maryland","Montgomery County","API_combo",98338,109926,11588,11.13,"overcount"
"2411",24033,"Maryland","Prince George's County","API_alone",38614,32663,-5951,-16.7,"undercount"
"2412",24033,"Maryland","Prince George's County","API_combo",38614,37030,-1584,-4.19,"undercount"
"2413",24035,"Maryland","Queen Anne's County","API_alone",233,258,25,10.18,"overcount"
"2414",24035,"Maryland","Queen Anne's County","API_combo",233,380,147,47.96,"overcount"
"2415",24037,"Maryland","St. Mary's County","API_alone",1664,1658,-6,-0.36,"undercount"
"2416",24037,"Maryland","St. Mary's County","API_combo",1664,2167,503,26.26,"overcount"
"2417",24039,"Maryland","Somerset County","API_alone",134,130,-4,-3.03,"undercount"
"2418",24039,"Maryland","Somerset County","API_combo",134,181,47,29.84,"overcount"
"2419",24041,"Maryland","Talbot County","API_alone",158,324,166,68.88,"overcount"
"2420",24041,"Maryland","Talbot County","API_combo",158,390,232,84.67,"overcount"
"2421",24043,"Maryland","Washington County","API_alone",1331,1134,-197,-15.98,"undercount"
"2422",24043,"Maryland","Washington County","API_combo",1331,1417,86,6.26,"overcount"
"2423",24045,"Maryland","Wicomico County","API_alone",1050,1563,513,39.27,"overcount"
"2424",24045,"Maryland","Wicomico County","API_combo",1050,1789,739,52.06,"overcount"
"2425",24047,"Maryland","Worcester County","API_alone",302,308,6,1.97,"overcount"
"2426",24047,"Maryland","Worcester County","API_combo",302,395,93,26.69,"overcount"
"2427",24510,"Maryland","Baltimore city","API_alone",8327,10593,2266,23.95,"overcount"
"2428",24510,"Maryland","Baltimore city","API_combo",8327,12636,4309,41.11,"overcount"
"2429",25001,"Massachusetts","Barnstable County","API_alone",1969,1530,-439,-25.09,"undercount"
"2430",25001,"Massachusetts","Barnstable County","API_combo",1969,2064,95,4.71,"overcount"
"2431",25003,"Massachusetts","Berkshire County","API_alone",1520,1421,-99,-6.73,"undercount"
"2432",25003,"Massachusetts","Berkshire County","API_combo",1520,1853,333,19.75,"overcount"
"2433",25005,"Massachusetts","Bristol County","API_alone",8127,7418,-709,-9.12,"undercount"
"2434",25005,"Massachusetts","Bristol County","API_combo",8127,9342,1215,13.91,"overcount"
"2435",25007,"Massachusetts","Dukes County","API_alone",85,96,11,12.15,"overcount"
"2436",25007,"Massachusetts","Dukes County","API_combo",85,144,59,51.53,"overcount"
"2437",25009,"Massachusetts","Essex County","API_alone",18638,18676,38,0.2,"overcount"
"2438",25009,"Massachusetts","Essex County","API_combo",18638,20938,2300,11.62,"overcount"
"2439",25011,"Massachusetts","Franklin County","API_alone",842,807,-35,-4.24,"undercount"
"2440",25011,"Massachusetts","Franklin County","API_combo",842,1022,180,19.31,"overcount"
"2441",25013,"Massachusetts","Hampden County","API_alone",6369,7163,794,11.74,"overcount"
"2442",25013,"Massachusetts","Hampden County","API_combo",6369,8456,2087,28.16,"overcount"
"2443",25015,"Massachusetts","Hampshire County","API_alone",7180,5381,-1799,-28.64,"undercount"
"2444",25015,"Massachusetts","Hampshire County","API_combo",7180,6184,-996,-14.91,"undercount"
"2445",25017,"Massachusetts","Middlesex County","API_alone",87105,94680,7575,8.33,"overcount"
"2446",25017,"Massachusetts","Middlesex County","API_combo",87105,102894,15789,16.62,"overcount"
"2447",25019,"Massachusetts","Nantucket County","API_alone",40,76,36,62.07,"overcount"
"2448",25019,"Massachusetts","Nantucket County","API_combo",40,101,61,86.52,"overcount"
"2449",25021,"Massachusetts","Norfolk County","API_alone",31810,36491,4681,13.71,"overcount"
"2450",25021,"Massachusetts","Norfolk County","API_combo",31810,39176,7366,20.75,"overcount"
"2451",25023,"Massachusetts","Plymouth County","API_alone",6640,5024,-1616,-27.71,"undercount"
"2452",25023,"Massachusetts","Plymouth County","API_combo",6640,6382,-258,-3.96,"undercount"
"2453",25025,"Massachusetts","Suffolk County","API_alone",50422,51120,698,1.37,"overcount"
"2454",25025,"Massachusetts","Suffolk County","API_combo",50422,55299,4877,9.23,"overcount"
"2455",25027,"Massachusetts","Worcester County","API_alone",20337,20894,557,2.7,"overcount"
"2456",25027,"Massachusetts","Worcester County","API_combo",20337,23291,2954,13.54,"overcount"
"2457",26001,"Michigan","Alcona County","API_alone",42,22,-20,-62.5,"undercount"
"2458",26001,"Michigan","Alcona County","API_combo",42,43,1,2.35,"overcount"
"2459",26003,"Michigan","Alger County","API_alone",48,38,-10,-23.26,"undercount"
"2460",26003,"Michigan","Alger County","API_combo",48,44,-4,-8.7,"undercount"
"2461",26005,"Michigan","Allegan County","API_alone",721,674,-47,-6.74,"undercount"
"2462",26005,"Michigan","Allegan County","API_combo",721,842,121,15.48,"overcount"
"2463",26007,"Michigan","Alpena County","API_alone",111,104,-7,-6.51,"undercount"
"2464",26007,"Michigan","Alpena County","API_combo",111,152,41,31.18,"overcount"
"2465",26009,"Michigan","Antrim County","API_alone",48,60,12,22.22,"overcount"
"2466",26009,"Michigan","Antrim County","API_combo",48,94,46,64.79,"overcount"
"2467",26011,"Michigan","Arenac County","API_alone",68,52,-16,-26.67,"undercount"
"2468",26011,"Michigan","Arenac County","API_combo",68,86,18,23.38,"overcount"
"2469",26013,"Michigan","Baraga County","API_alone",14,26,12,60,"overcount"
"2470",26013,"Michigan","Baraga County","API_combo",14,47,33,108.2,"overcount"
"2471",26015,"Michigan","Barry County","API_alone",241,162,-79,-39.21,"undercount"
"2472",26015,"Michigan","Barry County","API_combo",241,250,9,3.67,"overcount"
"2473",26017,"Michigan","Bay County","API_alone",645,556,-89,-14.82,"undercount"
"2474",26017,"Michigan","Bay County","API_combo",645,714,69,10.15,"overcount"
"2475",26019,"Michigan","Benzie County","API_alone",71,26,-45,-92.78,"undercount"
"2476",26019,"Michigan","Benzie County","API_combo",71,35,-36,-67.92,"undercount"
"2477",26021,"Michigan","Berrien County","API_alone",2157,1982,-175,-8.46,"undercount"
"2478",26021,"Michigan","Berrien County","API_combo",2157,2423,266,11.62,"overcount"
"2479",26023,"Michigan","Branch County","API_alone",253,228,-25,-10.4,"undercount"
"2480",26023,"Michigan","Branch County","API_combo",253,320,67,23.39,"overcount"
"2481",26025,"Michigan","Calhoun County","API_alone",1710,1599,-111,-6.71,"undercount"
"2482",26025,"Michigan","Calhoun County","API_combo",1710,1957,247,13.47,"overcount"
"2483",26027,"Michigan","Cass County","API_alone",279,315,36,12.12,"overcount"
"2484",26027,"Michigan","Cass County","API_combo",279,398,119,35.16,"overcount"
"2485",26029,"Michigan","Charlevoix County","API_alone",73,82,9,11.61,"overcount"
"2486",26029,"Michigan","Charlevoix County","API_combo",73,120,47,48.7,"overcount"
"2487",26031,"Michigan","Cheboygan County","API_alone",105,57,-48,-59.26,"undercount"
"2488",26031,"Michigan","Cheboygan County","API_combo",105,120,15,13.33,"overcount"
"2489",26033,"Michigan","Chippewa County","API_alone",239,194,-45,-20.79,"undercount"
"2490",26033,"Michigan","Chippewa County","API_combo",239,351,112,37.97,"overcount"
"2491",26035,"Michigan","Clare County","API_alone",113,84,-29,-29.44,"undercount"
"2492",26035,"Michigan","Clare County","API_combo",113,114,1,0.88,"overcount"
"2493",26037,"Michigan","Clinton County","API_alone",346,367,21,5.89,"overcount"
"2494",26037,"Michigan","Clinton County","API_combo",346,500,154,36.41,"overcount"
"2495",26039,"Michigan","Crawford County","API_alone",79,41,-38,-63.33,"undercount"
"2496",26039,"Michigan","Crawford County","API_combo",79,59,-20,-28.99,"undercount"
"2497",26041,"Michigan","Delta County","API_alone",150,135,-15,-10.53,"undercount"
"2498",26041,"Michigan","Delta County","API_combo",150,186,36,21.43,"overcount"
"2499",26043,"Michigan","Dickinson County","API_alone",149,124,-25,-18.32,"undercount"
"2500",26043,"Michigan","Dickinson County","API_combo",149,169,20,12.58,"overcount"
"2501",26045,"Michigan","Eaton County","API_alone",947,1223,276,25.44,"overcount"
"2502",26045,"Michigan","Eaton County","API_combo",947,1487,540,44.37,"overcount"
"2503",26047,"Michigan","Emmet County","API_alone",132,149,17,12.1,"overcount"
"2504",26047,"Michigan","Emmet County","API_combo",132,216,84,48.28,"overcount"
"2505",26049,"Michigan","Genesee County","API_alone",4457,3689,-768,-18.86,"undercount"
"2506",26049,"Michigan","Genesee County","API_combo",4457,4873,416,8.92,"overcount"
"2507",26051,"Michigan","Gladwin County","API_alone",75,85,10,12.5,"overcount"
"2508",26051,"Michigan","Gladwin County","API_combo",75,104,29,32.4,"overcount"
"2509",26053,"Michigan","Gogebic County","API_alone",36,43,7,17.72,"overcount"
"2510",26053,"Michigan","Gogebic County","API_combo",36,77,41,72.57,"overcount"
"2511",26055,"Michigan","Grand Traverse County","API_alone",563,429,-134,-27.02,"undercount"
"2512",26055,"Michigan","Grand Traverse County","API_combo",563,637,74,12.33,"overcount"
"2513",26057,"Michigan","Gratiot County","API_alone",150,162,12,7.69,"overcount"
"2514",26057,"Michigan","Gratiot County","API_combo",150,248,98,49.25,"overcount"
"2515",26059,"Michigan","Hillsdale County","API_alone",190,162,-28,-15.91,"undercount"
"2516",26059,"Michigan","Hillsdale County","API_combo",190,225,35,16.87,"overcount"
"2517",26061,"Michigan","Houghton County","API_alone",887,662,-225,-29.05,"undercount"
"2518",26061,"Michigan","Houghton County","API_combo",887,760,-127,-15.42,"undercount"
"2519",26063,"Michigan","Huron County","API_alone",92,133,41,36.44,"overcount"
"2520",26063,"Michigan","Huron County","API_combo",92,182,90,65.69,"overcount"
"2521",26065,"Michigan","Ingham County","API_alone",11545,10634,-911,-8.21,"undercount"
"2522",26065,"Michigan","Ingham County","API_combo",11545,12021,476,4.04,"overcount"
"2523",26067,"Michigan","Ionia County","API_alone",217,218,1,0.46,"overcount"
"2524",26067,"Michigan","Ionia County","API_combo",217,390,173,57,"overcount"
"2525",26069,"Michigan","Iosco County","API_alone",302,143,-159,-71.46,"undercount"
"2526",26069,"Michigan","Iosco County","API_combo",302,213,-89,-34.56,"undercount"
"2527",26071,"Michigan","Iron County","API_alone",40,26,-14,-42.42,"undercount"
"2528",26071,"Michigan","Iron County","API_combo",40,44,4,9.52,"overcount"
"2529",26073,"Michigan","Isabella County","API_alone",759,941,182,21.41,"overcount"
"2530",26073,"Michigan","Isabella County","API_combo",759,1101,342,36.77,"overcount"
"2531",26075,"Michigan","Jackson County","API_alone",1079,933,-146,-14.51,"undercount"
"2532",26075,"Michigan","Jackson County","API_combo",1079,1224,145,12.59,"overcount"
"2533",26077,"Michigan","Kalamazoo County","API_alone",4947,4545,-402,-8.47,"undercount"
"2534",26077,"Michigan","Kalamazoo County","API_combo",4947,5405,458,8.85,"overcount"
"2535",26079,"Michigan","Kalkaska County","API_alone",45,45,0,0,"equal"
"2536",26079,"Michigan","Kalkaska County","API_combo",45,72,27,46.15,"overcount"
"2537",26081,"Michigan","Kent County","API_alone",9243,11336,2093,20.34,"overcount"
"2538",26081,"Michigan","Kent County","API_combo",9243,13229,3986,35.48,"overcount"
"2539",26083,"Michigan","Keweenaw County","API_alone",11,3,-8,-114.29,"undercount"
"2540",26083,"Michigan","Keweenaw County","API_combo",11,7,-4,-44.44,"undercount"
"2541",26085,"Michigan","Lake County","API_alone",20,22,2,9.52,"overcount"
"2542",26085,"Michigan","Lake County","API_combo",20,49,29,84.06,"overcount"
"2543",26087,"Michigan","Lapeer County","API_alone",524,360,-164,-37.1,"undercount"
"2544",26087,"Michigan","Lapeer County","API_combo",524,520,-4,-0.77,"undercount"
"2545",26089,"Michigan","Leelanau County","API_alone",84,60,-24,-33.33,"undercount"
"2546",26089,"Michigan","Leelanau County","API_combo",84,116,32,32,"overcount"
"2547",26091,"Michigan","Lenawee County","API_alone",858,478,-380,-56.89,"undercount"
"2548",26091,"Michigan","Lenawee County","API_combo",858,663,-195,-25.64,"undercount"
"2549",26093,"Michigan","Livingston County","API_alone",962,970,8,0.83,"overcount"
"2550",26093,"Michigan","Livingston County","API_combo",962,1342,380,32.99,"overcount"
"2551",26095,"Michigan","Luce County","API_alone",21,29,8,32,"overcount"
"2552",26095,"Michigan","Luce County","API_combo",21,61,40,97.56,"overcount"
"2553",26097,"Michigan","Mackinac County","API_alone",17,39,22,78.57,"overcount"
"2554",26097,"Michigan","Mackinac County","API_combo",17,52,35,101.45,"overcount"
"2555",26099,"Michigan","Macomb County","API_alone",15795,17436,1641,9.88,"overcount"
"2556",26099,"Michigan","Macomb County","API_combo",15795,20348,4553,25.19,"overcount"
"2557",26101,"Michigan","Manistee County","API_alone",80,90,10,11.76,"overcount"
"2558",26101,"Michigan","Manistee County","API_combo",80,157,77,64.98,"overcount"
"2559",26103,"Michigan","Marquette County","API_alone",688,334,-354,-69.28,"undercount"
"2560",26103,"Michigan","Marquette County","API_combo",688,457,-231,-40.35,"undercount"
"2561",26105,"Michigan","Mason County","API_alone",131,84,-47,-43.72,"undercount"
"2562",26105,"Michigan","Mason County","API_combo",131,130,-1,-0.77,"undercount"
"2563",26107,"Michigan","Mecosta County","API_alone",275,374,99,30.51,"overcount"
"2564",26107,"Michigan","Mecosta County","API_combo",275,478,203,53.92,"overcount"
"2565",26109,"Michigan","Menominee County","API_alone",79,55,-24,-35.82,"undercount"
"2566",26109,"Michigan","Menominee County","API_combo",79,94,15,17.34,"overcount"
"2567",26111,"Michigan","Midland County","API_alone",1376,1271,-105,-7.93,"undercount"
"2568",26111,"Michigan","Midland County","API_combo",1376,1470,94,6.61,"overcount"
"2569",26113,"Michigan","Missaukee County","API_alone",54,35,-19,-42.7,"undercount"
"2570",26113,"Michigan","Missaukee County","API_combo",54,50,-4,-7.69,"undercount"
"2571",26115,"Michigan","Monroe County","API_alone",954,698,-256,-30.99,"undercount"
"2572",26115,"Michigan","Monroe County","API_combo",954,944,-10,-1.05,"undercount"
"2573",26117,"Michigan","Montcalm County","API_alone",292,210,-82,-32.67,"undercount"
"2574",26117,"Michigan","Montcalm County","API_combo",292,375,83,24.89,"overcount"
"2575",26119,"Michigan","Montmorency County","API_alone",19,10,-9,-62.07,"undercount"
"2576",26119,"Michigan","Montmorency County","API_combo",19,19,0,0,"equal"
"2577",26121,"Michigan","Muskegon County","API_alone",880,769,-111,-13.46,"undercount"
"2578",26121,"Michigan","Muskegon County","API_combo",880,1232,352,33.33,"overcount"
"2579",26123,"Michigan","Newaygo County","API_alone",237,158,-79,-40,"undercount"
"2580",26123,"Michigan","Newaygo County","API_combo",237,232,-5,-2.13,"undercount"
"2581",26125,"Michigan","Oakland County","API_alone",42437,50404,7967,17.16,"overcount"
"2582",26125,"Michigan","Oakland County","API_combo",42437,55774,13337,27.16,"overcount"
"2583",26127,"Michigan","Oceana County","API_alone",93,88,-5,-5.52,"undercount"
"2584",26127,"Michigan","Oceana County","API_combo",93,138,45,38.96,"overcount"
"2585",26129,"Michigan","Ogemaw County","API_alone",40,92,52,78.79,"overcount"
"2586",26129,"Michigan","Ogemaw County","API_combo",40,120,80,100,"overcount"
"2587",26131,"Michigan","Ontonagon County","API_alone",18,16,-2,-11.76,"undercount"
"2588",26131,"Michigan","Ontonagon County","API_combo",18,23,5,24.39,"overcount"
"2589",26133,"Michigan","Osceola County","API_alone",71,55,-16,-25.4,"undercount"
"2590",26133,"Michigan","Osceola County","API_combo",71,82,11,14.38,"overcount"
"2591",26135,"Michigan","Oscoda County","API_alone",12,8,-4,-40,"undercount"
"2592",26135,"Michigan","Oscoda County","API_combo",12,24,12,66.67,"overcount"
"2593",26137,"Michigan","Otsego County","API_alone",169,88,-81,-63.04,"undercount"
"2594",26137,"Michigan","Otsego County","API_combo",169,116,-53,-37.19,"undercount"
"2595",26139,"Michigan","Ottawa County","API_alone",4507,5231,724,14.87,"overcount"
"2596",26139,"Michigan","Ottawa County","API_combo",4507,6012,1505,28.61,"overcount"
"2597",26141,"Michigan","Presque Isle County","API_alone",47,25,-22,-61.11,"undercount"
"2598",26141,"Michigan","Presque Isle County","API_combo",47,34,-13,-32.1,"undercount"
"2599",26143,"Michigan","Roscommon County","API_alone",51,60,9,16.22,"overcount"
"2600",26143,"Michigan","Roscommon County","API_combo",51,89,38,54.29,"overcount"
"2601",26145,"Michigan","Saginaw County","API_alone",1972,1795,-177,-9.4,"undercount"
"2602",26145,"Michigan","Saginaw County","API_combo",1972,2293,321,15.05,"overcount"
"2603",26147,"Michigan","St. Clair County","API_alone",859,702,-157,-20.12,"undercount"
"2604",26147,"Michigan","St. Clair County","API_combo",859,1001,142,15.27,"overcount"
"2605",26149,"Michigan","St. Joseph County","API_alone",427,388,-39,-9.57,"undercount"
"2606",26149,"Michigan","St. Joseph County","API_combo",427,499,72,15.55,"overcount"
"2607",26151,"Michigan","Sanilac County","API_alone",124,120,-4,-3.28,"undercount"
"2608",26151,"Michigan","Sanilac County","API_combo",124,180,56,36.84,"overcount"
"2609",26153,"Michigan","Schoolcraft County","API_alone",16,37,21,79.25,"overcount"
"2610",26153,"Michigan","Schoolcraft County","API_combo",16,61,45,116.88,"overcount"
"2611",26155,"Michigan","Shiawassee County","API_alone",360,221,-139,-47.85,"undercount"
"2612",26155,"Michigan","Shiawassee County","API_combo",360,330,-30,-8.7,"undercount"
"2613",26157,"Michigan","Tuscola County","API_alone",318,193,-125,-48.92,"undercount"
"2614",26157,"Michigan","Tuscola County","API_combo",318,294,-24,-7.84,"undercount"
"2615",26159,"Michigan","Van Buren County","API_alone",383,255,-128,-40.13,"undercount"
"2616",26159,"Michigan","Van Buren County","API_combo",383,455,72,17.18,"overcount"
"2617",26161,"Michigan","Washtenaw County","API_alone",18687,20779,2092,10.6,"overcount"
"2618",26161,"Michigan","Washtenaw County","API_combo",18687,23164,4477,21.39,"overcount"
"2619",26163,"Michigan","Wayne County","API_alone",33016,37357,4341,12.34,"overcount"
"2620",26163,"Michigan","Wayne County","API_combo",33016,45482,12466,31.76,"overcount"
"2621",26165,"Michigan","Wexford County","API_alone",152,138,-14,-9.66,"undercount"
"2622",26165,"Michigan","Wexford County","API_combo",152,190,38,22.22,"overcount"
"2623",27001,"Minnesota","Aitkin County","API_alone",61,33,-28,-59.57,"undercount"
"2624",27001,"Minnesota","Aitkin County","API_combo",61,52,-9,-15.93,"undercount"
"2625",27003,"Minnesota","Anoka County","API_alone",6123,5235,-888,-15.64,"undercount"
"2626",27003,"Minnesota","Anoka County","API_combo",6123,6581,458,7.21,"overcount"
"2627",27005,"Minnesota","Becker County","API_alone",188,112,-76,-50.67,"undercount"
"2628",27005,"Minnesota","Becker County","API_combo",188,157,-31,-17.97,"undercount"
"2629",27007,"Minnesota","Beltrami County","API_alone",336,247,-89,-30.53,"undercount"
"2630",27007,"Minnesota","Beltrami County","API_combo",336,335,-1,-0.3,"undercount"
"2631",27009,"Minnesota","Benton County","API_alone",269,426,157,45.18,"overcount"
"2632",27009,"Minnesota","Benton County","API_combo",269,519,250,63.45,"overcount"
"2633",27011,"Minnesota","Big Stone County","API_alone",18,24,6,28.57,"overcount"
"2634",27011,"Minnesota","Big Stone County","API_combo",18,26,8,36.36,"overcount"
"2635",27013,"Minnesota","Blue Earth County","API_alone",1290,1055,-235,-20.04,"undercount"
"2636",27013,"Minnesota","Blue Earth County","API_combo",1290,1208,-82,-6.57,"undercount"
"2637",27015,"Minnesota","Brown County","API_alone",175,118,-57,-38.91,"undercount"
"2638",27015,"Minnesota","Brown County","API_combo",175,156,-19,-11.48,"undercount"
"2639",27017,"Minnesota","Carlton County","API_alone",136,118,-18,-14.17,"undercount"
"2640",27017,"Minnesota","Carlton County","API_combo",136,185,49,30.53,"overcount"
"2641",27019,"Minnesota","Carver County","API_alone",1056,1136,80,7.3,"overcount"
"2642",27019,"Minnesota","Carver County","API_combo",1056,1294,238,20.26,"overcount"
"2643",27021,"Minnesota","Cass County","API_alone",116,83,-33,-33.17,"undercount"
"2644",27021,"Minnesota","Cass County","API_combo",116,122,6,5.04,"overcount"
"2645",27023,"Minnesota","Chippewa County","API_alone",73,47,-26,-43.33,"undercount"
"2646",27023,"Minnesota","Chippewa County","API_combo",73,71,-2,-2.78,"undercount"
"2647",27025,"Minnesota","Chisago County","API_alone",221,315,94,35.07,"overcount"
"2648",27025,"Minnesota","Chisago County","API_combo",221,402,181,58.11,"overcount"
"2649",27027,"Minnesota","Clay County","API_alone",683,491,-192,-32.71,"undercount"
"2650",27027,"Minnesota","Clay County","API_combo",683,694,11,1.6,"overcount"
"2651",27029,"Minnesota","Clearwater County","API_alone",16,22,6,31.58,"overcount"
"2652",27029,"Minnesota","Clearwater County","API_combo",16,35,19,74.51,"overcount"
"2653",27031,"Minnesota","Cook County","API_alone",44,19,-25,-79.37,"undercount"
"2654",27031,"Minnesota","Cook County","API_combo",44,30,-14,-37.84,"undercount"
"2655",27033,"Minnesota","Cottonwood County","API_alone",129,266,137,69.37,"overcount"
"2656",27033,"Minnesota","Cottonwood County","API_combo",129,283,154,74.76,"overcount"
"2657",27035,"Minnesota","Crow Wing County","API_alone",293,168,-125,-54.23,"undercount"
"2658",27035,"Minnesota","Crow Wing County","API_combo",293,263,-30,-10.79,"undercount"
"2659",27037,"Minnesota","Dakota County","API_alone",10082,10773,691,6.63,"overcount"
"2660",27037,"Minnesota","Dakota County","API_combo",10082,12640,2558,22.52,"overcount"
"2661",27039,"Minnesota","Dodge County","API_alone",111,75,-36,-38.71,"undercount"
"2662",27039,"Minnesota","Dodge County","API_combo",111,108,-3,-2.74,"undercount"
"2663",27041,"Minnesota","Douglas County","API_alone",187,144,-43,-25.98,"undercount"
"2664",27041,"Minnesota","Douglas County","API_combo",187,180,-7,-3.81,"undercount"
"2665",27043,"Minnesota","Faribault County","API_alone",92,66,-26,-32.91,"undercount"
"2666",27043,"Minnesota","Faribault County","API_combo",92,98,6,6.32,"overcount"
"2667",27045,"Minnesota","Fillmore County","API_alone",81,35,-46,-79.31,"undercount"
"2668",27045,"Minnesota","Fillmore County","API_combo",81,68,-13,-17.45,"undercount"
"2669",27047,"Minnesota","Freeborn County","API_alone",199,188,-11,-5.68,"undercount"
"2670",27047,"Minnesota","Freeborn County","API_combo",199,243,44,19.91,"overcount"
"2671",27049,"Minnesota","Goodhue County","API_alone",316,272,-44,-14.97,"undercount"
"2672",27049,"Minnesota","Goodhue County","API_combo",316,343,27,8.19,"overcount"
"2673",27051,"Minnesota","Grant County","API_alone",18,12,-6,-40,"undercount"
"2674",27051,"Minnesota","Grant County","API_combo",18,23,5,24.39,"overcount"
"2675",27053,"Minnesota","Hennepin County","API_alone",50120,55611,5491,10.39,"overcount"
"2676",27053,"Minnesota","Hennepin County","API_combo",50120,62510,12390,22,"overcount"
"2677",27055,"Minnesota","Houston County","API_alone",91,77,-14,-16.67,"undercount"
"2678",27055,"Minnesota","Houston County","API_combo",91,109,18,18,"overcount"
"2679",27057,"Minnesota","Hubbard County","API_alone",30,51,21,51.85,"overcount"
"2680",27057,"Minnesota","Hubbard County","API_combo",30,64,34,72.34,"overcount"
"2681",27059,"Minnesota","Isanti County","API_alone",225,128,-97,-54.96,"undercount"
"2682",27059,"Minnesota","Isanti County","API_combo",225,198,-27,-12.77,"undercount"
"2683",27061,"Minnesota","Itasca County","API_alone",159,131,-28,-19.31,"undercount"
"2684",27061,"Minnesota","Itasca County","API_combo",159,194,35,19.83,"overcount"
"2685",27063,"Minnesota","Jackson County","API_alone",273,156,-117,-54.55,"undercount"
"2686",27063,"Minnesota","Jackson County","API_combo",273,167,-106,-48.18,"undercount"
"2687",27065,"Minnesota","Kanabec County","API_alone",90,71,-19,-23.6,"undercount"
"2688",27065,"Minnesota","Kanabec County","API_combo",90,102,12,12.5,"overcount"
"2689",27067,"Minnesota","Kandiyohi County","API_alone",218,198,-20,-9.62,"undercount"
"2690",27067,"Minnesota","Kandiyohi County","API_combo",218,257,39,16.42,"overcount"
"2691",27069,"Minnesota","Kittson County","API_alone",13,18,5,32.26,"overcount"
"2692",27069,"Minnesota","Kittson County","API_combo",13,24,11,59.46,"overcount"
"2693",27071,"Minnesota","Koochiching County","API_alone",70,34,-36,-69.23,"undercount"
"2694",27071,"Minnesota","Koochiching County","API_combo",70,52,-18,-29.51,"undercount"
"2695",27073,"Minnesota","Lac qui Parle County","API_alone",36,26,-10,-32.26,"undercount"
"2696",27073,"Minnesota","Lac qui Parle County","API_combo",36,31,-5,-14.93,"undercount"
"2697",27075,"Minnesota","Lake County","API_alone",30,21,-9,-35.29,"undercount"
"2698",27075,"Minnesota","Lake County","API_combo",30,38,8,23.53,"overcount"
"2699",27077,"Minnesota","Lake of the Woods County","API_alone",22,11,-11,-66.67,"undercount"
"2700",27077,"Minnesota","Lake of the Woods County","API_combo",22,21,-1,-4.65,"undercount"
"2701",27079,"Minnesota","Le Sueur County","API_alone",121,89,-32,-30.48,"undercount"
"2702",27079,"Minnesota","Le Sueur County","API_combo",121,142,21,15.97,"overcount"
"2703",27081,"Minnesota","Lincoln County","API_alone",10,13,3,26.09,"overcount"
"2704",27081,"Minnesota","Lincoln County","API_combo",10,15,5,40,"overcount"
"2705",27083,"Minnesota","Lyon County","API_alone",182,435,253,82.01,"overcount"
"2706",27083,"Minnesota","Lyon County","API_combo",182,509,327,94.65,"overcount"
"2707",27085,"Minnesota","McLeod County","API_alone",255,217,-38,-16.1,"undercount"
"2708",27085,"Minnesota","McLeod County","API_combo",255,265,10,3.85,"overcount"
"2709",27087,"Minnesota","Mahnomen County","API_alone",7,5,-2,-33.33,"undercount"
"2710",27087,"Minnesota","Mahnomen County","API_combo",7,13,6,60,"overcount"
"2711",27089,"Minnesota","Marshall County","API_alone",20,17,-3,-16.22,"undercount"
"2712",27089,"Minnesota","Marshall County","API_combo",20,27,7,29.79,"overcount"
"2713",27091,"Minnesota","Martin County","API_alone",134,104,-30,-25.21,"undercount"
"2714",27091,"Minnesota","Martin County","API_combo",134,133,-1,-0.75,"undercount"
"2715",27093,"Minnesota","Meeker County","API_alone",161,92,-69,-54.55,"undercount"
"2716",27093,"Minnesota","Meeker County","API_combo",161,122,-39,-27.56,"undercount"
"2717",27095,"Minnesota","Mille Lacs County","API_alone",72,52,-20,-32.26,"undercount"
"2718",27095,"Minnesota","Mille Lacs County","API_combo",72,95,23,27.54,"overcount"
"2719",27097,"Minnesota","Morrison County","API_alone",78,94,16,18.6,"overcount"
"2720",27097,"Minnesota","Morrison County","API_combo",78,136,58,54.21,"overcount"
"2721",27099,"Minnesota","Mower County","API_alone",484,592,108,20.07,"overcount"
"2722",27099,"Minnesota","Mower County","API_combo",484,677,193,33.25,"overcount"
"2723",27101,"Minnesota","Murray County","API_alone",27,21,-6,-25,"undercount"
"2724",27101,"Minnesota","Murray County","API_combo",27,39,12,36.36,"overcount"
"2725",27103,"Minnesota","Nicollet County","API_alone",360,349,-11,-3.1,"undercount"
"2726",27103,"Minnesota","Nicollet County","API_combo",360,403,43,11.27,"overcount"
"2727",27105,"Minnesota","Nobles County","API_alone",631,876,245,32.51,"overcount"
"2728",27105,"Minnesota","Nobles County","API_combo",631,977,346,43.03,"overcount"
"2729",27107,"Minnesota","Norman County","API_alone",24,23,-1,-4.26,"undercount"
"2730",27107,"Minnesota","Norman County","API_combo",24,34,10,34.48,"overcount"
"2731",27109,"Minnesota","Olmsted County","API_alone",6007,5536,-471,-8.16,"undercount"
"2732",27109,"Minnesota","Olmsted County","API_combo",6007,6137,130,2.14,"overcount"
"2733",27111,"Minnesota","Otter Tail County","API_alone",347,283,-64,-20.32,"undercount"
"2734",27111,"Minnesota","Otter Tail County","API_combo",347,368,21,5.87,"overcount"
"2735",27113,"Minnesota","Pennington County","API_alone",83,89,6,6.98,"overcount"
"2736",27113,"Minnesota","Pennington County","API_combo",83,106,23,24.34,"overcount"
"2737",27115,"Minnesota","Pine County","API_alone",164,91,-73,-57.25,"undercount"
"2738",27115,"Minnesota","Pine County","API_combo",164,141,-23,-15.08,"undercount"
"2739",27117,"Minnesota","Pipestone County","API_alone",129,48,-81,-91.53,"undercount"
"2740",27117,"Minnesota","Pipestone County","API_combo",129,69,-60,-60.61,"undercount"
"2741",27119,"Minnesota","Polk County","API_alone",148,115,-33,-25.1,"undercount"
"2742",27119,"Minnesota","Polk County","API_combo",148,165,17,10.86,"overcount"
"2743",27121,"Minnesota","Pope County","API_alone",22,19,-3,-14.63,"undercount"
"2744",27121,"Minnesota","Pope County","API_combo",22,23,1,4.44,"overcount"
"2745",27123,"Minnesota","Ramsey County","API_alone",38880,46163,7283,17.13,"overcount"
"2746",27123,"Minnesota","Ramsey County","API_combo",38880,50774,11894,26.53,"overcount"
"2747",27125,"Minnesota","Red Lake County","API_alone",4,3,-1,-28.57,"undercount"
"2748",27125,"Minnesota","Red Lake County","API_combo",4,4,0,0,"equal"
"2749",27127,"Minnesota","Redwood County","API_alone",46,66,20,35.71,"overcount"
"2750",27127,"Minnesota","Redwood County","API_combo",46,95,49,69.5,"overcount"
"2751",27129,"Minnesota","Renville County","API_alone",75,40,-35,-60.87,"undercount"
"2752",27129,"Minnesota","Renville County","API_combo",75,65,-10,-14.29,"undercount"
"2753",27131,"Minnesota","Rice County","API_alone",1020,892,-128,-13.39,"undercount"
"2754",27131,"Minnesota","Rice County","API_combo",1020,1092,72,6.82,"overcount"
"2755",27133,"Minnesota","Rock County","API_alone",29,62,33,72.53,"overcount"
"2756",27133,"Minnesota","Rock County","API_combo",29,71,42,84,"overcount"
"2757",27135,"Minnesota","Roseau County","API_alone",192,286,94,39.33,"overcount"
"2758",27135,"Minnesota","Roseau County","API_combo",192,321,129,50.29,"overcount"
"2759",27137,"Minnesota","St. Louis County","API_alone",1740,1407,-333,-21.16,"undercount"
"2760",27137,"Minnesota","St. Louis County","API_combo",1740,1867,127,7.04,"overcount"
"2761",27139,"Minnesota","Scott County","API_alone",1302,2011,709,42.8,"overcount"
"2762",27139,"Minnesota","Scott County","API_combo",1302,2357,1055,57.67,"overcount"
"2763",27141,"Minnesota","Sherburne County","API_alone",536,399,-137,-29.3,"undercount"
"2764",27141,"Minnesota","Sherburne County","API_combo",536,561,25,4.56,"overcount"
"2765",27143,"Minnesota","Sibley County","API_alone",61,54,-7,-12.17,"undercount"
"2766",27143,"Minnesota","Sibley County","API_combo",61,75,14,20.59,"overcount"
"2767",27145,"Minnesota","Stearns County","API_alone",1510,2185,675,36.54,"overcount"
"2768",27145,"Minnesota","Stearns County","API_combo",1510,2552,1042,51.3,"overcount"
"2769",27147,"Minnesota","Steele County","API_alone",285,312,27,9.05,"overcount"
"2770",27147,"Minnesota","Steele County","API_combo",285,366,81,24.88,"overcount"
"2771",27149,"Minnesota","Stevens County","API_alone",176,89,-87,-65.66,"undercount"
"2772",27149,"Minnesota","Stevens County","API_combo",176,99,-77,-56,"undercount"
"2773",27151,"Minnesota","Swift County","API_alone",69,356,287,135.06,"overcount"
"2774",27151,"Minnesota","Swift County","API_combo",69,601,532,158.81,"overcount"
"2775",27153,"Minnesota","Todd County","API_alone",90,79,-11,-13.02,"undercount"
"2776",27153,"Minnesota","Todd County","API_combo",90,120,30,28.57,"overcount"
"2777",27155,"Minnesota","Traverse County","API_alone",24,14,-10,-52.63,"undercount"
"2778",27155,"Minnesota","Traverse County","API_combo",24,15,-9,-46.15,"undercount"
"2779",27157,"Minnesota","Wabasha County","API_alone",162,100,-62,-47.33,"undercount"
"2780",27157,"Minnesota","Wabasha County","API_combo",162,117,-45,-32.26,"undercount"
"2781",27159,"Minnesota","Wadena County","API_alone",56,29,-27,-63.53,"undercount"
"2782",27159,"Minnesota","Wadena County","API_combo",56,40,-16,-33.33,"undercount"
"2783",27161,"Minnesota","Waseca County","API_alone",129,100,-29,-25.33,"undercount"
"2784",27161,"Minnesota","Waseca County","API_combo",129,134,5,3.8,"overcount"
"2785",27163,"Minnesota","Washington County","API_alone",3935,4430,495,11.84,"overcount"
"2786",27163,"Minnesota","Washington County","API_combo",3935,5271,1336,29.02,"overcount"
"2787",27165,"Minnesota","Watonwan County","API_alone",83,111,28,28.87,"overcount"
"2788",27165,"Minnesota","Watonwan County","API_combo",83,135,52,47.71,"overcount"
"2789",27167,"Minnesota","Wilkin County","API_alone",44,12,-32,-114.29,"undercount"
"2790",27167,"Minnesota","Wilkin County","API_combo",44,26,-18,-51.43,"undercount"
"2791",27169,"Minnesota","Winona County","API_alone",862,981,119,12.91,"overcount"
"2792",27169,"Minnesota","Winona County","API_combo",862,1108,246,24.97,"overcount"
"2793",27171,"Minnesota","Wright County","API_alone",602,413,-189,-37.24,"undercount"
"2794",27171,"Minnesota","Wright County","API_combo",602,574,-28,-4.76,"undercount"
"2795",27173,"Minnesota","Yellow Medicine County","API_alone",36,20,-16,-57.14,"undercount"
"2796",27173,"Minnesota","Yellow Medicine County","API_combo",36,31,-5,-14.93,"undercount"
"2797",28001,"Mississippi","Adams County","API_alone",79,95,16,18.39,"overcount"
"2798",28001,"Mississippi","Adams County","API_combo",79,166,87,71.02,"overcount"
"2799",28003,"Mississippi","Alcorn County","API_alone",81,107,26,27.66,"overcount"
"2800",28003,"Mississippi","Alcorn County","API_combo",81,149,68,59.13,"overcount"
"2801",28005,"Mississippi","Amite County","API_alone",10,13,3,26.09,"overcount"
"2802",28005,"Mississippi","Amite County","API_combo",10,22,12,75,"overcount"
"2803",28007,"Mississippi","Attala County","API_alone",37,53,16,35.56,"overcount"
"2804",28007,"Mississippi","Attala County","API_combo",37,70,33,61.68,"overcount"
"2805",28009,"Mississippi","Benton County","API_alone",7,6,-1,-15.38,"undercount"
"2806",28009,"Mississippi","Benton County","API_combo",7,12,5,52.63,"overcount"
"2807",28011,"Mississippi","Bolivar County","API_alone",199,210,11,5.38,"overcount"
"2808",28011,"Mississippi","Bolivar County","API_combo",199,297,98,39.52,"overcount"
"2809",28013,"Mississippi","Calhoun County","API_alone",3,15,12,133.33,"overcount"
"2810",28013,"Mississippi","Calhoun County","API_combo",3,35,32,168.42,"overcount"
"2811",28015,"Mississippi","Carroll County","API_alone",16,19,3,17.14,"overcount"
"2812",28015,"Mississippi","Carroll County","API_combo",16,27,11,51.16,"overcount"
"2813",28017,"Mississippi","Chickasaw County","API_alone",23,43,20,60.61,"overcount"
"2814",28017,"Mississippi","Chickasaw County","API_combo",23,73,50,104.17,"overcount"
"2815",28019,"Mississippi","Choctaw County","API_alone",14,15,1,6.9,"overcount"
"2816",28019,"Mississippi","Choctaw County","API_combo",14,29,15,69.77,"overcount"
"2817",28021,"Mississippi","Claiborne County","API_alone",26,18,-8,-36.36,"undercount"
"2818",28021,"Mississippi","Claiborne County","API_combo",26,31,5,17.54,"overcount"
"2819",28023,"Mississippi","Clarke County","API_alone",14,20,6,35.29,"overcount"
"2820",28023,"Mississippi","Clarke County","API_combo",14,28,14,66.67,"overcount"
"2821",28025,"Mississippi","Clay County","API_alone",46,37,-9,-21.69,"undercount"
"2822",28025,"Mississippi","Clay County","API_combo",46,93,47,67.63,"overcount"
"2823",28027,"Mississippi","Coahoma County","API_alone",160,155,-5,-3.17,"undercount"
"2824",28027,"Mississippi","Coahoma County","API_combo",160,237,77,38.79,"overcount"
"2825",28029,"Mississippi","Copiah County","API_alone",34,62,28,58.33,"overcount"
"2826",28029,"Mississippi","Copiah County","API_combo",34,89,55,89.43,"overcount"
"2827",28031,"Mississippi","Covington County","API_alone",31,26,-5,-17.54,"undercount"
"2828",28031,"Mississippi","Covington County","API_combo",31,66,35,72.16,"overcount"
"2829",28033,"Mississippi","DeSoto County","API_alone",368,730,362,65.94,"overcount"
"2830",28033,"Mississippi","DeSoto County","API_combo",368,912,544,85,"overcount"
"2831",28035,"Mississippi","Forrest County","API_alone",725,552,-173,-27.09,"undercount"
"2832",28035,"Mississippi","Forrest County","API_combo",725,694,-31,-4.37,"undercount"
"2833",28037,"Mississippi","Franklin County","API_alone",6,6,0,0,"equal"
"2834",28037,"Mississippi","Franklin County","API_combo",6,11,5,58.82,"overcount"
"2835",28039,"Mississippi","George County","API_alone",44,31,-13,-34.67,"undercount"
"2836",28039,"Mississippi","George County","API_combo",44,49,5,10.75,"overcount"
"2837",28041,"Mississippi","Greene County","API_alone",14,13,-1,-7.41,"undercount"
"2838",28041,"Mississippi","Greene County","API_combo",14,23,9,48.65,"overcount"
"2839",28043,"Mississippi","Grenada County","API_alone",49,91,42,60,"overcount"
"2840",28043,"Mississippi","Grenada County","API_combo",49,129,80,89.89,"overcount"
"2841",28045,"Mississippi","Hancock County","API_alone",322,402,80,22.1,"overcount"
"2842",28045,"Mississippi","Hancock County","API_combo",322,488,166,40.99,"overcount"
"2843",28047,"Mississippi","Harrison County","API_alone",6949,5203,-1746,-28.74,"undercount"
"2844",28047,"Mississippi","Harrison County","API_combo",6949,6355,-594,-8.93,"undercount"
"2845",28049,"Mississippi","Hinds County","API_alone",1674,1575,-99,-6.09,"undercount"
"2846",28049,"Mississippi","Hinds County","API_combo",1674,1987,313,17.1,"overcount"
"2847",28051,"Mississippi","Holmes County","API_alone",42,33,-9,-24,"undercount"
"2848",28051,"Mississippi","Holmes County","API_combo",42,71,29,51.33,"overcount"
"2849",28053,"Mississippi","Humphreys County","API_alone",54,30,-24,-57.14,"undercount"
"2850",28053,"Mississippi","Humphreys County","API_combo",54,37,-17,-37.36,"undercount"
"2851",28055,"Mississippi","Issaquena County","API_alone",4,0,-4,-200,"undercount"
"2852",28055,"Mississippi","Issaquena County","API_combo",4,2,-2,-66.67,"undercount"
"2853",28057,"Mississippi","Itawamba County","API_alone",57,43,-14,-28,"undercount"
"2854",28057,"Mississippi","Itawamba County","API_combo",57,64,7,11.57,"overcount"
"2855",28059,"Mississippi","Jackson County","API_alone",1885,2157,272,13.46,"overcount"
"2856",28059,"Mississippi","Jackson County","API_combo",1885,2586,701,31.36,"overcount"
"2857",28061,"Mississippi","Jasper County","API_alone",13,17,4,26.67,"overcount"
"2858",28061,"Mississippi","Jasper County","API_combo",13,34,21,89.36,"overcount"
"2859",28063,"Mississippi","Jefferson County","API_alone",16,11,-5,-37.04,"undercount"
"2860",28063,"Mississippi","Jefferson County","API_combo",16,18,2,11.76,"overcount"
"2861",28065,"Mississippi","Jefferson Davis County","API_alone",31,26,-5,-17.54,"undercount"
"2862",28065,"Mississippi","Jefferson Davis County","API_combo",31,33,2,6.25,"overcount"
"2863",28067,"Mississippi","Jones County","API_alone",145,180,35,21.54,"overcount"
"2864",28067,"Mississippi","Jones County","API_combo",145,226,81,43.67,"overcount"
"2865",28069,"Mississippi","Kemper County","API_alone",10,11,1,9.52,"overcount"
"2866",28069,"Mississippi","Kemper County","API_combo",10,28,18,94.74,"overcount"
"2867",28071,"Mississippi","Lafayette County","API_alone",1003,671,-332,-39.67,"undercount"
"2868",28071,"Mississippi","Lafayette County","API_combo",1003,813,-190,-20.93,"undercount"
"2869",28073,"Mississippi","Lamar County","API_alone",221,263,42,17.36,"overcount"
"2870",28073,"Mississippi","Lamar County","API_combo",221,305,84,31.94,"overcount"
"2871",28075,"Mississippi","Lauderdale County","API_alone",526,429,-97,-20.31,"undercount"
"2872",28075,"Mississippi","Lauderdale County","API_combo",526,576,50,9.07,"overcount"
"2873",28077,"Mississippi","Lawrence County","API_alone",21,41,20,64.52,"overcount"
"2874",28077,"Mississippi","Lawrence County","API_combo",21,47,26,76.47,"overcount"
"2875",28079,"Mississippi","Leake County","API_alone",15,45,30,100,"overcount"
"2876",28079,"Mississippi","Leake County","API_combo",15,72,57,131.03,"overcount"
"2877",28081,"Mississippi","Lee County","API_alone",244,418,174,52.57,"overcount"
"2878",28081,"Mississippi","Lee County","API_combo",244,536,292,74.87,"overcount"
"2879",28083,"Mississippi","Leflore County","API_alone",183,262,79,35.51,"overcount"
"2880",28083,"Mississippi","Leflore County","API_combo",183,338,155,59.5,"overcount"
"2881",28085,"Mississippi","Lincoln County","API_alone",72,85,13,16.56,"overcount"
"2882",28085,"Mississippi","Lincoln County","API_combo",72,116,44,46.81,"overcount"
"2883",28087,"Mississippi","Lowndes County","API_alone",460,356,-104,-25.49,"undercount"
"2884",28087,"Mississippi","Lowndes County","API_combo",460,546,86,17.1,"overcount"
"2885",28089,"Mississippi","Madison County","API_alone",406,1019,613,86.04,"overcount"
"2886",28089,"Mississippi","Madison County","API_combo",406,1160,754,96.3,"overcount"
"2887",28091,"Mississippi","Marion County","API_alone",68,59,-9,-14.17,"undercount"
"2888",28091,"Mississippi","Marion County","API_combo",68,91,23,28.93,"overcount"
"2889",28093,"Mississippi","Marshall County","API_alone",57,47,-10,-19.23,"undercount"
"2890",28093,"Mississippi","Marshall County","API_combo",57,80,23,33.58,"overcount"
"2891",28095,"Mississippi","Monroe County","API_alone",49,74,25,40.65,"overcount"
"2892",28095,"Mississippi","Monroe County","API_combo",49,109,60,75.95,"overcount"
"2893",28097,"Mississippi","Montgomery County","API_alone",26,34,8,26.67,"overcount"
"2894",28097,"Mississippi","Montgomery County","API_combo",26,53,27,68.35,"overcount"
"2895",28099,"Mississippi","Neshoba County","API_alone",65,67,2,3.03,"overcount"
"2896",28099,"Mississippi","Neshoba County","API_combo",65,105,40,47.06,"overcount"
"2897",28101,"Mississippi","Newton County","API_alone",12,42,30,111.11,"overcount"
"2898",28101,"Mississippi","Newton County","API_combo",12,50,38,122.58,"overcount"
"2899",28103,"Mississippi","Noxubee County","API_alone",8,14,6,54.55,"overcount"
"2900",28103,"Mississippi","Noxubee County","API_combo",8,29,21,113.51,"overcount"
"2901",28105,"Mississippi","Oktibbeha County","API_alone",1490,1118,-372,-28.53,"undercount"
"2902",28105,"Mississippi","Oktibbeha County","API_combo",1490,1270,-220,-15.94,"undercount"
"2903",28107,"Mississippi","Panola County","API_alone",57,72,15,23.26,"overcount"
"2904",28107,"Mississippi","Panola County","API_combo",57,101,44,55.7,"overcount"
"2905",28109,"Mississippi","Pearl River County","API_alone",150,146,-4,-2.7,"undercount"
"2906",28109,"Mississippi","Pearl River County","API_combo",150,235,85,44.16,"overcount"
"2907",28111,"Mississippi","Perry County","API_alone",8,20,12,85.71,"overcount"
"2908",28111,"Mississippi","Perry County","API_combo",8,25,17,103.03,"overcount"
"2909",28113,"Mississippi","Pike County","API_alone",74,136,62,59.05,"overcount"
"2910",28113,"Mississippi","Pike County","API_combo",74,216,142,97.93,"overcount"
"2911",28115,"Mississippi","Pontotoc County","API_alone",63,31,-32,-68.09,"undercount"
"2912",28115,"Mississippi","Pontotoc County","API_combo",63,69,6,9.09,"overcount"
"2913",28117,"Mississippi","Prentiss County","API_alone",31,40,9,25.35,"overcount"
"2914",28117,"Mississippi","Prentiss County","API_combo",31,76,45,84.11,"overcount"
"2915",28119,"Mississippi","Quitman County","API_alone",26,18,-8,-36.36,"undercount"
"2916",28119,"Mississippi","Quitman County","API_combo",26,31,5,17.54,"overcount"
"2917",28121,"Mississippi","Rankin County","API_alone",614,801,187,26.43,"overcount"
"2918",28121,"Mississippi","Rankin County","API_combo",614,990,376,46.88,"overcount"
"2919",28123,"Mississippi","Scott County","API_alone",32,57,25,56.18,"overcount"
"2920",28123,"Mississippi","Scott County","API_combo",32,102,70,104.48,"overcount"
"2921",28125,"Mississippi","Sharkey County","API_alone",26,18,-8,-36.36,"undercount"
"2922",28125,"Mississippi","Sharkey County","API_combo",26,23,-3,-12.24,"undercount"
"2923",28127,"Mississippi","Simpson County","API_alone",39,45,6,14.29,"overcount"
"2924",28127,"Mississippi","Simpson County","API_combo",39,60,21,42.42,"overcount"
"2925",28129,"Mississippi","Smith County","API_alone",11,22,11,66.67,"overcount"
"2926",28129,"Mississippi","Smith County","API_combo",11,38,27,110.2,"overcount"
"2927",28131,"Mississippi","Stone County","API_alone",23,26,3,12.24,"overcount"
"2928",28131,"Mississippi","Stone County","API_combo",23,39,16,51.61,"overcount"
"2929",28133,"Mississippi","Sunflower County","API_alone",135,147,12,8.51,"overcount"
"2930",28133,"Mississippi","Sunflower County","API_combo",135,180,45,28.57,"overcount"
"2931",28135,"Mississippi","Tallahatchie County","API_alone",66,54,-12,-20,"undercount"
"2932",28135,"Mississippi","Tallahatchie County","API_combo",66,74,8,11.43,"overcount"
"2933",28137,"Mississippi","Tate County","API_alone",46,35,-11,-27.16,"undercount"
"2934",28137,"Mississippi","Tate County","API_combo",46,51,5,10.31,"overcount"
"2935",28139,"Mississippi","Tippah County","API_alone",32,27,-5,-16.95,"undercount"
"2936",28139,"Mississippi","Tippah County","API_combo",32,44,12,31.58,"overcount"
"2937",28141,"Mississippi","Tishomingo County","API_alone",25,17,-8,-38.1,"undercount"
"2938",28141,"Mississippi","Tishomingo County","API_combo",25,39,14,43.75,"overcount"
"2939",28143,"Mississippi","Tunica County","API_alone",24,47,23,64.79,"overcount"
"2940",28143,"Mississippi","Tunica County","API_combo",24,81,57,108.57,"overcount"
"2941",28145,"Mississippi","Union County","API_alone",37,55,18,39.13,"overcount"
"2942",28145,"Mississippi","Union County","API_combo",37,83,46,76.67,"overcount"
"2943",28147,"Mississippi","Walthall County","API_alone",39,44,5,12.05,"overcount"
"2944",28147,"Mississippi","Walthall County","API_combo",39,65,26,50,"overcount"
"2945",28149,"Mississippi","Warren County","API_alone",365,326,-39,-11.29,"undercount"
"2946",28149,"Mississippi","Warren County","API_combo",365,402,37,9.65,"overcount"
"2947",28151,"Mississippi","Washington County","API_alone",370,362,-8,-2.19,"undercount"
"2948",28151,"Mississippi","Washington County","API_combo",370,475,105,24.85,"overcount"
"2949",28153,"Mississippi","Wayne County","API_alone",48,34,-14,-34.15,"undercount"
"2950",28153,"Mississippi","Wayne County","API_combo",48,66,18,31.58,"overcount"
"2951",28155,"Mississippi","Webster County","API_alone",12,19,7,45.16,"overcount"
"2952",28155,"Mississippi","Webster County","API_combo",12,29,17,82.93,"overcount"
"2953",28157,"Mississippi","Wilkinson County","API_alone",3,3,0,0,"equal"
"2954",28157,"Mississippi","Wilkinson County","API_combo",3,19,16,145.45,"overcount"
"2955",28159,"Mississippi","Winston County","API_alone",20,18,-2,-10.53,"undercount"
"2956",28159,"Mississippi","Winston County","API_combo",20,37,17,59.65,"overcount"
"2957",28161,"Mississippi","Yalobusha County","API_alone",16,22,6,31.58,"overcount"
"2958",28161,"Mississippi","Yalobusha County","API_combo",16,25,9,43.9,"overcount"
"2959",28163,"Mississippi","Yazoo County","API_alone",70,104,34,39.08,"overcount"
"2960",28163,"Mississippi","Yazoo County","API_combo",70,153,83,74.44,"overcount"
"2961",29001,"Missouri","Adair County","API_alone",308,367,59,17.48,"overcount"
"2962",29001,"Missouri","Adair County","API_combo",308,436,128,34.41,"overcount"
"2963",29003,"Missouri","Andrew County","API_alone",36,39,3,8,"overcount"
"2964",29003,"Missouri","Andrew County","API_combo",36,42,6,15.38,"overcount"
"2965",29005,"Missouri","Atchison County","API_alone",16,9,-7,-56,"undercount"
"2966",29005,"Missouri","Atchison County","API_combo",16,10,-6,-46.15,"undercount"
"2967",29007,"Missouri","Audrain County","API_alone",136,102,-34,-28.57,"undercount"
"2968",29007,"Missouri","Audrain County","API_combo",136,134,-2,-1.48,"undercount"
"2969",29009,"Missouri","Barry County","API_alone",169,102,-67,-49.45,"undercount"
"2970",29009,"Missouri","Barry County","API_combo",169,137,-32,-20.92,"undercount"
"2971",29011,"Missouri","Barton County","API_alone",47,48,1,2.11,"overcount"
"2972",29011,"Missouri","Barton County","API_combo",47,70,23,39.32,"overcount"
"2973",29013,"Missouri","Bates County","API_alone",20,27,7,29.79,"overcount"
"2974",29013,"Missouri","Bates County","API_combo",20,40,20,66.67,"overcount"
"2975",29015,"Missouri","Benton County","API_alone",34,24,-10,-34.48,"undercount"
"2976",29015,"Missouri","Benton County","API_combo",34,56,22,48.89,"overcount"
"2977",29017,"Missouri","Bollinger County","API_alone",45,30,-15,-40,"undercount"
"2978",29017,"Missouri","Bollinger County","API_combo",45,45,0,0,"equal"
"2979",29019,"Missouri","Boone County","API_alone",5316,4129,-1187,-25.13,"undercount"
"2980",29019,"Missouri","Boone County","API_combo",5316,4715,-601,-11.98,"undercount"
"2981",29021,"Missouri","Buchanan County","API_alone",400,420,20,4.88,"overcount"
"2982",29021,"Missouri","Buchanan County","API_combo",400,597,197,39.52,"overcount"
"2983",29023,"Missouri","Butler County","API_alone",207,199,-8,-3.94,"undercount"
"2984",29023,"Missouri","Butler County","API_combo",207,261,54,23.08,"overcount"
"2985",29025,"Missouri","Caldwell County","API_alone",3,11,8,114.29,"overcount"
"2986",29025,"Missouri","Caldwell County","API_combo",3,15,12,133.33,"overcount"
"2987",29027,"Missouri","Callaway County","API_alone",216,219,3,1.38,"overcount"
"2988",29027,"Missouri","Callaway County","API_combo",216,302,86,33.2,"overcount"
"2989",29029,"Missouri","Camden County","API_alone",105,121,16,14.16,"overcount"
"2990",29029,"Missouri","Camden County","API_combo",105,185,80,55.17,"overcount"
"2991",29031,"Missouri","Cape Girardeau County","API_alone",713,542,-171,-27.25,"undercount"
"2992",29031,"Missouri","Cape Girardeau County","API_combo",713,698,-15,-2.13,"undercount"
"2993",29033,"Missouri","Carroll County","API_alone",15,14,-1,-6.9,"undercount"
"2994",29033,"Missouri","Carroll County","API_combo",15,21,6,33.33,"overcount"
"2995",29035,"Missouri","Carter County","API_alone",9,8,-1,-11.76,"undercount"
"2996",29035,"Missouri","Carter County","API_combo",9,12,3,28.57,"overcount"
"2997",29037,"Missouri","Cass County","API_alone",549,430,-119,-24.31,"undercount"
"2998",29037,"Missouri","Cass County","API_combo",549,680,131,21.32,"overcount"
"2999",29039,"Missouri","Cedar County","API_alone",34,69,35,67.96,"overcount"
"3000",29039,"Missouri","Cedar County","API_combo",34,91,57,91.2,"overcount"
"3001",29041,"Missouri","Chariton County","API_alone",8,11,3,31.58,"overcount"
"3002",29041,"Missouri","Chariton County","API_combo",8,15,7,60.87,"overcount"
"3003",29043,"Missouri","Christian County","API_alone",187,175,-12,-6.63,"undercount"
"3004",29043,"Missouri","Christian County","API_combo",187,301,114,46.72,"overcount"
"3005",29045,"Missouri","Clark County","API_alone",7,6,-1,-15.38,"undercount"
"3006",29045,"Missouri","Clark County","API_combo",7,9,2,25,"overcount"
"3007",29047,"Missouri","Clay County","API_alone",2047,2714,667,28.02,"overcount"
"3008",29047,"Missouri","Clay County","API_combo",2047,3459,1412,51.29,"overcount"
"3009",29049,"Missouri","Clinton County","API_alone",41,33,-8,-21.62,"undercount"
"3010",29049,"Missouri","Clinton County","API_combo",41,51,10,21.74,"overcount"
"3011",29051,"Missouri","Cole County","API_alone",446,667,221,39.71,"overcount"
"3012",29051,"Missouri","Cole County","API_combo",446,901,455,67.56,"overcount"
"3013",29053,"Missouri","Cooper County","API_alone",73,45,-28,-47.46,"undercount"
"3014",29053,"Missouri","Cooper County","API_combo",73,73,0,0,"equal"
"3015",29055,"Missouri","Crawford County","API_alone",56,45,-11,-21.78,"undercount"
"3016",29055,"Missouri","Crawford County","API_combo",56,62,6,10.17,"overcount"
"3017",29057,"Missouri","Dade County","API_alone",26,20,-6,-26.09,"undercount"
"3018",29057,"Missouri","Dade County","API_combo",26,27,1,3.77,"overcount"
"3019",29059,"Missouri","Dallas County","API_alone",39,16,-23,-83.64,"undercount"
"3020",29059,"Missouri","Dallas County","API_combo",39,46,7,16.47,"overcount"
"3021",29061,"Missouri","Daviess County","API_alone",18,21,3,15.38,"overcount"
"3022",29061,"Missouri","Daviess County","API_combo",18,25,7,32.56,"overcount"
"3023",29063,"Missouri","DeKalb County","API_alone",62,21,-41,-98.8,"undercount"
"3024",29063,"Missouri","DeKalb County","API_combo",62,53,-9,-15.65,"undercount"
"3025",29065,"Missouri","Dent County","API_alone",57,37,-20,-42.55,"undercount"
"3026",29065,"Missouri","Dent County","API_combo",57,53,-4,-7.27,"undercount"
"3027",29067,"Missouri","Douglas County","API_alone",30,31,1,3.28,"overcount"
"3028",29067,"Missouri","Douglas County","API_combo",30,50,20,50,"overcount"
"3029",29069,"Missouri","Dunklin County","API_alone",100,97,-3,-3.05,"undercount"
"3030",29069,"Missouri","Dunklin County","API_combo",100,131,31,26.84,"overcount"
"3031",29071,"Missouri","Franklin County","API_alone",363,282,-81,-25.12,"undercount"
"3032",29071,"Missouri","Franklin County","API_combo",363,439,76,18.95,"overcount"
"3033",29073,"Missouri","Gasconade County","API_alone",33,25,-8,-27.59,"undercount"
"3034",29073,"Missouri","Gasconade County","API_combo",33,46,13,32.91,"overcount"
"3035",29075,"Missouri","Gentry County","API_alone",7,23,16,106.67,"overcount"
"3036",29075,"Missouri","Gentry County","API_combo",7,36,29,134.88,"overcount"
"3037",29077,"Missouri","Greene County","API_alone",2558,2942,384,13.96,"overcount"
"3038",29077,"Missouri","Greene County","API_combo",2558,3691,1133,36.26,"overcount"
"3039",29079,"Missouri","Grundy County","API_alone",32,17,-15,-61.22,"undercount"
"3040",29079,"Missouri","Grundy County","API_combo",32,28,-4,-13.33,"undercount"
"3041",29081,"Missouri","Harrison County","API_alone",32,18,-14,-56,"undercount"
"3042",29081,"Missouri","Harrison County","API_combo",32,57,25,56.18,"overcount"
"3043",29083,"Missouri","Henry County","API_alone",82,59,-23,-32.62,"undercount"
"3044",29083,"Missouri","Henry County","API_combo",82,104,22,23.66,"overcount"
"3045",29085,"Missouri","Hickory County","API_alone",12,10,-2,-18.18,"undercount"
"3046",29085,"Missouri","Hickory County","API_combo",12,20,8,50,"overcount"
"3047",29087,"Missouri","Holt County","API_alone",5,5,0,0,"equal"
"3048",29087,"Missouri","Holt County","API_combo",5,9,4,57.14,"overcount"
"3049",29089,"Missouri","Howard County","API_alone",23,20,-3,-13.95,"undercount"
"3050",29089,"Missouri","Howard County","API_combo",23,34,11,38.6,"overcount"
"3051",29091,"Missouri","Howell County","API_alone",144,157,13,8.64,"overcount"
"3052",29091,"Missouri","Howell County","API_combo",144,261,117,57.78,"overcount"
"3053",29093,"Missouri","Iron County","API_alone",23,11,-12,-70.59,"undercount"
"3054",29093,"Missouri","Iron County","API_combo",23,27,4,16,"overcount"
"3055",29095,"Missouri","Jackson County","API_alone",9986,9981,-5,-0.05,"undercount"
"3056",29095,"Missouri","Jackson County","API_combo",9986,12615,2629,23.26,"overcount"
"3057",29097,"Missouri","Jasper County","API_alone",790,818,28,3.48,"overcount"
"3058",29097,"Missouri","Jasper County","API_combo",790,1024,234,25.8,"overcount"
"3059",29099,"Missouri","Jefferson County","API_alone",1010,753,-257,-29.15,"undercount"
"3060",29099,"Missouri","Jefferson County","API_combo",1010,1127,117,10.95,"overcount"
"3061",29101,"Missouri","Johnson County","API_alone",1054,789,-265,-28.76,"undercount"
"3062",29101,"Missouri","Johnson County","API_combo",1054,1081,27,2.53,"overcount"
"3063",29103,"Missouri","Knox County","API_alone",3,4,1,28.57,"overcount"
"3064",29103,"Missouri","Knox County","API_combo",3,14,11,129.41,"overcount"
"3065",29105,"Missouri","Laclede County","API_alone",148,112,-36,-27.69,"undercount"
"3066",29105,"Missouri","Laclede County","API_combo",148,220,72,39.13,"overcount"
"3067",29107,"Missouri","Lafayette County","API_alone",113,92,-21,-20.49,"undercount"
"3068",29107,"Missouri","Lafayette County","API_combo",113,152,39,29.43,"overcount"
"3069",29109,"Missouri","Lawrence County","API_alone",102,96,-6,-6.06,"undercount"
"3070",29109,"Missouri","Lawrence County","API_combo",102,145,43,34.82,"overcount"
"3071",29111,"Missouri","Lewis County","API_alone",20,24,4,18.18,"overcount"
"3072",29111,"Missouri","Lewis County","API_combo",20,43,23,73.02,"overcount"
"3073",29113,"Missouri","Lincoln County","API_alone",122,82,-40,-39.22,"undercount"
"3074",29113,"Missouri","Lincoln County","API_combo",122,147,25,18.59,"overcount"
"3075",29115,"Missouri","Linn County","API_alone",20,20,0,0,"equal"
"3076",29115,"Missouri","Linn County","API_combo",20,41,21,68.85,"overcount"
"3077",29117,"Missouri","Livingston County","API_alone",39,43,4,9.76,"overcount"
"3078",29117,"Missouri","Livingston County","API_combo",39,77,38,65.52,"overcount"
"3079",29119,"Missouri","McDonald County","API_alone",85,62,-23,-31.29,"undercount"
"3080",29119,"Missouri","McDonald County","API_combo",85,93,8,8.99,"overcount"
"3081",29121,"Missouri","Macon County","API_alone",26,27,1,3.77,"overcount"
"3082",29121,"Missouri","Macon County","API_combo",26,35,9,29.51,"overcount"
"3083",29123,"Missouri","Madison County","API_alone",54,34,-20,-45.45,"undercount"
"3084",29123,"Missouri","Madison County","API_combo",54,52,-2,-3.77,"undercount"
"3085",29125,"Missouri","Maries County","API_alone",16,10,-6,-46.15,"undercount"
"3086",29125,"Missouri","Maries County","API_combo",16,23,7,35.9,"overcount"
"3087",29127,"Missouri","Marion County","API_alone",166,104,-62,-45.93,"undercount"
"3088",29127,"Missouri","Marion County","API_combo",166,149,-17,-10.79,"undercount"
"3089",29129,"Missouri","Mercer County","API_alone",2,2,0,0,"equal"
"3090",29129,"Missouri","Mercer County","API_combo",2,3,1,40,"overcount"
"3091",29131,"Missouri","Miller County","API_alone",53,37,-16,-35.56,"undercount"
"3092",29131,"Missouri","Miller County","API_combo",53,54,1,1.87,"overcount"
"3093",29133,"Missouri","Mississippi County","API_alone",17,17,0,0,"equal"
"3094",29133,"Missouri","Mississippi County","API_combo",17,32,15,61.22,"overcount"
"3095",29135,"Missouri","Moniteau County","API_alone",57,50,-7,-13.08,"undercount"
"3096",29135,"Missouri","Moniteau County","API_combo",57,87,30,41.67,"overcount"
"3097",29137,"Missouri","Monroe County","API_alone",20,14,-6,-35.29,"undercount"
"3098",29137,"Missouri","Monroe County","API_combo",20,20,0,0,"equal"
"3099",29139,"Missouri","Montgomery County","API_alone",33,32,-1,-3.08,"undercount"
"3100",29139,"Missouri","Montgomery County","API_combo",33,67,34,68,"overcount"
"3101",29141,"Missouri","Morgan County","API_alone",53,28,-25,-61.73,"undercount"
"3102",29141,"Missouri","Morgan County","API_combo",53,53,0,0,"equal"
"3103",29143,"Missouri","New Madrid County","API_alone",43,28,-15,-42.25,"undercount"
"3104",29143,"Missouri","New Madrid County","API_combo",43,57,14,28,"overcount"
"3105",29145,"Missouri","Newton County","API_alone",411,321,-90,-24.59,"undercount"
"3106",29145,"Missouri","Newton County","API_combo",411,462,51,11.68,"overcount"
"3107",29147,"Missouri","Nodaway County","API_alone",210,197,-13,-6.39,"undercount"
"3108",29147,"Missouri","Nodaway County","API_combo",210,235,25,11.24,"overcount"
"3109",29149,"Missouri","Oregon County","API_alone",24,15,-9,-46.15,"undercount"
"3110",29149,"Missouri","Oregon County","API_combo",24,23,-1,-4.26,"undercount"
"3111",29151,"Missouri","Osage County","API_alone",5,13,8,88.89,"overcount"
"3112",29151,"Missouri","Osage County","API_combo",5,35,30,150,"overcount"
"3113",29153,"Missouri","Ozark County","API_alone",22,9,-13,-83.87,"undercount"
"3114",29153,"Missouri","Ozark County","API_combo",22,29,7,27.45,"overcount"
"3115",29155,"Missouri","Pemiscot County","API_alone",69,61,-8,-12.31,"undercount"
"3116",29155,"Missouri","Pemiscot County","API_combo",69,84,15,19.61,"overcount"
"3117",29157,"Missouri","Perry County","API_alone",109,122,13,11.26,"overcount"
"3118",29157,"Missouri","Perry County","API_combo",109,149,40,31.01,"overcount"
"3119",29159,"Missouri","Pettis County","API_alone",200,190,-10,-5.13,"undercount"
"3120",29159,"Missouri","Pettis County","API_combo",200,320,120,46.15,"overcount"
"3121",29161,"Missouri","Phelps County","API_alone",1240,974,-266,-24.03,"undercount"
"3122",29161,"Missouri","Phelps County","API_combo",1240,1115,-125,-10.62,"undercount"
"3123",29163,"Missouri","Pike County","API_alone",32,38,6,17.14,"overcount"
"3124",29163,"Missouri","Pike County","API_combo",32,61,29,62.37,"overcount"
"3125",29165,"Missouri","Platte County","API_alone",1511,1288,-223,-15.93,"undercount"
"3126",29165,"Missouri","Platte County","API_combo",1511,1574,63,4.08,"overcount"
"3127",29167,"Missouri","Polk County","API_alone",141,63,-78,-76.47,"undercount"
"3128",29167,"Missouri","Polk County","API_combo",141,106,-35,-28.34,"undercount"
"3129",29169,"Missouri","Pulaski County","API_alone",1713,1125,-588,-41.44,"undercount"
"3130",29169,"Missouri","Pulaski County","API_combo",1713,1648,-65,-3.87,"undercount"
"3131",29171,"Missouri","Putnam County","API_alone",6,7,1,15.38,"overcount"
"3132",29171,"Missouri","Putnam County","API_combo",6,9,3,40,"overcount"
"3133",29173,"Missouri","Ralls County","API_alone",15,9,-6,-50,"undercount"
"3134",29173,"Missouri","Ralls County","API_combo",15,23,8,42.11,"overcount"
"3135",29175,"Missouri","Randolph County","API_alone",104,106,2,1.9,"overcount"
"3136",29175,"Missouri","Randolph County","API_combo",104,151,47,36.86,"overcount"
"3137",29177,"Missouri","Ray County","API_alone",54,45,-9,-18.18,"undercount"
"3138",29177,"Missouri","Ray County","API_combo",54,91,37,51.03,"overcount"
"3139",29179,"Missouri","Reynolds County","API_alone",11,13,2,16.67,"overcount"
"3140",29179,"Missouri","Reynolds County","API_combo",11,41,30,115.38,"overcount"
"3141",29181,"Missouri","Ripley County","API_alone",43,32,-11,-29.33,"undercount"
"3142",29181,"Missouri","Ripley County","API_combo",43,43,0,0,"equal"
"3143",29183,"Missouri","St. Charles County","API_alone",2903,2537,-366,-13.46,"undercount"
"3144",29183,"Missouri","St. Charles County","API_combo",2903,3359,456,14.56,"overcount"
"3145",29185,"Missouri","St. Clair County","API_alone",18,20,2,10.53,"overcount"
"3146",29185,"Missouri","St. Clair County","API_combo",18,25,7,32.56,"overcount"
"3147",29186,"Missouri","Ste. Genevieve County","API_alone",38,29,-9,-26.87,"undercount"
"3148",29186,"Missouri","Ste. Genevieve County","API_combo",38,39,1,2.6,"overcount"
"3149",29187,"Missouri","St. Francois County","API_alone",230,190,-40,-19.05,"undercount"
"3150",29187,"Missouri","St. Francois County","API_combo",230,289,59,22.74,"overcount"
"3151",29189,"Missouri","St. Louis County","API_alone",20901,23248,2347,10.63,"overcount"
"3152",29189,"Missouri","St. Louis County","API_combo",20901,27402,6501,26.92,"overcount"
"3153",29195,"Missouri","Saline County","API_alone",77,142,65,59.36,"overcount"
"3154",29195,"Missouri","Saline County","API_combo",77,209,132,92.31,"overcount"
"3155",29197,"Missouri","Schuyler County","API_alone",4,8,4,66.67,"overcount"
"3156",29197,"Missouri","Schuyler County","API_combo",4,9,5,76.92,"overcount"
"3157",29199,"Missouri","Scotland County","API_alone",0,5,5,200,"overcount"
"3158",29199,"Missouri","Scotland County","API_combo",0,6,6,200,"overcount"
"3159",29201,"Missouri","Scott County","API_alone",98,96,-2,-2.06,"undercount"
"3160",29201,"Missouri","Scott County","API_combo",98,142,44,36.67,"overcount"
"3161",29203,"Missouri","Shannon County","API_alone",6,8,2,28.57,"overcount"
"3162",29203,"Missouri","Shannon County","API_combo",6,25,19,122.58,"overcount"
"3163",29205,"Missouri","Shelby County","API_alone",4,8,4,66.67,"overcount"
"3164",29205,"Missouri","Shelby County","API_combo",4,18,14,127.27,"overcount"
"3165",29207,"Missouri","Stoddard County","API_alone",69,31,-38,-76,"undercount"
"3166",29207,"Missouri","Stoddard County","API_combo",69,74,5,6.99,"overcount"
"3167",29209,"Missouri","Stone County","API_alone",93,62,-31,-40,"undercount"
"3168",29209,"Missouri","Stone County","API_combo",93,115,22,21.15,"overcount"
"3169",29211,"Missouri","Sullivan County","API_alone",4,18,14,127.27,"overcount"
"3170",29211,"Missouri","Sullivan County","API_combo",4,28,24,150,"overcount"
"3171",29213,"Missouri","Taney County","API_alone",190,162,-28,-15.91,"undercount"
"3172",29213,"Missouri","Taney County","API_combo",190,280,90,38.3,"overcount"
"3173",29215,"Missouri","Texas County","API_alone",92,82,-10,-11.49,"undercount"
"3174",29215,"Missouri","Texas County","API_combo",92,146,54,45.38,"overcount"
"3175",29217,"Missouri","Vernon County","API_alone",100,72,-28,-32.56,"undercount"
"3176",29217,"Missouri","Vernon County","API_combo",100,103,3,2.96,"overcount"
"3177",29219,"Missouri","Warren County","API_alone",70,64,-6,-8.96,"undercount"
"3178",29219,"Missouri","Warren County","API_combo",70,109,39,43.58,"overcount"
"3179",29221,"Missouri","Washington County","API_alone",45,37,-8,-19.51,"undercount"
"3180",29221,"Missouri","Washington County","API_combo",45,64,19,34.86,"overcount"
"3181",29223,"Missouri","Wayne County","API_alone",15,21,6,33.33,"overcount"
"3182",29223,"Missouri","Wayne County","API_combo",15,33,18,75,"overcount"
"3183",29225,"Missouri","Webster County","API_alone",85,94,9,10.06,"overcount"
"3184",29225,"Missouri","Webster County","API_combo",85,149,64,54.7,"overcount"
"3185",29227,"Missouri","Worth County","API_alone",6,2,-4,-100,"undercount"
"3186",29227,"Missouri","Worth County","API_combo",6,11,5,58.82,"overcount"
"3187",29229,"Missouri","Wright County","API_alone",24,30,6,22.22,"overcount"
"3188",29229,"Missouri","Wright County","API_combo",24,49,25,68.49,"overcount"
"3189",29510,"Missouri","St. Louis city","API_alone",4284,7136,2852,49.95,"overcount"
"3190",29510,"Missouri","St. Louis city","API_combo",4284,8445,4161,65.38,"overcount"
"3191",30001,"Montana","Beaverhead County","API_alone",34,21,-13,-47.27,"undercount"
"3192",30001,"Montana","Beaverhead County","API_combo",34,52,18,41.86,"overcount"
"3193",30003,"Montana","Big Horn County","API_alone",63,29,-34,-73.91,"undercount"
"3194",30003,"Montana","Big Horn County","API_combo",63,65,2,3.12,"overcount"
"3195",30005,"Montana","Blaine County","API_alone",8,10,2,22.22,"overcount"
"3196",30005,"Montana","Blaine County","API_combo",8,16,8,66.67,"overcount"
"3197",30007,"Montana","Broadwater County","API_alone",8,8,0,0,"equal"
"3198",30007,"Montana","Broadwater County","API_combo",8,10,2,22.22,"overcount"
"3199",30009,"Montana","Carbon County","API_alone",22,34,12,42.86,"overcount"
"3200",30009,"Montana","Carbon County","API_combo",22,45,23,68.66,"overcount"
"3201",30011,"Montana","Carter County","API_alone",2,2,0,0,"equal"
"3202",30011,"Montana","Carter County","API_combo",2,3,1,40,"overcount"
"3203",30013,"Montana","Cascade County","API_alone",946,739,-207,-24.57,"undercount"
"3204",30013,"Montana","Cascade County","API_combo",946,1185,239,22.43,"overcount"
"3205",30015,"Montana","Chouteau County","API_alone",12,21,9,54.55,"overcount"
"3206",30015,"Montana","Chouteau County","API_combo",12,31,19,88.37,"overcount"
"3207",30017,"Montana","Custer County","API_alone",30,38,8,23.53,"overcount"
"3208",30017,"Montana","Custer County","API_combo",30,55,25,58.82,"overcount"
"3209",30019,"Montana","Daniels County","API_alone",19,7,-12,-92.31,"undercount"
"3210",30019,"Montana","Daniels County","API_combo",19,7,-12,-92.31,"undercount"
"3211",30021,"Montana","Dawson County","API_alone",28,13,-15,-73.17,"undercount"
"3212",30021,"Montana","Dawson County","API_combo",28,19,-9,-38.3,"undercount"
"3213",30023,"Montana","Deer Lodge County","API_alone",27,35,8,25.81,"overcount"
"3214",30023,"Montana","Deer Lodge County","API_combo",27,55,28,68.29,"overcount"
"3215",30025,"Montana","Fallon County","API_alone",25,11,-14,-77.78,"undercount"
"3216",30025,"Montana","Fallon County","API_combo",25,15,-10,-50,"undercount"
"3217",30027,"Montana","Fergus County","API_alone",14,27,13,63.41,"overcount"
"3218",30027,"Montana","Fergus County","API_combo",14,52,38,115.15,"overcount"
"3219",30029,"Montana","Flathead County","API_alone",351,393,42,11.29,"overcount"
"3220",30029,"Montana","Flathead County","API_combo",351,645,294,59.04,"overcount"
"3221",30031,"Montana","Gallatin County","API_alone",609,668,59,9.24,"overcount"
"3222",30031,"Montana","Gallatin County","API_combo",609,953,344,44.05,"overcount"
"3223",30033,"Montana","Garfield County","API_alone",5,2,-3,-85.71,"undercount"
"3224",30033,"Montana","Garfield County","API_combo",5,2,-3,-85.71,"undercount"
"3225",30035,"Montana","Glacier County","API_alone",13,16,3,20.69,"overcount"
"3226",30035,"Montana","Glacier County","API_combo",13,39,26,100,"overcount"
"3227",30037,"Montana","Golden Valley County","API_alone",5,1,-4,-133.33,"undercount"
"3228",30037,"Montana","Golden Valley County","API_combo",5,2,-3,-85.71,"undercount"
"3229",30039,"Montana","Granite County","API_alone",9,5,-4,-57.14,"undercount"
"3230",30039,"Montana","Granite County","API_combo",9,12,3,28.57,"overcount"
"3231",30041,"Montana","Hill County","API_alone",100,69,-31,-36.69,"undercount"
"3232",30041,"Montana","Hill County","API_combo",100,115,15,13.95,"overcount"
"3233",30043,"Montana","Jefferson County","API_alone",19,50,31,89.86,"overcount"
"3234",30043,"Montana","Jefferson County","API_combo",19,79,60,122.45,"overcount"
"3235",30045,"Montana","Judith Basin County","API_alone",6,2,-4,-100,"undercount"
"3236",30045,"Montana","Judith Basin County","API_combo",6,7,1,15.38,"overcount"
"3237",30047,"Montana","Lake County","API_alone",42,90,48,72.73,"overcount"
"3238",30047,"Montana","Lake County","API_combo",42,155,113,114.72,"overcount"
"3239",30049,"Montana","Lewis and Clark County","API_alone",340,320,-20,-6.06,"undercount"
"3240",30049,"Montana","Lewis and Clark County","API_combo",340,509,169,39.81,"overcount"
"3241",30051,"Montana","Liberty County","API_alone",37,7,-30,-136.36,"undercount"
"3242",30051,"Montana","Liberty County","API_combo",37,10,-27,-114.89,"undercount"
"3243",30053,"Montana","Lincoln County","API_alone",68,67,-1,-1.48,"undercount"
"3244",30053,"Montana","Lincoln County","API_combo",68,110,42,47.19,"overcount"
"3245",30055,"Montana","McCone County","API_alone",16,6,-10,-90.91,"undercount"
"3246",30055,"Montana","McCone County","API_combo",16,10,-6,-46.15,"undercount"
"3247",30057,"Montana","Madison County","API_alone",17,18,1,5.71,"overcount"
"3248",30057,"Montana","Madison County","API_combo",17,32,15,61.22,"overcount"
"3249",30059,"Montana","Meagher County","API_alone",5,4,-1,-22.22,"undercount"
"3250",30059,"Montana","Meagher County","API_combo",5,6,1,18.18,"overcount"
"3251",30061,"Montana","Mineral County","API_alone",34,21,-13,-47.27,"undercount"
"3252",30061,"Montana","Mineral County","API_combo",34,33,-1,-2.99,"undercount"
"3253",30063,"Montana","Missoula County","API_alone",1104,1087,-17,-1.55,"undercount"
"3254",30063,"Montana","Missoula County","API_combo",1104,1465,361,28.1,"overcount"
"3255",30065,"Montana","Musselshell County","API_alone",9,9,0,0,"equal"
"3256",30065,"Montana","Musselshell County","API_combo",9,20,11,75.86,"overcount"
"3257",30067,"Montana","Park County","API_alone",93,67,-26,-32.5,"undercount"
"3258",30067,"Montana","Park County","API_combo",93,100,7,7.25,"overcount"
"3259",30069,"Montana","Petroleum County","API_alone",0,0,0,0,"equal"
"3260",30069,"Montana","Petroleum County","API_combo",0,0,0,0,"equal"
"3261",30071,"Montana","Phillips County","API_alone",14,16,2,13.33,"overcount"
"3262",30071,"Montana","Phillips County","API_combo",14,16,2,13.33,"overcount"
"3263",30073,"Montana","Pondera County","API_alone",21,12,-9,-54.55,"undercount"
"3264",30073,"Montana","Pondera County","API_combo",21,21,0,0,"equal"
"3265",30075,"Montana","Powder River County","API_alone",4,2,-2,-66.67,"undercount"
"3266",30075,"Montana","Powder River County","API_combo",4,3,-1,-28.57,"undercount"
"3267",30077,"Montana","Powell County","API_alone",32,31,-1,-3.17,"undercount"
"3268",30077,"Montana","Powell County","API_combo",32,67,35,70.71,"overcount"
"3269",30079,"Montana","Prairie County","API_alone",4,2,-2,-66.67,"undercount"
"3270",30079,"Montana","Prairie County","API_combo",4,5,1,22.22,"overcount"
"3271",30081,"Montana","Ravalli County","API_alone",124,144,20,14.93,"overcount"
"3272",30081,"Montana","Ravalli County","API_combo",124,225,101,57.88,"overcount"
"3273",30083,"Montana","Richland County","API_alone",40,18,-22,-75.86,"undercount"
"3274",30083,"Montana","Richland County","API_combo",40,28,-12,-35.29,"undercount"
"3275",30085,"Montana","Roosevelt County","API_alone",36,51,15,34.48,"overcount"
"3276",30085,"Montana","Roosevelt County","API_combo",36,73,37,67.89,"overcount"
"3277",30087,"Montana","Rosebud County","API_alone",47,28,-19,-50.67,"undercount"
"3278",30087,"Montana","Rosebud County","API_combo",47,48,1,2.11,"overcount"
"3279",30089,"Montana","Sanders County","API_alone",59,36,-23,-48.42,"undercount"
"3280",30089,"Montana","Sanders County","API_combo",59,57,-2,-3.45,"undercount"
"3281",30091,"Montana","Sheridan County","API_alone",10,13,3,26.09,"overcount"
"3282",30091,"Montana","Sheridan County","API_combo",10,21,11,70.97,"overcount"
"3283",30093,"Montana","Silver Bow County","API_alone",163,172,9,5.37,"overcount"
"3284",30093,"Montana","Silver Bow County","API_combo",163,266,103,48.02,"overcount"
"3285",30095,"Montana","Stillwater County","API_alone",14,23,9,48.65,"overcount"
"3286",30095,"Montana","Stillwater County","API_combo",14,52,38,115.15,"overcount"
"3287",30097,"Montana","Sweet Grass County","API_alone",5,13,8,88.89,"overcount"
"3288",30097,"Montana","Sweet Grass County","API_combo",5,21,16,123.08,"overcount"
"3289",30099,"Montana","Teton County","API_alone",10,7,-3,-35.29,"undercount"
"3290",30099,"Montana","Teton County","API_combo",10,12,2,18.18,"overcount"
"3291",30101,"Montana","Toole County","API_alone",17,17,0,0,"equal"
"3292",30101,"Montana","Toole County","API_combo",17,39,22,78.57,"overcount"
"3293",30103,"Montana","Treasure County","API_alone",1,3,2,100,"overcount"
"3294",30103,"Montana","Treasure County","API_combo",1,5,4,133.33,"overcount"
"3295",30105,"Montana","Valley County","API_alone",21,20,-1,-4.88,"undercount"
"3296",30105,"Montana","Valley County","API_combo",21,35,14,50,"overcount"
"3297",30107,"Montana","Wheatland County","API_alone",9,10,1,10.53,"overcount"
"3298",30107,"Montana","Wheatland County","API_combo",9,15,6,50,"overcount"
"3299",30109,"Montana","Wibaux County","API_alone",2,2,0,0,"equal"
"3300",30109,"Montana","Wibaux County","API_combo",2,6,4,100,"overcount"
"3301",30111,"Montana","Yellowstone County","API_alone",764,777,13,1.69,"overcount"
"3302",30111,"Montana","Yellowstone County","API_combo",764,1278,514,50.34,"overcount"
"3303",31001,"Nebraska","Adams County","API_alone",214,518,304,83.06,"overcount"
"3304",31001,"Nebraska","Adams County","API_combo",214,587,373,93.13,"overcount"
"3305",31003,"Nebraska","Antelope County","API_alone",17,4,-13,-123.81,"undercount"
"3306",31003,"Nebraska","Antelope County","API_combo",17,11,-6,-42.86,"undercount"
"3307",31005,"Nebraska","Arthur County","API_alone",0,4,4,200,"overcount"
"3308",31005,"Nebraska","Arthur County","API_combo",0,5,5,200,"overcount"
"3309",31007,"Nebraska","Banner County","API_alone",0,1,1,200,"overcount"
"3310",31007,"Nebraska","Banner County","API_combo",0,3,3,200,"overcount"
"3311",31009,"Nebraska","Blaine County","API_alone",0,0,0,0,"equal"
"3312",31009,"Nebraska","Blaine County","API_combo",0,0,0,0,"equal"
"3313",31011,"Nebraska","Boone County","API_alone",12,4,-8,-100,"undercount"
"3314",31011,"Nebraska","Boone County","API_combo",12,5,-7,-82.35,"undercount"
"3315",31013,"Nebraska","Box Butte County","API_alone",88,66,-22,-28.57,"undercount"
"3316",31013,"Nebraska","Box Butte County","API_combo",88,106,18,18.56,"overcount"
"3317",31015,"Nebraska","Boyd County","API_alone",1,4,3,120,"overcount"
"3318",31015,"Nebraska","Boyd County","API_combo",1,4,3,120,"overcount"
"3319",31017,"Nebraska","Brown County","API_alone",11,11,0,0,"equal"
"3320",31017,"Nebraska","Brown County","API_combo",11,18,7,48.28,"overcount"
"3321",31019,"Nebraska","Buffalo County","API_alone",358,313,-45,-13.41,"undercount"
"3322",31019,"Nebraska","Buffalo County","API_combo",358,419,61,15.7,"overcount"
"3323",31021,"Nebraska","Burt County","API_alone",27,17,-10,-45.45,"undercount"
"3324",31021,"Nebraska","Burt County","API_combo",27,33,6,20,"overcount"
"3325",31023,"Nebraska","Butler County","API_alone",35,21,-14,-50,"undercount"
"3326",31023,"Nebraska","Butler County","API_combo",35,21,-14,-50,"undercount"
"3327",31025,"Nebraska","Cass County","API_alone",187,93,-94,-67.14,"undercount"
"3328",31025,"Nebraska","Cass County","API_combo",187,139,-48,-29.45,"undercount"
"3329",31027,"Nebraska","Cedar County","API_alone",22,6,-16,-114.29,"undercount"
"3330",31027,"Nebraska","Cedar County","API_combo",22,23,1,4.44,"overcount"
"3331",31029,"Nebraska","Chase County","API_alone",3,8,5,90.91,"overcount"
"3332",31029,"Nebraska","Chase County","API_combo",3,11,8,114.29,"overcount"
"3333",31031,"Nebraska","Cherry County","API_alone",21,41,20,64.52,"overcount"
"3334",31031,"Nebraska","Cherry County","API_combo",21,49,28,80,"overcount"
"3335",31033,"Nebraska","Cheyenne County","API_alone",24,42,18,54.55,"overcount"
"3336",31033,"Nebraska","Cheyenne County","API_combo",24,57,33,81.48,"overcount"
"3337",31035,"Nebraska","Clay County","API_alone",21,21,0,0,"equal"
"3338",31035,"Nebraska","Clay County","API_combo",21,24,3,13.33,"overcount"
"3339",31037,"Nebraska","Colfax County","API_alone",20,60,40,100,"overcount"
"3340",31037,"Nebraska","Colfax County","API_combo",20,76,56,116.67,"overcount"
"3341",31039,"Nebraska","Cuming County","API_alone",36,23,-13,-44.07,"undercount"
"3342",31039,"Nebraska","Cuming County","API_combo",36,34,-2,-5.71,"undercount"
"3343",31041,"Nebraska","Custer County","API_alone",28,18,-10,-43.48,"undercount"
"3344",31041,"Nebraska","Custer County","API_combo",28,28,0,0,"equal"
"3345",31043,"Nebraska","Dakota County","API_alone",714,668,-46,-6.66,"undercount"
"3346",31043,"Nebraska","Dakota County","API_combo",714,728,14,1.94,"overcount"
"3347",31045,"Nebraska","Dawes County","API_alone",123,33,-90,-115.38,"undercount"
"3348",31045,"Nebraska","Dawes County","API_combo",123,67,-56,-58.95,"undercount"
"3349",31047,"Nebraska","Dawson County","API_alone",107,191,84,56.38,"overcount"
"3350",31047,"Nebraska","Dawson County","API_combo",107,204,97,62.38,"overcount"
"3351",31049,"Nebraska","Deuel County","API_alone",8,8,0,0,"equal"
"3352",31049,"Nebraska","Deuel County","API_combo",8,12,4,40,"overcount"
"3353",31051,"Nebraska","Dixon County","API_alone",7,19,12,92.31,"overcount"
"3354",31051,"Nebraska","Dixon County","API_combo",7,26,19,115.15,"overcount"
"3355",31053,"Nebraska","Dodge County","API_alone",218,228,10,4.48,"overcount"
"3356",31053,"Nebraska","Dodge County","API_combo",218,320,102,37.92,"overcount"
"3357",31055,"Nebraska","Douglas County","API_alone",7666,8430,764,9.49,"overcount"
"3358",31055,"Nebraska","Douglas County","API_combo",7666,10205,2539,28.41,"overcount"
"3359",31057,"Nebraska","Dundy County","API_alone",4,12,8,100,"overcount"
"3360",31057,"Nebraska","Dundy County","API_combo",4,13,9,105.88,"overcount"
"3361",31059,"Nebraska","Fillmore County","API_alone",6,5,-1,-18.18,"undercount"
"3362",31059,"Nebraska","Fillmore County","API_combo",6,7,1,15.38,"overcount"
"3363",31061,"Nebraska","Franklin County","API_alone",9,2,-7,-127.27,"undercount"
"3364",31061,"Nebraska","Franklin County","API_combo",9,4,-5,-76.92,"undercount"
"3365",31063,"Nebraska","Frontier County","API_alone",14,9,-5,-43.48,"undercount"
"3366",31063,"Nebraska","Frontier County","API_combo",14,15,1,6.9,"overcount"
"3367",31065,"Nebraska","Furnas County","API_alone",13,12,-1,-8,"undercount"
"3368",31065,"Nebraska","Furnas County","API_combo",13,14,1,7.41,"overcount"
"3369",31067,"Nebraska","Gage County","API_alone",136,80,-56,-51.85,"undercount"
"3370",31067,"Nebraska","Gage County","API_combo",136,117,-19,-15.02,"undercount"
"3371",31069,"Nebraska","Garden County","API_alone",0,6,6,200,"overcount"
"3372",31069,"Nebraska","Garden County","API_combo",0,8,8,200,"overcount"
"3373",31071,"Nebraska","Garfield County","API_alone",8,2,-6,-120,"undercount"
"3374",31071,"Nebraska","Garfield County","API_combo",8,2,-6,-120,"undercount"
"3375",31073,"Nebraska","Gosper County","API_alone",26,6,-20,-125,"undercount"
"3376",31073,"Nebraska","Gosper County","API_combo",26,6,-20,-125,"undercount"
"3377",31075,"Nebraska","Grant County","API_alone",10,2,-8,-133.33,"undercount"
"3378",31075,"Nebraska","Grant County","API_combo",10,2,-8,-133.33,"undercount"
"3379",31077,"Nebraska","Greeley County","API_alone",5,2,-3,-85.71,"undercount"
"3380",31077,"Nebraska","Greeley County","API_combo",5,2,-3,-85.71,"undercount"
"3381",31079,"Nebraska","Hall County","API_alone",1060,704,-356,-40.36,"undercount"
"3382",31079,"Nebraska","Hall County","API_combo",1060,818,-242,-25.77,"undercount"
"3383",31081,"Nebraska","Hamilton County","API_alone",53,22,-31,-82.67,"undercount"
"3384",31081,"Nebraska","Hamilton County","API_combo",53,33,-20,-46.51,"undercount"
"3385",31083,"Nebraska","Harlan County","API_alone",1,4,3,120,"overcount"
"3386",31083,"Nebraska","Harlan County","API_combo",1,6,5,142.86,"overcount"
"3387",31085,"Nebraska","Hayes County","API_alone",3,3,0,0,"equal"
"3388",31085,"Nebraska","Hayes County","API_combo",3,5,2,50,"overcount"
"3389",31087,"Nebraska","Hitchcock County","API_alone",3,4,1,28.57,"overcount"
"3390",31087,"Nebraska","Hitchcock County","API_combo",3,4,1,28.57,"overcount"
"3391",31089,"Nebraska","Holt County","API_alone",36,27,-9,-28.57,"undercount"
"3392",31089,"Nebraska","Holt County","API_combo",36,32,-4,-11.76,"undercount"
"3393",31091,"Nebraska","Hooker County","API_alone",0,1,1,200,"overcount"
"3394",31091,"Nebraska","Hooker County","API_combo",0,1,1,200,"overcount"
"3395",31093,"Nebraska","Howard County","API_alone",15,8,-7,-60.87,"undercount"
"3396",31093,"Nebraska","Howard County","API_combo",15,8,-7,-60.87,"undercount"
"3397",31095,"Nebraska","Jefferson County","API_alone",11,19,8,53.33,"overcount"
"3398",31095,"Nebraska","Jefferson County","API_combo",11,25,14,77.78,"overcount"
"3399",31097,"Nebraska","Johnson County","API_alone",193,150,-43,-25.07,"undercount"
"3400",31097,"Nebraska","Johnson County","API_combo",193,154,-39,-22.48,"undercount"
"3401",31099,"Nebraska","Kearney County","API_alone",11,18,7,48.28,"overcount"
"3402",31099,"Nebraska","Kearney County","API_combo",11,29,18,90,"overcount"
"3403",31101,"Nebraska","Keith County","API_alone",22,16,-6,-31.58,"undercount"
"3404",31101,"Nebraska","Keith County","API_combo",22,32,10,37.04,"overcount"
"3405",31103,"Nebraska","Keya Paha County","API_alone",0,0,0,0,"equal"
"3406",31103,"Nebraska","Keya Paha County","API_combo",0,0,0,0,"equal"
"3407",31105,"Nebraska","Kimball County","API_alone",8,5,-3,-46.15,"undercount"
"3408",31105,"Nebraska","Kimball County","API_combo",8,6,-2,-28.57,"undercount"
"3409",31107,"Nebraska","Knox County","API_alone",31,19,-12,-48,"undercount"
"3410",31107,"Nebraska","Knox County","API_combo",31,28,-3,-10.17,"undercount"
"3411",31109,"Nebraska","Lancaster County","API_alone",6417,7432,1015,14.66,"overcount"
"3412",31109,"Nebraska","Lancaster County","API_combo",6417,8482,2065,27.72,"overcount"
"3413",31111,"Nebraska","Lincoln County","API_alone",221,143,-78,-42.86,"undercount"
"3414",31111,"Nebraska","Lincoln County","API_combo",221,205,-16,-7.51,"undercount"
"3415",31113,"Nebraska","Logan County","API_alone",0,0,0,0,"equal"
"3416",31113,"Nebraska","Logan County","API_combo",0,0,0,0,"equal"
"3417",31115,"Nebraska","Loup County","API_alone",1,1,0,0,"equal"
"3418",31115,"Nebraska","Loup County","API_combo",1,1,0,0,"equal"
"3419",31117,"Nebraska","McPherson County","API_alone",0,2,2,200,"overcount"
"3420",31117,"Nebraska","McPherson County","API_combo",0,2,2,200,"overcount"
"3421",31119,"Nebraska","Madison County","API_alone",222,167,-55,-28.28,"undercount"
"3422",31119,"Nebraska","Madison County","API_combo",222,213,-9,-4.14,"undercount"
"3423",31121,"Nebraska","Merrick County","API_alone",45,18,-27,-85.71,"undercount"
"3424",31121,"Nebraska","Merrick County","API_combo",45,26,-19,-53.52,"undercount"
"3425",31123,"Nebraska","Morrill County","API_alone",21,12,-9,-54.55,"undercount"
"3426",31123,"Nebraska","Morrill County","API_combo",21,12,-9,-54.55,"undercount"
"3427",31125,"Nebraska","Nance County","API_alone",13,2,-11,-146.67,"undercount"
"3428",31125,"Nebraska","Nance County","API_combo",13,4,-9,-105.88,"undercount"
"3429",31127,"Nebraska","Nemaha County","API_alone",20,50,30,85.71,"overcount"
"3430",31127,"Nebraska","Nemaha County","API_combo",20,60,40,100,"overcount"
"3431",31129,"Nebraska","Nuckolls County","API_alone",0,8,8,200,"overcount"
"3432",31129,"Nebraska","Nuckolls County","API_combo",0,9,9,200,"overcount"
"3433",31131,"Nebraska","Otoe County","API_alone",59,43,-16,-31.37,"undercount"
"3434",31131,"Nebraska","Otoe County","API_combo",59,61,2,3.33,"overcount"
"3435",31133,"Nebraska","Pawnee County","API_alone",5,8,3,46.15,"overcount"
"3436",31133,"Nebraska","Pawnee County","API_combo",5,10,5,66.67,"overcount"
"3437",31135,"Nebraska","Perkins County","API_alone",16,7,-9,-78.26,"undercount"
"3438",31135,"Nebraska","Perkins County","API_combo",16,10,-6,-46.15,"undercount"
"3439",31137,"Nebraska","Phelps County","API_alone",31,32,1,3.17,"overcount"
"3440",31137,"Nebraska","Phelps County","API_combo",31,67,36,73.47,"overcount"
"3441",31139,"Nebraska","Pierce County","API_alone",18,18,0,0,"equal"
"3442",31139,"Nebraska","Pierce County","API_combo",18,26,8,36.36,"overcount"
"3443",31141,"Nebraska","Platte County","API_alone",153,146,-7,-4.68,"undercount"
"3444",31141,"Nebraska","Platte County","API_combo",153,191,38,22.09,"overcount"
"3445",31143,"Nebraska","Polk County","API_alone",21,5,-16,-123.08,"undercount"
"3446",31143,"Nebraska","Polk County","API_combo",21,18,-3,-15.38,"undercount"
"3447",31145,"Nebraska","Red Willow County","API_alone",34,21,-13,-47.27,"undercount"
"3448",31145,"Nebraska","Red Willow County","API_combo",34,31,-3,-9.23,"undercount"
"3449",31147,"Nebraska","Richardson County","API_alone",21,14,-7,-40,"undercount"
"3450",31147,"Nebraska","Richardson County","API_combo",21,22,1,4.65,"overcount"
"3451",31149,"Nebraska","Rock County","API_alone",0,3,3,200,"overcount"
"3452",31149,"Nebraska","Rock County","API_combo",0,6,6,200,"overcount"
"3453",31151,"Nebraska","Saline County","API_alone",201,245,44,19.73,"overcount"
"3454",31151,"Nebraska","Saline County","API_combo",201,279,78,32.5,"overcount"
"3455",31153,"Nebraska","Sarpy County","API_alone",4197,2525,-1672,-49.75,"undercount"
"3456",31153,"Nebraska","Sarpy County","API_combo",4197,3594,-603,-15.48,"undercount"
"3457",31155,"Nebraska","Saunders County","API_alone",66,45,-21,-37.84,"undercount"
"3458",31155,"Nebraska","Saunders County","API_combo",66,71,5,7.3,"overcount"
"3459",31157,"Nebraska","Scotts Bluff County","API_alone",332,247,-85,-29.36,"undercount"
"3460",31157,"Nebraska","Scotts Bluff County","API_combo",332,308,-24,-7.5,"undercount"
"3461",31159,"Nebraska","Seward County","API_alone",72,64,-8,-11.76,"undercount"
"3462",31159,"Nebraska","Seward County","API_combo",72,95,23,27.54,"overcount"
"3463",31161,"Nebraska","Sheridan County","API_alone",32,12,-20,-90.91,"undercount"
"3464",31161,"Nebraska","Sheridan County","API_combo",32,23,-9,-32.73,"undercount"
"3465",31163,"Nebraska","Sherman County","API_alone",18,9,-9,-66.67,"undercount"
"3466",31163,"Nebraska","Sherman County","API_combo",18,16,-2,-11.76,"undercount"
"3467",31165,"Nebraska","Sioux County","API_alone",1,3,2,100,"overcount"
"3468",31165,"Nebraska","Sioux County","API_combo",1,5,4,133.33,"overcount"
"3469",31167,"Nebraska","Stanton County","API_alone",13,13,0,0,"equal"
"3470",31167,"Nebraska","Stanton County","API_combo",13,20,7,42.42,"overcount"
"3471",31169,"Nebraska","Thayer County","API_alone",8,7,-1,-13.33,"undercount"
"3472",31169,"Nebraska","Thayer County","API_combo",8,12,4,40,"overcount"
"3473",31171,"Nebraska","Thomas County","API_alone",0,0,0,0,"equal"
"3474",31171,"Nebraska","Thomas County","API_combo",0,0,0,0,"equal"
"3475",31173,"Nebraska","Thurston County","API_alone",11,4,-7,-93.33,"undercount"
"3476",31173,"Nebraska","Thurston County","API_combo",11,8,-3,-31.58,"undercount"
"3477",31175,"Nebraska","Valley County","API_alone",11,8,-3,-31.58,"undercount"
"3478",31175,"Nebraska","Valley County","API_combo",11,14,3,24,"overcount"
"3479",31177,"Nebraska","Washington County","API_alone",69,76,7,9.66,"overcount"
"3480",31177,"Nebraska","Washington County","API_combo",69,98,29,34.73,"overcount"
"3481",31179,"Nebraska","Wayne County","API_alone",60,36,-24,-50,"undercount"
"3482",31179,"Nebraska","Wayne County","API_combo",60,62,2,3.28,"overcount"
"3483",31181,"Nebraska","Webster County","API_alone",23,22,-1,-4.44,"undercount"
"3484",31181,"Nebraska","Webster County","API_combo",23,31,8,29.63,"overcount"
"3485",31183,"Nebraska","Wheeler County","API_alone",15,0,-15,-200,"undercount"
"3486",31183,"Nebraska","Wheeler County","API_combo",15,0,-15,-200,"undercount"
"3487",31185,"Nebraska","York County","API_alone",78,83,5,6.21,"overcount"
"3488",31185,"Nebraska","York County","API_combo",78,101,23,25.7,"overcount"
"3489",32001,"Nevada","Churchill County","API_alone",991,726,-265,-30.87,"undercount"
"3490",32001,"Nevada","Churchill County","API_combo",991,1022,31,3.08,"overcount"
"3491",32003,"Nevada","Clark County","API_alone",66495,82137,15642,21.05,"overcount"
"3492",32003,"Nevada","Clark County","API_combo",66495,104066,37571,44.06,"overcount"
"3493",32005,"Nevada","Douglas County","API_alone",781,606,-175,-25.23,"undercount"
"3494",32005,"Nevada","Douglas County","API_combo",781,947,166,19.21,"overcount"
"3495",32007,"Nevada","Elko County","API_alone",621,409,-212,-41.17,"undercount"
"3496",32007,"Nevada","Elko County","API_combo",621,568,-53,-8.92,"undercount"
"3497",32009,"Nevada","Esmeralda County","API_alone",10,2,-8,-133.33,"undercount"
"3498",32009,"Nevada","Esmeralda County","API_combo",10,2,-8,-133.33,"undercount"
"3499",32011,"Nevada","Eureka County","API_alone",19,14,-5,-30.3,"undercount"
"3500",32011,"Nevada","Eureka County","API_combo",19,15,-4,-23.53,"undercount"
"3501",32013,"Nevada","Humboldt County","API_alone",168,118,-50,-34.97,"undercount"
"3502",32013,"Nevada","Humboldt County","API_combo",168,189,21,11.76,"overcount"
"3503",32015,"Nevada","Lander County","API_alone",24,22,-2,-8.7,"undercount"
"3504",32015,"Nevada","Lander County","API_combo",24,32,8,28.57,"overcount"
"3505",32017,"Nevada","Lincoln County","API_alone",24,15,-9,-46.15,"undercount"
"3506",32017,"Nevada","Lincoln County","API_combo",24,33,9,31.58,"overcount"
"3507",32019,"Nevada","Lyon County","API_alone",425,268,-157,-45.31,"undercount"
"3508",32019,"Nevada","Lyon County","API_combo",425,478,53,11.74,"overcount"
"3509",32021,"Nevada","Mineral County","API_alone",85,46,-39,-59.54,"undercount"
"3510",32021,"Nevada","Mineral County","API_combo",85,58,-27,-37.76,"undercount"
"3511",32023,"Nevada","Nye County","API_alone",396,391,-5,-1.27,"undercount"
"3512",32023,"Nevada","Nye County","API_combo",396,567,171,35.51,"overcount"
"3513",32027,"Nevada","Pershing County","API_alone",45,57,12,23.53,"overcount"
"3514",32027,"Nevada","Pershing County","API_combo",45,95,50,71.43,"overcount"
"3515",32029,"Nevada","Storey County","API_alone",51,39,-12,-26.67,"undercount"
"3516",32029,"Nevada","Storey County","API_combo",51,60,9,16.22,"overcount"
"3517",32031,"Nevada","Washoe County","API_alone",19541,16787,-2754,-15.16,"undercount"
"3518",32031,"Nevada","Washoe County","API_combo",19541,20381,840,4.21,"overcount"
"3519",32033,"Nevada","White Pine County","API_alone",61,103,42,51.22,"overcount"
"3520",32033,"Nevada","White Pine County","API_combo",61,144,83,80.98,"overcount"
"3521",32510,"Nevada","Carson City","API_alone",1129,1033,-96,-8.88,"undercount"
"3522",32510,"Nevada","Carson City","API_combo",1129,1297,168,13.85,"overcount"
"3523",33001,"New Hampshire","Belknap County","API_alone",353,343,-10,-2.87,"undercount"
"3524",33001,"New Hampshire","Belknap County","API_combo",353,452,99,24.6,"overcount"
"3525",33003,"New Hampshire","Carroll County","API_alone",173,178,5,2.85,"overcount"
"3526",33003,"New Hampshire","Carroll County","API_combo",173,234,61,29.98,"overcount"
"3527",33005,"New Hampshire","Cheshire County","API_alone",464,396,-68,-15.81,"undercount"
"3528",33005,"New Hampshire","Cheshire County","API_combo",464,559,95,18.57,"overcount"
"3529",33007,"New Hampshire","Coos County","API_alone",174,132,-42,-27.45,"undercount"
"3530",33007,"New Hampshire","Coos County","API_combo",174,186,12,6.67,"overcount"
"3531",33009,"New Hampshire","Grafton County","API_alone",1198,1462,264,19.85,"overcount"
"3532",33009,"New Hampshire","Grafton County","API_combo",1198,1751,553,37.5,"overcount"
"3533",33011,"New Hampshire","Hillsborough County","API_alone",6228,7880,1652,23.42,"overcount"
"3534",33011,"New Hampshire","Hillsborough County","API_combo",6228,9142,2914,37.92,"overcount"
"3535",33013,"New Hampshire","Merrimack County","API_alone",999,1228,229,20.57,"overcount"
"3536",33013,"New Hampshire","Merrimack County","API_combo",999,1558,559,43.72,"overcount"
"3537",33015,"New Hampshire","Rockingham County","API_alone",3873,3276,-597,-16.7,"undercount"
"3538",33015,"New Hampshire","Rockingham County","API_combo",3873,4013,140,3.55,"overcount"
"3539",33017,"New Hampshire","Strafford County","API_alone",1523,1648,125,7.88,"overcount"
"3540",33017,"New Hampshire","Strafford County","API_combo",1523,1984,461,26.29,"overcount"
"3541",33019,"New Hampshire","Sullivan County","API_alone",217,161,-56,-29.63,"undercount"
"3542",33019,"New Hampshire","Sullivan County","API_combo",217,209,-8,-3.76,"undercount"
"3543",34001,"New Jersey","Atlantic County","API_alone",9115,13453,4338,38.44,"overcount"
"3544",34001,"New Jersey","Atlantic County","API_combo",9115,14608,5493,46.31,"overcount"
"3545",34003,"New Jersey","Bergen County","API_alone",98219,96220,-1999,-2.06,"undercount"
"3546",34003,"New Jersey","Bergen County","API_combo",98219,101190,2971,2.98,"overcount"
"3547",34005,"New Jersey","Burlington County","API_alone",15795,11848,-3947,-28.56,"undercount"
"3548",34005,"New Jersey","Burlington County","API_combo",15795,14413,-1382,-9.15,"undercount"
"3549",34007,"New Jersey","Camden County","API_alone",21140,19947,-1193,-5.81,"undercount"
"3550",34007,"New Jersey","Camden County","API_combo",21140,21939,799,3.71,"overcount"
"3551",34009,"New Jersey","Cape May County","API_alone",1236,735,-501,-50.84,"undercount"
"3552",34009,"New Jersey","Cape May County","API_combo",1236,955,-281,-25.65,"undercount"
"3553",34011,"New Jersey","Cumberland County","API_alone",2215,1636,-579,-30.07,"undercount"
"3554",34011,"New Jersey","Cumberland County","API_combo",2215,2081,-134,-6.24,"undercount"
"3555",34013,"New Jersey","Essex County","API_alone",33414,31468,-1946,-6,"undercount"
"3556",34013,"New Jersey","Essex County","API_combo",33414,35221,1807,5.27,"overcount"
"3557",34015,"New Jersey","Gloucester County","API_alone",5814,3990,-1824,-37.21,"undercount"
"3558",34015,"New Jersey","Gloucester County","API_combo",5814,4719,-1095,-20.79,"undercount"
"3559",34017,"New Jersey","Hudson County","API_alone",56674,61195,4521,7.67,"overcount"
"3560",34017,"New Jersey","Hudson County","API_combo",56674,65123,8449,13.87,"overcount"
"3561",34019,"New Jersey","Hunterdon County","API_alone",2947,2440,-507,-18.82,"undercount"
"3562",34019,"New Jersey","Hunterdon County","API_combo",2947,2814,-133,-4.62,"undercount"
"3563",34021,"New Jersey","Mercer County","API_alone",17636,18251,615,3.43,"overcount"
"3564",34021,"New Jersey","Mercer County","API_combo",17636,19939,2303,12.26,"overcount"
"3565",34023,"New Jersey","Middlesex County","API_alone",80691,106661,25970,27.72,"overcount"
"3566",34023,"New Jersey","Middlesex County","API_combo",80691,111394,30703,31.97,"overcount"
"3567",34025,"New Jersey","Monmouth County","API_alone",30026,25076,-4950,-17.97,"undercount"
"3568",34025,"New Jersey","Monmouth County","API_combo",30026,27733,-2293,-7.94,"undercount"
"3569",34027,"New Jersey","Morris County","API_alone",32656,30192,-2464,-7.84,"undercount"
"3570",34027,"New Jersey","Morris County","API_combo",32656,32561,-95,-0.29,"undercount"
"3571",34029,"New Jersey","Ocean County","API_alone",8400,6880,-1520,-19.9,"undercount"
"3572",34029,"New Jersey","Ocean County","API_combo",8400,8173,-227,-2.74,"undercount"
"3573",34031,"New Jersey","Passaic County","API_alone",20828,19904,-924,-4.54,"undercount"
"3574",34031,"New Jersey","Passaic County","API_combo",20828,22179,1351,6.28,"overcount"
"3575",34033,"New Jersey","Salem County","API_alone",676,436,-240,-43.17,"undercount"
"3576",34033,"New Jersey","Salem County","API_combo",676,521,-155,-25.9,"undercount"
"3577",34035,"New Jersey","Somerset County","API_alone",22498,25570,3072,12.78,"overcount"
"3578",34035,"New Jersey","Somerset County","API_combo",22498,27103,4605,18.57,"overcount"
"3579",34037,"New Jersey","Sussex County","API_alone",2473,1821,-652,-30.37,"undercount"
"3580",34037,"New Jersey","Sussex County","API_combo",2473,2231,-242,-10.29,"undercount"
"3581",34039,"New Jersey","Union County","API_alone",23436,21007,-2429,-10.93,"undercount"
"3582",34039,"New Jersey","Union County","API_combo",23436,23115,-321,-1.38,"undercount"
"3583",34041,"New Jersey","Warren County","API_alone",1489,1332,-157,-11.13,"undercount"
"3584",34041,"New Jersey","Warren County","API_combo",1489,1584,95,6.18,"overcount"
"3585",35001,"New Mexico","Bernalillo County","API_alone",13926,12304,-1622,-12.37,"undercount"
"3586",35001,"New Mexico","Bernalillo County","API_combo",13926,15685,1759,11.88,"overcount"
"3587",35003,"New Mexico","Catron County","API_alone",2,27,25,172.41,"overcount"
"3588",35003,"New Mexico","Catron County","API_combo",2,36,34,178.95,"overcount"
"3589",35005,"New Mexico","Chaves County","API_alone",575,432,-143,-28.4,"undercount"
"3590",35005,"New Mexico","Chaves County","API_combo",575,640,65,10.7,"overcount"
"3591",35006,"New Mexico","Cibola County","API_alone",149,133,-16,-11.35,"undercount"
"3592",35006,"New Mexico","Cibola County","API_combo",149,185,36,21.56,"overcount"
"3593",35007,"New Mexico","Colfax County","API_alone",59,47,-12,-22.64,"undercount"
"3594",35007,"New Mexico","Colfax County","API_combo",59,73,14,21.21,"overcount"
"3595",35009,"New Mexico","Curry County","API_alone",1587,934,-653,-51.8,"undercount"
"3596",35009,"New Mexico","Curry County","API_combo",1587,1284,-303,-21.11,"undercount"
"3597",35011,"New Mexico","De Baca County","API_alone",0,6,6,200,"overcount"
"3598",35011,"New Mexico","De Baca County","API_combo",0,9,9,200,"overcount"
"3599",35013,"New Mexico","Dona Ana County","API_alone",2358,1774,-584,-28.27,"undercount"
"3600",35013,"New Mexico","Dona Ana County","API_combo",2358,2498,140,5.77,"overcount"
"3601",35015,"New Mexico","Eddy County","API_alone",471,331,-140,-34.91,"undercount"
"3602",35015,"New Mexico","Eddy County","API_combo",471,441,-30,-6.58,"undercount"
"3603",35017,"New Mexico","Grant County","API_alone",129,130,1,0.77,"overcount"
"3604",35017,"New Mexico","Grant County","API_combo",129,199,70,42.68,"overcount"
"3605",35019,"New Mexico","Guadalupe County","API_alone",40,41,1,2.47,"overcount"
"3606",35019,"New Mexico","Guadalupe County","API_combo",40,47,7,16.09,"overcount"
"3607",35021,"New Mexico","Harding County","API_alone",1,0,-1,-200,"undercount"
"3608",35021,"New Mexico","Harding County","API_combo",1,0,-1,-200,"undercount"
"3609",35023,"New Mexico","Hidalgo County","API_alone",72,26,-46,-93.88,"undercount"
"3610",35023,"New Mexico","Hidalgo County","API_combo",72,33,-39,-74.29,"undercount"
"3611",35025,"New Mexico","Lea County","API_alone",373,283,-90,-27.44,"undercount"
"3612",35025,"New Mexico","Lea County","API_combo",373,369,-4,-1.08,"undercount"
"3613",35027,"New Mexico","Lincoln County","API_alone",66,75,9,12.77,"overcount"
"3614",35027,"New Mexico","Lincoln County","API_combo",66,106,40,46.51,"overcount"
"3615",35028,"New Mexico","Los Alamos County","API_alone",646,714,68,10,"overcount"
"3616",35028,"New Mexico","Los Alamos County","API_combo",646,833,187,25.29,"overcount"
"3617",35029,"New Mexico","Luna County","API_alone",122,106,-16,-14.04,"undercount"
"3618",35029,"New Mexico","Luna County","API_combo",122,151,29,21.25,"overcount"
"3619",35031,"New Mexico","McKinley County","API_alone",532,419,-113,-23.76,"undercount"
"3620",35031,"New Mexico","McKinley County","API_combo",532,559,27,4.95,"overcount"
"3621",35033,"New Mexico","Mora County","API_alone",31,11,-20,-95.24,"undercount"
"3622",35033,"New Mexico","Mora County","API_combo",31,15,-16,-69.57,"undercount"
"3623",35035,"New Mexico","Otero County","API_alone",1652,888,-764,-60.16,"undercount"
"3624",35035,"New Mexico","Otero County","API_combo",1652,1312,-340,-22.94,"undercount"
"3625",35037,"New Mexico","Quay County","API_alone",65,118,53,57.92,"overcount"
"3626",35037,"New Mexico","Quay County","API_combo",65,133,68,68.69,"overcount"
"3627",35039,"New Mexico","Rio Arriba County","API_alone",122,159,37,26.33,"overcount"
"3628",35039,"New Mexico","Rio Arriba County","API_combo",122,222,100,58.14,"overcount"
"3629",35041,"New Mexico","Roosevelt County","API_alone",228,138,-90,-49.18,"undercount"
"3630",35041,"New Mexico","Roosevelt County","API_combo",228,177,-51,-25.19,"undercount"
"3631",35043,"New Mexico","Sandoval County","API_alone",1293,1127,-166,-13.72,"undercount"
"3632",35043,"New Mexico","Sandoval County","API_combo",1293,1603,310,21.41,"overcount"
"3633",35045,"New Mexico","San Juan County","API_alone",513,408,-105,-22.8,"undercount"
"3634",35045,"New Mexico","San Juan County","API_combo",513,669,156,26.4,"overcount"
"3635",35047,"New Mexico","San Miguel County","API_alone",391,249,-142,-44.38,"undercount"
"3636",35047,"New Mexico","San Miguel County","API_combo",391,345,-46,-12.5,"undercount"
"3637",35049,"New Mexico","Santa Fe County","API_alone",1207,1447,240,18.09,"overcount"
"3638",35049,"New Mexico","Santa Fe County","API_combo",1207,1944,737,46.78,"overcount"
"3639",35051,"New Mexico","Sierra County","API_alone",24,34,10,34.48,"overcount"
"3640",35051,"New Mexico","Sierra County","API_combo",24,69,45,96.77,"overcount"
"3641",35053,"New Mexico","Socorro County","API_alone",358,241,-117,-39.07,"undercount"
"3642",35053,"New Mexico","Socorro County","API_combo",358,316,-42,-12.46,"undercount"
"3643",35055,"New Mexico","Taos County","API_alone",200,192,-8,-4.08,"undercount"
"3644",35055,"New Mexico","Taos County","API_combo",200,272,72,30.51,"overcount"
"3645",35057,"New Mexico","Torrance County","API_alone",66,82,16,21.62,"overcount"
"3646",35057,"New Mexico","Torrance County","API_combo",66,136,70,69.31,"overcount"
"3647",35059,"New Mexico","Union County","API_alone",5,24,19,131.03,"overcount"
"3648",35059,"New Mexico","Union County","API_combo",5,31,26,144.44,"overcount"
"3649",35061,"New Mexico","Valencia County","API_alone",659,400,-259,-48.91,"undercount"
"3650",35061,"New Mexico","Valencia County","API_combo",659,614,-45,-7.07,"undercount"
"3651",36001,"New York","Albany County","API_alone",8064,8439,375,4.54,"overcount"
"3652",36001,"New York","Albany County","API_combo",8064,9534,1470,16.71,"overcount"
"3653",36003,"New York","Allegany County","API_alone",464,373,-91,-21.74,"undercount"
"3654",36003,"New York","Allegany County","API_combo",464,450,-14,-3.06,"undercount"
"3655",36005,"New York","Bronx County","API_alone",50917,49546,-1371,-2.73,"undercount"
"3656",36005,"New York","Bronx County","API_combo",50917,56367,5450,10.16,"overcount"
"3657",36007,"New York","Broome County","API_alone",5358,5744,386,6.95,"overcount"
"3658",36007,"New York","Broome County","API_combo",5358,6390,1032,17.57,"overcount"
"3659",36009,"New York","Cattaraugus County","API_alone",574,418,-156,-31.45,"undercount"
"3660",36009,"New York","Cattaraugus County","API_combo",574,530,-44,-7.97,"undercount"
"3661",36011,"New York","Cayuga County","API_alone",558,380,-178,-37.95,"undercount"
"3662",36011,"New York","Cayuga County","API_combo",558,501,-57,-10.76,"undercount"
"3663",36013,"New York","Chautauqua County","API_alone",894,582,-312,-42.28,"undercount"
"3664",36013,"New York","Chautauqua County","API_combo",894,752,-142,-17.25,"undercount"
"3665",36015,"New York","Chemung County","API_alone",1158,749,-409,-42.89,"undercount"
"3666",36015,"New York","Chemung County","API_combo",1158,908,-250,-24.2,"undercount"
"3667",36017,"New York","Chenango County","API_alone",280,160,-120,-54.55,"undercount"
"3668",36017,"New York","Chenango County","API_combo",280,229,-51,-20.04,"undercount"
"3669",36019,"New York","Clinton County","API_alone",997,582,-415,-52.56,"undercount"
"3670",36019,"New York","Clinton County","API_combo",997,755,-242,-27.63,"undercount"
"3671",36021,"New York","Columbia County","API_alone",445,571,126,24.8,"overcount"
"3672",36021,"New York","Columbia County","API_combo",445,734,289,49.02,"overcount"
"3673",36023,"New York","Cortland County","API_alone",373,210,-163,-55.92,"undercount"
"3674",36023,"New York","Cortland County","API_combo",373,316,-57,-16.55,"undercount"
"3675",36025,"New York","Delaware County","API_alone",304,274,-30,-10.38,"undercount"
"3676",36025,"New York","Delaware County","API_combo",304,364,60,17.96,"overcount"
"3677",36027,"New York","Dutchess County","API_alone",9767,7307,-2460,-28.82,"undercount"
"3678",36027,"New York","Dutchess County","API_combo",9767,8356,-1411,-15.57,"undercount"
"3679",36029,"New York","Erie County","API_alone",15578,14396,-1182,-7.89,"undercount"
"3680",36029,"New York","Erie County","API_combo",15578,16565,987,6.14,"overcount"
"3681",36031,"New York","Essex County","API_alone",242,202,-40,-18.02,"undercount"
"3682",36031,"New York","Essex County","API_combo",242,259,17,6.79,"overcount"
"3683",36033,"New York","Franklin County","API_alone",236,199,-37,-17.01,"undercount"
"3684",36033,"New York","Franklin County","API_combo",236,262,26,10.44,"overcount"
"3685",36035,"New York","Fulton County","API_alone",385,313,-72,-20.63,"undercount"
"3686",36035,"New York","Fulton County","API_combo",385,405,20,5.06,"overcount"
"3687",36037,"New York","Genesee County","API_alone",379,332,-47,-13.22,"undercount"
"3688",36037,"New York","Genesee County","API_combo",379,412,33,8.34,"overcount"
"3689",36039,"New York","Greene County","API_alone",359,282,-77,-24.02,"undercount"
"3690",36039,"New York","Greene County","API_combo",359,399,40,10.55,"overcount"
"3691",36041,"New York","Hamilton County","API_alone",9,11,2,20,"overcount"
"3692",36041,"New York","Hamilton County","API_combo",9,14,5,43.48,"overcount"
"3693",36043,"New York","Herkimer County","API_alone",238,284,46,17.62,"overcount"
"3694",36043,"New York","Herkimer County","API_combo",238,351,113,38.37,"overcount"
"3695",36045,"New York","Jefferson County","API_alone",1663,1240,-423,-29.14,"undercount"
"3696",36045,"New York","Jefferson County","API_combo",1663,1736,73,4.3,"overcount"
"3697",36047,"New York","Kings County","API_alone",160917,199289,38372,21.31,"overcount"
"3698",36047,"New York","Kings County","API_combo",160917,215724,54807,29.1,"overcount"
"3699",36049,"New York","Lewis County","API_alone",167,78,-89,-72.65,"undercount"
"3700",36049,"New York","Lewis County","API_combo",167,104,-63,-46.49,"undercount"
"3701",36051,"New York","Livingston County","API_alone",563,525,-38,-6.99,"undercount"
"3702",36051,"New York","Livingston County","API_combo",563,646,83,13.73,"overcount"
"3703",36053,"New York","Madison County","API_alone",630,403,-227,-43.95,"undercount"
"3704",36053,"New York","Madison County","API_combo",630,538,-92,-15.75,"undercount"
"3705",36055,"New York","Monroe County","API_alone",20414,18765,-1649,-8.42,"undercount"
"3706",36055,"New York","Monroe County","API_combo",20414,21503,1089,5.2,"overcount"
"3707",36057,"New York","Montgomery County","API_alone",356,281,-75,-23.55,"undercount"
"3708",36057,"New York","Montgomery County","API_combo",356,352,-4,-1.13,"undercount"
"3709",36059,"New York","Nassau County","API_alone",65341,66053,712,1.08,"overcount"
"3710",36059,"New York","Nassau County","API_combo",65341,72271,6930,10.07,"overcount"
"3711",36061,"New York","New York County","API_alone",169637,151033,-18604,-11.6,"undercount"
"3712",36061,"New York","New York County","API_combo",169637,162381,-7256,-4.37,"undercount"
"3713",36063,"New York","Niagara County","API_alone",1355,1357,2,0.15,"overcount"
"3714",36063,"New York","Niagara County","API_combo",1355,1739,384,24.82,"overcount"
"3715",36065,"New York","Oneida County","API_alone",3258,2885,-373,-12.14,"undercount"
"3716",36065,"New York","Oneida County","API_combo",3258,3451,193,5.75,"overcount"
"3717",36067,"New York","Onondaga County","API_alone",10646,9913,-733,-7.13,"undercount"
"3718",36067,"New York","Onondaga County","API_combo",10646,11466,820,7.42,"overcount"
"3719",36069,"New York","Ontario County","API_alone",898,721,-177,-21.87,"undercount"
"3720",36069,"New York","Ontario County","API_combo",898,970,72,7.71,"overcount"
"3721",36071,"New York","Orange County","API_alone",6360,5537,-823,-13.84,"undercount"
"3722",36071,"New York","Orange County","API_combo",6360,6813,453,6.88,"overcount"
"3723",36073,"New York","Orleans County","API_alone",283,167,-116,-51.56,"undercount"
"3724",36073,"New York","Orleans County","API_combo",283,238,-45,-17.27,"undercount"
"3725",36075,"New York","Oswego County","API_alone",806,549,-257,-37.93,"undercount"
"3726",36075,"New York","Oswego County","API_combo",806,785,-21,-2.64,"undercount"
"3727",36077,"New York","Otsego County","API_alone",513,437,-76,-16,"undercount"
"3728",36077,"New York","Otsego County","API_combo",513,566,53,9.82,"overcount"
"3729",36079,"New York","Putnam County","API_alone",1429,1246,-183,-13.68,"undercount"
"3730",36079,"New York","Putnam County","API_combo",1429,1558,129,8.64,"overcount"
"3731",36081,"New York","Queens County","API_alone",352004,423599,71595,18.46,"overcount"
"3732",36081,"New York","Queens County","API_combo",352004,450922,98918,24.64,"overcount"
"3733",36083,"New York","Rensselaer County","API_alone",3128,2723,-405,-13.84,"undercount"
"3734",36083,"New York","Rensselaer County","API_combo",3128,3060,-68,-2.2,"undercount"
"3735",36085,"New York","Richmond County","API_alone",29797,26288,-3509,-12.51,"undercount"
"3736",36085,"New York","Richmond County","API_combo",29797,28529,-1268,-4.35,"undercount"
"3737",36087,"New York","Rockland County","API_alone",18646,16566,-2080,-11.81,"undercount"
"3738",36087,"New York","Rockland County","API_combo",18646,17926,-720,-3.94,"undercount"
"3739",36089,"New York","St. Lawrence County","API_alone",1280,853,-427,-40.04,"undercount"
"3740",36089,"New York","St. Lawrence County","API_combo",1280,1022,-258,-22.42,"undercount"
"3741",36091,"New York","Saratoga County","API_alone",2617,2188,-429,-17.86,"undercount"
"3742",36091,"New York","Saratoga County","API_combo",2617,2680,63,2.38,"overcount"
"3743",36093,"New York","Schenectady County","API_alone",3002,3080,78,2.56,"overcount"
"3744",36093,"New York","Schenectady County","API_combo",3002,3654,652,19.59,"overcount"
"3745",36095,"New York","Schoharie County","API_alone",180,134,-46,-29.3,"undercount"
"3746",36095,"New York","Schoharie County","API_combo",180,187,7,3.81,"overcount"
"3747",36097,"New York","Schuyler County","API_alone",73,61,-12,-17.91,"undercount"
"3748",36097,"New York","Schuyler County","API_combo",73,72,-1,-1.38,"undercount"
"3749",36099,"New York","Seneca County","API_alone",311,240,-71,-25.77,"undercount"
"3750",36099,"New York","Seneca County","API_combo",311,309,-2,-0.65,"undercount"
"3751",36101,"New York","Steuben County","API_alone",957,924,-33,-3.51,"undercount"
"3752",36101,"New York","Steuben County","API_combo",957,1033,76,7.64,"overcount"
"3753",36103,"New York","Suffolk County","API_alone",38770,37254,-1516,-3.99,"undercount"
"3754",36103,"New York","Suffolk County","API_combo",38770,42688,3918,9.62,"overcount"
"3755",36105,"New York","Sullivan County","API_alone",925,914,-11,-1.2,"undercount"
"3756",36105,"New York","Sullivan County","API_combo",925,1115,190,18.63,"overcount"
"3757",36107,"New York","Tioga County","API_alone",513,317,-196,-47.23,"undercount"
"3758",36107,"New York","Tioga County","API_combo",513,400,-113,-24.75,"undercount"
"3759",36109,"New York","Tompkins County","API_alone",7741,7111,-630,-8.48,"undercount"
"3760",36109,"New York","Tompkins County","API_combo",7741,8026,285,3.62,"overcount"
"3761",36111,"New York","Ulster County","API_alone",3160,2343,-817,-29.69,"undercount"
"3762",36111,"New York","Ulster County","API_combo",3160,2877,-283,-9.38,"undercount"
"3763",36113,"New York","Warren County","API_alone",488,364,-124,-29.11,"undercount"
"3764",36113,"New York","Warren County","API_combo",488,489,1,0.2,"overcount"
"3765",36115,"New York","Washington County","API_alone",216,197,-19,-9.2,"undercount"
"3766",36115,"New York","Washington County","API_combo",216,293,77,30.26,"overcount"
"3767",36117,"New York","Wayne County","API_alone",661,465,-196,-34.81,"undercount"
"3768",36117,"New York","Wayne County","API_combo",661,594,-67,-10.68,"undercount"
"3769",36119,"New York","Westchester County","API_alone",52982,43829,-9153,-18.91,"undercount"
"3770",36119,"New York","Westchester County","API_combo",52982,48741,-4241,-8.34,"undercount"
"3771",36121,"New York","Wyoming County","API_alone",230,203,-27,-12.47,"undercount"
"3772",36121,"New York","Wyoming County","API_combo",230,270,40,16,"overcount"
"3773",36123,"New York","Yates County","API_alone",137,73,-64,-60.95,"undercount"
"3774",36123,"New York","Yates County","API_combo",137,114,-23,-18.33,"undercount"
"3775",37001,"North Carolina","Alamance County","API_alone",987,1293,306,26.84,"overcount"
"3776",37001,"North Carolina","Alamance County","API_combo",987,1558,571,44.87,"overcount"
"3777",37003,"North Carolina","Alexander County","API_alone",111,364,253,106.53,"overcount"
"3778",37003,"North Carolina","Alexander County","API_combo",111,414,303,115.43,"overcount"
"3779",37005,"North Carolina","Alleghany County","API_alone",10,22,12,75,"overcount"
"3780",37005,"North Carolina","Alleghany County","API_combo",10,26,16,88.89,"overcount"
"3781",37007,"North Carolina","Anson County","API_alone",44,161,117,114.15,"overcount"
"3782",37007,"North Carolina","Anson County","API_combo",44,181,137,121.78,"overcount"
"3783",37009,"North Carolina","Ashe County","API_alone",63,60,-3,-4.88,"undercount"
"3784",37009,"North Carolina","Ashe County","API_combo",63,73,10,14.71,"overcount"
"3785",37011,"North Carolina","Avery County","API_alone",41,42,1,2.41,"overcount"
"3786",37011,"North Carolina","Avery County","API_combo",41,63,22,42.31,"overcount"
"3787",37013,"North Carolina","Beaufort County","API_alone",96,126,30,27.03,"overcount"
"3788",37013,"North Carolina","Beaufort County","API_combo",96,171,75,56.18,"overcount"
"3789",37015,"North Carolina","Bertie County","API_alone",28,26,-2,-7.41,"undercount"
"3790",37015,"North Carolina","Bertie County","API_combo",28,40,12,35.29,"overcount"
"3791",37017,"North Carolina","Bladen County","API_alone",62,53,-9,-15.65,"undercount"
"3792",37017,"North Carolina","Bladen County","API_combo",62,94,32,41.03,"overcount"
"3793",37019,"North Carolina","Brunswick County","API_alone",221,242,21,9.07,"overcount"
"3794",37019,"North Carolina","Brunswick County","API_combo",221,337,116,41.58,"overcount"
"3795",37021,"North Carolina","Buncombe County","API_alone",1574,1490,-84,-5.48,"undercount"
"3796",37021,"North Carolina","Buncombe County","API_combo",1574,1946,372,21.14,"overcount"
"3797",37023,"North Carolina","Burke County","API_alone",1595,3508,1913,74.98,"overcount"
"3798",37023,"North Carolina","Burke County","API_combo",1595,3738,2143,80.37,"overcount"
"3799",37025,"North Carolina","Cabarrus County","API_alone",855,1319,464,42.69,"overcount"
"3800",37025,"North Carolina","Cabarrus County","API_combo",855,1547,692,57.62,"overcount"
"3801",37027,"North Carolina","Caldwell County","API_alone",231,347,116,40.14,"overcount"
"3802",37027,"North Carolina","Caldwell County","API_combo",231,414,183,56.74,"overcount"
"3803",37029,"North Carolina","Camden County","API_alone",19,41,22,73.33,"overcount"
"3804",37029,"North Carolina","Camden County","API_combo",19,48,29,86.57,"overcount"
"3805",37031,"North Carolina","Carteret County","API_alone",616,388,-228,-45.42,"undercount"
"3806",37031,"North Carolina","Carteret County","API_combo",616,574,-42,-7.06,"undercount"
"3807",37033,"North Carolina","Caswell County","API_alone",36,50,14,32.56,"overcount"
"3808",37033,"North Carolina","Caswell County","API_combo",36,93,57,88.37,"overcount"
"3809",37035,"North Carolina","Catawba County","API_alone",1732,4399,2667,87,"overcount"
"3810",37035,"North Carolina","Catawba County","API_combo",1732,4797,3065,93.89,"overcount"
"3811",37037,"North Carolina","Chatham County","API_alone",196,337,141,52.91,"overcount"
"3812",37037,"North Carolina","Chatham County","API_combo",196,414,218,71.48,"overcount"
"3813",37039,"North Carolina","Cherokee County","API_alone",89,72,-17,-21.12,"undercount"
"3814",37039,"North Carolina","Cherokee County","API_combo",89,105,16,16.49,"overcount"
"3815",37041,"North Carolina","Chowan County","API_alone",58,53,-5,-9.01,"undercount"
"3816",37041,"North Carolina","Chowan County","API_combo",58,69,11,17.32,"overcount"
"3817",37043,"North Carolina","Clay County","API_alone",15,14,-1,-6.9,"undercount"
"3818",37043,"North Carolina","Clay County","API_combo",15,27,12,57.14,"overcount"
"3819",37045,"North Carolina","Cleveland County","API_alone",808,712,-96,-12.63,"undercount"
"3820",37045,"North Carolina","Cleveland County","API_combo",808,854,46,5.54,"overcount"
"3821",37047,"North Carolina","Columbus County","API_alone",101,142,41,33.74,"overcount"
"3822",37047,"North Carolina","Columbus County","API_combo",101,213,112,71.34,"overcount"
"3823",37049,"North Carolina","Craven County","API_alone",1435,1010,-425,-34.76,"undercount"
"3824",37049,"North Carolina","Craven County","API_combo",1435,1485,50,3.42,"overcount"
"3825",37051,"North Carolina","Cumberland County","API_alone",10741,6949,-3792,-42.87,"undercount"
"3826",37051,"North Carolina","Cumberland County","API_combo",10741,9922,-819,-7.93,"undercount"
"3827",37053,"North Carolina","Currituck County","API_alone",134,80,-54,-50.47,"undercount"
"3828",37053,"North Carolina","Currituck County","API_combo",134,124,-10,-7.75,"undercount"
"3829",37055,"North Carolina","Dare County","API_alone",184,126,-58,-37.42,"undercount"
"3830",37055,"North Carolina","Dare County","API_combo",184,181,-3,-1.64,"undercount"
"3831",37057,"North Carolina","Davidson County","API_alone",958,1394,436,37.07,"overcount"
"3832",37057,"North Carolina","Davidson County","API_combo",958,1631,673,51.99,"overcount"
"3833",37059,"North Carolina","Davie County","API_alone",112,119,7,6.06,"overcount"
"3834",37059,"North Carolina","Davie County","API_combo",112,188,76,50.67,"overcount"
"3835",37061,"North Carolina","Duplin County","API_alone",103,136,33,27.62,"overcount"
"3836",37061,"North Carolina","Duplin County","API_combo",103,185,82,56.94,"overcount"
"3837",37063,"North Carolina","Durham County","API_alone",6155,7688,1533,22.15,"overcount"
"3838",37063,"North Carolina","Durham County","API_combo",6155,8670,2515,33.93,"overcount"
"3839",37065,"North Carolina","Edgecombe County","API_alone",123,111,-12,-10.26,"undercount"
"3840",37065,"North Carolina","Edgecombe County","API_combo",123,152,29,21.09,"overcount"
"3841",37067,"North Carolina","Forsyth County","API_alone",3259,3435,176,5.26,"overcount"
"3842",37067,"North Carolina","Forsyth County","API_combo",3259,4206,947,25.37,"overcount"
"3843",37069,"North Carolina","Franklin County","API_alone",163,176,13,7.67,"overcount"
"3844",37069,"North Carolina","Franklin County","API_combo",163,271,108,49.77,"overcount"
"3845",37071,"North Carolina","Gaston County","API_alone",1766,1948,182,9.8,"overcount"
"3846",37071,"North Carolina","Gaston County","API_combo",1766,2269,503,24.93,"overcount"
"3847",37073,"North Carolina","Gates County","API_alone",24,29,5,18.87,"overcount"
"3848",37073,"North Carolina","Gates County","API_combo",24,60,36,85.71,"overcount"
"3849",37075,"North Carolina","Graham County","API_alone",17,14,-3,-19.35,"undercount"
"3850",37075,"North Carolina","Graham County","API_combo",17,19,2,11.11,"overcount"
"3851",37077,"North Carolina","Granville County","API_alone",213,203,-10,-4.81,"undercount"
"3852",37077,"North Carolina","Granville County","API_combo",213,306,93,35.84,"overcount"
"3853",37079,"North Carolina","Greene County","API_alone",18,20,2,10.53,"overcount"
"3854",37079,"North Carolina","Greene County","API_combo",18,63,45,111.11,"overcount"
"3855",37081,"North Carolina","Guilford County","API_alone",7512,10986,3474,37.56,"overcount"
"3856",37081,"North Carolina","Guilford County","API_combo",7512,12268,4756,48.09,"overcount"
"3857",37083,"North Carolina","Halifax County","API_alone",254,326,72,24.83,"overcount"
"3858",37083,"North Carolina","Halifax County","API_combo",254,412,158,47.45,"overcount"
"3859",37085,"North Carolina","Harnett County","API_alone",688,694,6,0.87,"overcount"
"3860",37085,"North Carolina","Harnett County","API_combo",688,1016,328,38.5,"overcount"
"3861",37087,"North Carolina","Haywood County","API_alone",132,140,8,5.88,"overcount"
"3862",37087,"North Carolina","Haywood County","API_combo",132,210,78,45.61,"overcount"
"3863",37089,"North Carolina","Henderson County","API_alone",638,580,-58,-9.52,"undercount"
"3864",37089,"North Carolina","Henderson County","API_combo",638,785,147,20.66,"overcount"
"3865",37091,"North Carolina","Hertford County","API_alone",118,90,-28,-26.92,"undercount"
"3866",37091,"North Carolina","Hertford County","API_combo",118,127,9,7.35,"overcount"
"3867",37093,"North Carolina","Hoke County","API_alone",217,348,131,46.37,"overcount"
"3868",37093,"North Carolina","Hoke County","API_combo",217,546,329,86.24,"overcount"
"3869",37095,"North Carolina","Hyde County","API_alone",3,25,22,157.14,"overcount"
"3870",37095,"North Carolina","Hyde County","API_combo",3,32,29,165.71,"overcount"
"3871",37097,"North Carolina","Iredell County","API_alone",827,1644,817,66.13,"overcount"
"3872",37097,"North Carolina","Iredell County","API_combo",827,1852,1025,76.52,"overcount"
"3873",37099,"North Carolina","Jackson County","API_alone",204,181,-23,-11.95,"undercount"
"3874",37099,"North Carolina","Jackson County","API_combo",204,223,19,8.9,"overcount"
"3875",37101,"North Carolina","Johnston County","API_alone",437,467,30,6.64,"overcount"
"3876",37101,"North Carolina","Johnston County","API_combo",437,630,193,36.18,"overcount"
"3877",37103,"North Carolina","Jones County","API_alone",24,25,1,4.08,"overcount"
"3878",37103,"North Carolina","Jones County","API_combo",24,62,38,88.37,"overcount"
"3879",37105,"North Carolina","Lee County","API_alone",457,399,-58,-13.55,"undercount"
"3880",37105,"North Carolina","Lee County","API_combo",457,483,26,5.53,"overcount"
"3881",37107,"North Carolina","Lenoir County","API_alone",295,245,-50,-18.52,"undercount"
"3882",37107,"North Carolina","Lenoir County","API_combo",295,326,31,9.98,"overcount"
"3883",37109,"North Carolina","Lincoln County","API_alone",403,226,-177,-56.28,"undercount"
"3884",37109,"North Carolina","Lincoln County","API_combo",403,310,-93,-26.09,"undercount"
"3885",37111,"North Carolina","McDowell County","API_alone",417,425,8,1.9,"overcount"
"3886",37111,"North Carolina","McDowell County","API_combo",417,491,74,16.3,"overcount"
"3887",37113,"North Carolina","Macon County","API_alone",145,130,-15,-10.91,"undercount"
"3888",37113,"North Carolina","Macon County","API_combo",145,159,14,9.21,"overcount"
"3889",37115,"North Carolina","Madison County","API_alone",72,47,-25,-42.02,"undercount"
"3890",37115,"North Carolina","Madison County","API_combo",72,68,-4,-5.71,"undercount"
"3891",37117,"North Carolina","Martin County","API_alone",86,74,-12,-15,"undercount"
"3892",37117,"North Carolina","Martin County","API_combo",86,96,10,10.99,"overcount"
"3893",37119,"North Carolina","Mecklenburg County","API_alone",19065,22976,3911,18.61,"overcount"
"3894",37119,"North Carolina","Mecklenburg County","API_combo",19065,25343,6278,28.27,"overcount"
"3895",37121,"North Carolina","Mitchell County","API_alone",41,34,-7,-18.67,"undercount"
"3896",37121,"North Carolina","Mitchell County","API_combo",41,46,5,11.49,"overcount"
"3897",37123,"North Carolina","Montgomery County","API_alone",306,480,174,44.27,"overcount"
"3898",37123,"North Carolina","Montgomery County","API_combo",306,537,231,54.8,"overcount"
"3899",37125,"North Carolina","Moore County","API_alone",347,405,58,15.43,"overcount"
"3900",37125,"North Carolina","Moore County","API_combo",347,535,188,42.63,"overcount"
"3901",37127,"North Carolina","Nash County","API_alone",489,549,60,11.56,"overcount"
"3902",37127,"North Carolina","Nash County","API_combo",489,743,254,41.23,"overcount"
"3903",37129,"North Carolina","New Hanover County","API_alone",1424,1452,28,1.95,"overcount"
"3904",37129,"North Carolina","New Hanover County","API_combo",1424,1837,413,25.33,"overcount"
"3905",37131,"North Carolina","Northampton County","API_alone",32,32,0,0,"equal"
"3906",37131,"North Carolina","Northampton County","API_combo",32,48,16,40,"overcount"
"3907",37133,"North Carolina","Onslow County","API_alone",5271,2984,-2287,-55.41,"undercount"
"3908",37133,"North Carolina","Onslow County","API_combo",5271,4593,-678,-13.75,"undercount"
"3909",37135,"North Carolina","Orange County","API_alone",4793,4931,138,2.84,"overcount"
"3910",37135,"North Carolina","Orange County","API_combo",4793,5569,776,14.98,"overcount"
"3911",37137,"North Carolina","Pamlico County","API_alone",37,53,16,35.56,"overcount"
"3912",37137,"North Carolina","Pamlico County","API_combo",37,67,30,57.69,"overcount"
"3913",37139,"North Carolina","Pasquotank County","API_alone",386,319,-67,-19.01,"undercount"
"3914",37139,"North Carolina","Pasquotank County","API_combo",386,435,49,11.94,"overcount"
"3915",37141,"North Carolina","Pender County","API_alone",124,89,-35,-32.86,"undercount"
"3916",37141,"North Carolina","Pender County","API_combo",124,142,18,13.53,"overcount"
"3917",37143,"North Carolina","Perquimans County","API_alone",36,29,-7,-21.54,"undercount"
"3918",37143,"North Carolina","Perquimans County","API_combo",36,38,2,5.41,"overcount"
"3919",37145,"North Carolina","Person County","API_alone",33,58,25,54.95,"overcount"
"3920",37145,"North Carolina","Person County","API_combo",33,86,53,89.08,"overcount"
"3921",37147,"North Carolina","Pitt County","API_alone",1552,1548,-4,-0.26,"undercount"
"3922",37147,"North Carolina","Pitt County","API_combo",1552,1893,341,19.8,"overcount"
"3923",37149,"North Carolina","Polk County","API_alone",62,49,-13,-23.42,"undercount"
"3924",37149,"North Carolina","Polk County","API_combo",62,70,8,12.12,"overcount"
"3925",37151,"North Carolina","Randolph County","API_alone",783,934,151,17.59,"overcount"
"3926",37151,"North Carolina","Randolph County","API_combo",783,1135,352,36.7,"overcount"
"3927",37153,"North Carolina","Richmond County","API_alone",359,342,-17,-4.85,"undercount"
"3928",37153,"North Carolina","Richmond County","API_combo",359,434,75,18.92,"overcount"
"3929",37155,"North Carolina","Robeson County","API_alone",466,534,68,13.6,"overcount"
"3930",37155,"North Carolina","Robeson County","API_combo",466,807,341,53.57,"overcount"
"3931",37157,"North Carolina","Rockingham County","API_alone",360,317,-43,-12.7,"undercount"
"3932",37157,"North Carolina","Rockingham County","API_combo",360,434,74,18.64,"overcount"
"3933",37159,"North Carolina","Rowan County","API_alone",950,1205,255,23.67,"overcount"
"3934",37159,"North Carolina","Rowan County","API_combo",950,1432,482,40.47,"overcount"
"3935",37161,"North Carolina","Rutherford County","API_alone",188,229,41,19.66,"overcount"
"3936",37161,"North Carolina","Rutherford County","API_combo",188,330,142,54.83,"overcount"
"3937",37163,"North Carolina","Sampson County","API_alone",164,344,180,70.87,"overcount"
"3938",37163,"North Carolina","Sampson County","API_combo",164,427,263,89,"overcount"
"3939",37165,"North Carolina","Scotland County","API_alone",152,192,40,23.26,"overcount"
"3940",37165,"North Carolina","Scotland County","API_combo",152,241,89,45.29,"overcount"
"3941",37167,"North Carolina","Stanly County","API_alone",487,1119,632,78.7,"overcount"
"3942",37167,"North Carolina","Stanly County","API_combo",487,1213,726,85.41,"overcount"
"3943",37169,"North Carolina","Stokes County","API_alone",187,115,-72,-47.68,"undercount"
"3944",37169,"North Carolina","Stokes County","API_combo",187,139,-48,-29.45,"undercount"
"3945",37171,"North Carolina","Surry County","API_alone",200,476,276,81.66,"overcount"
"3946",37171,"North Carolina","Surry County","API_combo",200,515,315,88.11,"overcount"
"3947",37173,"North Carolina","Swain County","API_alone",64,26,-38,-84.44,"undercount"
"3948",37173,"North Carolina","Swain County","API_combo",64,40,-24,-46.15,"undercount"
"3949",37175,"North Carolina","Transylvania County","API_alone",157,123,-34,-24.29,"undercount"
"3950",37175,"North Carolina","Transylvania County","API_combo",157,170,13,7.95,"overcount"
"3951",37177,"North Carolina","Tyrrell County","API_alone",11,53,42,131.25,"overcount"
"3952",37177,"North Carolina","Tyrrell County","API_combo",11,62,51,139.73,"overcount"
"3953",37179,"North Carolina","Union County","API_alone",633,824,191,26.22,"overcount"
"3954",37179,"North Carolina","Union County","API_combo",633,1050,417,49.55,"overcount"
"3955",37181,"North Carolina","Vance County","API_alone",115,200,85,53.97,"overcount"
"3956",37181,"North Carolina","Vance County","API_combo",115,270,155,80.52,"overcount"
"3957",37183,"North Carolina","Wake County","API_alone",20319,21934,1615,7.64,"overcount"
"3958",37183,"North Carolina","Wake County","API_combo",20319,24734,4415,19.6,"overcount"
"3959",37185,"North Carolina","Warren County","API_alone",25,31,6,21.43,"overcount"
"3960",37185,"North Carolina","Warren County","API_combo",25,51,26,68.42,"overcount"
"3961",37187,"North Carolina","Washington County","API_alone",57,50,-7,-13.08,"undercount"
"3962",37187,"North Carolina","Washington County","API_combo",57,85,28,39.44,"overcount"
"3963",37189,"North Carolina","Watauga County","API_alone",303,276,-27,-9.33,"undercount"
"3964",37189,"North Carolina","Watauga County","API_combo",303,327,24,7.62,"overcount"
"3965",37191,"North Carolina","Wayne County","API_alone",1582,1215,-367,-26.24,"undercount"
"3966",37191,"North Carolina","Wayne County","API_combo",1582,1606,24,1.51,"overcount"
"3967",37193,"North Carolina","Wilkes County","API_alone",193,252,59,26.52,"overcount"
"3968",37193,"North Carolina","Wilkes County","API_combo",193,311,118,46.83,"overcount"
"3969",37195,"North Carolina","Wilson County","API_alone",329,351,22,6.47,"overcount"
"3970",37195,"North Carolina","Wilson County","API_combo",329,493,164,39.9,"overcount"
"3971",37197,"North Carolina","Yadkin County","API_alone",58,92,34,45.33,"overcount"
"3972",37197,"North Carolina","Yadkin County","API_combo",58,134,76,79.17,"overcount"
"3973",37199,"North Carolina","Yancey County","API_alone",24,27,3,11.76,"overcount"
"3974",37199,"North Carolina","Yancey County","API_combo",24,43,19,56.72,"overcount"
"3975",38001,"North Dakota","Adams County","API_alone",0,6,6,200,"overcount"
"3976",38001,"North Dakota","Adams County","API_combo",0,7,7,200,"overcount"
"3977",38003,"North Dakota","Barnes County","API_alone",61,22,-39,-93.98,"undercount"
"3978",38003,"North Dakota","Barnes County","API_combo",61,35,-26,-54.17,"undercount"
"3979",38005,"North Dakota","Benson County","API_alone",6,2,-4,-100,"undercount"
"3980",38005,"North Dakota","Benson County","API_combo",6,3,-3,-66.67,"undercount"
"3981",38007,"North Dakota","Billings County","API_alone",4,1,-3,-120,"undercount"
"3982",38007,"North Dakota","Billings County","API_combo",4,2,-2,-66.67,"undercount"
"3983",38009,"North Dakota","Bottineau County","API_alone",17,14,-3,-19.35,"undercount"
"3984",38009,"North Dakota","Bottineau County","API_combo",17,22,5,25.64,"overcount"
"3985",38011,"North Dakota","Bowman County","API_alone",4,1,-3,-120,"undercount"
"3986",38011,"North Dakota","Bowman County","API_combo",4,9,5,76.92,"overcount"
"3987",38013,"North Dakota","Burke County","API_alone",8,3,-5,-90.91,"undercount"
"3988",38013,"North Dakota","Burke County","API_combo",8,6,-2,-28.57,"undercount"
"3989",38015,"North Dakota","Burleigh County","API_alone",418,305,-113,-31.26,"undercount"
"3990",38015,"North Dakota","Burleigh County","API_combo",418,417,-1,-0.24,"undercount"
"3991",38017,"North Dakota","Cass County","API_alone",1758,1613,-145,-8.6,"undercount"
"3992",38017,"North Dakota","Cass County","API_combo",1758,2038,280,14.75,"overcount"
"3993",38019,"North Dakota","Cavalier County","API_alone",4,5,1,22.22,"overcount"
"3994",38019,"North Dakota","Cavalier County","API_combo",4,11,7,93.33,"overcount"
"3995",38021,"North Dakota","Dickey County","API_alone",20,29,9,36.73,"overcount"
"3996",38021,"North Dakota","Dickey County","API_combo",20,41,21,68.85,"overcount"
"3997",38023,"North Dakota","Divide County","API_alone",8,12,4,40,"overcount"
"3998",38023,"North Dakota","Divide County","API_combo",8,12,4,40,"overcount"
"3999",38025,"North Dakota","Dunn County","API_alone",17,3,-14,-140,"undercount"
"4000",38025,"North Dakota","Dunn County","API_combo",17,4,-13,-123.81,"undercount"
"4001",38027,"North Dakota","Eddy County","API_alone",1,6,5,142.86,"overcount"
"4002",38027,"North Dakota","Eddy County","API_combo",1,6,5,142.86,"overcount"
"4003",38029,"North Dakota","Emmons County","API_alone",4,15,11,115.79,"overcount"
"4004",38029,"North Dakota","Emmons County","API_combo",4,16,12,120,"overcount"
"4005",38031,"North Dakota","Foster County","API_alone",2,0,-2,-200,"undercount"
"4006",38031,"North Dakota","Foster County","API_combo",2,0,-2,-200,"undercount"
"4007",38033,"North Dakota","Golden Valley County","API_alone",10,2,-8,-133.33,"undercount"
"4008",38033,"North Dakota","Golden Valley County","API_combo",10,3,-7,-107.69,"undercount"
"4009",38035,"North Dakota","Grand Forks County","API_alone",1263,694,-569,-58.15,"undercount"
"4010",38035,"North Dakota","Grand Forks County","API_combo",1263,1027,-236,-20.61,"undercount"
"4011",38037,"North Dakota","Grant County","API_alone",7,10,3,35.29,"overcount"
"4012",38037,"North Dakota","Grant County","API_combo",7,15,8,72.73,"overcount"
"4013",38039,"North Dakota","Griggs County","API_alone",7,4,-3,-54.55,"undercount"
"4014",38039,"North Dakota","Griggs County","API_combo",7,4,-3,-54.55,"undercount"
"4015",38041,"North Dakota","Hettinger County","API_alone",8,4,-4,-66.67,"undercount"
"4016",38041,"North Dakota","Hettinger County","API_combo",8,6,-2,-28.57,"undercount"
"4017",38043,"North Dakota","Kidder County","API_alone",4,2,-2,-66.67,"undercount"
"4018",38043,"North Dakota","Kidder County","API_combo",4,5,1,22.22,"overcount"
"4019",38045,"North Dakota","LaMoure County","API_alone",2,6,4,100,"overcount"
"4020",38045,"North Dakota","LaMoure County","API_combo",2,7,5,111.11,"overcount"
"4021",38047,"North Dakota","Logan County","API_alone",6,4,-2,-40,"undercount"
"4022",38047,"North Dakota","Logan County","API_combo",6,8,2,28.57,"overcount"
"4023",38049,"North Dakota","McHenry County","API_alone",15,4,-11,-115.79,"undercount"
"4024",38049,"North Dakota","McHenry County","API_combo",15,13,-2,-14.29,"undercount"
"4025",38051,"North Dakota","McIntosh County","API_alone",5,11,6,75,"overcount"
"4026",38051,"North Dakota","McIntosh County","API_combo",5,16,11,104.76,"overcount"
"4027",38053,"North Dakota","McKenzie County","API_alone",5,4,-1,-22.22,"undercount"
"4028",38053,"North Dakota","McKenzie County","API_combo",5,11,6,75,"overcount"
"4029",38055,"North Dakota","McLean County","API_alone",16,12,-4,-28.57,"undercount"
"4030",38055,"North Dakota","McLean County","API_combo",16,16,0,0,"equal"
"4031",38057,"North Dakota","Mercer County","API_alone",73,55,-18,-28.12,"undercount"
"4032",38057,"North Dakota","Mercer County","API_combo",73,67,-6,-8.57,"undercount"
"4033",38059,"North Dakota","Morton County","API_alone",86,81,-5,-5.99,"undercount"
"4034",38059,"North Dakota","Morton County","API_combo",86,125,39,36.97,"overcount"
"4035",38061,"North Dakota","Mountrail County","API_alone",18,17,-1,-5.71,"undercount"
"4036",38061,"North Dakota","Mountrail County","API_combo",18,24,6,28.57,"overcount"
"4037",38063,"North Dakota","Nelson County","API_alone",3,11,8,114.29,"overcount"
"4038",38063,"North Dakota","Nelson County","API_combo",3,15,12,133.33,"overcount"
"4039",38065,"North Dakota","Oliver County","API_alone",0,2,2,200,"overcount"
"4040",38065,"North Dakota","Oliver County","API_combo",0,3,3,200,"overcount"
"4041",38067,"North Dakota","Pembina County","API_alone",15,21,6,33.33,"overcount"
"4042",38067,"North Dakota","Pembina County","API_combo",15,28,13,60.47,"overcount"
"4043",38069,"North Dakota","Pierce County","API_alone",19,12,-7,-45.16,"undercount"
"4044",38069,"North Dakota","Pierce County","API_combo",19,17,-2,-11.11,"undercount"
"4045",38071,"North Dakota","Ramsey County","API_alone",45,34,-11,-27.85,"undercount"
"4046",38071,"North Dakota","Ramsey County","API_combo",45,47,2,4.35,"overcount"
"4047",38073,"North Dakota","Ransom County","API_alone",14,15,1,6.9,"overcount"
"4048",38073,"North Dakota","Ransom County","API_combo",14,21,7,40,"overcount"
"4049",38075,"North Dakota","Renville County","API_alone",17,12,-5,-34.48,"undercount"
"4050",38075,"North Dakota","Renville County","API_combo",17,17,0,0,"equal"
"4051",38077,"North Dakota","Richland County","API_alone",142,54,-88,-89.8,"undercount"
"4052",38077,"North Dakota","Richland County","API_combo",142,85,-57,-50.22,"undercount"
"4053",38079,"North Dakota","Rolette County","API_alone",20,10,-10,-66.67,"undercount"
"4054",38079,"North Dakota","Rolette County","API_combo",20,18,-2,-10.53,"undercount"
"4055",38081,"North Dakota","Sargent County","API_alone",7,4,-3,-54.55,"undercount"
"4056",38081,"North Dakota","Sargent County","API_combo",7,9,2,25,"overcount"
"4057",38083,"North Dakota","Sheridan County","API_alone",0,0,0,0,"equal"
"4058",38083,"North Dakota","Sheridan County","API_combo",0,1,1,200,"overcount"
"4059",38085,"North Dakota","Sioux County","API_alone",25,3,-22,-157.14,"undercount"
"4060",38085,"North Dakota","Sioux County","API_combo",25,9,-16,-94.12,"undercount"
"4061",38087,"North Dakota","Slope County","API_alone",16,0,-16,-200,"undercount"
"4062",38087,"North Dakota","Slope County","API_combo",16,0,-16,-200,"undercount"
"4063",38089,"North Dakota","Stark County","API_alone",158,58,-100,-92.59,"undercount"
"4064",38089,"North Dakota","Stark County","API_combo",158,87,-71,-57.96,"undercount"
"4065",38091,"North Dakota","Steele County","API_alone",3,1,-2,-100,"undercount"
"4066",38091,"North Dakota","Steele County","API_combo",3,1,-2,-100,"undercount"
"4067",38093,"North Dakota","Stutsman County","API_alone",148,92,-56,-46.67,"undercount"
"4068",38093,"North Dakota","Stutsman County","API_combo",148,121,-27,-20.07,"undercount"
"4069",38095,"North Dakota","Towner County","API_alone",7,2,-5,-111.11,"undercount"
"4070",38095,"North Dakota","Towner County","API_combo",7,3,-4,-80,"undercount"
"4071",38097,"North Dakota","Traill County","API_alone",36,14,-22,-88,"undercount"
"4072",38097,"North Dakota","Traill County","API_combo",36,17,-19,-71.7,"undercount"
"4073",38099,"North Dakota","Walsh County","API_alone",99,36,-63,-93.33,"undercount"
"4074",38099,"North Dakota","Walsh County","API_combo",99,59,-40,-50.63,"undercount"
"4075",38101,"North Dakota","Ward County","API_alone",984,533,-451,-59.46,"undercount"
"4076",38101,"North Dakota","Ward County","API_combo",984,848,-136,-14.85,"undercount"
"4077",38103,"North Dakota","Wells County","API_alone",3,12,9,120,"overcount"
"4078",38103,"North Dakota","Wells County","API_combo",3,13,10,125,"overcount"
"4079",38105,"North Dakota","Williams County","API_alone",69,39,-30,-55.56,"undercount"
"4080",38105,"North Dakota","Williams County","API_combo",69,67,-2,-2.94,"undercount"
"4081",39001,"Ohio","Adams County","API_alone",60,43,-17,-33.01,"undercount"
"4082",39001,"Ohio","Adams County","API_combo",60,68,8,12.5,"overcount"
"4083",39003,"Ohio","Allen County","API_alone",831,639,-192,-26.12,"undercount"
"4084",39003,"Ohio","Allen County","API_combo",831,818,-13,-1.58,"undercount"
"4085",39005,"Ohio","Ashland County","API_alone",443,302,-141,-37.85,"undercount"
"4086",39005,"Ohio","Ashland County","API_combo",443,385,-58,-14.01,"undercount"
"4087",39007,"Ohio","Ashtabula County","API_alone",583,392,-191,-39.18,"undercount"
"4088",39007,"Ohio","Ashtabula County","API_combo",583,555,-28,-4.92,"undercount"
"4089",39009,"Ohio","Athens County","API_alone",1895,1226,-669,-42.87,"undercount"
"4090",39009,"Ohio","Athens County","API_combo",1895,1435,-460,-27.63,"undercount"
"4091",39011,"Ohio","Auglaize County","API_alone",271,203,-68,-28.69,"undercount"
"4092",39011,"Ohio","Auglaize County","API_combo",271,265,-6,-2.24,"undercount"
"4093",39013,"Ohio","Belmont County","API_alone",200,233,33,15.24,"overcount"
"4094",39013,"Ohio","Belmont County","API_combo",200,334,134,50.19,"overcount"
"4095",39015,"Ohio","Brown County","API_alone",62,61,-1,-1.63,"undercount"
"4096",39015,"Ohio","Brown County","API_combo",62,89,27,35.76,"overcount"
"4097",39017,"Ohio","Butler County","API_alone",4458,5368,910,18.52,"overcount"
"4098",39017,"Ohio","Butler County","API_combo",4458,6233,1775,33.21,"overcount"
"4099",39019,"Ohio","Carroll County","API_alone",47,41,-6,-13.64,"undercount"
"4100",39019,"Ohio","Carroll County","API_combo",47,63,16,29.09,"overcount"
"4101",39021,"Ohio","Champaign County","API_alone",177,108,-69,-48.42,"undercount"
"4102",39021,"Ohio","Champaign County","API_combo",177,154,-23,-13.9,"undercount"
"4103",39023,"Ohio","Clark County","API_alone",933,816,-117,-13.38,"undercount"
"4104",39023,"Ohio","Clark County","API_combo",933,1169,236,22.45,"overcount"
"4105",39025,"Ohio","Clermont County","API_alone",815,1184,369,36.92,"overcount"
"4106",39025,"Ohio","Clermont County","API_combo",815,1537,722,61.39,"overcount"
"4107",39027,"Ohio","Clinton County","API_alone",234,155,-79,-40.62,"undercount"
"4108",39027,"Ohio","Clinton County","API_combo",234,228,-6,-2.6,"undercount"
"4109",39029,"Ohio","Columbiana County","API_alone",351,292,-59,-18.35,"undercount"
"4110",39029,"Ohio","Columbiana County","API_combo",351,422,71,18.37,"overcount"
"4111",39031,"Ohio","Coshocton County","API_alone",172,131,-41,-27.06,"undercount"
"4112",39031,"Ohio","Coshocton County","API_combo",172,162,-10,-5.99,"undercount"
"4113",39033,"Ohio","Crawford County","API_alone",169,155,-14,-8.64,"undercount"
"4114",39033,"Ohio","Crawford County","API_combo",169,204,35,18.77,"overcount"
"4115",39035,"Ohio","Cuyahoga County","API_alone",25705,26258,553,2.13,"overcount"
"4116",39035,"Ohio","Cuyahoga County","API_combo",25705,30811,5106,18.07,"overcount"
"4117",39037,"Ohio","Darke County","API_alone",165,144,-21,-13.59,"undercount"
"4118",39037,"Ohio","Darke County","API_combo",165,216,51,26.77,"overcount"
"4119",39039,"Ohio","Defiance County","API_alone",185,157,-28,-16.37,"undercount"
"4120",39039,"Ohio","Defiance County","API_combo",185,194,9,4.75,"overcount"
"4121",39041,"Ohio","Delaware County","API_alone",776,1753,977,77.26,"overcount"
"4122",39041,"Ohio","Delaware County","API_combo",776,2092,1316,91.77,"overcount"
"4123",39043,"Ohio","Erie County","API_alone",390,313,-77,-21.91,"undercount"
"4124",39043,"Ohio","Erie County","API_combo",390,433,43,10.45,"overcount"
"4125",39045,"Ohio","Fairfield County","API_alone",705,938,233,28.36,"overcount"
"4126",39045,"Ohio","Fairfield County","API_combo",705,1223,518,53.73,"overcount"
"4127",39047,"Ohio","Fayette County","API_alone",160,135,-25,-16.95,"undercount"
"4128",39047,"Ohio","Fayette County","API_combo",160,199,39,21.73,"overcount"
"4129",39049,"Ohio","Franklin County","API_alone",29629,34060,4431,13.91,"overcount"
"4130",39049,"Ohio","Franklin County","API_combo",29629,38976,9347,27.25,"overcount"
"4131",39051,"Ohio","Fulton County","API_alone",232,205,-27,-12.36,"undercount"
"4132",39051,"Ohio","Fulton County","API_combo",232,259,27,11,"overcount"
"4133",39053,"Ohio","Gallia County","API_alone",211,110,-101,-62.93,"undercount"
"4134",39053,"Ohio","Gallia County","API_combo",211,140,-71,-40.46,"undercount"
"4135",39055,"Ohio","Geauga County","API_alone",530,401,-129,-27.71,"undercount"
"4136",39055,"Ohio","Geauga County","API_combo",530,599,69,12.22,"overcount"
"4137",39057,"Ohio","Greene County","API_alone",3405,3079,-326,-10.06,"undercount"
"4138",39057,"Ohio","Greene County","API_combo",3405,3794,389,10.81,"overcount"
"4139",39059,"Ohio","Guernsey County","API_alone",227,127,-100,-56.5,"undercount"
"4140",39059,"Ohio","Guernsey County","API_combo",227,193,-34,-16.19,"undercount"
"4141",39061,"Ohio","Hamilton County","API_alone",12891,14136,1245,9.21,"overcount"
"4142",39061,"Ohio","Hamilton County","API_combo",12891,16507,3616,24.6,"overcount"
"4143",39063,"Ohio","Hancock County","API_alone",665,903,238,30.36,"overcount"
"4144",39063,"Ohio","Hancock County","API_combo",665,1056,391,45.44,"overcount"
"4145",39065,"Ohio","Hardin County","API_alone",155,145,-10,-6.67,"undercount"
"4146",39065,"Ohio","Hardin County","API_combo",155,187,32,18.71,"overcount"
"4147",39067,"Ohio","Harrison County","API_alone",22,18,-4,-20,"undercount"
"4148",39067,"Ohio","Harrison County","API_combo",22,29,7,27.45,"overcount"
"4149",39069,"Ohio","Henry County","API_alone",160,137,-23,-15.49,"undercount"
"4150",39069,"Ohio","Henry County","API_combo",160,162,2,1.24,"overcount"
"4151",39071,"Ohio","Highland County","API_alone",134,145,11,7.89,"overcount"
"4152",39071,"Ohio","Highland County","API_combo",134,194,60,36.59,"overcount"
"4153",39073,"Ohio","Hocking County","API_alone",50,22,-28,-77.78,"undercount"
"4154",39073,"Ohio","Hocking County","API_combo",50,65,15,26.09,"overcount"
"4155",39075,"Ohio","Holmes County","API_alone",79,28,-51,-95.33,"undercount"
"4156",39075,"Ohio","Holmes County","API_combo",79,53,-26,-39.39,"undercount"
"4157",39077,"Ohio","Huron County","API_alone",259,169,-90,-42.06,"undercount"
"4158",39077,"Ohio","Huron County","API_combo",259,234,-25,-10.14,"undercount"
"4159",39079,"Ohio","Jackson County","API_alone",81,64,-17,-23.45,"undercount"
"4160",39079,"Ohio","Jackson County","API_combo",81,101,20,21.98,"overcount"
"4161",39081,"Ohio","Jefferson County","API_alone",370,275,-95,-29.46,"undercount"
"4162",39081,"Ohio","Jefferson County","API_combo",370,379,9,2.4,"overcount"
"4163",39083,"Ohio","Knox County","API_alone",326,197,-129,-49.33,"undercount"
"4164",39083,"Ohio","Knox County","API_combo",326,266,-60,-20.27,"undercount"
"4165",39085,"Ohio","Lake County","API_alone",2358,2147,-211,-9.37,"undercount"
"4166",39085,"Ohio","Lake County","API_combo",2358,2634,276,11.06,"overcount"
"4167",39087,"Ohio","Lawrence County","API_alone",125,123,-2,-1.61,"undercount"
"4168",39087,"Ohio","Lawrence County","API_combo",125,185,60,38.71,"overcount"
"4169",39089,"Ohio","Licking County","API_alone",744,895,151,18.43,"overcount"
"4170",39089,"Ohio","Licking County","API_combo",744,1227,483,49.01,"overcount"
"4171",39091,"Ohio","Logan County","API_alone",409,207,-202,-65.58,"undercount"
"4172",39091,"Ohio","Logan County","API_combo",409,308,-101,-28.17,"undercount"
"4173",39093,"Ohio","Lorain County","API_alone",2197,1871,-326,-16.03,"undercount"
"4174",39093,"Ohio","Lorain County","API_combo",2197,2580,383,16.04,"overcount"
"4175",39095,"Ohio","Lucas County","API_alone",6719,5863,-856,-13.61,"undercount"
"4176",39095,"Ohio","Lucas County","API_combo",6719,7212,493,7.08,"overcount"
"4177",39097,"Ohio","Madison County","API_alone",279,184,-95,-41.04,"undercount"
"4178",39097,"Ohio","Madison County","API_combo",279,268,-11,-4.02,"undercount"
"4179",39099,"Ohio","Mahoning County","API_alone",1445,1321,-124,-8.97,"undercount"
"4180",39099,"Ohio","Mahoning County","API_combo",1445,1778,333,20.66,"overcount"
"4181",39101,"Ohio","Marion County","API_alone",447,382,-65,-15.68,"undercount"
"4182",39101,"Ohio","Marion County","API_combo",447,491,44,9.38,"overcount"
"4183",39103,"Ohio","Medina County","API_alone",1271,1010,-261,-22.88,"undercount"
"4184",39103,"Ohio","Medina County","API_combo",1271,1285,14,1.1,"overcount"
"4185",39105,"Ohio","Meigs County","API_alone",31,27,-4,-13.79,"undercount"
"4186",39105,"Ohio","Meigs County","API_combo",31,41,10,27.78,"overcount"
"4187",39107,"Ohio","Mercer County","API_alone",159,126,-33,-23.16,"undercount"
"4188",39107,"Ohio","Mercer County","API_combo",159,158,-1,-0.63,"undercount"
"4189",39109,"Ohio","Miami County","API_alone",961,798,-163,-18.53,"undercount"
"4190",39109,"Ohio","Miami County","API_combo",961,957,-4,-0.42,"undercount"
"4191",39111,"Ohio","Monroe County","API_alone",14,13,-1,-7.41,"undercount"
"4192",39111,"Ohio","Monroe County","API_combo",14,29,15,69.77,"overcount"
"4193",39113,"Ohio","Montgomery County","API_alone",8359,7713,-646,-8.04,"undercount"
"4194",39113,"Ohio","Montgomery County","API_combo",8359,9770,1411,15.57,"overcount"
"4195",39115,"Ohio","Morgan County","API_alone",13,12,-1,-8,"undercount"
"4196",39115,"Ohio","Morgan County","API_combo",13,33,20,86.96,"overcount"
"4197",39117,"Ohio","Morrow County","API_alone",67,47,-20,-35.09,"undercount"
"4198",39117,"Ohio","Morrow County","API_combo",67,75,8,11.27,"overcount"
"4199",39119,"Ohio","Muskingum County","API_alone",241,253,12,4.86,"overcount"
"4200",39119,"Ohio","Muskingum County","API_combo",241,355,114,38.26,"overcount"
"4201",39121,"Ohio","Noble County","API_alone",18,13,-5,-32.26,"undercount"
"4202",39121,"Ohio","Noble County","API_combo",18,16,-2,-11.76,"undercount"
"4203",39123,"Ohio","Ottawa County","API_alone",136,118,-18,-14.17,"undercount"
"4204",39123,"Ohio","Ottawa County","API_combo",136,157,21,14.33,"overcount"
"4205",39125,"Ohio","Paulding County","API_alone",30,37,7,20.9,"overcount"
"4206",39125,"Ohio","Paulding County","API_combo",30,51,21,51.85,"overcount"
"4207",39127,"Ohio","Perry County","API_alone",39,37,-2,-5.26,"undercount"
"4208",39127,"Ohio","Perry County","API_combo",39,88,49,77.17,"overcount"
"4209",39129,"Ohio","Pickaway County","API_alone",164,135,-29,-19.4,"undercount"
"4210",39129,"Ohio","Pickaway County","API_combo",164,209,45,24.13,"overcount"
"4211",39131,"Ohio","Pike County","API_alone",82,62,-20,-27.78,"undercount"
"4212",39131,"Ohio","Pike County","API_combo",82,85,3,3.59,"overcount"
"4213",39133,"Ohio","Portage County","API_alone",1780,1280,-500,-32.68,"undercount"
"4214",39133,"Ohio","Portage County","API_combo",1780,1622,-158,-9.29,"undercount"
"4215",39135,"Ohio","Preble County","API_alone",102,120,18,16.22,"overcount"
"4216",39135,"Ohio","Preble County","API_combo",102,164,62,46.62,"overcount"
"4217",39137,"Ohio","Putnam County","API_alone",46,65,19,34.23,"overcount"
"4218",39137,"Ohio","Putnam County","API_combo",46,92,46,66.67,"overcount"
"4219",39139,"Ohio","Richland County","API_alone",877,710,-167,-21.05,"undercount"
"4220",39139,"Ohio","Richland County","API_combo",877,962,85,9.24,"overcount"
"4221",39141,"Ohio","Ross County","API_alone",462,276,-186,-50.41,"undercount"
"4222",39141,"Ohio","Ross County","API_combo",462,442,-20,-4.42,"undercount"
"4223",39143,"Ohio","Sandusky County","API_alone",230,194,-36,-16.98,"undercount"
"4224",39143,"Ohio","Sandusky County","API_combo",230,290,60,23.08,"overcount"
"4225",39145,"Ohio","Scioto County","API_alone",219,214,-5,-2.31,"undercount"
"4226",39145,"Ohio","Scioto County","API_combo",219,327,108,39.56,"overcount"
"4227",39147,"Ohio","Seneca County","API_alone",340,240,-100,-34.48,"undercount"
"4228",39147,"Ohio","Seneca County","API_combo",340,314,-26,-7.95,"undercount"
"4229",39149,"Ohio","Shelby County","API_alone",620,501,-119,-21.23,"undercount"
"4230",39149,"Ohio","Shelby County","API_combo",620,592,-28,-4.62,"undercount"
"4231",39151,"Ohio","Stark County","API_alone",2318,2151,-167,-7.47,"undercount"
"4232",39151,"Ohio","Stark County","API_combo",2318,2859,541,20.9,"overcount"
"4233",39153,"Ohio","Summit County","API_alone",7489,7922,433,5.62,"overcount"
"4234",39153,"Ohio","Summit County","API_combo",7489,9322,1833,21.81,"overcount"
"4235",39155,"Ohio","Trumbull County","API_alone",1432,1069,-363,-29.03,"undercount"
"4236",39155,"Ohio","Trumbull County","API_combo",1432,1440,8,0.56,"overcount"
"4237",39157,"Ohio","Tuscarawas County","API_alone",308,272,-36,-12.41,"undercount"
"4238",39157,"Ohio","Tuscarawas County","API_combo",308,371,63,18.56,"overcount"
"4239",39159,"Ohio","Union County","API_alone",274,230,-44,-17.46,"undercount"
"4240",39159,"Ohio","Union County","API_combo",274,307,33,11.36,"overcount"
"4241",39161,"Ohio","Van Wert County","API_alone",109,60,-49,-57.99,"undercount"
"4242",39161,"Ohio","Van Wert County","API_combo",109,97,-12,-11.65,"undercount"
"4243",39163,"Ohio","Vinton County","API_alone",4,11,7,93.33,"overcount"
"4244",39163,"Ohio","Vinton County","API_combo",4,20,16,133.33,"overcount"
"4245",39165,"Ohio","Warren County","API_alone",1247,2063,816,49.31,"overcount"
"4246",39165,"Ohio","Warren County","API_combo",1247,2516,1269,67.45,"overcount"
"4247",39167,"Ohio","Washington County","API_alone",300,308,8,2.63,"overcount"
"4248",39167,"Ohio","Washington County","API_combo",300,434,134,36.51,"overcount"
"4249",39169,"Ohio","Wayne County","API_alone",862,784,-78,-9.48,"undercount"
"4250",39169,"Ohio","Wayne County","API_combo",862,977,115,12.51,"overcount"
"4251",39171,"Ohio","Williams County","API_alone",197,208,11,5.43,"overcount"
"4252",39171,"Ohio","Williams County","API_combo",197,258,61,26.81,"overcount"
"4253",39173,"Ohio","Wood County","API_alone",1560,1307,-253,-17.65,"undercount"
"4254",39173,"Ohio","Wood County","API_combo",1560,1593,33,2.09,"overcount"
"4255",39175,"Ohio","Wyandot County","API_alone",85,129,44,41.12,"overcount"
"4256",39175,"Ohio","Wyandot County","API_combo",85,155,70,58.33,"overcount"
"4257",40001,"Oklahoma","Adair County","API_alone",17,28,11,48.89,"overcount"
"4258",40001,"Oklahoma","Adair County","API_combo",17,56,39,106.85,"overcount"
"4259",40003,"Oklahoma","Alfalfa County","API_alone",6,10,4,50,"overcount"
"4260",40003,"Oklahoma","Alfalfa County","API_combo",6,16,10,90.91,"overcount"
"4261",40005,"Oklahoma","Atoka County","API_alone",29,37,8,24.24,"overcount"
"4262",40005,"Oklahoma","Atoka County","API_combo",29,60,31,69.66,"overcount"
"4263",40007,"Oklahoma","Beaver County","API_alone",3,8,5,90.91,"overcount"
"4264",40007,"Oklahoma","Beaver County","API_combo",3,11,8,114.29,"overcount"
"4265",40009,"Oklahoma","Beckham County","API_alone",72,86,14,17.72,"overcount"
"4266",40009,"Oklahoma","Beckham County","API_combo",72,116,44,46.81,"overcount"
"4267",40011,"Oklahoma","Blaine County","API_alone",25,190,165,153.49,"overcount"
"4268",40011,"Oklahoma","Blaine County","API_combo",25,397,372,176.3,"overcount"
"4269",40013,"Oklahoma","Bryan County","API_alone",181,174,-7,-3.94,"undercount"
"4270",40013,"Oklahoma","Bryan County","API_combo",181,236,55,26.38,"overcount"
"4271",40015,"Oklahoma","Caddo County","API_alone",99,70,-29,-34.32,"undercount"
"4272",40015,"Oklahoma","Caddo County","API_combo",99,166,67,50.57,"overcount"
"4273",40017,"Oklahoma","Canadian County","API_alone",1862,2220,358,17.54,"overcount"
"4274",40017,"Oklahoma","Canadian County","API_combo",1862,2457,595,27.55,"overcount"
"4275",40019,"Oklahoma","Carter County","API_alone",220,306,86,32.7,"overcount"
"4276",40019,"Oklahoma","Carter County","API_combo",220,386,166,54.79,"overcount"
"4277",40021,"Oklahoma","Cherokee County","API_alone",97,139,42,35.59,"overcount"
"4278",40021,"Oklahoma","Cherokee County","API_combo",97,253,156,89.14,"overcount"
"4279",40023,"Oklahoma","Choctaw County","API_alone",35,27,-8,-25.81,"undercount"
"4280",40023,"Oklahoma","Choctaw County","API_combo",35,52,17,39.08,"overcount"
"4281",40025,"Oklahoma","Cimarron County","API_alone",12,5,-7,-82.35,"undercount"
"4282",40025,"Oklahoma","Cimarron County","API_combo",12,8,-4,-40,"undercount"
"4283",40027,"Oklahoma","Cleveland County","API_alone",5518,6107,589,10.13,"overcount"
"4284",40027,"Oklahoma","Cleveland County","API_combo",5518,7331,1813,28.22,"overcount"
"4285",40029,"Oklahoma","Coal County","API_alone",3,19,16,145.45,"overcount"
"4286",40029,"Oklahoma","Coal County","API_combo",3,31,28,164.71,"overcount"
"4287",40031,"Oklahoma","Comanche County","API_alone",4062,2993,-1069,-30.3,"undercount"
"4288",40031,"Oklahoma","Comanche County","API_combo",4062,4519,457,10.65,"overcount"
"4289",40033,"Oklahoma","Cotton County","API_alone",8,12,4,40,"overcount"
"4290",40033,"Oklahoma","Cotton County","API_combo",8,28,20,111.11,"overcount"
"4291",40035,"Oklahoma","Craig County","API_alone",51,31,-20,-48.78,"undercount"
"4292",40035,"Oklahoma","Craig County","API_combo",51,69,18,30,"overcount"
"4293",40037,"Oklahoma","Creek County","API_alone",209,215,6,2.83,"overcount"
"4294",40037,"Oklahoma","Creek County","API_combo",209,358,149,52.56,"overcount"
"4295",40039,"Oklahoma","Custer County","API_alone",239,262,23,9.18,"overcount"
"4296",40039,"Oklahoma","Custer County","API_combo",239,326,87,30.8,"overcount"
"4297",40041,"Oklahoma","Delaware County","API_alone",83,78,-5,-6.21,"undercount"
"4298",40041,"Oklahoma","Delaware County","API_combo",83,148,65,56.28,"overcount"
"4299",40043,"Oklahoma","Dewey County","API_alone",7,4,-3,-54.55,"undercount"
"4300",40043,"Oklahoma","Dewey County","API_combo",7,6,-1,-15.38,"undercount"
"4301",40045,"Oklahoma","Ellis County","API_alone",12,4,-8,-100,"undercount"
"4302",40045,"Oklahoma","Ellis County","API_combo",12,7,-5,-52.63,"undercount"
"4303",40047,"Oklahoma","Garfield County","API_alone",769,795,26,3.32,"overcount"
"4304",40047,"Oklahoma","Garfield County","API_combo",769,1076,307,33.28,"overcount"
"4305",40049,"Oklahoma","Garvin County","API_alone",83,86,3,3.55,"overcount"
"4306",40049,"Oklahoma","Garvin County","API_combo",83,139,56,50.45,"overcount"
"4307",40051,"Oklahoma","Grady County","API_alone",195,178,-17,-9.12,"undercount"
"4308",40051,"Oklahoma","Grady County","API_combo",195,309,114,45.24,"overcount"
"4309",40053,"Oklahoma","Grant County","API_alone",15,9,-6,-50,"undercount"
"4310",40053,"Oklahoma","Grant County","API_combo",15,17,2,12.5,"overcount"
"4311",40055,"Oklahoma","Greer County","API_alone",28,19,-9,-38.3,"undercount"
"4312",40055,"Oklahoma","Greer County","API_combo",28,27,-1,-3.64,"undercount"
"4313",40057,"Oklahoma","Harmon County","API_alone",19,11,-8,-53.33,"undercount"
"4314",40057,"Oklahoma","Harmon County","API_combo",19,14,-5,-30.3,"undercount"
"4315",40059,"Oklahoma","Harper County","API_alone",6,5,-1,-18.18,"undercount"
"4316",40059,"Oklahoma","Harper County","API_combo",6,7,1,15.38,"overcount"
"4317",40061,"Oklahoma","Haskell County","API_alone",13,34,21,89.36,"overcount"
"4318",40061,"Oklahoma","Haskell County","API_combo",13,62,49,130.67,"overcount"
"4319",40063,"Oklahoma","Hughes County","API_alone",24,34,10,34.48,"overcount"
"4320",40063,"Oklahoma","Hughes County","API_combo",24,63,39,89.66,"overcount"
"4321",40065,"Oklahoma","Jackson County","API_alone",522,418,-104,-22.13,"undercount"
"4322",40065,"Oklahoma","Jackson County","API_combo",522,573,51,9.32,"overcount"
"4323",40067,"Oklahoma","Jefferson County","API_alone",29,80,51,93.58,"overcount"
"4324",40067,"Oklahoma","Jefferson County","API_combo",29,91,62,103.33,"overcount"
"4325",40069,"Oklahoma","Johnston County","API_alone",20,33,13,49.06,"overcount"
"4326",40069,"Oklahoma","Johnston County","API_combo",20,54,34,91.89,"overcount"
"4327",40071,"Oklahoma","Kay County","API_alone",300,287,-13,-4.43,"undercount"
"4328",40071,"Oklahoma","Kay County","API_combo",300,435,135,36.73,"overcount"
"4329",40073,"Oklahoma","Kingfisher County","API_alone",32,31,-1,-3.17,"undercount"
"4330",40073,"Oklahoma","Kingfisher County","API_combo",32,45,13,33.77,"overcount"
"4331",40075,"Oklahoma","Kiowa County","API_alone",41,38,-3,-7.59,"undercount"
"4332",40075,"Oklahoma","Kiowa County","API_combo",41,75,34,58.62,"overcount"
"4333",40077,"Oklahoma","Latimer County","API_alone",29,20,-9,-36.73,"undercount"
"4334",40077,"Oklahoma","Latimer County","API_combo",29,30,1,3.39,"overcount"
"4335",40079,"Oklahoma","Le Flore County","API_alone",148,122,-26,-19.26,"undercount"
"4336",40079,"Oklahoma","Le Flore County","API_combo",148,238,90,46.63,"overcount"
"4337",40081,"Oklahoma","Lincoln County","API_alone",93,90,-3,-3.28,"undercount"
"4338",40081,"Oklahoma","Lincoln County","API_combo",93,151,58,47.54,"overcount"
"4339",40083,"Oklahoma","Logan County","API_alone",148,140,-8,-5.56,"undercount"
"4340",40083,"Oklahoma","Logan County","API_combo",148,231,83,43.8,"overcount"
"4341",40085,"Oklahoma","Love County","API_alone",16,24,8,40,"overcount"
"4342",40085,"Oklahoma","Love County","API_combo",16,58,42,113.51,"overcount"
"4343",40087,"Oklahoma","McClain County","API_alone",66,73,7,10.07,"overcount"
"4344",40087,"Oklahoma","McClain County","API_combo",66,132,66,66.67,"overcount"
"4345",40089,"Oklahoma","McCurtain County","API_alone",136,83,-53,-48.4,"undercount"
"4346",40089,"Oklahoma","McCurtain County","API_combo",136,120,-16,-12.5,"undercount"
"4347",40091,"Oklahoma","McIntosh County","API_alone",42,40,-2,-4.88,"undercount"
"4348",40091,"Oklahoma","McIntosh County","API_combo",42,86,44,68.75,"overcount"
"4349",40093,"Oklahoma","Major County","API_alone",14,15,1,6.9,"overcount"
"4350",40093,"Oklahoma","Major County","API_combo",14,24,10,52.63,"overcount"
"4351",40095,"Oklahoma","Marshall County","API_alone",27,42,15,43.48,"overcount"
"4352",40095,"Oklahoma","Marshall County","API_combo",27,61,34,77.27,"overcount"
"4353",40097,"Oklahoma","Mayes County","API_alone",115,118,3,2.58,"overcount"
"4354",40097,"Oklahoma","Mayes County","API_combo",115,190,75,49.18,"overcount"
"4355",40099,"Oklahoma","Murray County","API_alone",22,45,23,68.66,"overcount"
"4356",40099,"Oklahoma","Murray County","API_combo",22,57,35,88.61,"overcount"
"4357",40101,"Oklahoma","Muskogee County","API_alone",362,436,74,18.55,"overcount"
"4358",40101,"Oklahoma","Muskogee County","API_combo",362,625,263,53.29,"overcount"
"4359",40103,"Oklahoma","Noble County","API_alone",32,43,11,29.33,"overcount"
"4360",40103,"Oklahoma","Noble County","API_combo",32,49,17,41.98,"overcount"
"4361",40105,"Oklahoma","Nowata County","API_alone",6,13,7,73.68,"overcount"
"4362",40105,"Oklahoma","Nowata County","API_combo",6,41,35,148.94,"overcount"
"4363",40107,"Oklahoma","Okfuskee County","API_alone",19,10,-9,-62.07,"undercount"
"4364",40107,"Oklahoma","Okfuskee County","API_combo",19,28,9,38.3,"overcount"
"4365",40109,"Oklahoma","Oklahoma County","API_alone",16601,19672,3071,16.93,"overcount"
"4366",40109,"Oklahoma","Oklahoma County","API_combo",16601,23358,6757,33.82,"overcount"
"4367",40111,"Oklahoma","Okmulgee County","API_alone",113,86,-27,-27.14,"undercount"
"4368",40111,"Oklahoma","Okmulgee County","API_combo",113,177,64,44.14,"overcount"
"4369",40113,"Oklahoma","Osage County","API_alone",115,122,7,5.91,"overcount"
"4370",40113,"Oklahoma","Osage County","API_combo",115,200,85,53.97,"overcount"
"4371",40115,"Oklahoma","Ottawa County","API_alone",148,143,-5,-3.44,"undercount"
"4372",40115,"Oklahoma","Ottawa County","API_combo",148,225,77,41.29,"overcount"
"4373",40117,"Oklahoma","Pawnee County","API_alone",37,42,5,12.66,"overcount"
"4374",40117,"Oklahoma","Pawnee County","API_combo",37,58,21,44.21,"overcount"
"4375",40119,"Oklahoma","Payne County","API_alone",1969,2104,135,6.63,"overcount"
"4376",40119,"Oklahoma","Payne County","API_combo",1969,2434,465,21.12,"overcount"
"4377",40121,"Oklahoma","Pittsburg County","API_alone",162,132,-30,-20.41,"undercount"
"4378",40121,"Oklahoma","Pittsburg County","API_combo",162,218,56,29.47,"overcount"
"4379",40123,"Oklahoma","Pontotoc County","API_alone",158,167,9,5.54,"overcount"
"4380",40123,"Oklahoma","Pontotoc County","API_combo",158,226,68,35.42,"overcount"
"4381",40125,"Oklahoma","Pottawatomie County","API_alone",489,475,-14,-2.9,"undercount"
"4382",40125,"Oklahoma","Pottawatomie County","API_combo",489,700,211,35.49,"overcount"
"4383",40127,"Oklahoma","Pushmataha County","API_alone",13,19,6,37.5,"overcount"
"4384",40127,"Oklahoma","Pushmataha County","API_combo",13,31,18,81.82,"overcount"
"4385",40129,"Oklahoma","Roger Mills County","API_alone",3,5,2,50,"overcount"
"4386",40129,"Oklahoma","Roger Mills County","API_combo",3,6,3,66.67,"overcount"
"4387",40131,"Oklahoma","Rogers County","API_alone",278,261,-17,-6.31,"undercount"
"4388",40131,"Oklahoma","Rogers County","API_combo",278,450,172,47.25,"overcount"
"4389",40133,"Oklahoma","Seminole County","API_alone",53,66,13,21.85,"overcount"
"4390",40133,"Oklahoma","Seminole County","API_combo",53,142,89,91.28,"overcount"
"4391",40135,"Oklahoma","Sequoyah County","API_alone",119,103,-16,-14.41,"undercount"
"4392",40135,"Oklahoma","Sequoyah County","API_combo",119,184,65,42.9,"overcount"
"4393",40137,"Oklahoma","Stephens County","API_alone",233,154,-79,-40.83,"undercount"
"4394",40137,"Oklahoma","Stephens County","API_combo",233,238,5,2.12,"overcount"
"4395",40139,"Oklahoma","Texas County","API_alone",80,155,75,63.83,"overcount"
"4396",40139,"Oklahoma","Texas County","API_combo",80,186,106,79.7,"overcount"
"4397",40141,"Oklahoma","Tillman County","API_alone",34,35,1,2.9,"overcount"
"4398",40141,"Oklahoma","Tillman County","API_combo",34,53,19,43.68,"overcount"
"4399",40143,"Oklahoma","Tulsa County","API_alone",8333,9664,1331,14.79,"overcount"
"4400",40143,"Oklahoma","Tulsa County","API_combo",8333,12074,3741,36.66,"overcount"
"4401",40145,"Oklahoma","Wagoner County","API_alone",291,318,27,8.87,"overcount"
"4402",40145,"Oklahoma","Wagoner County","API_combo",291,436,145,39.89,"overcount"
"4403",40147,"Oklahoma","Washington County","API_alone",543,379,-164,-35.57,"undercount"
"4404",40147,"Oklahoma","Washington County","API_combo",543,514,-29,-5.49,"undercount"
"4405",40149,"Oklahoma","Washita County","API_alone",32,34,2,6.06,"overcount"
"4406",40149,"Oklahoma","Washita County","API_combo",32,50,18,43.9,"overcount"
"4407",40151,"Oklahoma","Woods County","API_alone",31,51,20,48.78,"overcount"
"4408",40151,"Oklahoma","Woods County","API_combo",31,63,32,68.09,"overcount"
"4409",40153,"Oklahoma","Woodward County","API_alone",115,102,-13,-11.98,"undercount"
"4410",40153,"Oklahoma","Woodward County","API_combo",115,122,7,5.91,"overcount"
"4411",41001,"Oregon","Baker County","API_alone",78,75,-3,-3.92,"undercount"
"4412",41001,"Oregon","Baker County","API_combo",78,122,44,44,"overcount"
"4413",41003,"Oregon","Benton County","API_alone",5409,3757,-1652,-36.05,"undercount"
"4414",41003,"Oregon","Benton County","API_combo",5409,4648,-761,-15.13,"undercount"
"4415",41005,"Oregon","Clackamas County","API_alone",8539,9115,576,6.53,"overcount"
"4416",41005,"Oregon","Clackamas County","API_combo",8539,12359,3820,36.56,"overcount"
"4417",41007,"Oregon","Clatsop County","API_alone",709,509,-200,-32.84,"undercount"
"4418",41007,"Oregon","Clatsop County","API_combo",709,791,82,10.93,"overcount"
"4419",41009,"Oregon","Columbia County","API_alone",498,308,-190,-47.15,"undercount"
"4420",41009,"Oregon","Columbia County","API_combo",498,565,67,12.61,"overcount"
"4421",41011,"Oregon","Coos County","API_alone",846,689,-157,-20.46,"undercount"
"4422",41011,"Oregon","Coos County","API_combo",846,1059,213,22.36,"overcount"
"4423",41013,"Oregon","Crook County","API_alone",91,90,-1,-1.1,"undercount"
"4424",41013,"Oregon","Crook County","API_combo",91,153,62,50.82,"overcount"
"4425",41015,"Oregon","Curry County","API_alone",187,176,-11,-6.06,"undercount"
"4426",41015,"Oregon","Curry County","API_combo",187,240,53,24.82,"overcount"
"4427",41017,"Oregon","Deschutes County","API_alone",982,962,-20,-2.06,"undercount"
"4428",41017,"Oregon","Deschutes County","API_combo",982,1656,674,51.1,"overcount"
"4429",41019,"Oregon","Douglas County","API_alone",1041,762,-279,-30.95,"undercount"
"4430",41019,"Oregon","Douglas County","API_combo",1041,1289,248,21.29,"overcount"
"4431",41021,"Oregon","Gilliam County","API_alone",14,3,-11,-129.41,"undercount"
"4432",41021,"Oregon","Gilliam County","API_combo",14,5,-9,-94.74,"undercount"
"4433",41023,"Oregon","Grant County","API_alone",23,20,-3,-13.95,"undercount"
"4434",41023,"Oregon","Grant County","API_combo",23,33,10,35.71,"overcount"
"4435",41025,"Oregon","Harney County","API_alone",50,46,-4,-8.33,"undercount"
"4436",41025,"Oregon","Harney County","API_combo",50,80,30,46.15,"overcount"
"4437",41027,"Oregon","Hood River County","API_alone",515,345,-170,-39.53,"undercount"
"4438",41027,"Oregon","Hood River County","API_combo",515,457,-58,-11.93,"undercount"
"4439",41029,"Oregon","Jackson County","API_alone",2406,2036,-370,-16.66,"undercount"
"4440",41029,"Oregon","Jackson County","API_combo",2406,3275,869,30.59,"overcount"
"4441",41031,"Oregon","Jefferson County","API_alone",107,104,-3,-2.84,"undercount"
"4442",41031,"Oregon","Jefferson County","API_combo",107,193,86,57.33,"overcount"
"4443",41033,"Oregon","Josephine County","API_alone",827,575,-252,-35.95,"undercount"
"4444",41033,"Oregon","Josephine County","API_combo",827,1010,183,19.92,"overcount"
"4445",41035,"Oregon","Klamath County","API_alone",694,627,-67,-10.14,"undercount"
"4446",41035,"Oregon","Klamath County","API_combo",694,999,305,36.03,"overcount"
"4447",41037,"Oregon","Lake County","API_alone",64,63,-1,-1.57,"undercount"
"4448",41037,"Oregon","Lake County","API_combo",64,75,11,15.83,"overcount"
"4449",41039,"Oregon","Lane County","API_alone",8331,7291,-1040,-13.31,"undercount"
"4450",41039,"Oregon","Lane County","API_combo",8331,10370,2039,21.81,"overcount"
"4451",41041,"Oregon","Lincoln County","API_alone",628,504,-124,-21.91,"undercount"
"4452",41041,"Oregon","Lincoln County","API_combo",628,776,148,21.08,"overcount"
"4453",41043,"Oregon","Linn County","API_alone",1390,977,-413,-34.9,"undercount"
"4454",41043,"Oregon","Linn County","API_combo",1390,1585,195,13.11,"overcount"
"4455",41045,"Oregon","Malheur County","API_alone",1241,685,-556,-57.74,"undercount"
"4456",41045,"Oregon","Malheur County","API_combo",1241,860,-381,-36.27,"undercount"
"4457",41047,"Oregon","Marion County","API_alone",7078,6388,-690,-10.25,"undercount"
"4458",41047,"Oregon","Marion County","API_combo",7078,8501,1423,18.27,"overcount"
"4459",41049,"Oregon","Morrow County","API_alone",57,63,6,10,"overcount"
"4460",41049,"Oregon","Morrow County","API_combo",57,96,39,50.98,"overcount"
"4461",41051,"Oregon","Multnomah County","API_alone",42574,41036,-1538,-3.68,"undercount"
"4462",41051,"Oregon","Multnomah County","API_combo",42574,49653,7079,15.35,"overcount"
"4463",41053,"Oregon","Polk County","API_alone",1136,862,-274,-27.43,"undercount"
"4464",41053,"Oregon","Polk County","API_combo",1136,1282,146,12.08,"overcount"
"4465",41055,"Oregon","Sherman County","API_alone",15,9,-6,-50,"undercount"
"4466",41055,"Oregon","Sherman County","API_combo",15,15,0,0,"equal"
"4467",41057,"Oregon","Tillamook County","API_alone",276,210,-66,-27.16,"undercount"
"4468",41057,"Oregon","Tillamook County","API_combo",276,323,47,15.69,"overcount"
"4469",41059,"Oregon","Umatilla County","API_alone",887,716,-171,-21.33,"undercount"
"4470",41059,"Oregon","Umatilla County","API_combo",887,982,95,10.17,"overcount"
"4471",41061,"Oregon","Union County","API_alone",367,375,8,2.16,"overcount"
"4472",41061,"Oregon","Union County","API_combo",367,477,110,26.07,"overcount"
"4473",41063,"Oregon","Wallowa County","API_alone",36,21,-15,-52.63,"undercount"
"4474",41063,"Oregon","Wallowa County","API_combo",36,38,2,5.41,"overcount"
"4475",41065,"Oregon","Wasco County","API_alone",362,327,-35,-10.16,"undercount"
"4476",41065,"Oregon","Wasco County","API_combo",362,453,91,22.33,"overcount"
"4477",41067,"Oregon","Washington County","API_alone",25366,31868,6502,22.72,"overcount"
"4478",41067,"Oregon","Washington County","API_combo",25366,38338,12972,40.73,"overcount"
"4479",41069,"Oregon","Wheeler County","API_alone",2,5,3,85.71,"overcount"
"4480",41069,"Oregon","Wheeler County","API_combo",2,9,7,127.27,"overcount"
"4481",41071,"Oregon","Yamhill County","API_alone",1376,1038,-338,-28,"undercount"
"4482",41071,"Oregon","Yamhill County","API_combo",1376,1665,289,19.01,"overcount"
"4483",42001,"Pennsylvania","Adams County","API_alone",680,491,-189,-32.28,"undercount"
"4484",42001,"Pennsylvania","Adams County","API_combo",680,656,-24,-3.59,"undercount"
"4485",42003,"Pennsylvania","Allegheny County","API_alone",19728,22543,2815,13.32,"overcount"
"4486",42003,"Pennsylvania","Allegheny County","API_combo",19728,25688,5960,26.25,"overcount"
"4487",42005,"Pennsylvania","Armstrong County","API_alone",137,106,-31,-25.51,"undercount"
"4488",42005,"Pennsylvania","Armstrong County","API_combo",137,170,33,21.5,"overcount"
"4489",42007,"Pennsylvania","Beaver County","API_alone",605,486,-119,-21.81,"undercount"
"4490",42007,"Pennsylvania","Beaver County","API_combo",605,693,88,13.56,"overcount"
"4491",42009,"Pennsylvania","Bedford County","API_alone",141,150,9,6.19,"overcount"
"4492",42009,"Pennsylvania","Bedford County","API_combo",141,196,55,32.64,"overcount"
"4493",42011,"Pennsylvania","Berks County","API_alone",5274,4204,-1070,-22.58,"undercount"
"4494",42011,"Pennsylvania","Berks County","API_combo",5274,5012,-262,-5.09,"undercount"
"4495",42013,"Pennsylvania","Blair County","API_alone",611,498,-113,-20.38,"undercount"
"4496",42013,"Pennsylvania","Blair County","API_combo",611,659,48,7.56,"overcount"
"4497",42015,"Pennsylvania","Bradford County","API_alone",355,297,-58,-17.79,"undercount"
"4498",42015,"Pennsylvania","Bradford County","API_combo",355,379,24,6.54,"overcount"
"4499",42017,"Pennsylvania","Bucks County","API_alone",14690,14106,-584,-4.06,"undercount"
"4500",42017,"Pennsylvania","Bucks County","API_combo",14690,15983,1293,8.43,"overcount"
"4501",42019,"Pennsylvania","Butler County","API_alone",1010,1056,46,4.45,"overcount"
"4502",42019,"Pennsylvania","Butler County","API_combo",1010,1315,305,26.24,"overcount"
"4503",42021,"Pennsylvania","Cambria County","API_alone",598,619,21,3.45,"overcount"
"4504",42021,"Pennsylvania","Cambria County","API_combo",598,810,212,30.11,"overcount"
"4505",42023,"Pennsylvania","Cameron County","API_alone",8,10,2,22.22,"overcount"
"4506",42023,"Pennsylvania","Cameron County","API_combo",8,10,2,22.22,"overcount"
"4507",42025,"Pennsylvania","Carbon County","API_alone",316,208,-108,-41.22,"undercount"
"4508",42025,"Pennsylvania","Carbon County","API_combo",316,291,-25,-8.24,"undercount"
"4509",42027,"Pennsylvania","Centre County","API_alone",6289,5520,-769,-13.02,"undercount"
"4510",42027,"Pennsylvania","Centre County","API_combo",6289,6159,-130,-2.09,"undercount"
"4511",42029,"Pennsylvania","Chester County","API_alone",7233,8761,1528,19.11,"overcount"
"4512",42029,"Pennsylvania","Chester County","API_combo",7233,9762,2529,29.76,"overcount"
"4513",42031,"Pennsylvania","Clarion County","API_alone",331,148,-183,-76.41,"undercount"
"4514",42031,"Pennsylvania","Clarion County","API_combo",331,198,-133,-50.28,"undercount"
"4515",42033,"Pennsylvania","Clearfield County","API_alone",320,237,-83,-29.8,"undercount"
"4516",42033,"Pennsylvania","Clearfield County","API_combo",320,300,-20,-6.45,"undercount"
"4517",42035,"Pennsylvania","Clinton County","API_alone",172,165,-7,-4.15,"undercount"
"4518",42035,"Pennsylvania","Clinton County","API_combo",172,217,45,23.14,"overcount"
"4519",42037,"Pennsylvania","Columbia County","API_alone",371,359,-12,-3.29,"undercount"
"4520",42037,"Pennsylvania","Columbia County","API_combo",371,455,84,20.34,"overcount"
"4521",42039,"Pennsylvania","Crawford County","API_alone",454,283,-171,-46.4,"undercount"
"4522",42039,"Pennsylvania","Crawford County","API_combo",454,412,-42,-9.7,"undercount"
"4523",42041,"Pennsylvania","Cumberland County","API_alone",4215,3723,-492,-12.4,"undercount"
"4524",42041,"Pennsylvania","Cumberland County","API_combo",4215,4373,158,3.68,"overcount"
"4525",42043,"Pennsylvania","Dauphin County","API_alone",4554,5157,603,12.42,"overcount"
"4526",42043,"Pennsylvania","Dauphin County","API_combo",4554,5906,1352,25.85,"overcount"
"4527",42045,"Pennsylvania","Delaware County","API_alone",15483,18539,3056,17.96,"overcount"
"4528",42045,"Pennsylvania","Delaware County","API_combo",15483,20341,4858,27.12,"overcount"
"4529",42047,"Pennsylvania","Elk County","API_alone",158,141,-17,-11.37,"undercount"
"4530",42047,"Pennsylvania","Elk County","API_combo",158,164,6,3.73,"overcount"
"4531",42049,"Pennsylvania","Erie County","API_alone",2229,2047,-182,-8.51,"undercount"
"4532",42049,"Pennsylvania","Erie County","API_combo",2229,2629,400,16.47,"overcount"
"4533",42051,"Pennsylvania","Fayette County","API_alone",354,348,-6,-1.71,"undercount"
"4534",42051,"Pennsylvania","Fayette County","API_combo",354,497,143,33.61,"overcount"
"4535",42053,"Pennsylvania","Forest County","API_alone",6,7,1,15.38,"overcount"
"4536",42053,"Pennsylvania","Forest County","API_combo",6,13,7,73.68,"overcount"
"4537",42055,"Pennsylvania","Franklin County","API_alone",1058,781,-277,-30.13,"undercount"
"4538",42055,"Pennsylvania","Franklin County","API_combo",1058,1025,-33,-3.17,"undercount"
"4539",42057,"Pennsylvania","Fulton County","API_alone",29,18,-11,-46.81,"undercount"
"4540",42057,"Pennsylvania","Fulton County","API_combo",29,33,4,12.9,"overcount"
"4541",42059,"Pennsylvania","Greene County","API_alone",205,96,-109,-72.43,"undercount"
"4542",42059,"Pennsylvania","Greene County","API_combo",205,160,-45,-24.66,"undercount"
"4543",42061,"Pennsylvania","Huntingdon County","API_alone",124,103,-21,-18.5,"undercount"
"4544",42061,"Pennsylvania","Huntingdon County","API_combo",124,168,44,30.14,"overcount"
"4545",42063,"Pennsylvania","Indiana County","API_alone",845,680,-165,-21.64,"undercount"
"4546",42063,"Pennsylvania","Indiana County","API_combo",845,810,-35,-4.23,"undercount"
"4547",42065,"Pennsylvania","Jefferson County","API_alone",119,103,-16,-14.41,"undercount"
"4548",42065,"Pennsylvania","Jefferson County","API_combo",119,134,15,11.86,"overcount"
"4549",42067,"Pennsylvania","Juniata County","API_alone",75,106,31,34.25,"overcount"
"4550",42067,"Pennsylvania","Juniata County","API_combo",75,138,63,59.15,"overcount"
"4551",42069,"Pennsylvania","Lackawanna County","API_alone",2043,1660,-383,-20.69,"undercount"
"4552",42069,"Pennsylvania","Lackawanna County","API_combo",2043,1953,-90,-4.5,"undercount"
"4553",42071,"Pennsylvania","Lancaster County","API_alone",8006,7212,-794,-10.44,"undercount"
"4554",42071,"Pennsylvania","Lancaster County","API_combo",8006,8180,174,2.15,"overcount"
"4555",42073,"Pennsylvania","Lawrence County","API_alone",422,270,-152,-43.93,"undercount"
"4556",42073,"Pennsylvania","Lawrence County","API_combo",422,371,-51,-12.86,"undercount"
"4557",42075,"Pennsylvania","Lebanon County","API_alone",1505,1148,-357,-26.91,"undercount"
"4558",42075,"Pennsylvania","Lebanon County","API_combo",1505,1335,-170,-11.97,"undercount"
"4559",42077,"Pennsylvania","Lehigh County","API_alone",5903,6877,974,15.24,"overcount"
"4560",42077,"Pennsylvania","Lehigh County","API_combo",5903,7757,1854,27.14,"overcount"
"4561",42079,"Pennsylvania","Luzerne County","API_alone",2234,1941,-293,-14.04,"undercount"
"4562",42079,"Pennsylvania","Luzerne County","API_combo",2234,2421,187,8.03,"overcount"
"4563",42081,"Pennsylvania","Lycoming County","API_alone",749,533,-216,-33.7,"undercount"
"4564",42081,"Pennsylvania","Lycoming County","API_combo",749,703,-46,-6.34,"undercount"
"4565",42083,"Pennsylvania","McKean County","API_alone",247,159,-88,-43.35,"undercount"
"4566",42083,"Pennsylvania","McKean County","API_combo",247,217,-30,-12.93,"undercount"
"4567",42085,"Pennsylvania","Mercer County","API_alone",629,522,-107,-18.59,"undercount"
"4568",42085,"Pennsylvania","Mercer County","API_combo",629,715,86,12.8,"overcount"
"4569",42087,"Pennsylvania","Mifflin County","API_alone",168,139,-29,-18.89,"undercount"
"4570",42087,"Pennsylvania","Mifflin County","API_combo",168,205,37,19.84,"overcount"
"4571",42089,"Pennsylvania","Monroe County","API_alone",1466,1700,234,14.78,"overcount"
"4572",42089,"Pennsylvania","Monroe County","API_combo",1466,2126,660,36.75,"overcount"
"4573",42091,"Pennsylvania","Montgomery County","API_alone",26947,30903,3956,13.68,"overcount"
"4574",42091,"Pennsylvania","Montgomery County","API_combo",26947,33385,6438,21.34,"overcount"
"4575",42093,"Pennsylvania","Montour County","API_alone",226,238,12,5.17,"overcount"
"4576",42093,"Pennsylvania","Montour County","API_combo",226,271,45,18.11,"overcount"
"4577",42095,"Pennsylvania","Northampton County","API_alone",4351,3929,-422,-10.19,"undercount"
"4578",42095,"Pennsylvania","Northampton County","API_combo",4351,4490,139,3.14,"overcount"
"4579",42097,"Pennsylvania","Northumberland County","API_alone",274,232,-42,-16.6,"undercount"
"4580",42097,"Pennsylvania","Northumberland County","API_combo",274,347,73,23.51,"overcount"
"4581",42099,"Pennsylvania","Perry County","API_alone",127,71,-56,-56.57,"undercount"
"4582",42099,"Pennsylvania","Perry County","API_combo",127,115,-12,-9.92,"undercount"
"4583",42101,"Pennsylvania","Philadelphia County","API_alone",57323,71252,13929,21.67,"overcount"
"4584",42101,"Pennsylvania","Philadelphia County","API_combo",57323,77479,20156,29.9,"overcount"
"4585",42103,"Pennsylvania","Pike County","API_alone",320,300,-20,-6.45,"undercount"
"4586",42103,"Pennsylvania","Pike County","API_combo",320,389,69,19.46,"overcount"
"4587",42105,"Pennsylvania","Potter County","API_alone",50,95,45,62.07,"overcount"
"4588",42105,"Pennsylvania","Potter County","API_combo",50,122,72,83.72,"overcount"
"4589",42107,"Pennsylvania","Schuylkill County","API_alone",773,660,-113,-15.77,"undercount"
"4590",42107,"Pennsylvania","Schuylkill County","API_combo",773,800,27,3.43,"overcount"
"4591",42109,"Pennsylvania","Snyder County","API_alone",159,164,5,3.1,"overcount"
"4592",42109,"Pennsylvania","Snyder County","API_combo",159,220,61,32.19,"overcount"
"4593",42111,"Pennsylvania","Somerset County","API_alone",223,179,-44,-21.89,"undercount"
"4594",42111,"Pennsylvania","Somerset County","API_combo",223,239,16,6.93,"overcount"
"4595",42113,"Pennsylvania","Sullivan County","API_alone",14,11,-3,-24,"undercount"
"4596",42113,"Pennsylvania","Sullivan County","API_combo",14,21,7,40,"overcount"
"4597",42115,"Pennsylvania","Susquehanna County","API_alone",156,100,-56,-43.75,"undercount"
"4598",42115,"Pennsylvania","Susquehanna County","API_combo",156,145,-11,-7.31,"undercount"
"4599",42117,"Pennsylvania","Tioga County","API_alone",156,131,-25,-17.42,"undercount"
"4600",42117,"Pennsylvania","Tioga County","API_combo",156,175,19,11.48,"overcount"
"4601",42119,"Pennsylvania","Union County","API_alone",421,471,50,11.21,"overcount"
"4602",42119,"Pennsylvania","Union County","API_combo",421,676,255,46.49,"overcount"
"4603",42121,"Pennsylvania","Venango County","API_alone",205,147,-58,-32.95,"undercount"
"4604",42121,"Pennsylvania","Venango County","API_combo",205,199,-6,-2.97,"undercount"
"4605",42123,"Pennsylvania","Warren County","API_alone",165,137,-28,-18.54,"undercount"
"4606",42123,"Pennsylvania","Warren County","API_combo",165,180,15,8.7,"overcount"
"4607",42125,"Pennsylvania","Washington County","API_alone",856,784,-72,-8.78,"undercount"
"4608",42125,"Pennsylvania","Washington County","API_combo",856,1087,231,23.78,"overcount"
"4609",42127,"Pennsylvania","Wayne County","API_alone",185,184,-1,-0.54,"undercount"
"4610",42127,"Pennsylvania","Wayne County","API_combo",185,203,18,9.28,"overcount"
"4611",42129,"Pennsylvania","Westmoreland County","API_alone",2523,2004,-519,-22.93,"undercount"
"4612",42129,"Pennsylvania","Westmoreland County","API_combo",2523,2467,-56,-2.24,"undercount"
"4613",42131,"Pennsylvania","Wyoming County","API_alone",147,79,-68,-60.18,"undercount"
"4614",42131,"Pennsylvania","Wyoming County","API_combo",147,114,-33,-25.29,"undercount"
"4615",42133,"Pennsylvania","York County","API_alone",3750,3527,-223,-6.13,"undercount"
"4616",42133,"Pennsylvania","York County","API_combo",3750,4308,558,13.85,"overcount"
"4617",44001,"Rhode Island","Bristol County","API_alone",432,526,94,19.62,"overcount"
"4618",44001,"Rhode Island","Bristol County","API_combo",432,698,266,47.08,"overcount"
"4619",44003,"Rhode Island","Kent County","API_alone",1826,2331,505,24.3,"overcount"
"4620",44003,"Rhode Island","Kent County","API_combo",1826,2822,996,42.86,"overcount"
"4621",44005,"Rhode Island","Newport County","API_alone",1315,1151,-164,-13.3,"undercount"
"4622",44005,"Rhode Island","Newport County","API_combo",1315,1624,309,21.03,"overcount"
"4623",44007,"Rhode Island","Providence County","API_alone",17931,20531,2600,13.52,"overcount"
"4624",44007,"Rhode Island","Providence County","API_combo",17931,23235,5304,25.77,"overcount"
"4625",44009,"Rhode Island","Washington County","API_alone",2124,1935,-189,-9.31,"undercount"
"4626",44009,"Rhode Island","Washington County","API_combo",2124,2327,203,9.12,"overcount"
"4627",45001,"South Carolina","Abbeville County","API_alone",82,67,-15,-20.13,"undercount"
"4628",45001,"South Carolina","Abbeville County","API_combo",82,82,0,0,"equal"
"4629",45003,"South Carolina","Aiken County","API_alone",914,972,58,6.15,"overcount"
"4630",45003,"South Carolina","Aiken County","API_combo",914,1326,412,36.79,"overcount"
"4631",45005,"South Carolina","Allendale County","API_alone",13,24,11,59.46,"overcount"
"4632",45005,"South Carolina","Allendale County","API_combo",13,45,32,110.34,"overcount"
"4633",45007,"South Carolina","Anderson County","API_alone",579,750,171,25.73,"overcount"
"4634",45007,"South Carolina","Anderson County","API_combo",579,1054,475,58.18,"overcount"
"4635",45009,"South Carolina","Bamberg County","API_alone",26,33,7,23.73,"overcount"
"4636",45009,"South Carolina","Bamberg County","API_combo",26,54,28,70,"overcount"
"4637",45011,"South Carolina","Barnwell County","API_alone",25,100,75,120,"overcount"
"4638",45011,"South Carolina","Barnwell County","API_combo",25,145,120,141.18,"overcount"
"4639",45013,"South Carolina","Beaufort County","API_alone",1628,1075,-553,-40.92,"undercount"
"4640",45013,"South Carolina","Beaufort County","API_combo",1628,1560,-68,-4.27,"undercount"
"4641",45015,"South Carolina","Berkeley County","API_alone",4171,2900,-1271,-35.95,"undercount"
"4642",45015,"South Carolina","Berkeley County","API_combo",4171,3758,-413,-10.42,"undercount"
"4643",45017,"South Carolina","Calhoun County","API_alone",14,25,11,56.41,"overcount"
"4644",45017,"South Carolina","Calhoun County","API_combo",14,50,36,112.5,"overcount"
"4645",45019,"South Carolina","Charleston County","API_alone",4188,3799,-389,-9.74,"undercount"
"4646",45019,"South Carolina","Charleston County","API_combo",4188,4817,629,13.97,"overcount"
"4647",45021,"South Carolina","Cherokee County","API_alone",323,215,-108,-40.15,"undercount"
"4648",45021,"South Carolina","Cherokee County","API_combo",323,285,-38,-12.5,"undercount"
"4649",45023,"South Carolina","Chester County","API_alone",52,98,46,61.33,"overcount"
"4650",45023,"South Carolina","Chester County","API_combo",52,132,80,86.96,"overcount"
"4651",45025,"South Carolina","Chesterfield County","API_alone",50,145,95,97.44,"overcount"
"4652",45025,"South Carolina","Chesterfield County","API_combo",50,218,168,125.37,"overcount"
"4653",45027,"South Carolina","Clarendon County","API_alone",43,95,52,75.36,"overcount"
"4654",45027,"South Carolina","Clarendon County","API_combo",43,172,129,120,"overcount"
"4655",45029,"South Carolina","Colleton County","API_alone",57,122,65,72.63,"overcount"
"4656",45029,"South Carolina","Colleton County","API_combo",57,187,130,106.56,"overcount"
"4657",45031,"South Carolina","Darlington County","API_alone",101,162,61,46.39,"overcount"
"4658",45031,"South Carolina","Darlington County","API_combo",101,258,157,87.47,"overcount"
"4659",45033,"South Carolina","Dillon County","API_alone",92,117,25,23.92,"overcount"
"4660",45033,"South Carolina","Dillon County","API_combo",92,189,97,69.04,"overcount"
"4661",45035,"South Carolina","Dorchester County","API_alone",1236,1191,-45,-3.71,"undercount"
"4662",45035,"South Carolina","Dorchester County","API_combo",1236,1621,385,26.95,"overcount"
"4663",45037,"South Carolina","Edgefield County","API_alone",43,67,24,43.64,"overcount"
"4664",45037,"South Carolina","Edgefield County","API_combo",43,112,69,89.03,"overcount"
"4665",45039,"South Carolina","Fairfield County","API_alone",38,46,8,19.05,"overcount"
"4666",45039,"South Carolina","Fairfield County","API_combo",38,69,31,57.94,"overcount"
"4667",45041,"South Carolina","Florence County","API_alone",498,924,426,59.92,"overcount"
"4668",45041,"South Carolina","Florence County","API_combo",498,1140,642,78.39,"overcount"
"4669",45043,"South Carolina","Georgetown County","API_alone",116,164,48,34.29,"overcount"
"4670",45043,"South Carolina","Georgetown County","API_combo",116,230,114,65.9,"overcount"
"4671",45045,"South Carolina","Greenville County","API_alone",3508,5525,2017,44.66,"overcount"
"4672",45045,"South Carolina","Greenville County","API_combo",3508,6440,2932,58.95,"overcount"
"4673",45047,"South Carolina","Greenwood County","API_alone",383,521,138,30.53,"overcount"
"4674",45047,"South Carolina","Greenwood County","API_combo",383,631,248,48.92,"overcount"
"4675",45049,"South Carolina","Hampton County","API_alone",20,38,18,62.07,"overcount"
"4676",45049,"South Carolina","Hampton County","API_combo",20,61,41,101.23,"overcount"
"4677",45051,"South Carolina","Horry County","API_alone",2017,1714,-303,-16.24,"undercount"
"4678",45051,"South Carolina","Horry County","API_combo",2017,2197,180,8.54,"overcount"
"4679",45053,"South Carolina","Jasper County","API_alone",49,104,55,71.9,"overcount"
"4680",45053,"South Carolina","Jasper County","API_combo",49,131,82,91.11,"overcount"
"4681",45055,"South Carolina","Kershaw County","API_alone",176,192,16,8.7,"overcount"
"4682",45055,"South Carolina","Kershaw County","API_combo",176,250,74,34.74,"overcount"
"4683",45057,"South Carolina","Lancaster County","API_alone",101,180,79,56.23,"overcount"
"4684",45057,"South Carolina","Lancaster County","API_combo",101,276,175,92.84,"overcount"
"4685",45059,"South Carolina","Laurens County","API_alone",167,170,3,1.78,"overcount"
"4686",45059,"South Carolina","Laurens County","API_combo",167,288,121,53.19,"overcount"
"4687",45061,"South Carolina","Lee County","API_alone",41,46,5,11.49,"overcount"
"4688",45061,"South Carolina","Lee County","API_combo",41,77,36,61.02,"overcount"
"4689",45063,"South Carolina","Lexington County","API_alone",1885,2401,516,24.08,"overcount"
"4690",45063,"South Carolina","Lexington County","API_combo",1885,2858,973,41.03,"overcount"
"4691",45065,"South Carolina","McCormick County","API_alone",15,32,17,72.34,"overcount"
"4692",45065,"South Carolina","McCormick County","API_combo",15,63,48,123.08,"overcount"
"4693",45067,"South Carolina","Marion County","API_alone",184,105,-79,-54.67,"undercount"
"4694",45067,"South Carolina","Marion County","API_combo",184,146,-38,-23.03,"undercount"
"4695",45069,"South Carolina","Marlboro County","API_alone",35,76,41,73.87,"overcount"
"4696",45069,"South Carolina","Marlboro County","API_combo",35,107,72,101.41,"overcount"
"4697",45071,"South Carolina","Newberry County","API_alone",131,159,28,19.31,"overcount"
"4698",45071,"South Carolina","Newberry County","API_combo",131,191,60,37.27,"overcount"
"4699",45073,"South Carolina","Oconee County","API_alone",300,261,-39,-13.9,"undercount"
"4700",45073,"South Carolina","Oconee County","API_combo",300,357,57,17.35,"overcount"
"4701",45075,"South Carolina","Orangeburg County","API_alone",493,429,-64,-13.88,"undercount"
"4702",45075,"South Carolina","Orangeburg County","API_combo",493,541,48,9.28,"overcount"
"4703",45077,"South Carolina","Pickens County","API_alone",1286,1349,63,4.78,"overcount"
"4704",45077,"South Carolina","Pickens County","API_combo",1286,1579,293,20.45,"overcount"
"4705",45079,"South Carolina","Richland County","API_alone",6062,5946,-116,-1.93,"undercount"
"4706",45079,"South Carolina","Richland County","API_combo",6062,7255,1193,17.92,"overcount"
"4707",45081,"South Carolina","Saluda County","API_alone",13,18,5,32.26,"overcount"
"4708",45081,"South Carolina","Saluda County","API_combo",13,27,14,70,"overcount"
"4709",45083,"South Carolina","Spartanburg County","API_alone",2768,3925,1157,34.57,"overcount"
"4710",45083,"South Carolina","Spartanburg County","API_combo",2768,4488,1720,47.41,"overcount"
"4711",45085,"South Carolina","Sumter County","API_alone",1461,1059,-402,-31.9,"undercount"
"4712",45085,"South Carolina","Sumter County","API_combo",1461,1461,0,0,"equal"
"4713",45087,"South Carolina","Union County","API_alone",53,66,13,21.85,"overcount"
"4714",45087,"South Carolina","Union County","API_combo",53,133,80,86.02,"overcount"
"4715",45089,"South Carolina","Williamsburg County","API_alone",46,83,37,57.36,"overcount"
"4716",45089,"South Carolina","Williamsburg County","API_combo",46,119,73,88.48,"overcount"
"4717",45091,"South Carolina","York County","API_alone",1221,1541,320,23.17,"overcount"
"4718",45091,"South Carolina","York County","API_combo",1221,1828,607,39.82,"overcount"
"4719",46003,"South Dakota","Aurora County","API_alone",3,3,0,0,"equal"
"4720",46003,"South Dakota","Aurora County","API_combo",3,8,5,90.91,"overcount"
"4721",46005,"South Dakota","Beadle County","API_alone",66,58,-8,-12.9,"undercount"
"4722",46005,"South Dakota","Beadle County","API_combo",66,86,20,26.32,"overcount"
"4723",46007,"South Dakota","Bennett County","API_alone",3,7,4,80,"overcount"
"4724",46007,"South Dakota","Bennett County","API_combo",3,14,11,129.41,"overcount"
"4725",46009,"South Dakota","Bon Homme County","API_alone",7,6,-1,-15.38,"undercount"
"4726",46009,"South Dakota","Bon Homme County","API_combo",7,11,4,44.44,"overcount"
"4727",46011,"South Dakota","Brookings County","API_alone",449,394,-55,-13.05,"undercount"
"4728",46011,"South Dakota","Brookings County","API_combo",449,454,5,1.11,"overcount"
"4729",46013,"South Dakota","Brown County","API_alone",228,173,-55,-27.43,"undercount"
"4730",46013,"South Dakota","Brown County","API_combo",228,235,7,3.02,"overcount"
"4731",46015,"South Dakota","Brule County","API_alone",16,27,11,51.16,"overcount"
"4732",46015,"South Dakota","Brule County","API_combo",16,35,19,74.51,"overcount"
"4733",46017,"South Dakota","Buffalo County","API_alone",5,0,-5,-200,"undercount"
"4734",46017,"South Dakota","Buffalo County","API_combo",5,3,-2,-50,"undercount"
"4735",46019,"South Dakota","Butte County","API_alone",32,22,-10,-37.04,"undercount"
"4736",46019,"South Dakota","Butte County","API_combo",32,32,0,0,"equal"
"4737",46021,"South Dakota","Campbell County","API_alone",4,1,-3,-120,"undercount"
"4738",46021,"South Dakota","Campbell County","API_combo",4,1,-3,-120,"undercount"
"4739",46023,"South Dakota","Charles Mix County","API_alone",5,10,5,66.67,"overcount"
"4740",46023,"South Dakota","Charles Mix County","API_combo",5,25,20,133.33,"overcount"
"4741",46025,"South Dakota","Clark County","API_alone",9,5,-4,-57.14,"undercount"
"4742",46025,"South Dakota","Clark County","API_combo",9,10,1,10.53,"overcount"
"4743",46027,"South Dakota","Clay County","API_alone",207,266,59,24.95,"overcount"
"4744",46027,"South Dakota","Clay County","API_combo",207,308,101,39.22,"overcount"
"4745",46029,"South Dakota","Codington County","API_alone",124,81,-43,-41.95,"undercount"
"4746",46029,"South Dakota","Codington County","API_combo",124,124,0,0,"equal"
"4747",46031,"South Dakota","Corson County","API_alone",7,2,-5,-111.11,"undercount"
"4748",46031,"South Dakota","Corson County","API_combo",7,6,-1,-15.38,"undercount"
"4749",46033,"South Dakota","Custer County","API_alone",18,14,-4,-25,"undercount"
"4750",46033,"South Dakota","Custer County","API_combo",18,43,25,81.97,"overcount"
"4751",46035,"South Dakota","Davison County","API_alone",94,87,-7,-7.73,"undercount"
"4752",46035,"South Dakota","Davison County","API_combo",94,123,29,26.73,"overcount"
"4753",46037,"South Dakota","Day County","API_alone",6,7,1,15.38,"overcount"
"4754",46037,"South Dakota","Day County","API_combo",6,12,6,66.67,"overcount"
"4755",46039,"South Dakota","Deuel County","API_alone",19,9,-10,-71.43,"undercount"
"4756",46039,"South Dakota","Deuel County","API_combo",19,21,2,10,"overcount"
"4757",46041,"South Dakota","Dewey County","API_alone",16,10,-6,-46.15,"undercount"
"4758",46041,"South Dakota","Dewey County","API_combo",16,17,1,6.06,"overcount"
"4759",46043,"South Dakota","Douglas County","API_alone",1,5,4,133.33,"overcount"
"4760",46043,"South Dakota","Douglas County","API_combo",1,5,4,133.33,"overcount"
"4761",46045,"South Dakota","Edmunds County","API_alone",5,5,0,0,"equal"
"4762",46045,"South Dakota","Edmunds County","API_combo",5,11,6,75,"overcount"
"4763",46047,"South Dakota","Fall River County","API_alone",37,22,-15,-50.85,"undercount"
"4764",46047,"South Dakota","Fall River County","API_combo",37,41,4,10.26,"overcount"
"4765",46049,"South Dakota","Faulk County","API_alone",1,1,0,0,"equal"
"4766",46049,"South Dakota","Faulk County","API_combo",1,1,0,0,"equal"
"4767",46051,"South Dakota","Grant County","API_alone",22,18,-4,-20,"undercount"
"4768",46051,"South Dakota","Grant County","API_combo",22,25,3,12.77,"overcount"
"4769",46053,"South Dakota","Gregory County","API_alone",5,11,6,75,"overcount"
"4770",46053,"South Dakota","Gregory County","API_combo",5,23,18,128.57,"overcount"
"4771",46055,"South Dakota","Haakon County","API_alone",25,2,-23,-170.37,"undercount"
"4772",46055,"South Dakota","Haakon County","API_combo",25,4,-21,-144.83,"undercount"
"4773",46057,"South Dakota","Hamlin County","API_alone",14,10,-4,-33.33,"undercount"
"4774",46057,"South Dakota","Hamlin County","API_combo",14,19,5,30.3,"overcount"
"4775",46059,"South Dakota","Hand County","API_alone",15,3,-12,-133.33,"undercount"
"4776",46059,"South Dakota","Hand County","API_combo",15,9,-6,-50,"undercount"
"4777",46061,"South Dakota","Hanson County","API_alone",0,5,5,200,"overcount"
"4778",46061,"South Dakota","Hanson County","API_combo",0,9,9,200,"overcount"
"4779",46063,"South Dakota","Harding County","API_alone",35,8,-27,-125.58,"undercount"
"4780",46063,"South Dakota","Harding County","API_combo",35,8,-27,-125.58,"undercount"
"4781",46065,"South Dakota","Hughes County","API_alone",63,70,7,10.53,"overcount"
"4782",46065,"South Dakota","Hughes County","API_combo",63,99,36,44.44,"overcount"
"4783",46067,"South Dakota","Hutchinson County","API_alone",15,8,-7,-60.87,"undercount"
"4784",46067,"South Dakota","Hutchinson County","API_combo",15,9,-6,-50,"undercount"
"4785",46069,"South Dakota","Hyde County","API_alone",4,2,-2,-66.67,"undercount"
"4786",46069,"South Dakota","Hyde County","API_combo",4,2,-2,-66.67,"undercount"
"4787",46071,"South Dakota","Jackson County","API_alone",7,2,-5,-111.11,"undercount"
"4788",46071,"South Dakota","Jackson County","API_combo",7,6,-1,-15.38,"undercount"
"4789",46073,"South Dakota","Jerauld County","API_alone",7,3,-4,-80,"undercount"
"4790",46073,"South Dakota","Jerauld County","API_combo",7,3,-4,-80,"undercount"
"4791",46075,"South Dakota","Jones County","API_alone",0,1,1,200,"overcount"
"4792",46075,"South Dakota","Jones County","API_combo",0,1,1,200,"overcount"
"4793",46077,"South Dakota","Kingsbury County","API_alone",7,23,16,106.67,"overcount"
"4794",46077,"South Dakota","Kingsbury County","API_combo",7,32,25,128.21,"overcount"
"4795",46079,"South Dakota","Lake County","API_alone",45,62,17,31.78,"overcount"
"4796",46079,"South Dakota","Lake County","API_combo",45,70,25,43.48,"overcount"
"4797",46081,"South Dakota","Lawrence County","API_alone",88,84,-4,-4.65,"undercount"
"4798",46081,"South Dakota","Lawrence County","API_combo",88,126,38,35.51,"overcount"
"4799",46083,"South Dakota","Lincoln County","API_alone",89,116,27,26.34,"overcount"
"4800",46083,"South Dakota","Lincoln County","API_combo",89,171,82,63.08,"overcount"
"4801",46085,"South Dakota","Lyman County","API_alone",5,9,4,57.14,"overcount"
"4802",46085,"South Dakota","Lyman County","API_combo",5,21,16,123.08,"overcount"
"4803",46087,"South Dakota","McCook County","API_alone",7,13,6,60,"overcount"
"4804",46087,"South Dakota","McCook County","API_combo",7,15,8,72.73,"overcount"
"4805",46089,"South Dakota","McPherson County","API_alone",2,4,2,66.67,"overcount"
"4806",46089,"South Dakota","McPherson County","API_combo",2,5,3,85.71,"overcount"
"4807",46091,"South Dakota","Marshall County","API_alone",3,4,1,28.57,"overcount"
"4808",46091,"South Dakota","Marshall County","API_combo",3,11,8,114.29,"overcount"
"4809",46093,"South Dakota","Meade County","API_alone",240,177,-63,-30.22,"undercount"
"4810",46093,"South Dakota","Meade County","API_combo",240,335,95,33.04,"overcount"
"4811",46095,"South Dakota","Mellette County","API_alone",3,2,-1,-40,"undercount"
"4812",46095,"South Dakota","Mellette County","API_combo",3,5,2,50,"overcount"
"4813",46097,"South Dakota","Miner County","API_alone",18,3,-15,-142.86,"undercount"
"4814",46097,"South Dakota","Miner County","API_combo",18,4,-14,-127.27,"undercount"
"4815",46099,"South Dakota","Minnehaha County","API_alone",1287,1604,317,21.93,"overcount"
"4816",46099,"South Dakota","Minnehaha County","API_combo",1287,2087,800,47.42,"overcount"
"4817",46101,"South Dakota","Moody County","API_alone",21,37,16,55.17,"overcount"
"4818",46101,"South Dakota","Moody County","API_combo",21,52,31,84.93,"overcount"
"4819",46103,"South Dakota","Pennington County","API_alone",1409,844,-565,-50.16,"undercount"
"4820",46103,"South Dakota","Pennington County","API_combo",1409,1284,-125,-9.28,"undercount"
"4821",46105,"South Dakota","Perkins County","API_alone",5,8,3,46.15,"overcount"
"4822",46105,"South Dakota","Perkins County","API_combo",5,9,4,57.14,"overcount"
"4823",46107,"South Dakota","Potter County","API_alone",1,5,4,133.33,"overcount"
"4824",46107,"South Dakota","Potter County","API_combo",1,15,14,175,"overcount"
"4825",46109,"South Dakota","Roberts County","API_alone",12,24,12,66.67,"overcount"
"4826",46109,"South Dakota","Roberts County","API_combo",12,35,23,97.87,"overcount"
"4827",46111,"South Dakota","Sanborn County","API_alone",12,12,0,0,"equal"
"4828",46111,"South Dakota","Sanborn County","API_combo",12,14,2,15.38,"overcount"
"4829",46113,"South Dakota","Shannon County","API_alone",26,10,-16,-88.89,"undercount"
"4830",46113,"South Dakota","Shannon County","API_combo",26,19,-7,-31.11,"undercount"
"4831",46115,"South Dakota","Spink County","API_alone",2,8,6,120,"overcount"
"4832",46115,"South Dakota","Spink County","API_combo",2,16,14,155.56,"overcount"
"4833",46117,"South Dakota","Stanley County","API_alone",0,8,8,200,"overcount"
"4834",46117,"South Dakota","Stanley County","API_combo",0,9,9,200,"overcount"
"4835",46119,"South Dakota","Sully County","API_alone",0,2,2,200,"overcount"
"4836",46119,"South Dakota","Sully County","API_combo",0,5,5,200,"overcount"
"4837",46121,"South Dakota","Todd County","API_alone",15,13,-2,-14.29,"undercount"
"4838",46121,"South Dakota","Todd County","API_combo",15,21,6,33.33,"overcount"
"4839",46123,"South Dakota","Tripp County","API_alone",9,4,-5,-76.92,"undercount"
"4840",46123,"South Dakota","Tripp County","API_combo",9,9,0,0,"equal"
"4841",46125,"South Dakota","Turner County","API_alone",5,15,10,100,"overcount"
"4842",46125,"South Dakota","Turner County","API_combo",5,24,19,131.03,"overcount"
"4843",46127,"South Dakota","Union County","API_alone",53,170,117,104.93,"overcount"
"4844",46127,"South Dakota","Union County","API_combo",53,199,146,115.87,"overcount"
"4845",46129,"South Dakota","Walworth County","API_alone",16,11,-5,-37.04,"undercount"
"4846",46129,"South Dakota","Walworth County","API_combo",16,13,-3,-20.69,"undercount"
"4847",46135,"South Dakota","Yankton County","API_alone",99,96,-3,-3.08,"undercount"
"4848",46135,"South Dakota","Yankton County","API_combo",99,132,33,28.57,"overcount"
"4849",46137,"South Dakota","Ziebach County","API_alone",6,2,-4,-100,"undercount"
"4850",46137,"South Dakota","Ziebach County","API_combo",6,3,-3,-66.67,"undercount"
"4851",47001,"Tennessee","Anderson County","API_alone",973,617,-356,-44.78,"undercount"
"4852",47001,"Tennessee","Anderson County","API_combo",973,778,-195,-22.27,"undercount"
"4853",47003,"Tennessee","Bedford County","API_alone",302,208,-94,-36.86,"undercount"
"4854",47003,"Tennessee","Bedford County","API_combo",302,241,-61,-22.47,"undercount"
"4855",47005,"Tennessee","Benton County","API_alone",68,44,-24,-42.86,"undercount"
"4856",47005,"Tennessee","Benton County","API_combo",68,72,4,5.71,"overcount"
"4857",47007,"Tennessee","Bledsoe County","API_alone",5,17,12,109.09,"overcount"
"4858",47007,"Tennessee","Bledsoe County","API_combo",5,36,31,151.22,"overcount"
"4859",47009,"Tennessee","Blount County","API_alone",791,805,14,1.75,"overcount"
"4860",47009,"Tennessee","Blount County","API_combo",791,961,170,19.41,"overcount"
"4861",47011,"Tennessee","Bradley County","API_alone",454,542,88,17.67,"overcount"
"4862",47011,"Tennessee","Bradley County","API_combo",454,710,256,43.99,"overcount"
"4863",47013,"Tennessee","Campbell County","API_alone",77,78,1,1.29,"overcount"
"4864",47013,"Tennessee","Campbell County","API_combo",77,124,47,46.77,"overcount"
"4865",47015,"Tennessee","Cannon County","API_alone",30,18,-12,-50,"undercount"
"4866",47015,"Tennessee","Cannon County","API_combo",30,28,-2,-6.9,"undercount"
"4867",47017,"Tennessee","Carroll County","API_alone",19,55,36,97.3,"overcount"
"4868",47017,"Tennessee","Carroll County","API_combo",19,95,76,133.33,"overcount"
"4869",47019,"Tennessee","Carter County","API_alone",235,152,-83,-42.89,"undercount"
"4870",47019,"Tennessee","Carter County","API_combo",235,232,-3,-1.28,"undercount"
"4871",47021,"Tennessee","Cheatham County","API_alone",93,87,-6,-6.67,"undercount"
"4872",47021,"Tennessee","Cheatham County","API_combo",93,124,31,28.57,"overcount"
"4873",47023,"Tennessee","Chester County","API_alone",37,41,4,10.26,"overcount"
"4874",47023,"Tennessee","Chester County","API_combo",37,79,42,72.41,"overcount"
"4875",47025,"Tennessee","Claiborne County","API_alone",187,88,-99,-72,"undercount"
"4876",47025,"Tennessee","Claiborne County","API_combo",187,169,-18,-10.11,"undercount"
"4877",47027,"Tennessee","Clay County","API_alone",4,21,17,136,"overcount"
"4878",47027,"Tennessee","Clay County","API_combo",4,26,22,146.67,"overcount"
"4879",47029,"Tennessee","Cocke County","API_alone",47,65,18,32.14,"overcount"
"4880",47029,"Tennessee","Cocke County","API_combo",47,103,56,74.67,"overcount"
"4881",47031,"Tennessee","Coffee County","API_alone",487,375,-112,-25.99,"undercount"
"4882",47031,"Tennessee","Coffee County","API_combo",487,459,-28,-5.92,"undercount"
"4883",47033,"Tennessee","Crockett County","API_alone",11,9,-2,-20,"undercount"
"4884",47033,"Tennessee","Crockett County","API_combo",11,21,10,62.5,"overcount"
"4885",47035,"Tennessee","Cumberland County","API_alone",113,127,14,11.67,"overcount"
"4886",47035,"Tennessee","Cumberland County","API_combo",113,184,71,47.81,"overcount"
"4887",47037,"Tennessee","Davidson County","API_alone",11746,14255,2509,19.3,"overcount"
"4888",47037,"Tennessee","Davidson County","API_combo",11746,16936,5190,36.19,"overcount"
"4889",47039,"Tennessee","Decatur County","API_alone",30,26,-4,-14.29,"undercount"
"4890",47039,"Tennessee","Decatur County","API_combo",30,39,9,26.09,"overcount"
"4891",47041,"Tennessee","DeKalb County","API_alone",24,30,6,22.22,"overcount"
"4892",47041,"Tennessee","DeKalb County","API_combo",24,44,20,58.82,"overcount"
"4893",47043,"Tennessee","Dickson County","API_alone",150,122,-28,-20.59,"undercount"
"4894",47043,"Tennessee","Dickson County","API_combo",150,189,39,23.01,"overcount"
"4895",47045,"Tennessee","Dyer County","API_alone",107,135,28,23.14,"overcount"
"4896",47045,"Tennessee","Dyer County","API_combo",107,176,69,48.76,"overcount"
"4897",47047,"Tennessee","Fayette County","API_alone",48,65,17,30.09,"overcount"
"4898",47047,"Tennessee","Fayette County","API_combo",48,100,52,70.27,"overcount"
"4899",47049,"Tennessee","Fentress County","API_alone",35,16,-19,-74.51,"undercount"
"4900",47049,"Tennessee","Fentress County","API_combo",35,30,-5,-15.38,"undercount"
"4901",47051,"Tennessee","Franklin County","API_alone",150,177,27,16.51,"overcount"
"4902",47051,"Tennessee","Franklin County","API_combo",150,242,92,46.94,"overcount"
"4903",47053,"Tennessee","Gibson County","API_alone",99,83,-16,-17.58,"undercount"
"4904",47053,"Tennessee","Gibson County","API_combo",99,132,33,28.57,"overcount"
"4905",47055,"Tennessee","Giles County","API_alone",96,108,12,11.76,"overcount"
"4906",47055,"Tennessee","Giles County","API_combo",96,144,48,40,"overcount"
"4907",47057,"Tennessee","Grainger County","API_alone",18,23,5,24.39,"overcount"
"4908",47057,"Tennessee","Grainger County","API_combo",18,33,15,58.82,"overcount"
"4909",47059,"Tennessee","Greene County","API_alone",133,186,53,33.23,"overcount"
"4910",47059,"Tennessee","Greene County","API_combo",133,224,91,50.98,"overcount"
"4911",47061,"Tennessee","Grundy County","API_alone",12,24,12,66.67,"overcount"
"4912",47061,"Tennessee","Grundy County","API_combo",12,35,23,97.87,"overcount"
"4913",47063,"Tennessee","Hamblen County","API_alone",241,377,136,44.01,"overcount"
"4914",47063,"Tennessee","Hamblen County","API_combo",241,451,210,60.69,"overcount"
"4915",47065,"Tennessee","Hamilton County","API_alone",4096,4229,133,3.2,"overcount"
"4916",47065,"Tennessee","Hamilton County","API_combo",4096,4933,837,18.54,"overcount"
"4917",47067,"Tennessee","Hancock County","API_alone",1,6,5,142.86,"overcount"
"4918",47067,"Tennessee","Hancock County","API_combo",1,12,11,169.23,"overcount"
"4919",47069,"Tennessee","Hardeman County","API_alone",111,93,-18,-17.65,"undercount"
"4920",47069,"Tennessee","Hardeman County","API_combo",111,139,28,22.4,"overcount"
"4921",47071,"Tennessee","Hardin County","API_alone",73,47,-26,-43.33,"undercount"
"4922",47071,"Tennessee","Hardin County","API_combo",73,70,-3,-4.2,"undercount"
"4923",47073,"Tennessee","Hawkins County","API_alone",110,135,25,20.41,"overcount"
"4924",47073,"Tennessee","Hawkins County","API_combo",110,180,70,48.28,"overcount"
"4925",47075,"Tennessee","Haywood County","API_alone",27,28,1,3.64,"overcount"
"4926",47075,"Tennessee","Haywood County","API_combo",27,48,21,56,"overcount"
"4927",47077,"Tennessee","Henderson County","API_alone",37,39,2,5.26,"overcount"
"4928",47077,"Tennessee","Henderson County","API_combo",37,54,17,37.36,"overcount"
"4929",47079,"Tennessee","Henry County","API_alone",99,95,-4,-4.12,"undercount"
"4930",47079,"Tennessee","Henry County","API_combo",99,131,32,27.83,"overcount"
"4931",47081,"Tennessee","Hickman County","API_alone",24,23,-1,-4.26,"undercount"
"4932",47081,"Tennessee","Hickman County","API_combo",24,46,22,62.86,"overcount"
"4933",47083,"Tennessee","Houston County","API_alone",9,15,6,50,"overcount"
"4934",47083,"Tennessee","Houston County","API_combo",9,28,19,102.7,"overcount"
"4935",47085,"Tennessee","Humphreys County","API_alone",52,52,0,0,"equal"
"4936",47085,"Tennessee","Humphreys County","API_combo",52,73,21,33.6,"overcount"
"4937",47087,"Tennessee","Jackson County","API_alone",31,10,-21,-102.44,"undercount"
"4938",47087,"Tennessee","Jackson County","API_combo",31,19,-12,-48,"undercount"
"4939",47089,"Tennessee","Jefferson County","API_alone",95,140,45,38.3,"overcount"
"4940",47089,"Tennessee","Jefferson County","API_combo",95,184,89,63.8,"overcount"
"4941",47091,"Tennessee","Johnson County","API_alone",29,26,-3,-10.91,"undercount"
"4942",47091,"Tennessee","Johnson County","API_combo",29,43,14,38.89,"overcount"
"4943",47093,"Tennessee","Knox County","API_alone",6080,5143,-937,-16.7,"undercount"
"4944",47093,"Tennessee","Knox County","API_combo",6080,6064,-16,-0.26,"undercount"
"4945",47095,"Tennessee","Lake County","API_alone",3,16,13,136.84,"overcount"
"4946",47095,"Tennessee","Lake County","API_combo",3,37,34,170,"overcount"
"4947",47097,"Tennessee","Lauderdale County","API_alone",31,51,20,48.78,"overcount"
"4948",47097,"Tennessee","Lauderdale County","API_combo",31,73,42,80.77,"overcount"
"4949",47099,"Tennessee","Lawrence County","API_alone",144,109,-35,-27.67,"undercount"
"4950",47099,"Tennessee","Lawrence County","API_combo",144,153,9,6.06,"overcount"
"4951",47101,"Tennessee","Lewis County","API_alone",14,21,7,40,"overcount"
"4952",47101,"Tennessee","Lewis County","API_combo",14,30,16,72.73,"overcount"
"4953",47103,"Tennessee","Lincoln County","API_alone",107,110,3,2.76,"overcount"
"4954",47103,"Tennessee","Lincoln County","API_combo",107,159,52,39.1,"overcount"
"4955",47105,"Tennessee","Loudon County","API_alone",106,95,-11,-10.95,"undercount"
"4956",47105,"Tennessee","Loudon County","API_combo",106,154,48,36.92,"overcount"
"4957",47107,"Tennessee","McMinn County","API_alone",208,357,149,52.74,"overcount"
"4958",47107,"Tennessee","McMinn County","API_combo",208,424,216,68.35,"overcount"
"4959",47109,"Tennessee","McNairy County","API_alone",70,43,-27,-47.79,"undercount"
"4960",47109,"Tennessee","McNairy County","API_combo",70,83,13,16.99,"overcount"
"4961",47111,"Tennessee","Macon County","API_alone",21,62,41,98.8,"overcount"
"4962",47111,"Tennessee","Macon County","API_combo",21,81,60,117.65,"overcount"
"4963",47113,"Tennessee","Madison County","API_alone",452,617,165,30.87,"overcount"
"4964",47113,"Tennessee","Madison County","API_combo",452,799,347,55.48,"overcount"
"4965",47115,"Tennessee","Marion County","API_alone",55,64,9,15.13,"overcount"
"4966",47115,"Tennessee","Marion County","API_combo",55,93,38,51.35,"overcount"
"4967",47117,"Tennessee","Marshall County","API_alone",125,88,-37,-34.74,"undercount"
"4968",47117,"Tennessee","Marshall County","API_combo",125,120,-5,-4.08,"undercount"
"4969",47119,"Tennessee","Maury County","API_alone",351,260,-91,-29.79,"undercount"
"4970",47119,"Tennessee","Maury County","API_combo",351,359,8,2.25,"overcount"
"4971",47121,"Tennessee","Meigs County","API_alone",7,20,13,96.3,"overcount"
"4972",47121,"Tennessee","Meigs County","API_combo",7,31,24,126.32,"overcount"
"4973",47123,"Tennessee","Monroe County","API_alone",120,158,38,27.34,"overcount"
"4974",47123,"Tennessee","Monroe County","API_combo",120,223,103,60.06,"overcount"
"4975",47125,"Tennessee","Montgomery County","API_alone",3844,2894,-950,-28.2,"undercount"
"4976",47125,"Tennessee","Montgomery County","API_combo",3844,4176,332,8.28,"overcount"
"4977",47127,"Tennessee","Moore County","API_alone",3,8,5,90.91,"overcount"
"4978",47127,"Tennessee","Moore County","API_combo",3,12,9,120,"overcount"
"4979",47129,"Tennessee","Morgan County","API_alone",38,28,-10,-30.3,"undercount"
"4980",47129,"Tennessee","Morgan County","API_combo",38,46,8,19.05,"overcount"
"4981",47131,"Tennessee","Obion County","API_alone",68,77,9,12.41,"overcount"
"4982",47131,"Tennessee","Obion County","API_combo",68,117,49,52.97,"overcount"
"4983",47133,"Tennessee","Overton County","API_alone",6,29,23,131.43,"overcount"
"4984",47133,"Tennessee","Overton County","API_combo",6,40,34,147.83,"overcount"
"4985",47135,"Tennessee","Perry County","API_alone",13,18,5,32.26,"overcount"
"4986",47135,"Tennessee","Perry County","API_combo",13,22,9,51.43,"overcount"
"4987",47137,"Tennessee","Pickett County","API_alone",3,2,-1,-40,"undercount"
"4988",47137,"Tennessee","Pickett County","API_combo",3,2,-1,-40,"undercount"
"4989",47139,"Tennessee","Polk County","API_alone",81,22,-59,-114.56,"undercount"
"4990",47139,"Tennessee","Polk County","API_combo",81,41,-40,-65.57,"undercount"
"4991",47141,"Tennessee","Putnam County","API_alone",837,658,-179,-23.95,"undercount"
"4992",47141,"Tennessee","Putnam County","API_combo",837,782,-55,-6.79,"undercount"
"4993",47143,"Tennessee","Rhea County","API_alone",115,95,-20,-19.05,"undercount"
"4994",47143,"Tennessee","Rhea County","API_combo",115,132,17,13.77,"overcount"
"4995",47145,"Tennessee","Roane County","API_alone",336,233,-103,-36.2,"undercount"
"4996",47145,"Tennessee","Roane County","API_combo",336,301,-35,-10.99,"undercount"
"4997",47147,"Tennessee","Robertson County","API_alone",104,194,90,60.4,"overcount"
"4998",47147,"Tennessee","Robertson County","API_combo",104,271,167,89.07,"overcount"
"4999",47149,"Tennessee","Rutherford County","API_alone",3998,3681,-317,-8.26,"undercount"
"5000",47149,"Tennessee","Rutherford County","API_combo",3998,4224,226,5.5,"overcount"
"5001",47151,"Tennessee","Scott County","API_alone",27,25,-2,-7.69,"undercount"
"5002",47151,"Tennessee","Scott County","API_combo",27,38,11,33.85,"overcount"
"5003",47153,"Tennessee","Sequatchie County","API_alone",11,18,7,48.28,"overcount"
"5004",47153,"Tennessee","Sequatchie County","API_combo",11,24,13,74.29,"overcount"
"5005",47155,"Tennessee","Sevier County","API_alone",432,415,-17,-4.01,"undercount"
"5006",47155,"Tennessee","Sevier County","API_combo",432,501,69,14.79,"overcount"
"5007",47157,"Tennessee","Shelby County","API_alone",12813,15408,2595,18.39,"overcount"
"5008",47157,"Tennessee","Shelby County","API_combo",12813,17876,5063,33,"overcount"
"5009",47159,"Tennessee","Smith County","API_alone",27,31,4,13.79,"overcount"
"5010",47159,"Tennessee","Smith County","API_combo",27,53,26,65,"overcount"
"5011",47161,"Tennessee","Stewart County","API_alone",57,187,130,106.56,"overcount"
"5012",47161,"Tennessee","Stewart County","API_combo",57,219,162,117.39,"overcount"
"5013",47163,"Tennessee","Sullivan County","API_alone",827,688,-139,-18.35,"undercount"
"5014",47163,"Tennessee","Sullivan County","API_combo",827,880,53,6.21,"overcount"
"5015",47165,"Tennessee","Sumner County","API_alone",710,931,221,26.93,"overcount"
"5016",47165,"Tennessee","Sumner County","API_combo",710,1197,487,51.07,"overcount"
"5017",47167,"Tennessee","Tipton County","API_alone",216,225,9,4.08,"overcount"
"5018",47167,"Tennessee","Tipton County","API_combo",216,376,160,54.05,"overcount"
"5019",47169,"Tennessee","Trousdale County","API_alone",14,10,-4,-33.33,"undercount"
"5020",47169,"Tennessee","Trousdale County","API_combo",14,10,-4,-33.33,"undercount"
"5021",47171,"Tennessee","Unicoi County","API_alone",22,20,-2,-9.52,"undercount"
"5022",47171,"Tennessee","Unicoi County","API_combo",22,48,26,74.29,"overcount"
"5023",47173,"Tennessee","Union County","API_alone",12,32,20,90.91,"overcount"
"5024",47173,"Tennessee","Union County","API_combo",12,49,37,121.31,"overcount"
"5025",47175,"Tennessee","Van Buren County","API_alone",2,4,2,66.67,"overcount"
"5026",47175,"Tennessee","Van Buren County","API_combo",2,5,3,85.71,"overcount"
"5027",47177,"Tennessee","Warren County","API_alone",219,188,-31,-15.23,"undercount"
"5028",47177,"Tennessee","Warren County","API_combo",219,243,24,10.39,"overcount"
"5029",47179,"Tennessee","Washington County","API_alone",682,825,143,18.98,"overcount"
"5030",47179,"Tennessee","Washington County","API_combo",682,995,313,37.33,"overcount"
"5031",47181,"Tennessee","Wayne County","API_alone",22,44,22,66.67,"overcount"
"5032",47181,"Tennessee","Wayne County","API_combo",22,58,36,90,"overcount"
"5033",47183,"Tennessee","Weakley County","API_alone",381,466,85,20.07,"overcount"
"5034",47183,"Tennessee","Weakley County","API_combo",381,518,137,30.48,"overcount"
"5035",47185,"Tennessee","White County","API_alone",47,66,19,33.63,"overcount"
"5036",47185,"Tennessee","White County","API_combo",47,104,57,75.5,"overcount"
"5037",47187,"Tennessee","Williamson County","API_alone",1136,1640,504,36.31,"overcount"
"5038",47187,"Tennessee","Williamson County","API_combo",1136,1919,783,51.26,"overcount"
"5039",47189,"Tennessee","Wilson County","API_alone",537,480,-57,-11.21,"undercount"
"5040",47189,"Tennessee","Wilson County","API_combo",537,624,87,14.99,"overcount"
"5041",48001,"Texas","Anderson County","API_alone",323,278,-45,-14.98,"undercount"
"5042",48001,"Texas","Anderson County","API_combo",323,374,51,14.63,"overcount"
"5043",48003,"Texas","Andrews County","API_alone",241,106,-135,-77.81,"undercount"
"5044",48003,"Texas","Andrews County","API_combo",241,118,-123,-68.52,"undercount"
"5045",48005,"Texas","Angelina County","API_alone",628,589,-39,-6.41,"undercount"
"5046",48005,"Texas","Angelina County","API_combo",628,671,43,6.62,"overcount"
"5047",48007,"Texas","Aransas County","API_alone",1184,652,-532,-57.95,"undercount"
"5048",48007,"Texas","Aransas County","API_combo",1184,726,-458,-47.96,"undercount"
"5049",48009,"Texas","Archer County","API_alone",9,14,5,43.48,"overcount"
"5050",48009,"Texas","Archer County","API_combo",9,25,16,94.12,"overcount"
"5051",48011,"Texas","Armstrong County","API_alone",17,0,-17,-200,"undercount"
"5052",48011,"Texas","Armstrong County","API_combo",17,0,-17,-200,"undercount"
"5053",48013,"Texas","Atascosa County","API_alone",110,186,76,51.35,"overcount"
"5054",48013,"Texas","Atascosa County","API_combo",110,248,138,77.09,"overcount"
"5055",48015,"Texas","Austin County","API_alone",55,79,24,35.82,"overcount"
"5056",48015,"Texas","Austin County","API_combo",55,111,56,67.47,"overcount"
"5057",48017,"Texas","Bailey County","API_alone",12,17,5,34.48,"overcount"
"5058",48017,"Texas","Bailey County","API_combo",12,28,16,80,"overcount"
"5059",48019,"Texas","Bandera County","API_alone",71,61,-10,-15.15,"undercount"
"5060",48019,"Texas","Bandera County","API_combo",71,103,32,36.78,"overcount"
"5061",48021,"Texas","Bastrop County","API_alone",328,346,18,5.34,"overcount"
"5062",48021,"Texas","Bastrop County","API_combo",328,493,165,40.19,"overcount"
"5063",48023,"Texas","Baylor County","API_alone",24,26,2,8,"overcount"
"5064",48023,"Texas","Baylor County","API_combo",24,30,6,22.22,"overcount"
"5065",48025,"Texas","Bee County","API_alone",357,245,-112,-37.21,"undercount"
"5066",48025,"Texas","Bee County","API_combo",357,308,-49,-14.74,"undercount"
"5067",48027,"Texas","Bell County","API_alone",11269,7662,-3607,-38.11,"undercount"
"5068",48027,"Texas","Bell County","API_combo",11269,10610,-659,-6.02,"undercount"
"5069",48029,"Texas","Bexar County","API_alone",27551,26570,-981,-3.63,"undercount"
"5070",48029,"Texas","Bexar County","API_combo",27551,34304,6753,21.83,"overcount"
"5071",48031,"Texas","Blanco County","API_alone",51,17,-34,-100,"undercount"
"5072",48031,"Texas","Blanco County","API_combo",51,27,-24,-61.54,"undercount"
"5073",48033,"Texas","Borden County","API_alone",1,0,-1,-200,"undercount"
"5074",48033,"Texas","Borden County","API_combo",1,2,1,66.67,"overcount"
"5075",48035,"Texas","Bosque County","API_alone",102,33,-69,-102.22,"undercount"
"5076",48035,"Texas","Bosque County","API_combo",102,45,-57,-77.55,"undercount"
"5077",48037,"Texas","Bowie County","API_alone",438,451,13,2.92,"overcount"
"5078",48037,"Texas","Bowie County","API_combo",438,610,172,32.82,"overcount"
"5079",48039,"Texas","Brazoria County","API_alone",4047,5168,1121,24.33,"overcount"
"5080",48039,"Texas","Brazoria County","API_combo",4047,5855,1808,36.52,"overcount"
"5081",48041,"Texas","Brazos County","API_alone",6947,6419,-528,-7.9,"undercount"
"5082",48041,"Texas","Brazos County","API_combo",6947,7038,91,1.3,"overcount"
"5083",48043,"Texas","Brewster County","API_alone",74,46,-28,-46.67,"undercount"
"5084",48043,"Texas","Brewster County","API_combo",74,78,4,5.26,"overcount"
"5085",48045,"Texas","Briscoe County","API_alone",9,1,-8,-160,"undercount"
"5086",48045,"Texas","Briscoe County","API_combo",9,7,-2,-25,"undercount"
"5087",48047,"Texas","Brooks County","API_alone",10,15,5,40,"overcount"
"5088",48047,"Texas","Brooks County","API_combo",10,18,8,57.14,"overcount"
"5089",48049,"Texas","Brown County","API_alone",161,159,-2,-1.25,"undercount"
"5090",48049,"Texas","Brown County","API_combo",161,217,56,29.63,"overcount"
"5091",48051,"Texas","Burleson County","API_alone",56,35,-21,-46.15,"undercount"
"5092",48051,"Texas","Burleson County","API_combo",56,65,9,14.88,"overcount"
"5093",48053,"Texas","Burnet County","API_alone",202,125,-77,-47.09,"undercount"
"5094",48053,"Texas","Burnet County","API_combo",202,188,-14,-7.18,"undercount"
"5095",48055,"Texas","Caldwell County","API_alone",169,166,-3,-1.79,"undercount"
"5096",48055,"Texas","Caldwell County","API_combo",169,220,51,26.22,"overcount"
"5097",48057,"Texas","Calhoun County","API_alone",855,726,-129,-16.32,"undercount"
"5098",48057,"Texas","Calhoun County","API_combo",855,765,-90,-11.11,"undercount"
"5099",48059,"Texas","Callahan County","API_alone",92,62,-30,-38.96,"undercount"
"5100",48059,"Texas","Callahan County","API_combo",92,96,4,4.26,"overcount"
"5101",48061,"Texas","Cameron County","API_alone",1454,2062,608,34.58,"overcount"
"5102",48061,"Texas","Cameron County","API_combo",1454,2427,973,50.14,"overcount"
"5103",48063,"Texas","Camp County","API_alone",11,38,27,110.2,"overcount"
"5104",48063,"Texas","Camp County","API_combo",11,47,36,124.14,"overcount"
"5105",48065,"Texas","Carson County","API_alone",13,10,-3,-26.09,"undercount"
"5106",48065,"Texas","Carson County","API_combo",13,15,2,14.29,"overcount"
"5107",48067,"Texas","Cass County","API_alone",46,49,3,6.32,"overcount"
"5108",48067,"Texas","Cass County","API_combo",46,91,45,65.69,"overcount"
"5109",48069,"Texas","Castro County","API_alone",25,8,-17,-103.03,"undercount"
"5110",48069,"Texas","Castro County","API_combo",25,10,-15,-85.71,"undercount"
"5111",48071,"Texas","Chambers County","API_alone",238,193,-45,-20.88,"undercount"
"5112",48071,"Texas","Chambers County","API_combo",238,237,-1,-0.42,"undercount"
"5113",48073,"Texas","Cherokee County","API_alone",317,243,-74,-26.43,"undercount"
"5114",48073,"Texas","Cherokee County","API_combo",317,322,5,1.56,"overcount"
"5115",48075,"Texas","Childress County","API_alone",28,36,8,25,"overcount"
"5116",48075,"Texas","Childress County","API_combo",28,45,17,46.58,"overcount"
"5117",48077,"Texas","Clay County","API_alone",39,12,-27,-105.88,"undercount"
"5118",48077,"Texas","Clay County","API_combo",39,22,-17,-55.74,"undercount"
"5119",48079,"Texas","Cochran County","API_alone",2,12,10,142.86,"overcount"
"5120",48079,"Texas","Cochran County","API_combo",2,12,10,142.86,"overcount"
"5121",48081,"Texas","Coke County","API_alone",5,8,3,46.15,"overcount"
"5122",48081,"Texas","Coke County","API_combo",5,11,6,75,"overcount"
"5123",48083,"Texas","Coleman County","API_alone",11,39,28,112,"overcount"
"5124",48083,"Texas","Coleman County","API_combo",11,47,36,124.14,"overcount"
"5125",48085,"Texas","Collin County","API_alone",20755,34914,14159,50.87,"overcount"
"5126",48085,"Texas","Collin County","API_combo",20755,37974,17219,58.64,"overcount"
"5127",48087,"Texas","Collingsworth County","API_alone",12,6,-6,-66.67,"undercount"
"5128",48087,"Texas","Collingsworth County","API_combo",12,10,-2,-18.18,"undercount"
"5129",48089,"Texas","Colorado County","API_alone",46,71,25,42.74,"overcount"
"5130",48089,"Texas","Colorado County","API_combo",46,108,62,80.52,"overcount"
"5131",48091,"Texas","Comal County","API_alone",437,418,-19,-4.44,"undercount"
"5132",48091,"Texas","Comal County","API_combo",437,580,143,28.12,"overcount"
"5133",48093,"Texas","Comanche County","API_alone",17,23,6,30,"overcount"
"5134",48093,"Texas","Comanche County","API_combo",17,39,22,78.57,"overcount"
"5135",48095,"Texas","Concho County","API_alone",8,8,0,0,"equal"
"5136",48095,"Texas","Concho County","API_combo",8,12,4,40,"overcount"
"5137",48097,"Texas","Cooke County","API_alone",233,142,-91,-48.53,"undercount"
"5138",48097,"Texas","Cooke County","API_combo",233,216,-17,-7.57,"undercount"
"5139",48099,"Texas","Coryell County","API_alone",3577,1764,-1813,-67.89,"undercount"
"5140",48099,"Texas","Coryell County","API_combo",3577,2640,-937,-30.14,"undercount"
"5141",48101,"Texas","Cottle County","API_alone",5,0,-5,-200,"undercount"
"5142",48101,"Texas","Cottle County","API_combo",5,0,-5,-200,"undercount"
"5143",48103,"Texas","Crane County","API_alone",14,14,0,0,"equal"
"5144",48103,"Texas","Crane County","API_combo",14,17,3,19.35,"overcount"
"5145",48105,"Texas","Crockett County","API_alone",6,17,11,95.65,"overcount"
"5146",48105,"Texas","Crockett County","API_combo",6,17,11,95.65,"overcount"
"5147",48107,"Texas","Crosby County","API_alone",9,12,3,28.57,"overcount"
"5148",48107,"Texas","Crosby County","API_combo",9,23,14,87.5,"overcount"
"5149",48109,"Texas","Culberson County","API_alone",29,22,-7,-27.45,"undercount"
"5150",48109,"Texas","Culberson County","API_combo",29,22,-7,-27.45,"undercount"
"5151",48111,"Texas","Dallam County","API_alone",29,16,-13,-57.78,"undercount"
"5152",48111,"Texas","Dallam County","API_combo",29,36,7,21.54,"overcount"
"5153",48113,"Texas","Dallas County","API_alone",93279,93950,671,0.72,"overcount"
"5154",48113,"Texas","Dallas County","API_combo",93279,102952,9673,9.86,"overcount"
"5155",48115,"Texas","Dawson County","API_alone",22,45,23,68.66,"overcount"
"5156",48115,"Texas","Dawson County","API_combo",22,53,31,82.67,"overcount"
"5157",48117,"Texas","Deaf Smith County","API_alone",85,108,23,23.83,"overcount"
"5158",48117,"Texas","Deaf Smith County","API_combo",85,125,40,38.1,"overcount"
"5159",48119,"Texas","Delta County","API_alone",13,8,-5,-47.62,"undercount"
"5160",48119,"Texas","Delta County","API_combo",13,12,-1,-8,"undercount"
"5161",48121,"Texas","Denton County","API_alone",16491,18221,1730,9.97,"overcount"
"5162",48121,"Texas","Denton County","API_combo",16491,20331,3840,20.86,"overcount"
"5163",48123,"Texas","DeWitt County","API_alone",41,66,25,46.73,"overcount"
"5164",48123,"Texas","DeWitt County","API_combo",41,85,44,69.84,"overcount"
"5165",48125,"Texas","Dickens County","API_alone",3,18,15,142.86,"overcount"
"5166",48125,"Texas","Dickens County","API_combo",3,18,15,142.86,"overcount"
"5167",48127,"Texas","Dimmit County","API_alone",22,81,59,114.56,"overcount"
"5168",48127,"Texas","Dimmit County","API_combo",22,91,69,122.12,"overcount"
"5169",48129,"Texas","Donley County","API_alone",4,4,0,0,"equal"
"5170",48129,"Texas","Donley County","API_combo",4,6,2,40,"overcount"
"5171",48131,"Texas","Duval County","API_alone",24,22,-2,-8.7,"undercount"
"5172",48131,"Texas","Duval County","API_combo",24,28,4,15.38,"overcount"
"5173",48133,"Texas","Eastland County","API_alone",57,42,-15,-30.3,"undercount"
"5174",48133,"Texas","Eastland County","API_combo",57,51,-6,-11.11,"undercount"
"5175",48135,"Texas","Ector County","API_alone",1185,929,-256,-24.22,"undercount"
"5176",48135,"Texas","Ector County","API_combo",1185,1158,-27,-2.3,"undercount"
"5177",48137,"Texas","Edwards County","API_alone",4,14,10,111.11,"overcount"
"5178",48137,"Texas","Edwards County","API_combo",4,15,11,115.79,"overcount"
"5179",48139,"Texas","Ellis County","API_alone",488,468,-20,-4.18,"undercount"
"5180",48139,"Texas","Ellis County","API_combo",488,671,183,31.58,"overcount"
"5181",48141,"Texas","El Paso County","API_alone",11316,8408,-2908,-29.49,"undercount"
"5182",48141,"Texas","El Paso County","API_combo",11316,10850,-466,-4.2,"undercount"
"5183",48143,"Texas","Erath County","API_alone",249,219,-30,-12.82,"undercount"
"5184",48143,"Texas","Erath County","API_combo",249,269,20,7.72,"overcount"
"5185",48145,"Texas","Falls County","API_alone",65,38,-27,-52.43,"undercount"
"5186",48145,"Texas","Falls County","API_combo",65,49,-16,-28.07,"undercount"
"5187",48147,"Texas","Fannin County","API_alone",112,102,-10,-9.35,"undercount"
"5188",48147,"Texas","Fannin County","API_combo",112,144,32,25,"overcount"
"5189",48149,"Texas","Fayette County","API_alone",31,63,32,68.09,"overcount"
"5190",48149,"Texas","Fayette County","API_combo",31,87,56,94.92,"overcount"
"5191",48151,"Texas","Fisher County","API_alone",1,6,5,142.86,"overcount"
"5192",48151,"Texas","Fisher County","API_combo",1,7,6,150,"overcount"
"5193",48153,"Texas","Floyd County","API_alone",62,29,-33,-72.53,"undercount"
"5194",48153,"Texas","Floyd County","API_combo",62,29,-33,-72.53,"undercount"
"5195",48155,"Texas","Foard County","API_alone",5,3,-2,-50,"undercount"
"5196",48155,"Texas","Foard County","API_combo",5,3,-2,-50,"undercount"
"5197",48157,"Texas","Fort Bend County","API_alone",34385,40942,6557,17.41,"overcount"
"5198",48157,"Texas","Fort Bend County","API_combo",34385,43251,8866,22.84,"overcount"
"5199",48159,"Texas","Franklin County","API_alone",46,20,-26,-78.79,"undercount"
"5200",48159,"Texas","Franklin County","API_combo",46,26,-20,-55.56,"undercount"
"5201",48161,"Texas","Freestone County","API_alone",96,55,-41,-54.3,"undercount"
"5202",48161,"Texas","Freestone County","API_combo",96,77,-19,-21.97,"undercount"
"5203",48163,"Texas","Frio County","API_alone",70,96,26,31.33,"overcount"
"5204",48163,"Texas","Frio County","API_combo",70,101,31,36.26,"overcount"
"5205",48165,"Texas","Gaines County","API_alone",22,32,10,37.04,"overcount"
"5206",48165,"Texas","Gaines County","API_combo",22,57,35,88.61,"overcount"
"5207",48167,"Texas","Galveston County","API_alone",6594,5684,-910,-14.82,"undercount"
"5208",48167,"Texas","Galveston County","API_combo",6594,6522,-72,-1.1,"undercount"
"5209",48169,"Texas","Garza County","API_alone",23,9,-14,-87.5,"undercount"
"5210",48169,"Texas","Garza County","API_combo",23,19,-4,-19.05,"undercount"
"5211",48171,"Texas","Gillespie County","API_alone",54,43,-11,-22.68,"undercount"
"5212",48171,"Texas","Gillespie County","API_combo",54,61,7,12.17,"overcount"
"5213",48173,"Texas","Glasscock County","API_alone",0,3,3,200,"overcount"
"5214",48173,"Texas","Glasscock County","API_combo",0,3,3,200,"overcount"
"5215",48175,"Texas","Goliad County","API_alone",12,16,4,28.57,"overcount"
"5216",48175,"Texas","Goliad County","API_combo",12,18,6,40,"overcount"
"5217",48177,"Texas","Gonzales County","API_alone",36,98,62,92.54,"overcount"
"5218",48177,"Texas","Gonzales County","API_combo",36,137,101,116.76,"overcount"
"5219",48179,"Texas","Gray County","API_alone",172,97,-75,-55.76,"undercount"
"5220",48179,"Texas","Gray County","API_combo",172,137,-35,-22.65,"undercount"
"5221",48181,"Texas","Grayson County","API_alone",762,714,-48,-6.5,"undercount"
"5222",48181,"Texas","Grayson County","API_combo",762,997,235,26.72,"overcount"
"5223",48183,"Texas","Gregg County","API_alone",893,820,-73,-8.52,"undercount"
"5224",48183,"Texas","Gregg County","API_combo",893,1005,112,11.8,"overcount"
"5225",48185,"Texas","Grimes County","API_alone",109,92,-17,-16.92,"undercount"
"5226",48185,"Texas","Grimes County","API_combo",109,133,24,19.83,"overcount"
"5227",48187,"Texas","Guadalupe County","API_alone",1058,958,-100,-9.92,"undercount"
"5228",48187,"Texas","Guadalupe County","API_combo",1058,1322,264,22.18,"overcount"
"5229",48189,"Texas","Hale County","API_alone",296,152,-144,-64.29,"undercount"
"5230",48189,"Texas","Hale County","API_combo",296,194,-102,-41.63,"undercount"
"5231",48191,"Texas","Hall County","API_alone",9,17,8,61.54,"overcount"
"5232",48191,"Texas","Hall County","API_combo",9,21,12,80,"overcount"
"5233",48193,"Texas","Hamilton County","API_alone",42,22,-20,-62.5,"undercount"
"5234",48193,"Texas","Hamilton County","API_combo",42,31,-11,-30.14,"undercount"
"5235",48195,"Texas","Hansford County","API_alone",43,16,-27,-91.53,"undercount"
"5236",48195,"Texas","Hansford County","API_combo",43,19,-24,-77.42,"undercount"
"5237",48197,"Texas","Hardeman County","API_alone",21,14,-7,-40,"undercount"
"5238",48197,"Texas","Hardeman County","API_combo",21,16,-5,-27.03,"undercount"
"5239",48199,"Texas","Hardin County","API_alone",149,120,-29,-21.56,"undercount"
"5240",48199,"Texas","Hardin County","API_combo",149,166,17,10.79,"overcount"
"5241",48201,"Texas","Harris County","API_alone",200590,184808,-15782,-8.19,"undercount"
"5242",48201,"Texas","Harris County","API_combo",200590,200666,76,0.04,"overcount"
"5243",48203,"Texas","Harrison County","API_alone",291,256,-35,-12.8,"undercount"
"5244",48203,"Texas","Harrison County","API_combo",291,374,83,24.96,"overcount"
"5245",48205,"Texas","Hartley County","API_alone",8,20,12,85.71,"overcount"
"5246",48205,"Texas","Hartley County","API_combo",8,30,22,115.79,"overcount"
"5247",48207,"Texas","Haskell County","API_alone",27,12,-15,-76.92,"undercount"
"5248",48207,"Texas","Haskell County","API_combo",27,14,-13,-63.41,"undercount"
"5249",48209,"Texas","Hays County","API_alone",926,966,40,4.23,"overcount"
"5250",48209,"Texas","Hays County","API_combo",926,1314,388,34.64,"overcount"
"5251",48211,"Texas","Hemphill County","API_alone",7,14,7,66.67,"overcount"
"5252",48211,"Texas","Hemphill County","API_combo",7,14,7,66.67,"overcount"
"5253",48213,"Texas","Henderson County","API_alone",331,265,-66,-22.15,"undercount"
"5254",48213,"Texas","Henderson County","API_combo",331,362,31,8.95,"overcount"
"5255",48215,"Texas","Hidalgo County","API_alone",2356,3978,1622,51.22,"overcount"
"5256",48215,"Texas","Hidalgo County","API_combo",2356,4457,2101,61.68,"overcount"
"5257",48217,"Texas","Hill County","API_alone",80,92,12,13.95,"overcount"
"5258",48217,"Texas","Hill County","API_combo",80,143,63,56.5,"overcount"
"5259",48219,"Texas","Hockley County","API_alone",42,58,16,32,"overcount"
"5260",48219,"Texas","Hockley County","API_combo",42,80,38,62.3,"overcount"
"5261",48221,"Texas","Hood County","API_alone",398,152,-246,-89.45,"undercount"
"5262",48221,"Texas","Hood County","API_combo",398,209,-189,-62.27,"undercount"
"5263",48223,"Texas","Hopkins County","API_alone",151,106,-45,-35.02,"undercount"
"5264",48223,"Texas","Hopkins County","API_combo",151,148,-3,-2.01,"undercount"
"5265",48225,"Texas","Houston County","API_alone",82,72,-10,-12.99,"undercount"
"5266",48225,"Texas","Houston County","API_combo",82,97,15,16.76,"overcount"
"5267",48227,"Texas","Howard County","API_alone",291,231,-60,-22.99,"undercount"
"5268",48227,"Texas","Howard County","API_combo",291,306,15,5.03,"overcount"
"5269",48229,"Texas","Hudspeth County","API_alone",2,7,5,111.11,"overcount"
"5270",48229,"Texas","Hudspeth County","API_combo",2,8,6,120,"overcount"
"5271",48231,"Texas","Hunt County","API_alone",614,509,-105,-18.7,"undercount"
"5272",48231,"Texas","Hunt County","API_combo",614,644,30,4.77,"overcount"
"5273",48233,"Texas","Hutchinson County","API_alone",304,88,-216,-110.2,"undercount"
"5274",48233,"Texas","Hutchinson County","API_combo",304,136,-168,-76.36,"undercount"
"5275",48235,"Texas","Irion County","API_alone",0,0,0,0,"equal"
"5276",48235,"Texas","Irion County","API_combo",0,0,0,0,"equal"
"5277",48237,"Texas","Jack County","API_alone",19,32,13,50.98,"overcount"
"5278",48237,"Texas","Jack County","API_combo",19,35,16,59.26,"overcount"
"5279",48239,"Texas","Jackson County","API_alone",18,80,62,126.53,"overcount"
"5280",48239,"Texas","Jackson County","API_combo",18,99,81,138.46,"overcount"
"5281",48241,"Texas","Jasper County","API_alone",71,125,54,55.1,"overcount"
"5282",48241,"Texas","Jasper County","API_combo",71,200,129,95.2,"overcount"
"5283",48243,"Texas","Jeff Davis County","API_alone",7,3,-4,-80,"undercount"
"5284",48243,"Texas","Jeff Davis County","API_combo",7,3,-4,-80,"undercount"
"5285",48245,"Texas","Jefferson County","API_alone",8070,7549,-521,-6.67,"undercount"
"5286",48245,"Texas","Jefferson County","API_combo",8070,8194,124,1.52,"overcount"
"5287",48247,"Texas","Jim Hogg County","API_alone",6,11,5,58.82,"overcount"
"5288",48247,"Texas","Jim Hogg County","API_combo",6,13,7,73.68,"overcount"
"5289",48249,"Texas","Jim Wells County","API_alone",223,266,43,17.59,"overcount"
"5290",48249,"Texas","Jim Wells County","API_combo",223,295,72,27.8,"overcount"
"5291",48251,"Texas","Johnson County","API_alone",1031,948,-83,-8.39,"undercount"
"5292",48251,"Texas","Johnson County","API_combo",1031,1246,215,18.88,"overcount"
"5293",48253,"Texas","Jones County","API_alone",116,105,-11,-9.95,"undercount"
"5294",48253,"Texas","Jones County","API_combo",116,131,15,12.15,"overcount"
"5295",48255,"Texas","Karnes County","API_alone",39,78,39,66.67,"overcount"
"5296",48255,"Texas","Karnes County","API_combo",39,107,68,93.15,"overcount"
"5297",48257,"Texas","Kaufman County","API_alone",531,397,-134,-28.88,"undercount"
"5298",48257,"Texas","Kaufman County","API_combo",531,497,-34,-6.61,"undercount"
"5299",48259,"Texas","Kendall County","API_alone",111,76,-35,-37.43,"undercount"
"5300",48259,"Texas","Kendall County","API_combo",111,118,7,6.11,"overcount"
"5301",48261,"Texas","Kenedy County","API_alone",0,7,7,200,"overcount"
"5302",48261,"Texas","Kenedy County","API_combo",0,7,7,200,"overcount"
"5303",48263,"Texas","Kent County","API_alone",0,0,0,0,"equal"
"5304",48263,"Texas","Kent County","API_combo",0,0,0,0,"equal"
"5305",48265,"Texas","Kerr County","API_alone",293,268,-25,-8.91,"undercount"
"5306",48265,"Texas","Kerr County","API_combo",293,378,85,25.34,"overcount"
"5307",48267,"Texas","Kimble County","API_alone",36,27,-9,-28.57,"undercount"
"5308",48267,"Texas","Kimble County","API_combo",36,28,-8,-25,"undercount"
"5309",48269,"Texas","King County","API_alone",0,0,0,0,"equal"
"5310",48269,"Texas","King County","API_combo",0,0,0,0,"equal"
"5311",48271,"Texas","Kinney County","API_alone",16,4,-12,-120,"undercount"
"5312",48271,"Texas","Kinney County","API_combo",16,7,-9,-78.26,"undercount"
"5313",48273,"Texas","Kleberg County","API_alone",540,547,7,1.29,"overcount"
"5314",48273,"Texas","Kleberg County","API_combo",540,648,108,18.18,"overcount"
"5315",48275,"Texas","Knox County","API_alone",6,17,11,95.65,"overcount"
"5316",48275,"Texas","Knox County","API_combo",6,24,18,120,"overcount"
"5317",48277,"Texas","Lamar County","API_alone",252,216,-36,-15.38,"undercount"
"5318",48277,"Texas","Lamar County","API_combo",252,289,37,13.68,"overcount"
"5319",48279,"Texas","Lamb County","API_alone",52,40,-12,-26.09,"undercount"
"5320",48279,"Texas","Lamb County","API_combo",52,61,9,15.93,"overcount"
"5321",48281,"Texas","Lampasas County","API_alone",354,164,-190,-73.36,"undercount"
"5322",48281,"Texas","Lampasas County","API_combo",354,253,-101,-33.28,"undercount"
"5323",48283,"Texas","La Salle County","API_alone",44,20,-24,-75,"undercount"
"5324",48283,"Texas","La Salle County","API_combo",44,24,-20,-58.82,"undercount"
"5325",48285,"Texas","Lavaca County","API_alone",33,34,1,2.99,"overcount"
"5326",48285,"Texas","Lavaca County","API_combo",33,45,12,30.77,"overcount"
"5327",48287,"Texas","Lee County","API_alone",34,44,10,25.64,"overcount"
"5328",48287,"Texas","Lee County","API_combo",34,82,48,82.76,"overcount"
"5329",48289,"Texas","Leon County","API_alone",23,35,12,41.38,"overcount"
"5330",48289,"Texas","Leon County","API_combo",23,81,58,111.54,"overcount"
"5331",48291,"Texas","Liberty County","API_alone",296,273,-23,-8.08,"undercount"
"5332",48291,"Texas","Liberty County","API_combo",296,369,73,21.95,"overcount"
"5333",48293,"Texas","Limestone County","API_alone",76,45,-31,-51.24,"undercount"
"5334",48293,"Texas","Limestone County","API_combo",76,58,-18,-26.87,"undercount"
"5335",48295,"Texas","Lipscomb County","API_alone",14,2,-12,-150,"undercount"
"5336",48295,"Texas","Lipscomb County","API_combo",14,4,-10,-111.11,"undercount"
"5337",48297,"Texas","Live Oak County","API_alone",62,37,-25,-50.51,"undercount"
"5338",48297,"Texas","Live Oak County","API_combo",62,57,-5,-8.4,"undercount"
"5339",48299,"Texas","Llano County","API_alone",47,70,23,39.32,"overcount"
"5340",48299,"Texas","Llano County","API_combo",47,84,37,56.49,"overcount"
"5341",48301,"Texas","Loving County","API_alone",0,0,0,0,"equal"
"5342",48301,"Texas","Loving County","API_combo",0,0,0,0,"equal"
"5343",48303,"Texas","Lubbock County","API_alone",4287,3489,-798,-20.52,"undercount"
"5344",48303,"Texas","Lubbock County","API_combo",4287,4108,-179,-4.26,"undercount"
"5345",48305,"Texas","Lynn County","API_alone",22,11,-11,-66.67,"undercount"
"5346",48305,"Texas","Lynn County","API_combo",22,26,4,16.67,"overcount"
"5347",48307,"Texas","McCulloch County","API_alone",12,21,9,54.55,"overcount"
"5348",48307,"Texas","McCulloch County","API_combo",12,26,14,73.68,"overcount"
"5349",48309,"Texas","McLennan County","API_alone",2400,2555,155,6.26,"overcount"
"5350",48309,"Texas","McLennan County","API_combo",2400,3165,765,27.49,"overcount"
"5351",48311,"Texas","McMullen County","API_alone",0,8,8,200,"overcount"
"5352",48311,"Texas","McMullen County","API_combo",0,8,8,200,"overcount"
"5353",48313,"Texas","Madison County","API_alone",28,54,26,63.41,"overcount"
"5354",48313,"Texas","Madison County","API_combo",28,66,38,80.85,"overcount"
"5355",48315,"Texas","Marion County","API_alone",12,25,13,70.27,"overcount"
"5356",48315,"Texas","Marion County","API_combo",12,42,30,111.11,"overcount"
"5357",48317,"Texas","Martin County","API_alone",10,8,-2,-22.22,"undercount"
"5358",48317,"Texas","Martin County","API_combo",10,15,5,40,"overcount"
"5359",48319,"Texas","Mason County","API_alone",10,3,-7,-107.69,"undercount"
"5360",48319,"Texas","Mason County","API_combo",10,6,-4,-50,"undercount"
"5361",48321,"Texas","Matagorda County","API_alone",1345,962,-383,-33.2,"undercount"
"5362",48321,"Texas","Matagorda County","API_combo",1345,1039,-306,-25.67,"undercount"
"5363",48323,"Texas","Maverick County","API_alone",172,307,135,56.37,"overcount"
"5364",48323,"Texas","Maverick County","API_combo",172,353,181,68.95,"overcount"
"5365",48325,"Texas","Medina County","API_alone",181,223,42,20.79,"overcount"
"5366",48325,"Texas","Medina County","API_combo",181,302,121,50.1,"overcount"
"5367",48327,"Texas","Menard County","API_alone",0,19,19,200,"overcount"
"5368",48327,"Texas","Menard County","API_combo",0,22,22,200,"overcount"
"5369",48329,"Texas","Midland County","API_alone",1658,1219,-439,-30.52,"undercount"
"5370",48329,"Texas","Midland County","API_combo",1658,1443,-215,-13.87,"undercount"
"5371",48331,"Texas","Milam County","API_alone",77,68,-9,-12.41,"undercount"
"5372",48331,"Texas","Milam County","API_combo",77,78,1,1.29,"overcount"
"5373",48333,"Texas","Mills County","API_alone",3,9,6,100,"overcount"
"5374",48333,"Texas","Mills County","API_combo",3,11,8,114.29,"overcount"
"5375",48335,"Texas","Mitchell County","API_alone",11,41,30,115.38,"overcount"
"5376",48335,"Texas","Mitchell County","API_combo",11,42,31,116.98,"overcount"
"5377",48337,"Texas","Montague County","API_alone",23,55,32,82.05,"overcount"
"5378",48337,"Texas","Montague County","API_combo",23,82,59,112.38,"overcount"
"5379",48339,"Texas","Montgomery County","API_alone",3340,3582,242,6.99,"overcount"
"5380",48339,"Texas","Montgomery County","API_combo",3340,4388,1048,27.12,"overcount"
"5381",48341,"Texas","Moore County","API_alone",563,215,-348,-89.46,"undercount"
"5382",48341,"Texas","Moore County","API_combo",563,243,-320,-79.4,"undercount"
"5383",48343,"Texas","Morris County","API_alone",35,36,1,2.82,"overcount"
"5384",48343,"Texas","Morris County","API_combo",35,49,14,33.33,"overcount"
"5385",48345,"Texas","Motley County","API_alone",6,4,-2,-40,"undercount"
"5386",48345,"Texas","Motley County","API_combo",6,5,-1,-18.18,"undercount"
"5387",48347,"Texas","Nacogdoches County","API_alone",531,490,-41,-8.03,"undercount"
"5388",48347,"Texas","Nacogdoches County","API_combo",531,604,73,12.86,"overcount"
"5389",48349,"Texas","Navarro County","API_alone",456,406,-50,-11.6,"undercount"
"5390",48349,"Texas","Navarro County","API_combo",456,499,43,9.01,"overcount"
"5391",48351,"Texas","Newton County","API_alone",18,46,28,87.5,"overcount"
"5392",48351,"Texas","Newton County","API_combo",18,61,43,108.86,"overcount"
"5393",48353,"Texas","Nolan County","API_alone",42,59,17,33.66,"overcount"
"5394",48353,"Texas","Nolan County","API_combo",42,75,33,56.41,"overcount"
"5395",48355,"Texas","Nueces County","API_alone",4474,4352,-122,-2.76,"undercount"
"5396",48355,"Texas","Nueces County","API_combo",4474,5471,997,20.05,"overcount"
"5397",48357,"Texas","Ochiltree County","API_alone",52,38,-14,-31.11,"undercount"
"5398",48357,"Texas","Ochiltree County","API_combo",52,49,-3,-5.94,"undercount"
"5399",48359,"Texas","Oldham County","API_alone",26,9,-17,-97.14,"undercount"
"5400",48359,"Texas","Oldham County","API_combo",26,15,-11,-53.66,"undercount"
"5401",48361,"Texas","Orange County","API_alone",858,698,-160,-20.57,"undercount"
"5402",48361,"Texas","Orange County","API_combo",858,848,-10,-1.17,"undercount"
"5403",48363,"Texas","Palo Pinto County","API_alone",297,162,-135,-58.82,"undercount"
"5404",48363,"Texas","Palo Pinto County","API_combo",297,199,-98,-39.52,"undercount"
"5405",48365,"Texas","Panola County","API_alone",38,72,34,61.82,"overcount"
"5406",48365,"Texas","Panola County","API_combo",38,108,70,95.89,"overcount"
"5407",48367,"Texas","Parker County","API_alone",560,343,-217,-48.06,"undercount"
"5408",48367,"Texas","Parker County","API_combo",560,483,-77,-14.77,"undercount"
"5409",48369,"Texas","Parmer County","API_alone",38,55,17,36.56,"overcount"
"5410",48369,"Texas","Parmer County","API_combo",38,63,25,49.5,"overcount"
"5411",48371,"Texas","Pecos County","API_alone",76,98,22,25.29,"overcount"
"5412",48371,"Texas","Pecos County","API_combo",76,141,65,59.91,"overcount"
"5413",48373,"Texas","Polk County","API_alone",234,176,-58,-28.29,"undercount"
"5414",48373,"Texas","Polk County","API_combo",234,227,-7,-3.04,"undercount"
"5415",48375,"Texas","Potter County","API_alone",4714,3016,-1698,-43.93,"undercount"
"5416",48375,"Texas","Potter County","API_combo",4714,3330,-1384,-34.41,"undercount"
"5417",48377,"Texas","Presidio County","API_alone",36,14,-22,-88,"undercount"
"5418",48377,"Texas","Presidio County","API_combo",36,22,-14,-48.28,"undercount"
"5419",48379,"Texas","Rains County","API_alone",23,37,14,46.67,"overcount"
"5420",48379,"Texas","Rains County","API_combo",23,41,18,56.25,"overcount"
"5421",48381,"Texas","Randall County","API_alone",1231,1167,-64,-5.34,"undercount"
"5422",48381,"Texas","Randall County","API_combo",1231,1384,153,11.7,"overcount"
"5423",48383,"Texas","Reagan County","API_alone",8,13,5,47.62,"overcount"
"5424",48383,"Texas","Reagan County","API_combo",8,18,10,76.92,"overcount"
"5425",48385,"Texas","Real County","API_alone",0,7,7,200,"overcount"
"5426",48385,"Texas","Real County","API_combo",0,10,10,200,"overcount"
"5427",48387,"Texas","Red River County","API_alone",18,18,0,0,"equal"
"5428",48387,"Texas","Red River County","API_combo",18,31,13,53.06,"overcount"
"5429",48389,"Texas","Reeves County","API_alone",49,62,13,23.42,"overcount"
"5430",48389,"Texas","Reeves County","API_combo",49,72,23,38.02,"overcount"
"5431",48391,"Texas","Refugio County","API_alone",7,35,28,133.33,"overcount"
"5432",48391,"Texas","Refugio County","API_combo",7,46,39,147.17,"overcount"
"5433",48393,"Texas","Roberts County","API_alone",3,1,-2,-100,"undercount"
"5434",48393,"Texas","Roberts County","API_combo",3,6,3,66.67,"overcount"
"5435",48395,"Texas","Robertson County","API_alone",41,35,-6,-15.79,"undercount"
"5436",48395,"Texas","Robertson County","API_combo",41,56,15,30.93,"overcount"
"5437",48397,"Texas","Rockwall County","API_alone",425,632,207,39.17,"overcount"
"5438",48397,"Texas","Rockwall County","API_combo",425,766,341,57.26,"overcount"
"5439",48399,"Texas","Runnels County","API_alone",23,49,26,72.22,"overcount"
"5440",48399,"Texas","Runnels County","API_combo",23,70,47,101.08,"overcount"
"5441",48401,"Texas","Rusk County","API_alone",84,121,37,36.1,"overcount"
"5442",48401,"Texas","Rusk County","API_combo",84,180,96,72.73,"overcount"
"5443",48403,"Texas","Sabine County","API_alone",24,12,-12,-66.67,"undercount"
"5444",48403,"Texas","Sabine County","API_combo",24,18,-6,-28.57,"undercount"
"5445",48405,"Texas","San Augustine County","API_alone",6,18,12,100,"overcount"
"5446",48405,"Texas","San Augustine County","API_combo",6,19,13,104,"overcount"
"5447",48407,"Texas","San Jacinto County","API_alone",32,83,51,88.7,"overcount"
"5448",48407,"Texas","San Jacinto County","API_combo",32,120,88,115.79,"overcount"
"5449",48409,"Texas","San Patricio County","API_alone",513,580,67,12.26,"overcount"
"5450",48409,"Texas","San Patricio County","API_combo",513,819,306,45.95,"overcount"
"5451",48411,"Texas","San Saba County","API_alone",5,9,4,57.14,"overcount"
"5452",48411,"Texas","San Saba County","API_combo",5,15,10,100,"overcount"
"5453",48413,"Texas","Schleicher County","API_alone",2,11,9,138.46,"overcount"
"5454",48413,"Texas","Schleicher County","API_combo",2,11,9,138.46,"overcount"
"5455",48415,"Texas","Scurry County","API_alone",100,38,-62,-89.86,"undercount"
"5456",48415,"Texas","Scurry County","API_combo",100,49,-51,-68.46,"undercount"
"5457",48417,"Texas","Shackelford County","API_alone",12,0,-12,-200,"undercount"
"5458",48417,"Texas","Shackelford County","API_combo",12,0,-12,-200,"undercount"
"5459",48419,"Texas","Shelby County","API_alone",56,203,147,113.51,"overcount"
"5460",48419,"Texas","Shelby County","API_combo",56,238,182,123.81,"overcount"
"5461",48421,"Texas","Sherman County","API_alone",7,13,6,60,"overcount"
"5462",48421,"Texas","Sherman County","API_combo",7,18,11,88,"overcount"
"5463",48423,"Texas","Smith County","API_alone",1205,1402,197,15.11,"overcount"
"5464",48423,"Texas","Smith County","API_combo",1205,1709,504,34.59,"overcount"
"5465",48425,"Texas","Somervell County","API_alone",42,26,-16,-47.06,"undercount"
"5466",48425,"Texas","Somervell County","API_combo",42,36,-6,-15.38,"undercount"
"5467",48427,"Texas","Starr County","API_alone",65,222,157,109.41,"overcount"
"5468",48427,"Texas","Starr County","API_combo",65,241,176,115.03,"overcount"
"5469",48429,"Texas","Stephens County","API_alone",42,32,-10,-27.03,"undercount"
"5470",48429,"Texas","Stephens County","API_combo",42,35,-7,-18.18,"undercount"
"5471",48431,"Texas","Sterling County","API_alone",0,1,1,200,"overcount"
"5472",48431,"Texas","Sterling County","API_combo",0,1,1,200,"overcount"
"5473",48433,"Texas","Stonewall County","API_alone",7,10,3,35.29,"overcount"
"5474",48433,"Texas","Stonewall County","API_combo",7,12,5,52.63,"overcount"
"5475",48435,"Texas","Sutton County","API_alone",10,13,3,26.09,"overcount"
"5476",48435,"Texas","Sutton County","API_combo",10,19,9,62.07,"overcount"
"5477",48437,"Texas","Swisher County","API_alone",55,20,-35,-93.33,"undercount"
"5478",48437,"Texas","Swisher County","API_combo",55,22,-33,-85.71,"undercount"
"5479",48439,"Texas","Tarrant County","API_alone",56123,57089,966,1.71,"overcount"
"5480",48439,"Texas","Tarrant County","API_combo",56123,64033,7910,13.17,"overcount"
"5481",48441,"Texas","Taylor County","API_alone",2585,1774,-811,-37.21,"undercount"
"5482",48441,"Texas","Taylor County","API_combo",2585,2429,-156,-6.22,"undercount"
"5483",48443,"Texas","Terrell County","API_alone",2,7,5,111.11,"overcount"
"5484",48443,"Texas","Terrell County","API_combo",2,7,5,111.11,"overcount"
"5485",48445,"Texas","Terry County","API_alone",41,42,1,2.41,"overcount"
"5486",48445,"Texas","Terry County","API_combo",41,46,5,11.49,"overcount"
"5487",48447,"Texas","Throckmorton County","API_alone",12,1,-11,-169.23,"undercount"
"5488",48447,"Texas","Throckmorton County","API_combo",12,1,-11,-169.23,"undercount"
"5489",48449,"Texas","Titus County","API_alone",64,174,110,92.44,"overcount"
"5490",48449,"Texas","Titus County","API_combo",64,204,140,104.48,"overcount"
"5491",48451,"Texas","Tom Green County","API_alone",1665,1072,-593,-43.33,"undercount"
"5492",48451,"Texas","Tom Green County","API_combo",1665,1480,-185,-11.76,"undercount"
"5493",48453,"Texas","Travis County","API_alone",31677,38362,6685,19.09,"overcount"
"5494",48453,"Texas","Travis County","API_combo",31677,43103,11426,30.56,"overcount"
"5495",48455,"Texas","Trinity County","API_alone",33,38,5,14.08,"overcount"
"5496",48455,"Texas","Trinity County","API_combo",33,55,22,50,"overcount"
"5497",48457,"Texas","Tyler County","API_alone",35,47,12,29.27,"overcount"
"5498",48457,"Texas","Tyler County","API_combo",35,79,44,77.19,"overcount"
"5499",48459,"Texas","Upshur County","API_alone",63,96,33,41.51,"overcount"
"5500",48459,"Texas","Upshur County","API_combo",63,157,94,85.45,"overcount"
"5501",48461,"Texas","Upton County","API_alone",2,4,2,66.67,"overcount"
"5502",48461,"Texas","Upton County","API_combo",2,13,11,146.67,"overcount"
"5503",48463,"Texas","Uvalde County","API_alone",159,154,-5,-3.19,"undercount"
"5504",48463,"Texas","Uvalde County","API_combo",159,194,35,19.83,"overcount"
"5505",48465,"Texas","Val Verde County","API_alone",417,312,-105,-28.81,"undercount"
"5506",48465,"Texas","Val Verde County","API_combo",417,418,1,0.24,"overcount"
"5507",48467,"Texas","Van Zandt County","API_alone",121,113,-8,-6.84,"undercount"
"5508",48467,"Texas","Van Zandt County","API_combo",121,165,44,30.77,"overcount"
"5509",48469,"Texas","Victoria County","API_alone",464,765,301,48.98,"overcount"
"5510",48469,"Texas","Victoria County","API_combo",464,895,431,63.43,"overcount"
"5511",48471,"Texas","Walker County","API_alone",650,550,-100,-16.67,"undercount"
"5512",48471,"Texas","Walker County","API_combo",650,681,31,4.66,"overcount"
"5513",48473,"Texas","Waller County","API_alone",146,160,14,9.15,"overcount"
"5514",48473,"Texas","Waller County","API_combo",146,238,92,47.92,"overcount"
"5515",48475,"Texas","Ward County","API_alone",42,39,-3,-7.41,"undercount"
"5516",48475,"Texas","Ward County","API_combo",42,40,-2,-4.88,"undercount"
"5517",48477,"Texas","Washington County","API_alone",341,375,34,9.5,"overcount"
"5518",48477,"Texas","Washington County","API_combo",341,413,72,19.1,"overcount"
"5519",48479,"Texas","Webb County","API_alone",1046,1087,41,3.84,"overcount"
"5520",48479,"Texas","Webb County","API_combo",1046,1273,227,19.58,"overcount"
"5521",48481,"Texas","Wharton County","API_alone",224,202,-22,-10.33,"undercount"
"5522",48481,"Texas","Wharton County","API_combo",224,258,34,14.11,"overcount"
"5523",48483,"Texas","Wheeler County","API_alone",36,35,-1,-2.82,"undercount"
"5524",48483,"Texas","Wheeler County","API_combo",36,48,12,28.57,"overcount"
"5525",48485,"Texas","Wichita County","API_alone",3253,2623,-630,-21.44,"undercount"
"5526",48485,"Texas","Wichita County","API_combo",3253,3444,191,5.7,"overcount"
"5527",48487,"Texas","Wilbarger County","API_alone",162,107,-55,-40.89,"undercount"
"5528",48487,"Texas","Wilbarger County","API_combo",162,138,-24,-16,"undercount"
"5529",48489,"Texas","Willacy County","API_alone",22,54,32,84.21,"overcount"
"5530",48489,"Texas","Willacy County","API_combo",22,64,42,97.67,"overcount"
"5531",48491,"Texas","Williamson County","API_alone",5192,7075,1883,30.7,"overcount"
"5532",48491,"Texas","Williamson County","API_combo",5192,8359,3167,46.74,"overcount"
"5533",48493,"Texas","Wilson County","API_alone",58,136,78,80.41,"overcount"
"5534",48493,"Texas","Wilson County","API_combo",58,188,130,105.69,"overcount"
"5535",48495,"Texas","Winkler County","API_alone",27,21,-6,-25,"undercount"
"5536",48495,"Texas","Winkler County","API_combo",27,23,-4,-16,"undercount"
"5537",48497,"Texas","Wise County","API_alone",193,150,-43,-25.07,"undercount"
"5538",48497,"Texas","Wise County","API_combo",193,254,61,27.29,"overcount"
"5539",48499,"Texas","Wood County","API_alone",92,81,-11,-12.72,"undercount"
"5540",48499,"Texas","Wood County","API_combo",92,122,30,28.04,"overcount"
"5541",48501,"Texas","Yoakum County","API_alone",21,14,-7,-40,"undercount"
"5542",48501,"Texas","Yoakum County","API_combo",21,14,-7,-40,"undercount"
"5543",48503,"Texas","Young County","API_alone",81,70,-11,-14.57,"undercount"
"5544",48503,"Texas","Young County","API_combo",81,87,6,7.14,"overcount"
"5545",48505,"Texas","Zapata County","API_alone",21,40,19,62.3,"overcount"
"5546",48505,"Texas","Zapata County","API_combo",21,61,40,97.56,"overcount"
"5547",48507,"Texas","Zavala County","API_alone",10,32,22,104.76,"overcount"
"5548",48507,"Texas","Zavala County","API_combo",10,37,27,114.89,"overcount"
"5549",49001,"Utah","Beaver County","API_alone",38,47,9,21.18,"overcount"
"5550",49001,"Utah","Beaver County","API_combo",38,78,40,68.97,"overcount"
"5551",49003,"Utah","Box Elder County","API_alone",694,497,-197,-33.08,"undercount"
"5552",49003,"Utah","Box Elder County","API_combo",694,666,-28,-4.12,"undercount"
"5553",49005,"Utah","Cache County","API_alone",3324,2063,-1261,-46.82,"undercount"
"5554",49005,"Utah","Cache County","API_combo",3324,2433,-891,-30.95,"undercount"
"5555",49007,"Utah","Carbon County","API_alone",187,83,-104,-77.04,"undercount"
"5556",49007,"Utah","Carbon County","API_combo",187,123,-64,-41.29,"undercount"
"5557",49009,"Utah","Daggett County","API_alone",7,2,-5,-111.11,"undercount"
"5558",49009,"Utah","Daggett County","API_combo",7,8,1,13.33,"overcount"
"5559",49011,"Utah","Davis County","API_alone",5967,4495,-1472,-28.14,"undercount"
"5560",49011,"Utah","Davis County","API_combo",5967,6613,646,10.27,"overcount"
"5561",49013,"Utah","Duchesne County","API_alone",71,38,-33,-60.55,"undercount"
"5562",49013,"Utah","Duchesne County","API_combo",71,68,-3,-4.32,"undercount"
"5563",49015,"Utah","Emery County","API_alone",54,45,-9,-18.18,"undercount"
"5564",49015,"Utah","Emery County","API_combo",54,75,21,32.56,"overcount"
"5565",49017,"Utah","Garfield County","API_alone",13,22,9,51.43,"overcount"
"5566",49017,"Utah","Garfield County","API_combo",13,38,25,98.04,"overcount"
"5567",49019,"Utah","Grand County","API_alone",52,23,-29,-77.33,"undercount"
"5568",49019,"Utah","Grand County","API_combo",52,38,-14,-31.11,"undercount"
"5569",49021,"Utah","Iron County","API_alone",212,366,154,53.29,"overcount"
"5570",49021,"Utah","Iron County","API_combo",212,499,287,80.73,"overcount"
"5571",49023,"Utah","Juab County","API_alone",19,36,17,61.82,"overcount"
"5572",49023,"Utah","Juab County","API_combo",19,52,33,92.96,"overcount"
"5573",49025,"Utah","Kane County","API_alone",43,18,-25,-81.97,"undercount"
"5574",49025,"Utah","Kane County","API_combo",43,35,-8,-20.51,"undercount"
"5575",49027,"Utah","Millard County","API_alone",158,84,-74,-61.16,"undercount"
"5576",49027,"Utah","Millard County","API_combo",158,117,-41,-29.82,"undercount"
"5577",49029,"Utah","Morgan County","API_alone",29,12,-17,-82.93,"undercount"
"5578",49029,"Utah","Morgan County","API_combo",29,39,10,29.41,"overcount"
"5579",49031,"Utah","Piute County","API_alone",1,4,3,120,"overcount"
"5580",49031,"Utah","Piute County","API_combo",1,7,6,150,"overcount"
"5581",49033,"Utah","Rich County","API_alone",8,9,1,11.76,"overcount"
"5582",49033,"Utah","Rich County","API_combo",8,11,3,31.58,"overcount"
"5583",49035,"Utah","Salt Lake County","API_alone",33310,35592,2282,6.62,"overcount"
"5584",49035,"Utah","Salt Lake County","API_combo",33310,43006,9696,25.41,"overcount"
"5585",49037,"Utah","San Juan County","API_alone",53,30,-23,-55.42,"undercount"
"5586",49037,"Utah","San Juan County","API_combo",53,74,21,33.07,"overcount"
"5587",49039,"Utah","Sanpete County","API_alone",398,212,-186,-60.98,"undercount"
"5588",49039,"Utah","Sanpete County","API_combo",398,294,-104,-30.06,"undercount"
"5589",49041,"Utah","Sevier County","API_alone",48,66,18,31.58,"overcount"
"5590",49041,"Utah","Sevier County","API_combo",48,102,54,72,"overcount"
"5591",49043,"Utah","Summit County","API_alone",217,308,91,34.67,"overcount"
"5592",49043,"Utah","Summit County","API_combo",217,439,222,67.68,"overcount"
"5593",49045,"Utah","Tooele County","API_alone",420,341,-79,-20.76,"undercount"
"5594",49045,"Utah","Tooele County","API_combo",420,590,170,33.66,"overcount"
"5595",49047,"Utah","Uintah County","API_alone",144,76,-68,-61.82,"undercount"
"5596",49047,"Utah","Uintah County","API_combo",144,130,-14,-10.22,"undercount"
"5597",49049,"Utah","Utah County","API_alone",7343,6290,-1053,-15.45,"undercount"
"5598",49049,"Utah","Utah County","API_combo",7343,9490,2147,25.51,"overcount"
"5599",49051,"Utah","Wasatch County","API_alone",37,61,24,48.98,"overcount"
"5600",49051,"Utah","Wasatch County","API_combo",37,133,96,112.94,"overcount"
"5601",49053,"Utah","Washington County","API_alone",758,815,57,7.25,"overcount"
"5602",49053,"Utah","Washington County","API_combo",758,1360,602,56.85,"overcount"
"5603",49055,"Utah","Wayne County","API_alone",2,7,5,111.11,"overcount"
"5604",49055,"Utah","Wayne County","API_combo",2,9,7,127.27,"overcount"
"5605",49057,"Utah","Weber County","API_alone",3832,2966,-866,-25.48,"undercount"
"5606",49057,"Utah","Weber County","API_combo",3832,4139,307,7.7,"overcount"
"5607",50001,"Vermont","Addison County","API_alone",296,284,-12,-4.14,"undercount"
"5608",50001,"Vermont","Addison County","API_combo",296,411,115,32.53,"overcount"
"5609",50003,"Vermont","Bennington County","API_alone",255,240,-15,-6.06,"undercount"
"5610",50003,"Vermont","Bennington County","API_combo",255,297,42,15.22,"overcount"
"5611",50005,"Vermont","Caledonia County","API_alone",125,115,-10,-8.33,"undercount"
"5612",50005,"Vermont","Caledonia County","API_combo",125,157,32,22.7,"overcount"
"5613",50007,"Vermont","Chittenden County","API_alone",2499,3029,530,19.18,"overcount"
"5614",50007,"Vermont","Chittenden County","API_combo",2499,3558,1059,34.97,"overcount"
"5615",50009,"Vermont","Essex County","API_alone",15,20,5,28.57,"overcount"
"5616",50009,"Vermont","Essex County","API_combo",15,30,15,66.67,"overcount"
"5617",50011,"Vermont","Franklin County","API_alone",239,133,-106,-56.99,"undercount"
"5618",50011,"Vermont","Franklin County","API_combo",239,191,-48,-22.33,"undercount"
"5619",50013,"Vermont","Grand Isle County","API_alone",16,19,3,17.14,"overcount"
"5620",50013,"Vermont","Grand Isle County","API_combo",16,29,13,57.78,"overcount"
"5621",50015,"Vermont","Lamoille County","API_alone",119,96,-23,-21.4,"undercount"
"5622",50015,"Vermont","Lamoille County","API_combo",119,151,32,23.7,"overcount"
"5623",50017,"Vermont","Orange County","API_alone",126,111,-15,-12.66,"undercount"
"5624",50017,"Vermont","Orange County","API_combo",126,170,44,29.73,"overcount"
"5625",50019,"Vermont","Orleans County","API_alone",85,83,-2,-2.38,"undercount"
"5626",50019,"Vermont","Orleans County","API_combo",85,107,22,22.92,"overcount"
"5627",50021,"Vermont","Rutland County","API_alone",332,271,-61,-20.23,"undercount"
"5628",50021,"Vermont","Rutland County","API_combo",332,347,15,4.42,"overcount"
"5629",50023,"Vermont","Washington County","API_alone",352,346,-6,-1.72,"undercount"
"5630",50023,"Vermont","Washington County","API_combo",352,470,118,28.71,"overcount"
"5631",50025,"Vermont","Windham County","API_alone",446,377,-69,-16.77,"undercount"
"5632",50025,"Vermont","Windham County","API_combo",446,531,85,17.4,"overcount"
"5633",50027,"Vermont","Windsor County","API_alone",440,385,-55,-13.33,"undercount"
"5634",50027,"Vermont","Windsor County","API_combo",440,502,62,13.16,"overcount"
"5635",51001,"Virginia","Accomack County","API_alone",96,126,30,27.03,"overcount"
"5636",51001,"Virginia","Accomack County","API_combo",96,170,74,55.64,"overcount"
"5637",51003,"Virginia","Albemarle County","API_alone",2883,2313,-570,-21.94,"undercount"
"5638",51003,"Virginia","Albemarle County","API_combo",2883,2589,-294,-10.75,"undercount"
"5639",51005,"Virginia","Alleghany County","API_alone",52,33,-19,-44.71,"undercount"
"5640",51005,"Virginia","Alleghany County","API_combo",52,46,-6,-12.24,"undercount"
"5641",51007,"Virginia","Amelia County","API_alone",27,21,-6,-25,"undercount"
"5642",51007,"Virginia","Amelia County","API_combo",27,25,-2,-7.69,"undercount"
"5643",51009,"Virginia","Amherst County","API_alone",112,120,8,6.9,"overcount"
"5644",51009,"Virginia","Amherst County","API_combo",112,161,49,35.9,"overcount"
"5645",51011,"Virginia","Appomattox County","API_alone",11,26,15,81.08,"overcount"
"5646",51011,"Virginia","Appomattox County","API_combo",11,33,22,100,"overcount"
"5647",51013,"Virginia","Arlington County","API_alone",17366,17218,-148,-0.86,"undercount"
"5648",51013,"Virginia","Arlington County","API_combo",17366,19243,1877,10.25,"overcount"
"5649",51015,"Virginia","Augusta County","API_alone",228,207,-21,-9.66,"undercount"
"5650",51015,"Virginia","Augusta County","API_combo",228,284,56,21.88,"overcount"
"5651",51017,"Virginia","Bath County","API_alone",12,22,10,58.82,"overcount"
"5652",51017,"Virginia","Bath County","API_combo",12,31,19,88.37,"overcount"
"5653",51019,"Virginia","Bedford County","API_alone",243,272,29,11.26,"overcount"
"5654",51019,"Virginia","Bedford County","API_combo",243,376,133,42.97,"overcount"
"5655",51021,"Virginia","Bland County","API_alone",11,9,-2,-20,"undercount"
"5656",51021,"Virginia","Bland County","API_combo",11,18,7,48.28,"overcount"
"5657",51023,"Virginia","Botetourt County","API_alone",136,156,20,13.7,"overcount"
"5658",51023,"Virginia","Botetourt County","API_combo",136,201,65,38.58,"overcount"
"5659",51025,"Virginia","Brunswick County","API_alone",14,42,28,100,"overcount"
"5660",51025,"Virginia","Brunswick County","API_combo",14,49,35,111.11,"overcount"
"5661",51027,"Virginia","Buchanan County","API_alone",54,38,-16,-34.78,"undercount"
"5662",51027,"Virginia","Buchanan County","API_combo",54,69,15,24.39,"overcount"
"5663",51029,"Virginia","Buckingham County","API_alone",33,30,-3,-9.52,"undercount"
"5664",51029,"Virginia","Buckingham County","API_combo",33,42,9,24,"overcount"
"5665",51031,"Virginia","Campbell County","API_alone",269,322,53,17.94,"overcount"
"5666",51031,"Virginia","Campbell County","API_combo",269,405,136,40.36,"overcount"
"5667",51033,"Virginia","Caroline County","API_alone",92,89,-3,-3.31,"undercount"
"5668",51033,"Virginia","Caroline County","API_combo",92,139,47,40.69,"overcount"
"5669",51035,"Virginia","Carroll County","API_alone",43,32,-11,-29.33,"undercount"
"5670",51035,"Virginia","Carroll County","API_combo",43,59,16,31.37,"overcount"
"5671",51036,"Virginia","Charles City County","API_alone",17,7,-10,-83.33,"undercount"
"5672",51036,"Virginia","Charles City County","API_combo",17,13,-4,-26.67,"undercount"
"5673",51037,"Virginia","Charlotte County","API_alone",9,20,11,75.86,"overcount"
"5674",51037,"Virginia","Charlotte County","API_combo",9,32,23,112.2,"overcount"
"5675",51041,"Virginia","Chesterfield County","API_alone",7010,6454,-556,-8.26,"undercount"
"5676",51041,"Virginia","Chesterfield County","API_combo",7010,7411,401,5.56,"overcount"
"5677",51043,"Virginia","Clarke County","API_alone",54,69,15,24.39,"overcount"
"5678",51043,"Virginia","Clarke County","API_combo",54,113,59,70.66,"overcount"
"5679",51045,"Virginia","Craig County","API_alone",8,8,0,0,"equal"
"5680",51045,"Virginia","Craig County","API_combo",8,16,8,66.67,"overcount"
"5681",51047,"Virginia","Culpeper County","API_alone",541,237,-304,-78.15,"undercount"
"5682",51047,"Virginia","Culpeper County","API_combo",541,343,-198,-44.8,"undercount"
"5683",51049,"Virginia","Cumberland County","API_alone",15,32,17,72.34,"overcount"
"5684",51049,"Virginia","Cumberland County","API_combo",15,44,29,98.31,"overcount"
"5685",51051,"Virginia","Dickenson County","API_alone",24,14,-10,-52.63,"undercount"
"5686",51051,"Virginia","Dickenson County","API_combo",24,34,10,34.48,"overcount"
"5687",51053,"Virginia","Dinwiddie County","API_alone",111,91,-20,-19.8,"undercount"
"5688",51053,"Virginia","Dinwiddie County","API_combo",111,156,45,33.71,"overcount"
"5689",51057,"Virginia","Essex County","API_alone",58,84,26,36.62,"overcount"
"5690",51057,"Virginia","Essex County","API_combo",58,96,38,49.35,"overcount"
"5691",51059,"Virginia","Fairfax County","API_alone",116886,129505,12619,10.24,"overcount"
"5692",51059,"Virginia","Fairfax County","API_combo",116886,142808,25922,19.96,"overcount"
"5693",51061,"Virginia","Fauquier County","API_alone",500,348,-152,-35.85,"undercount"
"5694",51061,"Virginia","Fauquier County","API_combo",500,507,7,1.39,"overcount"
"5695",51063,"Virginia","Floyd County","API_alone",38,23,-15,-49.18,"undercount"
"5696",51063,"Virginia","Floyd County","API_combo",38,35,-3,-8.22,"undercount"
"5697",51065,"Virginia","Fluvanna County","API_alone",45,86,41,62.6,"overcount"
"5698",51065,"Virginia","Fluvanna County","API_combo",45,133,88,98.88,"overcount"
"5699",51067,"Virginia","Franklin County","API_alone",120,181,61,40.53,"overcount"
"5700",51067,"Virginia","Franklin County","API_combo",120,255,135,72,"overcount"
"5701",51069,"Virginia","Frederick County","API_alone",432,420,-12,-2.82,"undercount"
"5702",51069,"Virginia","Frederick County","API_combo",432,571,139,27.72,"overcount"
"5703",51071,"Virginia","Giles County","API_alone",37,31,-6,-17.65,"undercount"
"5704",51071,"Virginia","Giles County","API_combo",37,56,19,40.86,"overcount"
"5705",51073,"Virginia","Gloucester County","API_alone",362,260,-102,-32.8,"undercount"
"5706",51073,"Virginia","Gloucester County","API_combo",362,404,42,10.97,"overcount"
"5707",51075,"Virginia","Goochland County","API_alone",68,82,14,18.67,"overcount"
"5708",51075,"Virginia","Goochland County","API_combo",68,116,48,52.17,"overcount"
"5709",51077,"Virginia","Grayson County","API_alone",26,19,-7,-31.11,"undercount"
"5710",51077,"Virginia","Grayson County","API_combo",26,35,9,29.51,"overcount"
"5711",51079,"Virginia","Greene County","API_alone",65,78,13,18.18,"overcount"
"5712",51079,"Virginia","Greene County","API_combo",65,104,39,46.15,"overcount"
"5713",51081,"Virginia","Greensville County","API_alone",52,50,-2,-3.92,"undercount"
"5714",51081,"Virginia","Greensville County","API_combo",52,59,7,12.61,"overcount"
"5715",51083,"Virginia","Halifax County","API_alone",79,100,21,23.46,"overcount"
"5716",51083,"Virginia","Halifax County","API_combo",79,142,63,57.01,"overcount"
"5717",51085,"Virginia","Hanover County","API_alone",554,717,163,25.65,"overcount"
"5718",51085,"Virginia","Hanover County","API_combo",554,911,357,48.74,"overcount"
"5719",51087,"Virginia","Henrico County","API_alone",7414,9723,2309,26.95,"overcount"
"5720",51087,"Virginia","Henrico County","API_combo",7414,10738,3324,36.62,"overcount"
"5721",51089,"Virginia","Henry County","API_alone",141,259,118,59,"overcount"
"5722",51089,"Virginia","Henry County","API_combo",141,325,184,78.97,"overcount"
"5723",51091,"Virginia","Highland County","API_alone",2,3,1,40,"overcount"
"5724",51091,"Virginia","Highland County","API_combo",2,7,5,111.11,"overcount"
"5725",51093,"Virginia","Isle of Wight County","API_alone",140,113,-27,-21.34,"undercount"
"5726",51093,"Virginia","Isle of Wight County","API_combo",140,156,16,10.81,"overcount"
"5727",51095,"Virginia","James City County","API_alone",917,738,-179,-21.63,"undercount"
"5728",51095,"Virginia","James City County","API_combo",917,967,50,5.31,"overcount"
"5729",51097,"Virginia","King and Queen County","API_alone",10,19,9,62.07,"overcount"
"5730",51097,"Virginia","King and Queen County","API_combo",10,31,21,102.44,"overcount"
"5731",51099,"Virginia","King George County","API_alone",252,183,-69,-31.72,"undercount"
"5732",51099,"Virginia","King George County","API_combo",252,247,-5,-2,"undercount"
"5733",51101,"Virginia","King William County","API_alone",51,58,7,12.84,"overcount"
"5734",51101,"Virginia","King William County","API_combo",51,75,24,38.1,"overcount"
"5735",51103,"Virginia","Lancaster County","API_alone",17,46,29,92.06,"overcount"
"5736",51103,"Virginia","Lancaster County","API_combo",17,58,41,109.33,"overcount"
"5737",51105,"Virginia","Lee County","API_alone",30,48,18,46.15,"overcount"
"5738",51105,"Virginia","Lee County","API_combo",30,70,40,80,"overcount"
"5739",51107,"Virginia","Loudoun County","API_alone",5769,9418,3649,48.05,"overcount"
"5740",51107,"Virginia","Loudoun County","API_combo",5769,10864,5095,61.26,"overcount"
"5741",51109,"Virginia","Louisa County","API_alone",74,67,-7,-9.93,"undercount"
"5742",51109,"Virginia","Louisa County","API_combo",74,92,18,21.69,"overcount"
"5743",51111,"Virginia","Lunenburg County","API_alone",29,33,4,12.9,"overcount"
"5744",51111,"Virginia","Lunenburg County","API_combo",29,67,38,79.17,"overcount"
"5745",51113,"Virginia","Madison County","API_alone",20,66,46,106.98,"overcount"
"5746",51113,"Virginia","Madison County","API_combo",20,94,74,129.82,"overcount"
"5747",51115,"Virginia","Mathews County","API_alone",23,18,-5,-24.39,"undercount"
"5748",51115,"Virginia","Mathews County","API_combo",23,34,11,38.6,"overcount"
"5749",51117,"Virginia","Mecklenburg County","API_alone",69,102,33,38.6,"overcount"
"5750",51117,"Virginia","Mecklenburg County","API_combo",69,139,70,67.31,"overcount"
"5751",51119,"Virginia","Middlesex County","API_alone",19,12,-7,-45.16,"undercount"
"5752",51119,"Virginia","Middlesex County","API_combo",19,16,-3,-17.14,"undercount"
"5753",51121,"Virginia","Montgomery County","API_alone",4231,3455,-776,-20.19,"undercount"
"5754",51121,"Virginia","Montgomery County","API_combo",4231,3893,-338,-8.32,"undercount"
"5755",51125,"Virginia","Nelson County","API_alone",41,44,3,7.06,"overcount"
"5756",51125,"Virginia","Nelson County","API_combo",41,71,30,53.57,"overcount"
"5757",51127,"Virginia","New Kent County","API_alone",77,75,-2,-2.63,"undercount"
"5758",51127,"Virginia","New Kent County","API_combo",77,103,26,28.89,"overcount"
"5759",51131,"Virginia","Northampton County","API_alone",22,32,10,37.04,"overcount"
"5760",51131,"Virginia","Northampton County","API_combo",22,50,28,77.78,"overcount"
"5761",51133,"Virginia","Northumberland County","API_alone",29,25,-4,-14.81,"undercount"
"5762",51133,"Virginia","Northumberland County","API_combo",29,29,0,0,"equal"
"5763",51135,"Virginia","Nottoway County","API_alone",63,67,4,6.15,"overcount"
"5764",51135,"Virginia","Nottoway County","API_combo",63,91,28,36.36,"overcount"
"5765",51137,"Virginia","Orange County","API_alone",92,93,1,1.08,"overcount"
"5766",51137,"Virginia","Orange County","API_combo",92,133,41,36.44,"overcount"
"5767",51139,"Virginia","Page County","API_alone",127,61,-66,-70.21,"undercount"
"5768",51139,"Virginia","Page County","API_combo",127,92,-35,-31.96,"undercount"
"5769",51141,"Virginia","Patrick County","API_alone",33,42,9,24,"overcount"
"5770",51141,"Virginia","Patrick County","API_combo",33,64,31,63.92,"overcount"
"5771",51143,"Virginia","Pittsylvania County","API_alone",88,121,33,31.58,"overcount"
"5772",51143,"Virginia","Pittsylvania County","API_combo",88,196,108,76.06,"overcount"
"5773",51145,"Virginia","Powhatan County","API_alone",65,55,-10,-16.67,"undercount"
"5774",51145,"Virginia","Powhatan County","API_combo",65,88,23,30.07,"overcount"
"5775",51147,"Virginia","Prince Edward County","API_alone",124,129,5,3.95,"overcount"
"5776",51147,"Virginia","Prince Edward County","API_combo",124,184,60,38.96,"overcount"
"5777",51149,"Virginia","Prince George County","API_alone",932,656,-276,-34.76,"undercount"
"5778",51149,"Virginia","Prince George County","API_combo",932,863,-69,-7.69,"undercount"
"5779",51153,"Virginia","Prince William County","API_alone",12462,11590,-872,-7.25,"undercount"
"5780",51153,"Virginia","Prince William County","API_combo",12462,14635,2173,16.04,"overcount"
"5781",51155,"Virginia","Pulaski County","API_alone",113,127,14,11.67,"overcount"
"5782",51155,"Virginia","Pulaski County","API_combo",113,159,46,33.82,"overcount"
"5783",51157,"Virginia","Rappahannock County","API_alone",22,15,-7,-37.84,"undercount"
"5784",51157,"Virginia","Rappahannock County","API_combo",22,28,6,24,"overcount"
"5785",51159,"Virginia","Richmond County","API_alone",39,34,-5,-13.7,"undercount"
"5786",51159,"Virginia","Richmond County","API_combo",39,54,15,32.26,"overcount"
"5787",51161,"Virginia","Roanoke County","API_alone",1031,1414,383,31.33,"overcount"
"5788",51161,"Virginia","Roanoke County","API_combo",1031,1601,570,43.31,"overcount"
"5789",51163,"Virginia","Rockbridge County","API_alone",78,97,19,21.71,"overcount"
"5790",51163,"Virginia","Rockbridge County","API_combo",78,127,49,47.8,"overcount"
"5791",51165,"Virginia","Rockingham County","API_alone",264,209,-55,-23.26,"undercount"
"5792",51165,"Virginia","Rockingham County","API_combo",264,305,41,14.41,"overcount"
"5793",51167,"Virginia","Russell County","API_alone",25,16,-9,-43.9,"undercount"
"5794",51167,"Virginia","Russell County","API_combo",25,34,9,30.51,"overcount"
"5795",51169,"Virginia","Scott County","API_alone",7,22,15,103.45,"overcount"
"5796",51169,"Virginia","Scott County","API_combo",7,45,38,146.15,"overcount"
"5797",51171,"Virginia","Shenandoah County","API_alone",188,137,-51,-31.38,"undercount"
"5798",51171,"Virginia","Shenandoah County","API_combo",188,192,4,2.11,"overcount"
"5799",51173,"Virginia","Smyth County","API_alone",107,65,-42,-48.84,"undercount"
"5800",51173,"Virginia","Smyth County","API_combo",107,120,13,11.45,"overcount"
"5801",51175,"Virginia","Southampton County","API_alone",23,33,10,35.71,"overcount"
"5802",51175,"Virginia","Southampton County","API_combo",23,57,34,85,"overcount"
"5803",51177,"Virginia","Spotsylvania County","API_alone",1445,1341,-104,-7.47,"undercount"
"5804",51177,"Virginia","Spotsylvania County","API_combo",1445,1812,367,22.54,"overcount"
"5805",51179,"Virginia","Stafford County","API_alone",1817,1656,-161,-9.27,"undercount"
"5806",51179,"Virginia","Stafford County","API_combo",1817,2408,591,27.98,"overcount"
"5807",51181,"Virginia","Surry County","API_alone",2,11,9,138.46,"overcount"
"5808",51181,"Virginia","Surry County","API_combo",2,13,11,146.67,"overcount"
"5809",51183,"Virginia","Sussex County","API_alone",20,17,-3,-16.22,"undercount"
"5810",51183,"Virginia","Sussex County","API_combo",20,49,29,84.06,"overcount"
"5811",51185,"Virginia","Tazewell County","API_alone",386,300,-86,-25.07,"undercount"
"5812",51185,"Virginia","Tazewell County","API_combo",386,350,-36,-9.78,"undercount"
"5813",51187,"Virginia","Warren County","API_alone",149,148,-1,-0.67,"undercount"
"5814",51187,"Virginia","Warren County","API_combo",149,269,120,57.42,"overcount"
"5815",51191,"Virginia","Washington County","API_alone",123,152,29,21.09,"overcount"
"5816",51191,"Virginia","Washington County","API_combo",123,227,104,59.43,"overcount"
"5817",51193,"Virginia","Westmoreland County","API_alone",97,75,-22,-25.58,"undercount"
"5818",51193,"Virginia","Westmoreland County","API_combo",97,93,-4,-4.21,"undercount"
"5819",51195,"Virginia","Wise County","API_alone",194,128,-66,-40.99,"undercount"
"5820",51195,"Virginia","Wise County","API_combo",194,172,-22,-12.02,"undercount"
"5821",51197,"Virginia","Wythe County","API_alone",119,110,-9,-7.86,"undercount"
"5822",51197,"Virginia","Wythe County","API_combo",119,131,12,9.6,"overcount"
"5823",51199,"Virginia","York County","API_alone",2078,1926,-152,-7.59,"undercount"
"5824",51199,"Virginia","York County","API_combo",2078,2400,322,14.38,"overcount"
"5825",51510,"Virginia","Alexandria city","API_alone",7111,7788,677,9.09,"overcount"
"5826",51510,"Virginia","Alexandria city","API_combo",7111,9032,1921,23.8,"overcount"
"5827",51515,"Virginia","Bedford city","API_alone",48,42,-6,-13.33,"undercount"
"5828",51515,"Virginia","Bedford city","API_combo",48,51,3,6.06,"overcount"
"5829",51520,"Virginia","Bristol city","API_alone",111,68,-43,-48.04,"undercount"
"5830",51520,"Virginia","Bristol city","API_combo",111,93,-18,-17.65,"undercount"
"5831",51530,"Virginia","Buena Vista city","API_alone",26,28,2,7.41,"overcount"
"5832",51530,"Virginia","Buena Vista city","API_combo",26,45,19,53.52,"overcount"
"5833",51540,"Virginia","Charlottesville city","API_alone",1207,2264,1057,60.9,"overcount"
"5834",51540,"Virginia","Charlottesville city","API_combo",1207,2665,1458,75.31,"overcount"
"5835",51550,"Virginia","Chesapeake city","API_alone",3906,3855,-51,-1.31,"undercount"
"5836",51550,"Virginia","Chesapeake city","API_combo",3906,5039,1133,25.33,"overcount"
"5837",51560,"Virginia","Clifton Forge city","API_alone",8,2,-6,-120,"undercount"
"5838",51560,"Virginia","Clifton Forge city","API_combo",8,11,3,31.58,"overcount"
"5839",51570,"Virginia","Colonial Heights city","API_alone",569,477,-92,-17.59,"undercount"
"5840",51570,"Virginia","Colonial Heights city","API_combo",569,545,-24,-4.31,"undercount"
"5841",51580,"Virginia","Covington city","API_alone",65,45,-20,-36.36,"undercount"
"5842",51580,"Virginia","Covington city","API_combo",65,66,1,1.53,"overcount"
"5843",51590,"Virginia","Danville city","API_alone",361,313,-48,-14.24,"undercount"
"5844",51590,"Virginia","Danville city","API_combo",361,380,19,5.13,"overcount"
"5845",51595,"Virginia","Emporia city","API_alone",31,34,3,9.23,"overcount"
"5846",51595,"Virginia","Emporia city","API_combo",31,39,8,22.86,"overcount"
"5847",51600,"Virginia","Fairfax city","API_alone",2206,2674,468,19.18,"overcount"
"5848",51600,"Virginia","Fairfax city","API_combo",2206,2905,699,27.35,"overcount"
"5849",51610,"Virginia","Falls Church city","API_alone",700,693,-7,-1.01,"undercount"
"5850",51610,"Virginia","Falls Church city","API_combo",700,812,112,14.81,"overcount"
"5851",51620,"Virginia","Franklin city","API_alone",24,66,42,93.33,"overcount"
"5852",51620,"Virginia","Franklin city","API_combo",24,79,55,106.8,"overcount"
"5853",51630,"Virginia","Fredericksburg city","API_alone",291,311,20,6.64,"overcount"
"5854",51630,"Virginia","Fredericksburg city","API_combo",291,398,107,31.06,"overcount"
"5855",51640,"Virginia","Galax city","API_alone",24,49,25,68.49,"overcount"
"5856",51640,"Virginia","Galax city","API_combo",24,51,27,72,"overcount"
"5857",51650,"Virginia","Hampton city","API_alone",3531,2929,-602,-18.64,"undercount"
"5858",51650,"Virginia","Hampton city","API_combo",3531,4031,500,13.22,"overcount"
"5859",51660,"Virginia","Harrisonburg city","API_alone",789,1307,518,49.43,"overcount"
"5860",51660,"Virginia","Harrisonburg city","API_combo",789,1705,916,73.46,"overcount"
"5861",51670,"Virginia","Hopewell city","API_alone",447,212,-235,-71.32,"undercount"
"5862",51670,"Virginia","Hopewell city","API_combo",447,323,-124,-32.21,"undercount"
"5863",51678,"Virginia","Lexington city","API_alone",117,135,18,14.29,"overcount"
"5864",51678,"Virginia","Lexington city","API_combo",117,168,51,35.79,"overcount"
"5865",51680,"Virginia","Lynchburg city","API_alone",696,888,192,24.24,"overcount"
"5866",51680,"Virginia","Lynchburg city","API_combo",696,1072,376,42.53,"overcount"
"5867",51683,"Virginia","Manassas city","API_alone",1657,1272,-385,-26.29,"undercount"
"5868",51683,"Virginia","Manassas city","API_combo",1657,1486,-171,-10.88,"undercount"
"5869",51685,"Virginia","Manassas Park city","API_alone",309,446,137,36.29,"overcount"
"5870",51685,"Virginia","Manassas Park city","API_combo",309,526,217,51.98,"overcount"
"5871",51690,"Virginia","Martinsville city","API_alone",35,72,37,69.16,"overcount"
"5872",51690,"Virginia","Martinsville city","API_combo",35,89,54,87.1,"overcount"
"5873",51700,"Virginia","Newport News city","API_alone",6255,4563,-1692,-31.28,"undercount"
"5874",51700,"Virginia","Newport News city","API_combo",6255,6130,-125,-2.02,"undercount"
"5875",51710,"Virginia","Norfolk city","API_alone",8847,7060,-1787,-22.47,"undercount"
"5876",51710,"Virginia","Norfolk city","API_combo",8847,8984,137,1.54,"overcount"
"5877",51720,"Virginia","Norton city","API_alone",42,44,2,4.65,"overcount"
"5878",51720,"Virginia","Norton city","API_combo",42,49,7,15.38,"overcount"
"5879",51730,"Virginia","Petersburg city","API_alone",372,252,-120,-38.46,"undercount"
"5880",51730,"Virginia","Petersburg city","API_combo",372,352,-20,-5.52,"undercount"
"5881",51735,"Virginia","Poquoson city","API_alone",262,187,-75,-33.41,"undercount"
"5882",51735,"Virginia","Poquoson city","API_combo",262,231,-31,-12.58,"undercount"
"5883",51740,"Virginia","Portsmouth city","API_alone",1148,860,-288,-28.69,"undercount"
"5884",51740,"Virginia","Portsmouth city","API_combo",1148,1308,160,13.03,"overcount"
"5885",51750,"Virginia","Radford city","API_alone",377,249,-128,-40.89,"undercount"
"5886",51750,"Virginia","Radford city","API_combo",377,308,-69,-20.15,"undercount"
"5887",51760,"Virginia","Richmond city","API_alone",2313,2806,493,19.26,"overcount"
"5888",51760,"Virginia","Richmond city","API_combo",2313,3462,1149,39.79,"overcount"
"5889",51770,"Virginia","Roanoke city","API_alone",1019,1169,150,13.71,"overcount"
"5890",51770,"Virginia","Roanoke city","API_combo",1019,1385,366,30.45,"overcount"
"5891",51775,"Virginia","Salem city","API_alone",251,251,0,0,"equal"
"5892",51775,"Virginia","Salem city","API_combo",251,288,37,13.73,"overcount"
"5893",51790,"Virginia","Staunton city","API_alone",152,113,-39,-29.43,"undercount"
"5894",51790,"Virginia","Staunton city","API_combo",152,221,69,37,"overcount"
"5895",51800,"Virginia","Suffolk city","API_alone",374,523,149,33.22,"overcount"
"5896",51800,"Virginia","Suffolk city","API_combo",374,732,358,64.74,"overcount"
"5897",51810,"Virginia","Virginia Beach city","API_alone",29145,21797,-7348,-28.85,"undercount"
"5898",51810,"Virginia","Virginia Beach city","API_combo",29145,26626,-2519,-9.03,"undercount"
"5899",51820,"Virginia","Waynesboro city","API_alone",64,120,56,60.87,"overcount"
"5900",51820,"Virginia","Waynesboro city","API_combo",64,176,112,93.33,"overcount"
"5901",51830,"Virginia","Williamsburg city","API_alone",473,557,84,16.31,"overcount"
"5902",51830,"Virginia","Williamsburg city","API_combo",473,643,170,30.47,"overcount"
"5903",51840,"Virginia","Winchester city","API_alone",343,386,43,11.8,"overcount"
"5904",51840,"Virginia","Winchester city","API_combo",343,461,118,29.35,"overcount"
"5905",53001,"Washington","Adams County","API_alone",182,145,-37,-22.63,"undercount"
"5906",53001,"Washington","Adams County","API_combo",182,197,15,7.92,"overcount"
"5907",53003,"Washington","Asotin County","API_alone",196,111,-85,-55.37,"undercount"
"5908",53003,"Washington","Asotin County","API_combo",196,156,-40,-22.73,"undercount"
"5909",53005,"Washington","Benton County","API_alone",4202,3437,-765,-20.03,"undercount"
"5910",53005,"Washington","Benton County","API_combo",4202,4345,143,3.35,"overcount"
"5911",53007,"Washington","Chelan County","API_alone",675,632,-43,-6.58,"undercount"
"5912",53007,"Washington","Chelan County","API_combo",675,946,271,33.44,"overcount"
"5913",53009,"Washington","Clallam County","API_alone",1023,849,-174,-18.59,"undercount"
"5914",53009,"Washington","Clallam County","API_combo",1023,1300,277,23.85,"overcount"
"5915",53011,"Washington","Clark County","API_alone",12008,12707,699,5.66,"overcount"
"5916",53011,"Washington","Clark County","API_combo",12008,16755,4747,33.01,"overcount"
"5917",53013,"Washington","Columbia County","API_alone",19,19,0,0,"equal"
"5918",53013,"Washington","Columbia County","API_combo",19,34,15,56.6,"overcount"
"5919",53015,"Washington","Cowlitz County","API_alone",1894,1367,-527,-32.32,"undercount"
"5920",53015,"Washington","Cowlitz County","API_combo",1894,1916,22,1.15,"overcount"
"5921",53017,"Washington","Douglas County","API_alone",303,229,-74,-27.82,"undercount"
"5922",53017,"Washington","Douglas County","API_combo",303,341,38,11.8,"overcount"
"5923",53019,"Washington","Ferry County","API_alone",35,30,-5,-15.38,"undercount"
"5924",53019,"Washington","Ferry County","API_combo",35,65,30,60,"overcount"
"5925",53021,"Washington","Franklin County","API_alone",1493,1006,-487,-38.98,"undercount"
"5926",53021,"Washington","Franklin County","API_combo",1493,1184,-309,-23.09,"undercount"
"5927",53023,"Washington","Garfield County","API_alone",10,17,7,51.85,"overcount"
"5928",53023,"Washington","Garfield County","API_combo",10,25,15,85.71,"overcount"
"5929",53025,"Washington","Grant County","API_alone",1248,775,-473,-46.76,"undercount"
"5930",53025,"Washington","Grant County","API_combo",1248,1127,-121,-10.19,"undercount"
"5931",53027,"Washington","Grays Harbor County","API_alone",1136,940,-196,-18.88,"undercount"
"5932",53027,"Washington","Grays Harbor County","API_combo",1136,1413,277,21.73,"overcount"
"5933",53029,"Washington","Island County","API_alone",4573,3397,-1176,-29.51,"undercount"
"5934",53029,"Washington","Island County","API_combo",4573,4716,143,3.08,"overcount"
"5935",53031,"Washington","Jefferson County","API_alone",406,350,-56,-14.81,"undercount"
"5936",53031,"Washington","Jefferson County","API_combo",406,557,151,31.36,"overcount"
"5937",53033,"Washington","King County","API_alone",189340,201237,11897,6.09,"overcount"
"5938",53033,"Washington","King County","API_combo",189340,234030,44690,21.11,"overcount"
"5939",53035,"Washington","Kitsap County","API_alone",15593,12335,-3258,-23.33,"undercount"
"5940",53035,"Washington","Kitsap County","API_combo",15593,17814,2221,13.3,"overcount"
"5941",53037,"Washington","Kittitas County","API_alone",730,799,69,9.03,"overcount"
"5942",53037,"Washington","Kittitas County","API_combo",730,1015,285,32.66,"overcount"
"5943",53039,"Washington","Klickitat County","API_alone",228,182,-46,-22.44,"undercount"
"5944",53039,"Washington","Klickitat County","API_combo",228,296,68,25.95,"overcount"
"5945",53041,"Washington","Lewis County","API_alone",665,617,-48,-7.49,"undercount"
"5946",53041,"Washington","Lewis County","API_combo",665,900,235,30.03,"overcount"
"5947",53043,"Washington","Lincoln County","API_alone",45,36,-9,-22.22,"undercount"
"5948",53043,"Washington","Lincoln County","API_combo",45,54,9,18.18,"overcount"
"5949",53045,"Washington","Mason County","API_alone",987,765,-222,-25.34,"undercount"
"5950",53045,"Washington","Mason County","API_combo",987,1172,185,17.14,"overcount"
"5951",53047,"Washington","Okanogan County","API_alone",301,217,-84,-32.43,"undercount"
"5952",53047,"Washington","Okanogan County","API_combo",301,386,85,24.75,"overcount"
"5953",53049,"Washington","Pacific County","API_alone",784,462,-322,-51.69,"undercount"
"5954",53049,"Washington","Pacific County","API_combo",784,583,-201,-29.41,"undercount"
"5955",53051,"Washington","Pend Oreille County","API_alone",55,98,43,56.21,"overcount"
"5956",53051,"Washington","Pend Oreille County","API_combo",55,155,100,95.24,"overcount"
"5957",53053,"Washington","Pierce County","API_alone",49700,42836,-6864,-14.84,"undercount"
"5958",53053,"Washington","Pierce County","API_combo",49700,58716,9016,16.63,"overcount"
"5959",53055,"Washington","San Juan County","API_alone",169,143,-26,-16.67,"undercount"
"5960",53055,"Washington","San Juan County","API_combo",169,225,56,28.43,"overcount"
"5961",53057,"Washington","Skagit County","API_alone",1486,1813,327,19.82,"overcount"
"5962",53057,"Washington","Skagit County","API_combo",1486,2476,990,49.97,"overcount"
"5963",53059,"Washington","Skamania County","API_alone",91,75,-16,-19.28,"undercount"
"5964",53059,"Washington","Skamania County","API_combo",91,133,42,37.5,"overcount"
"5965",53061,"Washington","Snohomish County","API_alone",31262,37617,6355,18.45,"overcount"
"5966",53061,"Washington","Snohomish County","API_combo",31262,46404,15142,38.99,"overcount"
"5967",53063,"Washington","Spokane County","API_alone",10979,8705,-2274,-23.11,"undercount"
"5968",53063,"Washington","Spokane County","API_combo",10979,12507,1528,13.01,"overcount"
"5969",53065,"Washington","Stevens County","API_alone",363,264,-99,-31.58,"undercount"
"5970",53065,"Washington","Stevens County","API_combo",363,512,149,34.06,"overcount"
"5971",53067,"Washington","Thurston County","API_alone",11551,10521,-1030,-9.33,"undercount"
"5972",53067,"Washington","Thurston County","API_combo",11551,13978,2427,19.01,"overcount"
"5973",53069,"Washington","Wahkiakum County","API_alone",29,21,-8,-32,"undercount"
"5974",53069,"Washington","Wahkiakum County","API_combo",29,38,9,26.87,"overcount"
"5975",53071,"Washington","Walla Walla County","API_alone",1037,789,-248,-27.16,"undercount"
"5976",53071,"Washington","Walla Walla County","API_combo",1037,1137,100,9.2,"overcount"
"5977",53073,"Washington","Whatcom County","API_alone",4356,5017,661,14.1,"overcount"
"5978",53073,"Washington","Whatcom County","API_combo",4356,6692,2336,42.29,"overcount"
"5979",53075,"Washington","Whitman County","API_alone",2895,2412,-483,-18.2,"undercount"
"5980",53075,"Washington","Whitman County","API_combo",2895,2924,29,1,"overcount"
"5981",53077,"Washington","Yakima County","API_alone",4345,2833,-1512,-42.13,"undercount"
"5982",53077,"Washington","Yakima County","API_combo",4345,4017,-328,-7.85,"undercount"
"5983",54001,"West Virginia","Barbour County","API_alone",43,48,5,10.99,"overcount"
"5984",54001,"West Virginia","Barbour County","API_combo",43,60,17,33.01,"overcount"
"5985",54003,"West Virginia","Berkeley County","API_alone",429,386,-43,-10.55,"undercount"
"5986",54003,"West Virginia","Berkeley County","API_combo",429,578,149,29.59,"overcount"
"5987",54005,"West Virginia","Boone County","API_alone",32,24,-8,-28.57,"undercount"
"5988",54005,"West Virginia","Boone County","API_combo",32,39,7,19.72,"overcount"
"5989",54007,"West Virginia","Braxton County","API_alone",31,23,-8,-29.63,"undercount"
"5990",54007,"West Virginia","Braxton County","API_combo",31,30,-1,-3.28,"undercount"
"5991",54009,"West Virginia","Brooke County","API_alone",74,96,22,25.88,"overcount"
"5992",54009,"West Virginia","Brooke County","API_combo",74,116,42,44.21,"overcount"
"5993",54011,"West Virginia","Cabell County","API_alone",607,813,206,29.01,"overcount"
"5994",54011,"West Virginia","Cabell County","API_combo",607,1012,405,50.03,"overcount"
"5995",54013,"West Virginia","Calhoun County","API_alone",41,9,-32,-128,"undercount"
"5996",54013,"West Virginia","Calhoun County","API_combo",41,12,-29,-109.43,"undercount"
"5997",54015,"West Virginia","Clay County","API_alone",28,2,-26,-173.33,"undercount"
"5998",54015,"West Virginia","Clay County","API_combo",28,14,-14,-66.67,"undercount"
"5999",54017,"West Virginia","Doddridge County","API_alone",21,11,-10,-62.5,"undercount"
"6000",54017,"West Virginia","Doddridge County","API_combo",21,24,3,13.33,"overcount"
"6001",54019,"West Virginia","Fayette County","API_alone",170,162,-8,-4.82,"undercount"
"6002",54019,"West Virginia","Fayette County","API_combo",170,212,42,21.99,"overcount"
"6003",54021,"West Virginia","Gilmer County","API_alone",31,42,11,30.14,"overcount"
"6004",54021,"West Virginia","Gilmer County","API_combo",31,51,20,48.78,"overcount"
"6005",54023,"West Virginia","Grant County","API_alone",33,18,-15,-58.82,"undercount"
"6006",54023,"West Virginia","Grant County","API_combo",33,19,-14,-53.85,"undercount"
"6007",54025,"West Virginia","Greenbrier County","API_alone",74,67,-7,-9.93,"undercount"
"6008",54025,"West Virginia","Greenbrier County","API_combo",74,109,35,38.25,"overcount"
"6009",54027,"West Virginia","Hampshire County","API_alone",33,39,6,16.67,"overcount"
"6010",54027,"West Virginia","Hampshire County","API_combo",33,59,26,56.52,"overcount"
"6011",54029,"West Virginia","Hancock County","API_alone",103,119,16,14.41,"overcount"
"6012",54029,"West Virginia","Hancock County","API_combo",103,171,68,49.64,"overcount"
"6013",54031,"West Virginia","Hardy County","API_alone",6,20,14,107.69,"overcount"
"6014",54031,"West Virginia","Hardy County","API_combo",6,24,18,120,"overcount"
"6015",54033,"West Virginia","Harrison County","API_alone",251,436,185,53.86,"overcount"
"6016",54033,"West Virginia","Harrison County","API_combo",251,540,289,73.07,"overcount"
"6017",54035,"West Virginia","Jackson County","API_alone",75,68,-7,-9.79,"undercount"
"6018",54035,"West Virginia","Jackson County","API_combo",75,95,20,23.53,"overcount"
"6019",54037,"West Virginia","Jefferson County","API_alone",214,280,66,26.72,"overcount"
"6020",54037,"West Virginia","Jefferson County","API_combo",214,396,182,59.67,"overcount"
"6021",54039,"West Virginia","Kanawha County","API_alone",1463,1767,304,18.82,"overcount"
"6022",54039,"West Virginia","Kanawha County","API_combo",1463,2160,697,38.48,"overcount"
"6023",54041,"West Virginia","Lewis County","API_alone",70,52,-18,-29.51,"undercount"
"6024",54041,"West Virginia","Lewis County","API_combo",70,70,0,0,"equal"
"6025",54043,"West Virginia","Lincoln County","API_alone",31,15,-16,-69.57,"undercount"
"6026",54043,"West Virginia","Lincoln County","API_combo",31,44,13,34.67,"overcount"
"6027",54045,"West Virginia","Logan County","API_alone",211,122,-89,-53.45,"undercount"
"6028",54045,"West Virginia","Logan County","API_combo",211,151,-60,-33.15,"undercount"
"6029",54047,"West Virginia","McDowell County","API_alone",49,18,-31,-92.54,"undercount"
"6030",54047,"West Virginia","McDowell County","API_combo",49,37,-12,-27.91,"undercount"
"6031",54049,"West Virginia","Marion County","API_alone",170,240,70,34.15,"overcount"
"6032",54049,"West Virginia","Marion County","API_combo",170,314,144,59.5,"overcount"
"6033",54051,"West Virginia","Marshall County","API_alone",103,104,1,0.97,"overcount"
"6034",54051,"West Virginia","Marshall County","API_combo",103,141,38,31.15,"overcount"
"6035",54053,"West Virginia","Mason County","API_alone",111,73,-38,-41.3,"undercount"
"6036",54053,"West Virginia","Mason County","API_combo",111,83,-28,-28.87,"undercount"
"6037",54055,"West Virginia","Mercer County","API_alone",345,302,-43,-13.29,"undercount"
"6038",54055,"West Virginia","Mercer County","API_combo",345,388,43,11.73,"overcount"
"6039",54057,"West Virginia","Mineral County","API_alone",73,57,-16,-24.62,"undercount"
"6040",54057,"West Virginia","Mineral County","API_combo",73,93,20,24.1,"overcount"
"6041",54059,"West Virginia","Mingo County","API_alone",121,68,-53,-56.08,"undercount"
"6042",54059,"West Virginia","Mingo County","API_combo",121,95,-26,-24.07,"undercount"
"6043",54061,"West Virginia","Monongalia County","API_alone",1779,2078,299,15.5,"overcount"
"6044",54061,"West Virginia","Monongalia County","API_combo",1779,2457,678,32.01,"overcount"
"6045",54063,"West Virginia","Monroe County","API_alone",16,25,9,43.9,"overcount"
"6046",54063,"West Virginia","Monroe County","API_combo",16,36,20,76.92,"overcount"
"6047",54065,"West Virginia","Morgan County","API_alone",28,20,-8,-33.33,"undercount"
"6048",54065,"West Virginia","Morgan County","API_combo",28,37,9,27.69,"overcount"
"6049",54067,"West Virginia","Nicholas County","API_alone",72,56,-16,-25,"undercount"
"6050",54067,"West Virginia","Nicholas County","API_combo",72,85,13,16.56,"overcount"
"6051",54069,"West Virginia","Ohio County","API_alone",384,390,6,1.55,"overcount"
"6052",54069,"West Virginia","Ohio County","API_combo",384,488,104,23.85,"overcount"
"6053",54071,"West Virginia","Pendleton County","API_alone",15,18,3,18.18,"overcount"
"6054",54071,"West Virginia","Pendleton County","API_combo",15,32,17,72.34,"overcount"
"6055",54073,"West Virginia","Pleasants County","API_alone",2,15,13,152.94,"overcount"
"6056",54073,"West Virginia","Pleasants County","API_combo",2,17,15,157.89,"overcount"
"6057",54075,"West Virginia","Pocahontas County","API_alone",8,13,5,47.62,"overcount"
"6058",54075,"West Virginia","Pocahontas County","API_combo",8,19,11,81.48,"overcount"
"6059",54077,"West Virginia","Preston County","API_alone",42,48,6,13.33,"overcount"
"6060",54077,"West Virginia","Preston County","API_combo",42,78,36,60,"overcount"
"6061",54079,"West Virginia","Putnam County","API_alone",194,329,135,51.63,"overcount"
"6062",54079,"West Virginia","Putnam County","API_combo",194,388,194,66.67,"overcount"
"6063",54081,"West Virginia","Raleigh County","API_alone",514,597,83,14.94,"overcount"
"6064",54081,"West Virginia","Raleigh County","API_combo",514,724,210,33.93,"overcount"
"6065",54083,"West Virginia","Randolph County","API_alone",94,112,18,17.48,"overcount"
"6066",54083,"West Virginia","Randolph County","API_combo",94,145,51,42.68,"overcount"
"6067",54085,"West Virginia","Ritchie County","API_alone",14,13,-1,-7.41,"undercount"
"6068",54085,"West Virginia","Ritchie County","API_combo",14,19,5,30.3,"overcount"
"6069",54087,"West Virginia","Roane County","API_alone",45,37,-8,-19.51,"undercount"
"6070",54087,"West Virginia","Roane County","API_combo",45,55,10,20,"overcount"
"6071",54089,"West Virginia","Summers County","API_alone",40,18,-22,-75.86,"undercount"
"6072",54089,"West Virginia","Summers County","API_combo",40,34,-6,-16.22,"undercount"
"6073",54091,"West Virginia","Taylor County","API_alone",38,33,-5,-14.08,"undercount"
"6074",54091,"West Virginia","Taylor County","API_combo",38,50,12,27.27,"overcount"
"6075",54093,"West Virginia","Tucker County","API_alone",14,10,-4,-33.33,"undercount"
"6076",54093,"West Virginia","Tucker County","API_combo",14,16,2,13.33,"overcount"
"6077",54095,"West Virginia","Tyler County","API_alone",20,9,-11,-75.86,"undercount"
"6078",54095,"West Virginia","Tyler County","API_combo",20,18,-2,-10.53,"undercount"
"6079",54097,"West Virginia","Upshur County","API_alone",79,75,-4,-5.19,"undercount"
"6080",54097,"West Virginia","Upshur County","API_combo",79,94,15,17.34,"overcount"
"6081",54099,"West Virginia","Wayne County","API_alone",59,96,37,47.74,"overcount"
"6082",54099,"West Virginia","Wayne County","API_combo",59,136,77,78.97,"overcount"
"6083",54101,"West Virginia","Webster County","API_alone",17,8,-9,-72,"undercount"
"6084",54101,"West Virginia","Webster County","API_combo",17,17,0,0,"equal"
"6085",54103,"West Virginia","Wetzel County","API_alone",51,63,12,21.05,"overcount"
"6086",54103,"West Virginia","Wetzel County","API_combo",51,77,26,40.62,"overcount"
"6087",54105,"West Virginia","Wirt County","API_alone",3,6,3,66.67,"overcount"
"6088",54105,"West Virginia","Wirt County","API_combo",3,9,6,100,"overcount"
"6089",54107,"West Virginia","Wood County","API_alone",393,484,91,20.75,"overcount"
"6090",54107,"West Virginia","Wood County","API_combo",393,586,193,39.43,"overcount"
"6091",54109,"West Virginia","Wyoming County","API_alone",35,21,-14,-50,"undercount"
"6092",54109,"West Virginia","Wyoming County","API_combo",35,46,11,27.16,"overcount"
"6093",55001,"Wisconsin","Adams County","API_alone",142,65,-77,-74.4,"undercount"
"6094",55001,"Wisconsin","Adams County","API_combo",142,90,-52,-44.83,"undercount"
"6095",55003,"Wisconsin","Ashland County","API_alone",76,63,-13,-18.71,"undercount"
"6096",55003,"Wisconsin","Ashland County","API_combo",76,101,25,28.25,"overcount"
"6097",55005,"Wisconsin","Barron County","API_alone",172,168,-4,-2.35,"undercount"
"6098",55005,"Wisconsin","Barron County","API_combo",172,239,67,32.6,"overcount"
"6099",55007,"Wisconsin","Bayfield County","API_alone",40,42,2,4.88,"overcount"
"6100",55007,"Wisconsin","Bayfield County","API_combo",40,64,24,46.15,"overcount"
"6101",55009,"Wisconsin","Brown County","API_alone",4385,5130,745,15.66,"overcount"
"6102",55009,"Wisconsin","Brown County","API_combo",4385,5749,1364,26.92,"overcount"
"6103",55011,"Wisconsin","Buffalo County","API_alone",50,51,1,1.98,"overcount"
"6104",55011,"Wisconsin","Buffalo County","API_combo",50,69,19,31.93,"overcount"
"6105",55013,"Wisconsin","Burnett County","API_alone",46,49,3,6.32,"overcount"
"6106",55013,"Wisconsin","Burnett County","API_combo",46,71,25,42.74,"overcount"
"6107",55015,"Wisconsin","Calumet County","API_alone",350,641,291,58.73,"overcount"
"6108",55015,"Wisconsin","Calumet County","API_combo",350,746,396,72.26,"overcount"
"6109",55017,"Wisconsin","Chippewa County","API_alone",451,520,69,14.21,"overcount"
"6110",55017,"Wisconsin","Chippewa County","API_combo",451,602,151,28.68,"overcount"
"6111",55019,"Wisconsin","Clark County","API_alone",69,106,37,42.29,"overcount"
"6112",55019,"Wisconsin","Clark County","API_combo",69,126,57,58.46,"overcount"
"6113",55021,"Wisconsin","Columbia County","API_alone",272,192,-80,-34.48,"undercount"
"6114",55021,"Wisconsin","Columbia County","API_combo",272,286,14,5.02,"overcount"
"6115",55023,"Wisconsin","Crawford County","API_alone",84,47,-37,-56.49,"undercount"
"6116",55023,"Wisconsin","Crawford County","API_combo",84,86,2,2.35,"overcount"
"6117",55025,"Wisconsin","Dane County","API_alone",14867,15171,304,2.02,"overcount"
"6118",55025,"Wisconsin","Dane County","API_combo",14867,17181,2314,14.44,"overcount"
"6119",55027,"Wisconsin","Dodge County","API_alone",373,323,-50,-14.37,"undercount"
"6120",55027,"Wisconsin","Dodge County","API_combo",373,455,82,19.81,"overcount"
"6121",55029,"Wisconsin","Door County","API_alone",76,85,9,11.18,"overcount"
"6122",55029,"Wisconsin","Door County","API_combo",76,111,35,37.43,"overcount"
"6123",55031,"Wisconsin","Douglas County","API_alone",421,292,-129,-36.19,"undercount"
"6124",55031,"Wisconsin","Douglas County","API_combo",421,402,-19,-4.62,"undercount"
"6125",55033,"Wisconsin","Dunn County","API_alone",1035,866,-169,-17.78,"undercount"
"6126",55033,"Wisconsin","Dunn County","API_combo",1035,1000,-35,-3.44,"undercount"
"6127",55035,"Wisconsin","Eau Claire County","API_alone",3377,2405,-972,-33.62,"undercount"
"6128",55035,"Wisconsin","Eau Claire County","API_combo",3377,2848,-529,-17,"undercount"
"6129",55037,"Wisconsin","Florence County","API_alone",9,15,6,50,"overcount"
"6130",55037,"Wisconsin","Florence County","API_combo",9,20,11,75.86,"overcount"
"6131",55039,"Wisconsin","Fond du Lac County","API_alone",743,895,152,18.56,"overcount"
"6132",55039,"Wisconsin","Fond du Lac County","API_combo",743,1071,328,36.16,"overcount"
"6133",55041,"Wisconsin","Forest County","API_alone",25,21,-4,-17.39,"undercount"
"6134",55041,"Wisconsin","Forest County","API_combo",25,37,12,38.71,"overcount"
"6135",55043,"Wisconsin","Grant County","API_alone",349,237,-112,-38.23,"undercount"
"6136",55043,"Wisconsin","Grant County","API_combo",349,316,-33,-9.92,"undercount"
"6137",55045,"Wisconsin","Green County","API_alone",125,103,-22,-19.3,"undercount"
"6138",55045,"Wisconsin","Green County","API_combo",125,155,30,21.43,"overcount"
"6139",55047,"Wisconsin","Green Lake County","API_alone",167,82,-85,-68.27,"undercount"
"6140",55047,"Wisconsin","Green Lake County","API_combo",167,111,-56,-40.29,"undercount"
"6141",55049,"Wisconsin","Iowa County","API_alone",39,83,44,72.13,"overcount"
"6142",55049,"Wisconsin","Iowa County","API_combo",39,110,71,95.3,"overcount"
"6143",55051,"Wisconsin","Iron County","API_alone",2,15,13,152.94,"overcount"
"6144",55051,"Wisconsin","Iron County","API_combo",2,23,21,168,"overcount"
"6145",55053,"Wisconsin","Jackson County","API_alone",51,39,-12,-26.67,"undercount"
"6146",55053,"Wisconsin","Jackson County","API_combo",51,70,19,31.4,"overcount"
"6147",55055,"Wisconsin","Jefferson County","API_alone",492,355,-137,-32.35,"undercount"
"6148",55055,"Wisconsin","Jefferson County","API_combo",492,510,18,3.59,"overcount"
"6149",55057,"Wisconsin","Juneau County","API_alone",149,112,-37,-28.35,"undercount"
"6150",55057,"Wisconsin","Juneau County","API_combo",149,134,-15,-10.6,"undercount"
"6151",55059,"Wisconsin","Kenosha County","API_alone",1205,1509,304,22.4,"overcount"
"6152",55059,"Wisconsin","Kenosha County","API_combo",1205,1951,746,47.28,"overcount"
"6153",55061,"Wisconsin","Kewaunee County","API_alone",43,28,-15,-42.25,"undercount"
"6154",55061,"Wisconsin","Kewaunee County","API_combo",43,46,3,6.74,"overcount"
"6155",55063,"Wisconsin","La Crosse County","API_alone",4262,3436,-826,-21.46,"undercount"
"6156",55063,"Wisconsin","La Crosse County","API_combo",4262,3919,-343,-8.39,"undercount"
"6157",55065,"Wisconsin","Lafayette County","API_alone",33,42,9,24,"overcount"
"6158",55065,"Wisconsin","Lafayette County","API_combo",33,58,25,54.95,"overcount"
"6159",55067,"Wisconsin","Langlade County","API_alone",36,62,26,53.06,"overcount"
"6160",55067,"Wisconsin","Langlade County","API_combo",36,85,49,80.99,"overcount"
"6161",55069,"Wisconsin","Lincoln County","API_alone",150,126,-24,-17.39,"undercount"
"6162",55069,"Wisconsin","Lincoln County","API_combo",150,163,13,8.31,"overcount"
"6163",55071,"Wisconsin","Manitowoc County","API_alone",1697,1722,25,1.46,"overcount"
"6164",55071,"Wisconsin","Manitowoc County","API_combo",1697,1870,173,9.7,"overcount"
"6165",55073,"Wisconsin","Marathon County","API_alone",4001,5833,1832,37.26,"overcount"
"6166",55073,"Wisconsin","Marathon County","API_combo",4001,6191,2190,42.97,"overcount"
"6167",55075,"Wisconsin","Marinette County","API_alone",111,133,22,18.03,"overcount"
"6168",55075,"Wisconsin","Marinette County","API_combo",111,193,82,53.95,"overcount"
"6169",55077,"Wisconsin","Marquette County","API_alone",42,58,16,32,"overcount"
"6170",55077,"Wisconsin","Marquette County","API_combo",42,94,52,76.47,"overcount"
"6171",55078,"Wisconsin","Menominee County","API_alone",16,2,-14,-155.56,"undercount"
"6172",55078,"Wisconsin","Menominee County","API_combo",16,3,-13,-136.84,"undercount"
"6173",55079,"Wisconsin","Milwaukee County","API_alone",21170,25615,4445,19,"overcount"
"6174",55079,"Wisconsin","Milwaukee County","API_combo",21170,29155,7985,31.73,"overcount"
"6175",55081,"Wisconsin","Monroe County","API_alone",258,211,-47,-20.04,"undercount"
"6176",55081,"Wisconsin","Monroe County","API_combo",258,298,40,14.39,"overcount"
"6177",55083,"Wisconsin","Oconto County","API_alone",79,77,-2,-2.56,"undercount"
"6178",55083,"Wisconsin","Oconto County","API_combo",79,113,34,35.42,"overcount"
"6179",55085,"Wisconsin","Oneida County","API_alone",118,128,10,8.13,"overcount"
"6180",55085,"Wisconsin","Oneida County","API_combo",118,186,68,44.74,"overcount"
"6181",55087,"Wisconsin","Outagamie County","API_alone",3388,3752,364,10.2,"overcount"
"6182",55087,"Wisconsin","Outagamie County","API_combo",3388,4181,793,20.95,"overcount"
"6183",55089,"Wisconsin","Ozaukee County","API_alone",807,903,96,11.23,"overcount"
"6184",55089,"Wisconsin","Ozaukee County","API_combo",807,1136,329,33.87,"overcount"
"6185",55091,"Wisconsin","Pepin County","API_alone",15,18,3,18.18,"overcount"
"6186",55091,"Wisconsin","Pepin County","API_combo",15,21,6,33.33,"overcount"
"6187",55093,"Wisconsin","Pierce County","API_alone",283,173,-110,-48.25,"undercount"
"6188",55093,"Wisconsin","Pierce County","API_combo",283,234,-49,-18.96,"undercount"
"6189",55095,"Wisconsin","Polk County","API_alone",108,121,13,11.35,"overcount"
"6190",55095,"Wisconsin","Polk County","API_combo",108,177,69,48.42,"overcount"
"6191",55097,"Wisconsin","Portage County","API_alone",1221,1566,345,24.76,"overcount"
"6192",55097,"Wisconsin","Portage County","API_combo",1221,1815,594,39.13,"overcount"
"6193",55099,"Wisconsin","Price County","API_alone",42,52,10,21.28,"overcount"
"6194",55099,"Wisconsin","Price County","API_combo",42,73,31,53.91,"overcount"
"6195",55101,"Wisconsin","Racine County","API_alone",1685,1505,-180,-11.29,"undercount"
"6196",55101,"Wisconsin","Racine County","API_combo",1685,1911,226,12.57,"overcount"
"6197",55103,"Wisconsin","Richland County","API_alone",57,45,-12,-23.53,"undercount"
"6198",55103,"Wisconsin","Richland County","API_combo",57,70,13,20.47,"overcount"
"6199",55105,"Wisconsin","Rock County","API_alone",1679,1289,-390,-26.28,"undercount"
"6200",55105,"Wisconsin","Rock County","API_combo",1679,1698,19,1.13,"overcount"
"6201",55107,"Wisconsin","Rusk County","API_alone",146,55,-91,-90.55,"undercount"
"6202",55107,"Wisconsin","Rusk County","API_combo",146,72,-74,-67.89,"undercount"
"6203",55109,"Wisconsin","St. Croix County","API_alone",293,413,120,33.99,"overcount"
"6204",55109,"Wisconsin","St. Croix County","API_combo",293,543,250,59.81,"overcount"
"6205",55111,"Wisconsin","Sauk County","API_alone",159,158,-1,-0.63,"undercount"
"6206",55111,"Wisconsin","Sauk County","API_combo",159,232,73,37.34,"overcount"
"6207",55113,"Wisconsin","Sawyer County","API_alone",32,51,19,45.78,"overcount"
"6208",55113,"Wisconsin","Sawyer County","API_combo",32,66,34,69.39,"overcount"
"6209",55115,"Wisconsin","Shawano County","API_alone",113,158,45,33.21,"overcount"
"6210",55115,"Wisconsin","Shawano County","API_combo",113,196,83,53.72,"overcount"
"6211",55117,"Wisconsin","Sheboygan County","API_alone",3395,3845,450,12.43,"overcount"
"6212",55117,"Wisconsin","Sheboygan County","API_combo",3395,4264,869,22.69,"overcount"
"6213",55119,"Wisconsin","Taylor County","API_alone",69,49,-20,-33.9,"undercount"
"6214",55119,"Wisconsin","Taylor County","API_combo",69,92,23,28.57,"overcount"
"6215",55121,"Wisconsin","Trempealeau County","API_alone",78,39,-39,-66.67,"undercount"
"6216",55121,"Wisconsin","Trempealeau County","API_combo",78,64,-14,-19.72,"undercount"
"6217",55123,"Wisconsin","Vernon County","API_alone",77,62,-15,-21.58,"undercount"
"6218",55123,"Wisconsin","Vernon County","API_combo",77,83,6,7.5,"overcount"
"6219",55125,"Wisconsin","Vilas County","API_alone",90,40,-50,-76.92,"undercount"
"6220",55125,"Wisconsin","Vilas County","API_combo",90,60,-30,-40,"undercount"
"6221",55127,"Wisconsin","Walworth County","API_alone",872,647,-225,-29.62,"undercount"
"6222",55127,"Wisconsin","Walworth County","API_combo",872,863,-9,-1.04,"undercount"
"6223",55129,"Wisconsin","Washburn County","API_alone",58,34,-24,-52.17,"undercount"
"6224",55129,"Wisconsin","Washburn County","API_combo",58,62,4,6.67,"overcount"
"6225",55131,"Wisconsin","Washington County","API_alone",675,728,53,7.56,"overcount"
"6226",55131,"Wisconsin","Washington County","API_combo",675,943,268,33.13,"overcount"
"6227",55133,"Wisconsin","Waukesha County","API_alone",5081,5568,487,9.15,"overcount"
"6228",55133,"Wisconsin","Waukesha County","API_combo",5081,6524,1443,24.87,"overcount"
"6229",55135,"Wisconsin","Waupaca County","API_alone",184,147,-37,-22.36,"undercount"
"6230",55135,"Wisconsin","Waupaca County","API_combo",184,201,17,8.83,"overcount"
"6231",55137,"Wisconsin","Waushara County","API_alone",85,88,3,3.47,"overcount"
"6232",55137,"Wisconsin","Waushara County","API_combo",85,114,29,29.15,"overcount"
"6233",55139,"Wisconsin","Winnebago County","API_alone",2894,2975,81,2.76,"overcount"
"6234",55139,"Wisconsin","Winnebago County","API_combo",2894,3420,526,16.66,"overcount"
"6235",55141,"Wisconsin","Wood County","API_alone",1171,1246,75,6.21,"overcount"
"6236",55141,"Wisconsin","Wood County","API_combo",1171,1332,161,12.86,"overcount"
"6237",56001,"Wyoming","Albany County","API_alone",803,573,-230,-33.43,"undercount"
"6238",56001,"Wyoming","Albany County","API_combo",803,715,-88,-11.59,"undercount"
"6239",56003,"Wyoming","Big Horn County","API_alone",33,32,-1,-3.08,"undercount"
"6240",56003,"Wyoming","Big Horn County","API_combo",33,49,16,39.02,"overcount"
"6241",56005,"Wyoming","Campbell County","API_alone",185,140,-45,-27.69,"undercount"
"6242",56005,"Wyoming","Campbell County","API_combo",185,213,28,14.07,"overcount"
"6243",56007,"Wyoming","Carbon County","API_alone",134,131,-3,-2.26,"undercount"
"6244",56007,"Wyoming","Carbon County","API_combo",134,161,27,18.31,"overcount"
"6245",56009,"Wyoming","Converse County","API_alone",59,35,-24,-51.06,"undercount"
"6246",56009,"Wyoming","Converse County","API_combo",59,59,0,0,"equal"
"6247",56011,"Wyoming","Crook County","API_alone",4,5,1,22.22,"overcount"
"6248",56011,"Wyoming","Crook County","API_combo",4,19,15,130.43,"overcount"
"6249",56013,"Wyoming","Fremont County","API_alone",155,123,-32,-23.02,"undercount"
"6250",56013,"Wyoming","Fremont County","API_combo",155,205,50,27.78,"overcount"
"6251",56015,"Wyoming","Goshen County","API_alone",20,42,22,70.97,"overcount"
"6252",56015,"Wyoming","Goshen County","API_combo",20,52,32,88.89,"overcount"
"6253",56017,"Wyoming","Hot Springs County","API_alone",1,12,11,169.23,"overcount"
"6254",56017,"Wyoming","Hot Springs County","API_combo",1,15,14,175,"overcount"
"6255",56019,"Wyoming","Johnson County","API_alone",11,10,-1,-9.52,"undercount"
"6256",56019,"Wyoming","Johnson County","API_combo",11,21,10,62.5,"overcount"
"6257",56021,"Wyoming","Laramie County","API_alone",1291,930,-361,-32.51,"undercount"
"6258",56021,"Wyoming","Laramie County","API_combo",1291,1442,151,11.05,"overcount"
"6259",56023,"Wyoming","Lincoln County","API_alone",67,42,-25,-45.87,"undercount"
"6260",56023,"Wyoming","Lincoln County","API_combo",67,74,7,9.93,"overcount"
"6261",56025,"Wyoming","Natrona County","API_alone",451,309,-142,-37.37,"undercount"
"6262",56025,"Wyoming","Natrona County","API_combo",451,472,21,4.55,"overcount"
"6263",56027,"Wyoming","Niobrara County","API_alone",4,3,-1,-28.57,"undercount"
"6264",56027,"Wyoming","Niobrara County","API_combo",4,3,-1,-28.57,"undercount"
"6265",56029,"Wyoming","Park County","API_alone",164,127,-37,-25.43,"undercount"
"6266",56029,"Wyoming","Park County","API_combo",164,188,24,13.64,"overcount"
"6267",56031,"Wyoming","Platte County","API_alone",10,21,11,70.97,"overcount"
"6268",56031,"Wyoming","Platte County","API_combo",10,35,25,111.11,"overcount"
"6269",56033,"Wyoming","Sheridan County","API_alone",144,136,-8,-5.71,"undercount"
"6270",56033,"Wyoming","Sheridan County","API_combo",144,214,70,39.11,"overcount"
"6271",56035,"Wyoming","Sublette County","API_alone",20,20,0,0,"equal"
"6272",56035,"Wyoming","Sublette County","API_combo",20,28,8,33.33,"overcount"
"6273",56037,"Wyoming","Sweetwater County","API_alone",390,262,-128,-39.26,"undercount"
"6274",56037,"Wyoming","Sweetwater County","API_combo",390,385,-5,-1.29,"undercount"
"6275",56039,"Wyoming","Teton County","API_alone",105,125,20,17.39,"overcount"
"6276",56039,"Wyoming","Teton County","API_combo",105,195,90,60,"overcount"
"6277",56041,"Wyoming","Uinta County","API_alone",129,75,-54,-52.94,"undercount"
"6278",56041,"Wyoming","Uinta County","API_combo",129,127,-2,-1.56,"undercount"
"6279",56043,"Wyoming","Washakie County","API_alone",65,65,0,0,"equal"
"6280",56043,"Wyoming","Washakie County","API_combo",65,85,20,26.67,"overcount"
"6281",56045,"Wyoming","Weston County","API_alone",12,15,3,22.22,"overcount"
"6282",56045,"Wyoming","Weston County","API_combo",12,23,11,62.86,"overcount"
