"","FIPS","STNAME","CTYNAME","RACE","ESTIM","MR","NUM_DIFF","PERC_DIFF","COVERAGE"
"1",1001,"Alabama","Autauga County","A_A",657,878,221,28.79,"overcount"
"2",1001,"Alabama","Autauga County","A_AIC",969,1317,348,30.45,"overcount"
"3",1001,"Alabama","Autauga County","NHPI_A",61,25,-36,-83.72,"undercount"
"4",1001,"Alabama","Autauga County","NHPI_AIC",101,96,-5,-5.08,"undercount"
"5",1003,"Alabama","Baldwin County","A_A",2529,2042,-487,-21.31,"undercount"
"6",1003,"Alabama","Baldwin County","A_AIC",3573,3376,-197,-5.67,"undercount"
"7",1003,"Alabama","Baldwin County","NHPI_A",152,125,-27,-19.49,"undercount"
"8",1003,"Alabama","Baldwin County","NHPI_AIC",375,333,-42,-11.86,"undercount"
"9",1005,"Alabama","Barbour County","A_A",112,104,-8,-7.41,"undercount"
"10",1005,"Alabama","Barbour County","A_AIC",155,136,-19,-13.06,"undercount"
"11",1005,"Alabama","Barbour County","NHPI_A",50,0,-50,-200,"undercount"
"12",1005,"Alabama","Barbour County","NHPI_AIC",65,11,-54,-142.11,"undercount"
"13",1007,"Alabama","Bibb County","A_A",57,26,-31,-74.7,"undercount"
"14",1007,"Alabama","Bibb County","A_AIC",106,45,-61,-80.79,"undercount"
"15",1007,"Alabama","Bibb County","NHPI_A",27,9,-18,-100,"undercount"
"16",1007,"Alabama","Bibb County","NHPI_AIC",43,14,-29,-101.75,"undercount"
"17",1009,"Alabama","Blount County","A_A",220,174,-46,-23.35,"undercount"
"18",1009,"Alabama","Blount County","A_AIC",358,344,-14,-3.99,"undercount"
"19",1009,"Alabama","Blount County","NHPI_A",70,11,-59,-145.68,"undercount"
"20",1009,"Alabama","Blount County","NHPI_AIC",94,43,-51,-74.45,"undercount"
"21",1011,"Alabama","Bullock County","A_A",27,12,-15,-76.92,"undercount"
"22",1011,"Alabama","Bullock County","A_AIC",51,24,-27,-72,"undercount"
"23",1011,"Alabama","Bullock County","NHPI_A",76,7,-69,-166.27,"undercount"
"24",1011,"Alabama","Bullock County","NHPI_AIC",79,14,-65,-139.78,"undercount"
"25",1013,"Alabama","Butler County","A_A",266,143,-123,-60.15,"undercount"
"26",1013,"Alabama","Butler County","A_AIC",296,194,-102,-41.63,"undercount"
"27",1013,"Alabama","Butler County","NHPI_A",8,5,-3,-46.15,"undercount"
"28",1013,"Alabama","Butler County","NHPI_AIC",21,24,3,13.33,"overcount"
"29",1015,"Alabama","Calhoun County","A_A",1002,1164,162,14.96,"overcount"
"30",1015,"Alabama","Calhoun County","A_AIC",1544,1687,143,8.85,"overcount"
"31",1015,"Alabama","Calhoun County","NHPI_A",127,118,-9,-7.35,"undercount"
"32",1015,"Alabama","Calhoun County","NHPI_AIC",270,222,-48,-19.51,"undercount"
"33",1017,"Alabama","Chambers County","A_A",377,385,8,2.1,"overcount"
"34",1017,"Alabama","Chambers County","A_AIC",431,465,34,7.59,"overcount"
"35",1017,"Alabama","Chambers County","NHPI_A",19,11,-8,-53.33,"undercount"
"36",1017,"Alabama","Chambers County","NHPI_AIC",27,33,6,20,"overcount"
"37",1019,"Alabama","Cherokee County","A_A",124,57,-67,-74.03,"undercount"
"38",1019,"Alabama","Cherokee County","A_AIC",165,83,-82,-66.13,"undercount"
"39",1019,"Alabama","Cherokee County","NHPI_A",8,1,-7,-155.56,"undercount"
"40",1019,"Alabama","Cherokee County","NHPI_AIC",19,24,5,23.26,"overcount"
"41",1021,"Alabama","Chilton County","A_A",213,176,-37,-19.02,"undercount"
"42",1021,"Alabama","Chilton County","A_AIC",302,249,-53,-19.24,"undercount"
"43",1021,"Alabama","Chilton County","NHPI_A",77,5,-72,-175.61,"undercount"
"44",1021,"Alabama","Chilton County","NHPI_AIC",101,20,-81,-133.88,"undercount"
"45",1023,"Alabama","Choctaw County","A_A",30,19,-11,-44.9,"undercount"
"46",1023,"Alabama","Choctaw County","A_AIC",48,43,-5,-10.99,"undercount"
"47",1023,"Alabama","Choctaw County","NHPI_A",0,0,0,0,"equal"
"48",1023,"Alabama","Choctaw County","NHPI_AIC",6,4,-2,-40,"undercount"
"49",1025,"Alabama","Clarke County","A_A",102,91,-11,-11.4,"undercount"
"50",1025,"Alabama","Clarke County","A_AIC",147,132,-15,-10.75,"undercount"
"51",1025,"Alabama","Clarke County","NHPI_A",5,1,-4,-133.33,"undercount"
"52",1025,"Alabama","Clarke County","NHPI_AIC",15,8,-7,-60.87,"undercount"
"53",1027,"Alabama","Clay County","A_A",39,46,7,16.47,"overcount"
"54",1027,"Alabama","Clay County","A_AIC",65,73,8,11.59,"overcount"
"55",1027,"Alabama","Clay County","NHPI_A",0,4,4,200,"overcount"
"56",1027,"Alabama","Clay County","NHPI_AIC",11,16,5,37.04,"overcount"
"57",1029,"Alabama","Cleburne County","A_A",29,22,-7,-27.45,"undercount"
"58",1029,"Alabama","Cleburne County","A_AIC",52,48,-4,-8,"undercount"
"59",1029,"Alabama","Cleburne County","NHPI_A",11,2,-9,-138.46,"undercount"
"60",1029,"Alabama","Cleburne County","NHPI_AIC",23,14,-9,-48.65,"undercount"
"61",1031,"Alabama","Coffee County","A_A",892,922,30,3.31,"overcount"
"62",1031,"Alabama","Coffee County","A_AIC",1360,1423,63,4.53,"overcount"
"63",1031,"Alabama","Coffee County","NHPI_A",220,57,-163,-117.69,"undercount"
"64",1031,"Alabama","Coffee County","NHPI_AIC",344,168,-176,-68.75,"undercount"
"65",1033,"Alabama","Colbert County","A_A",383,432,49,12.02,"overcount"
"66",1033,"Alabama","Colbert County","A_AIC",501,563,62,11.65,"overcount"
"67",1033,"Alabama","Colbert County","NHPI_A",37,9,-28,-121.74,"undercount"
"68",1033,"Alabama","Colbert County","NHPI_AIC",71,28,-43,-86.87,"undercount"
"69",1035,"Alabama","Conecuh County","A_A",32,37,5,14.49,"overcount"
"70",1035,"Alabama","Conecuh County","A_AIC",60,59,-1,-1.68,"undercount"
"71",1035,"Alabama","Conecuh County","NHPI_A",4,5,1,22.22,"overcount"
"72",1035,"Alabama","Conecuh County","NHPI_AIC",16,19,3,17.14,"overcount"
"73",1037,"Alabama","Coosa County","A_A",21,8,-13,-89.66,"undercount"
"74",1037,"Alabama","Coosa County","A_AIC",43,22,-21,-64.62,"undercount"
"75",1037,"Alabama","Coosa County","NHPI_A",18,0,-18,-200,"undercount"
"76",1037,"Alabama","Coosa County","NHPI_AIC",30,8,-22,-115.79,"undercount"
"77",1039,"Alabama","Covington County","A_A",188,246,58,26.73,"overcount"
"78",1039,"Alabama","Covington County","A_AIC",242,322,80,28.37,"overcount"
"79",1039,"Alabama","Covington County","NHPI_A",4,1,-3,-120,"undercount"
"80",1039,"Alabama","Covington County","NHPI_AIC",23,18,-5,-24.39,"undercount"
"81",1041,"Alabama","Crenshaw County","A_A",163,87,-76,-60.8,"undercount"
"82",1041,"Alabama","Crenshaw County","A_AIC",187,110,-77,-51.85,"undercount"
"83",1041,"Alabama","Crenshaw County","NHPI_A",6,2,-4,-100,"undercount"
"84",1041,"Alabama","Crenshaw County","NHPI_AIC",10,13,3,26.09,"overcount"
"85",1043,"Alabama","Cullman County","A_A",560,524,-36,-6.64,"undercount"
"86",1043,"Alabama","Cullman County","A_AIC",719,739,20,2.74,"overcount"
"87",1043,"Alabama","Cullman County","NHPI_A",72,64,-8,-11.76,"undercount"
"88",1043,"Alabama","Cullman County","NHPI_AIC",109,136,27,22.04,"overcount"
"89",1045,"Alabama","Dale County","A_A",706,659,-47,-6.89,"undercount"
"90",1045,"Alabama","Dale County","A_AIC",1056,1011,-45,-4.35,"undercount"
"91",1045,"Alabama","Dale County","NHPI_A",88,42,-46,-70.77,"undercount"
"92",1045,"Alabama","Dale County","NHPI_AIC",181,142,-39,-24.15,"undercount"
"93",1047,"Alabama","Dallas County","A_A",193,148,-45,-26.39,"undercount"
"94",1047,"Alabama","Dallas County","A_AIC",250,167,-83,-39.81,"undercount"
"95",1047,"Alabama","Dallas County","NHPI_A",16,12,-4,-28.57,"undercount"
"96",1047,"Alabama","Dallas County","NHPI_AIC",34,35,1,2.9,"overcount"
"97",1049,"Alabama","DeKalb County","A_A",371,237,-134,-44.08,"undercount"
"98",1049,"Alabama","DeKalb County","A_AIC",507,376,-131,-29.67,"undercount"
"99",1049,"Alabama","DeKalb County","NHPI_A",452,16,-436,-186.32,"undercount"
"100",1049,"Alabama","DeKalb County","NHPI_AIC",507,41,-466,-170.07,"undercount"
"101",1051,"Alabama","Elmore County","A_A",649,681,32,4.81,"overcount"
"102",1051,"Alabama","Elmore County","A_AIC",1016,1084,68,6.48,"overcount"
"103",1051,"Alabama","Elmore County","NHPI_A",101,28,-73,-113.18,"undercount"
"104",1051,"Alabama","Elmore County","NHPI_AIC",165,84,-81,-65.06,"undercount"
"105",1053,"Alabama","Escambia County","A_A",111,108,-3,-2.74,"undercount"
"106",1053,"Alabama","Escambia County","A_AIC",217,193,-24,-11.71,"undercount"
"107",1053,"Alabama","Escambia County","NHPI_A",27,22,-5,-20.41,"undercount"
"108",1053,"Alabama","Escambia County","NHPI_AIC",54,44,-10,-20.41,"undercount"
"109",1055,"Alabama","Etowah County","A_A",881,924,43,4.76,"overcount"
"110",1055,"Alabama","Etowah County","A_AIC",1113,1191,78,6.77,"overcount"
"111",1055,"Alabama","Etowah County","NHPI_A",338,39,-299,-158.62,"undercount"
"112",1055,"Alabama","Etowah County","NHPI_AIC",395,65,-330,-143.48,"undercount"
"113",1057,"Alabama","Fayette County","A_A",85,49,-36,-53.73,"undercount"
"114",1057,"Alabama","Fayette County","A_AIC",106,82,-24,-25.53,"undercount"
"115",1057,"Alabama","Fayette County","NHPI_A",0,1,1,200,"overcount"
"116",1057,"Alabama","Fayette County","NHPI_AIC",6,3,-3,-66.67,"undercount"
"117",1059,"Alabama","Franklin County","A_A",121,68,-53,-56.08,"undercount"
"118",1059,"Alabama","Franklin County","A_AIC",175,106,-69,-49.11,"undercount"
"119",1059,"Alabama","Franklin County","NHPI_A",79,5,-74,-176.19,"undercount"
"120",1059,"Alabama","Franklin County","NHPI_AIC",97,34,-63,-96.18,"undercount"
"121",1061,"Alabama","Geneva County","A_A",105,91,-14,-14.29,"undercount"
"122",1061,"Alabama","Geneva County","A_AIC",171,152,-19,-11.76,"undercount"
"123",1061,"Alabama","Geneva County","NHPI_A",22,7,-15,-103.45,"undercount"
"124",1061,"Alabama","Geneva County","NHPI_AIC",40,32,-8,-22.22,"undercount"
"125",1063,"Alabama","Greene County","A_A",19,7,-12,-92.31,"undercount"
"126",1063,"Alabama","Greene County","A_AIC",28,22,-6,-24,"undercount"
"127",1063,"Alabama","Greene County","NHPI_A",0,0,0,0,"equal"
"128",1063,"Alabama","Greene County","NHPI_AIC",1,4,3,120,"overcount"
"129",1065,"Alabama","Hale County","A_A",47,18,-29,-89.23,"undercount"
"130",1065,"Alabama","Hale County","A_AIC",76,58,-18,-26.87,"undercount"
"131",1065,"Alabama","Hale County","NHPI_A",5,5,0,0,"equal"
"132",1065,"Alabama","Hale County","NHPI_AIC",9,21,12,80,"overcount"
"133",1067,"Alabama","Henry County","A_A",84,73,-11,-14.01,"undercount"
"134",1067,"Alabama","Henry County","A_AIC",119,143,24,18.32,"overcount"
"135",1067,"Alabama","Henry County","NHPI_A",3,0,-3,-200,"undercount"
"136",1067,"Alabama","Henry County","NHPI_AIC",13,13,0,0,"equal"
"137",1069,"Alabama","Houston County","A_A",1202,1264,62,5.03,"overcount"
"138",1069,"Alabama","Houston County","A_AIC",1673,1875,202,11.39,"overcount"
"139",1069,"Alabama","Houston County","NHPI_A",106,59,-47,-56.97,"undercount"
"140",1069,"Alabama","Houston County","NHPI_AIC",244,159,-85,-42.18,"undercount"
"141",1071,"Alabama","Jackson County","A_A",299,217,-82,-31.78,"undercount"
"142",1071,"Alabama","Jackson County","A_AIC",397,334,-63,-17.24,"undercount"
"143",1071,"Alabama","Jackson County","NHPI_A",67,2,-65,-188.41,"undercount"
"144",1071,"Alabama","Jackson County","NHPI_AIC",93,30,-63,-102.44,"undercount"
"145",1073,"Alabama","Jefferson County","A_A",12005,13194,1189,9.44,"overcount"
"146",1073,"Alabama","Jefferson County","A_AIC",14471,16205,1734,11.31,"overcount"
"147",1073,"Alabama","Jefferson County","NHPI_A",372,335,-37,-10.47,"undercount"
"148",1073,"Alabama","Jefferson County","NHPI_AIC",697,732,35,4.9,"overcount"
"149",1075,"Alabama","Lamar County","A_A",15,6,-9,-85.71,"undercount"
"150",1075,"Alabama","Lamar County","A_AIC",52,29,-23,-56.79,"undercount"
"151",1075,"Alabama","Lamar County","NHPI_A",2,3,1,40,"overcount"
"152",1075,"Alabama","Lamar County","NHPI_AIC",9,4,-5,-76.92,"undercount"
"153",1077,"Alabama","Lauderdale County","A_A",853,749,-104,-12.98,"undercount"
"154",1077,"Alabama","Lauderdale County","A_AIC",1081,1076,-5,-0.46,"undercount"
"155",1077,"Alabama","Lauderdale County","NHPI_A",72,31,-41,-79.61,"undercount"
"156",1077,"Alabama","Lauderdale County","NHPI_AIC",122,103,-19,-16.89,"undercount"
"157",1079,"Alabama","Lawrence County","A_A",87,84,-3,-3.51,"undercount"
"158",1079,"Alabama","Lawrence County","A_AIC",177,180,3,1.68,"overcount"
"159",1079,"Alabama","Lawrence County","NHPI_A",7,9,2,25,"overcount"
"160",1079,"Alabama","Lawrence County","NHPI_AIC",43,33,-10,-26.32,"undercount"
"161",1081,"Alabama","Lee County","A_A",6955,8580,1625,20.92,"overcount"
"162",1081,"Alabama","Lee County","A_AIC",7916,9958,2042,22.85,"overcount"
"163",1081,"Alabama","Lee County","NHPI_A",158,111,-47,-34.94,"undercount"
"164",1081,"Alabama","Lee County","NHPI_AIC",302,287,-15,-5.09,"undercount"
"165",1083,"Alabama","Limestone County","A_A",1837,1861,24,1.3,"overcount"
"166",1083,"Alabama","Limestone County","A_AIC",2331,2613,282,11.41,"overcount"
"167",1083,"Alabama","Limestone County","NHPI_A",187,70,-117,-91.05,"undercount"
"168",1083,"Alabama","Limestone County","NHPI_AIC",276,189,-87,-37.42,"undercount"
"169",1085,"Alabama","Lowndes County","A_A",45,19,-26,-81.25,"undercount"
"170",1085,"Alabama","Lowndes County","A_AIC",55,38,-17,-36.56,"undercount"
"171",1085,"Alabama","Lowndes County","NHPI_A",4,0,-4,-200,"undercount"
"172",1085,"Alabama","Lowndes County","NHPI_AIC",7,4,-3,-54.55,"undercount"
"173",1087,"Alabama","Macon County","A_A",93,74,-19,-22.75,"undercount"
"174",1087,"Alabama","Macon County","A_AIC",155,93,-62,-50,"undercount"
"175",1087,"Alabama","Macon County","NHPI_A",3,5,2,50,"overcount"
"176",1087,"Alabama","Macon County","NHPI_AIC",20,20,0,0,"equal"
"177",1089,"Alabama","Madison County","A_A",10109,10298,189,1.85,"overcount"
"178",1089,"Alabama","Madison County","A_AIC",13487,14671,1184,8.41,"overcount"
"179",1089,"Alabama","Madison County","NHPI_A",397,461,64,14.92,"overcount"
"180",1089,"Alabama","Madison County","NHPI_AIC",816,998,182,20.07,"overcount"
"181",1091,"Alabama","Marengo County","A_A",64,54,-10,-16.95,"undercount"
"182",1091,"Alabama","Marengo County","A_AIC",90,77,-13,-15.57,"undercount"
"183",1091,"Alabama","Marengo County","NHPI_A",34,1,-33,-188.57,"undercount"
"184",1091,"Alabama","Marengo County","NHPI_AIC",43,7,-36,-144,"undercount"
"185",1093,"Alabama","Marion County","A_A",102,75,-27,-30.51,"undercount"
"186",1093,"Alabama","Marion County","A_AIC",150,153,3,1.98,"overcount"
"187",1093,"Alabama","Marion County","NHPI_A",22,14,-8,-44.44,"undercount"
"188",1093,"Alabama","Marion County","NHPI_AIC",32,19,-13,-50.98,"undercount"
"189",1095,"Alabama","Marshall County","A_A",757,587,-170,-25.3,"undercount"
"190",1095,"Alabama","Marshall County","A_AIC",991,879,-112,-11.98,"undercount"
"191",1095,"Alabama","Marshall County","NHPI_A",345,128,-217,-91.75,"undercount"
"192",1095,"Alabama","Marshall County","NHPI_AIC",423,185,-238,-78.29,"undercount"
"193",1097,"Alabama","Mobile County","A_A",8704,8636,-68,-0.78,"undercount"
"194",1097,"Alabama","Mobile County","A_AIC",10499,10505,6,0.06,"overcount"
"195",1097,"Alabama","Mobile County","NHPI_A",185,220,35,17.28,"overcount"
"196",1097,"Alabama","Mobile County","NHPI_AIC",474,537,63,12.46,"overcount"
"197",1099,"Alabama","Monroe County","A_A",90,88,-2,-2.25,"undercount"
"198",1099,"Alabama","Monroe County","A_AIC",143,125,-18,-13.43,"undercount"
"199",1099,"Alabama","Monroe County","NHPI_A",8,0,-8,-200,"undercount"
"200",1099,"Alabama","Monroe County","NHPI_AIC",20,15,-5,-28.57,"undercount"
"201",1101,"Alabama","Montgomery County","A_A",7568,7979,411,5.29,"overcount"
"202",1101,"Alabama","Montgomery County","A_AIC",8697,9175,478,5.35,"overcount"
"203",1101,"Alabama","Montgomery County","NHPI_A",217,123,-94,-55.29,"undercount"
"204",1101,"Alabama","Montgomery County","NHPI_AIC",414,271,-143,-41.75,"undercount"
"205",1103,"Alabama","Morgan County","A_A",821,848,27,3.24,"overcount"
"206",1103,"Alabama","Morgan County","A_AIC",1225,1389,164,12.55,"overcount"
"207",1103,"Alabama","Morgan County","NHPI_A",194,84,-110,-79.14,"undercount"
"208",1103,"Alabama","Morgan County","NHPI_AIC",269,147,-122,-58.65,"undercount"
"209",1105,"Alabama","Perry County","A_A",54,10,-44,-137.5,"undercount"
"210",1105,"Alabama","Perry County","A_AIC",70,32,-38,-74.51,"undercount"
"211",1105,"Alabama","Perry County","NHPI_A",6,1,-5,-142.86,"undercount"
"212",1105,"Alabama","Perry County","NHPI_AIC",9,3,-6,-100,"undercount"
"213",1107,"Alabama","Pickens County","A_A",71,78,7,9.4,"overcount"
"214",1107,"Alabama","Pickens County","A_AIC",100,109,9,8.61,"overcount"
"215",1107,"Alabama","Pickens County","NHPI_A",68,0,-68,-200,"undercount"
"216",1107,"Alabama","Pickens County","NHPI_AIC",74,2,-72,-189.47,"undercount"
"217",1109,"Alabama","Pike County","A_A",621,588,-33,-5.46,"undercount"
"218",1109,"Alabama","Pike County","A_AIC",768,735,-33,-4.39,"undercount"
"219",1109,"Alabama","Pike County","NHPI_A",31,9,-22,-110,"undercount"
"220",1109,"Alabama","Pike County","NHPI_AIC",70,35,-35,-66.67,"undercount"
"221",1111,"Alabama","Randolph County","A_A",109,87,-22,-22.45,"undercount"
"222",1111,"Alabama","Randolph County","A_AIC",155,132,-23,-16.03,"undercount"
"223",1111,"Alabama","Randolph County","NHPI_A",24,1,-23,-184,"undercount"
"224",1111,"Alabama","Randolph County","NHPI_AIC",43,11,-32,-118.52,"undercount"
"225",1113,"Alabama","Russell County","A_A",520,412,-108,-23.18,"undercount"
"226",1113,"Alabama","Russell County","A_AIC",952,781,-171,-19.73,"undercount"
"227",1113,"Alabama","Russell County","NHPI_A",170,135,-35,-22.95,"undercount"
"228",1113,"Alabama","Russell County","NHPI_AIC",289,226,-63,-24.47,"undercount"
"229",1115,"Alabama","St. Clair County","A_A",861,659,-202,-26.58,"undercount"
"230",1115,"Alabama","St. Clair County","A_AIC",1118,985,-133,-12.65,"undercount"
"231",1115,"Alabama","St. Clair County","NHPI_A",76,20,-56,-116.67,"undercount"
"232",1115,"Alabama","St. Clair County","NHPI_AIC",118,56,-62,-71.26,"undercount"
"233",1117,"Alabama","Shelby County","A_A",5196,5184,-12,-0.23,"undercount"
"234",1117,"Alabama","Shelby County","A_AIC",6263,6608,345,5.36,"overcount"
"235",1117,"Alabama","Shelby County","NHPI_A",118,91,-27,-25.84,"undercount"
"236",1117,"Alabama","Shelby County","NHPI_AIC",287,231,-56,-21.62,"undercount"
"237",1119,"Alabama","Sumter County","A_A",214,102,-112,-70.89,"undercount"
"238",1119,"Alabama","Sumter County","A_AIC",226,133,-93,-51.81,"undercount"
"239",1119,"Alabama","Sumter County","NHPI_A",4,3,-1,-28.57,"undercount"
"240",1119,"Alabama","Sumter County","NHPI_AIC",12,29,17,82.93,"overcount"
"241",1121,"Alabama","Talladega County","A_A",479,397,-82,-18.72,"undercount"
"242",1121,"Alabama","Talladega County","A_AIC",734,581,-153,-23.27,"undercount"
"243",1121,"Alabama","Talladega County","NHPI_A",17,27,10,45.45,"overcount"
"244",1121,"Alabama","Talladega County","NHPI_AIC",108,79,-29,-31.02,"undercount"
"245",1123,"Alabama","Tallapoosa County","A_A",251,223,-28,-11.81,"undercount"
"246",1123,"Alabama","Tallapoosa County","A_AIC",345,291,-54,-16.98,"undercount"
"247",1123,"Alabama","Tallapoosa County","NHPI_A",23,0,-23,-200,"undercount"
"248",1123,"Alabama","Tallapoosa County","NHPI_AIC",64,14,-50,-128.21,"undercount"
"249",1125,"Alabama","Tuscaloosa County","A_A",3592,3264,-328,-9.57,"undercount"
"250",1125,"Alabama","Tuscaloosa County","A_AIC",4445,4296,-149,-3.41,"undercount"
"251",1125,"Alabama","Tuscaloosa County","NHPI_A",151,94,-57,-46.53,"undercount"
"252",1125,"Alabama","Tuscaloosa County","NHPI_AIC",297,221,-76,-29.34,"undercount"
"253",1127,"Alabama","Walker County","A_A",346,283,-63,-20.03,"undercount"
"254",1127,"Alabama","Walker County","A_AIC",451,400,-51,-11.99,"undercount"
"255",1127,"Alabama","Walker County","NHPI_A",73,3,-70,-184.21,"undercount"
"256",1127,"Alabama","Walker County","NHPI_AIC",105,32,-73,-106.57,"undercount"
"257",1129,"Alabama","Washington County","A_A",128,16,-112,-155.56,"undercount"
"258",1129,"Alabama","Washington County","A_AIC",180,43,-137,-122.87,"undercount"
"259",1129,"Alabama","Washington County","NHPI_A",20,3,-17,-147.83,"undercount"
"260",1129,"Alabama","Washington County","NHPI_AIC",35,17,-18,-69.23,"undercount"
"261",1131,"Alabama","Wilcox County","A_A",23,9,-14,-87.5,"undercount"
"262",1131,"Alabama","Wilcox County","A_AIC",49,16,-33,-101.54,"undercount"
"263",1131,"Alabama","Wilcox County","NHPI_A",2,5,3,85.71,"overcount"
"264",1131,"Alabama","Wilcox County","NHPI_AIC",8,5,-3,-46.15,"undercount"
"265",1133,"Alabama","Winston County","A_A",85,58,-27,-37.76,"undercount"
"266",1133,"Alabama","Winston County","A_AIC",144,91,-53,-45.11,"undercount"
"267",1133,"Alabama","Winston County","NHPI_A",47,9,-38,-135.71,"undercount"
"268",1133,"Alabama","Winston County","NHPI_AIC",60,13,-47,-128.77,"undercount"
"269",2013,"Alaska","Aleutians East Borough","A_A",1494,773,-721,-63.61,"undercount"
"270",2013,"Alaska","Aleutians East Borough","A_AIC",1547,807,-740,-62.87,"undercount"
"271",2013,"Alaska","Aleutians East Borough","NHPI_A",35,32,-3,-8.96,"undercount"
"272",2013,"Alaska","Aleutians East Borough","NHPI_AIC",49,45,-4,-8.51,"undercount"
"273",2016,"Alaska","Aleutians West Census Area","A_A",2304,1506,-798,-41.89,"undercount"
"274",2016,"Alaska","Aleutians West Census Area","A_AIC",2398,1603,-795,-39.74,"undercount"
"275",2016,"Alaska","Aleutians West Census Area","NHPI_A",174,238,64,31.07,"overcount"
"276",2016,"Alaska","Aleutians West Census Area","NHPI_AIC",228,272,44,17.6,"overcount"
"277",2020,"Alaska","Anchorage Municipality","A_A",28867,27548,-1319,-4.68,"undercount"
"278",2020,"Alaska","Anchorage Municipality","A_AIC",37152,35806,-1346,-3.69,"undercount"
"279",2020,"Alaska","Anchorage Municipality","NHPI_A",9143,9912,769,8.07,"overcount"
"280",2020,"Alaska","Anchorage Municipality","NHPI_AIC",11660,12898,1238,10.08,"overcount"
"281",2050,"Alaska","Bethel Census Area","A_A",211,201,-10,-4.85,"undercount"
"282",2050,"Alaska","Bethel Census Area","A_AIC",329,295,-34,-10.9,"undercount"
"283",2050,"Alaska","Bethel Census Area","NHPI_A",41,2,-39,-181.4,"undercount"
"284",2050,"Alaska","Bethel Census Area","NHPI_AIC",85,39,-46,-74.19,"undercount"
"285",2060,"Alaska","Bristol Bay Borough","A_A",20,5,-15,-120,"undercount"
"286",2060,"Alaska","Bristol Bay Borough","A_AIC",55,24,-31,-78.48,"undercount"
"287",2060,"Alaska","Bristol Bay Borough","NHPI_A",2,3,1,40,"overcount"
"288",2060,"Alaska","Bristol Bay Borough","NHPI_AIC",11,20,9,58.06,"overcount"
"289",2063,"Alaska","Chugach Census Area","A_A",437,527,90,18.67,"overcount"
"290",2063,"Alaska","Chugach Census Area","A_AIC",530,662,132,22.15,"overcount"
"291",2063,"Alaska","Chugach Census Area","NHPI_A",45,61,16,30.19,"overcount"
"292",2063,"Alaska","Chugach Census Area","NHPI_AIC",69,75,6,8.33,"overcount"
"293",2066,"Alaska","Copper River Census Area","A_A",73,17,-56,-124.44,"undercount"
"294",2066,"Alaska","Copper River Census Area","A_AIC",101,45,-56,-76.71,"undercount"
"295",2066,"Alaska","Copper River Census Area","NHPI_A",10,10,0,0,"equal"
"296",2066,"Alaska","Copper River Census Area","NHPI_AIC",20,29,9,36.73,"overcount"
"297",2068,"Alaska","Denali Borough","A_A",117,13,-104,-160,"undercount"
"298",2068,"Alaska","Denali Borough","A_AIC",133,47,-86,-95.56,"undercount"
"299",2068,"Alaska","Denali Borough","NHPI_A",1,3,2,100,"overcount"
"300",2068,"Alaska","Denali Borough","NHPI_AIC",4,13,9,105.88,"overcount"
"301",2070,"Alaska","Dillingham Census Area","A_A",50,45,-5,-10.53,"undercount"
"302",2070,"Alaska","Dillingham Census Area","A_AIC",114,99,-15,-14.08,"undercount"
"303",2070,"Alaska","Dillingham Census Area","NHPI_A",10,9,-1,-10.53,"undercount"
"304",2070,"Alaska","Dillingham Census Area","NHPI_AIC",28,23,-5,-19.61,"undercount"
"305",2090,"Alaska","Fairbanks North Star Borough","A_A",3308,3097,-211,-6.59,"undercount"
"306",2090,"Alaska","Fairbanks North Star Borough","A_AIC",5340,4998,-342,-6.62,"undercount"
"307",2090,"Alaska","Fairbanks North Star Borough","NHPI_A",537,584,47,8.39,"overcount"
"308",2090,"Alaska","Fairbanks North Star Borough","NHPI_AIC",985,999,14,1.41,"overcount"
"309",2100,"Alaska","Haines Borough","A_A",25,16,-9,-43.9,"undercount"
"310",2100,"Alaska","Haines Borough","A_AIC",55,45,-10,-20,"undercount"
"311",2100,"Alaska","Haines Borough","NHPI_A",0,2,2,200,"overcount"
"312",2100,"Alaska","Haines Borough","NHPI_AIC",5,15,10,100,"overcount"
"313",2105,"Alaska","Hoonah-Angoon Census Area","A_A",18,16,-2,-11.76,"undercount"
"314",2105,"Alaska","Hoonah-Angoon Census Area","A_AIC",46,56,10,19.61,"overcount"
"315",2105,"Alaska","Hoonah-Angoon Census Area","NHPI_A",2,4,2,66.67,"overcount"
"316",2105,"Alaska","Hoonah-Angoon Census Area","NHPI_AIC",10,9,-1,-10.53,"undercount"
"317",2110,"Alaska","Juneau City and Borough","A_A",2270,2111,-159,-7.26,"undercount"
"318",2110,"Alaska","Juneau City and Borough","A_AIC",3399,3241,-158,-4.76,"undercount"
"319",2110,"Alaska","Juneau City and Borough","NHPI_A",405,469,64,14.65,"overcount"
"320",2110,"Alaska","Juneau City and Borough","NHPI_AIC",630,704,74,11.09,"overcount"
"321",2122,"Alaska","Kenai Peninsula Borough","A_A",1112,813,-299,-31.06,"undercount"
"322",2122,"Alaska","Kenai Peninsula Borough","A_AIC",1900,1520,-380,-22.22,"undercount"
"323",2122,"Alaska","Kenai Peninsula Borough","NHPI_A",182,173,-9,-5.07,"undercount"
"324",2122,"Alaska","Kenai Peninsula Borough","NHPI_AIC",395,405,10,2.5,"overcount"
"325",2130,"Alaska","Ketchikan Gateway Borough","A_A",1140,1125,-15,-1.32,"undercount"
"326",2130,"Alaska","Ketchikan Gateway Borough","A_AIC",1450,1423,-27,-1.88,"undercount"
"327",2130,"Alaska","Ketchikan Gateway Borough","NHPI_A",49,26,-23,-61.33,"undercount"
"328",2130,"Alaska","Ketchikan Gateway Borough","NHPI_AIC",119,99,-20,-18.35,"undercount"
"329",2150,"Alaska","Kodiak Island Borough","A_A",3082,2796,-286,-9.73,"undercount"
"330",2150,"Alaska","Kodiak Island Borough","A_AIC",3404,3060,-344,-10.64,"undercount"
"331",2150,"Alaska","Kodiak Island Borough","NHPI_A",106,107,1,0.94,"overcount"
"332",2150,"Alaska","Kodiak Island Borough","NHPI_AIC",204,189,-15,-7.63,"undercount"
"333",2158,"Alaska","Kusilvak Census Area","A_A",36,23,-13,-44.07,"undercount"
"334",2158,"Alaska","Kusilvak Census Area","A_AIC",82,44,-38,-60.32,"undercount"
"335",2158,"Alaska","Kusilvak Census Area","NHPI_A",2,0,-2,-200,"undercount"
"336",2158,"Alaska","Kusilvak Census Area","NHPI_AIC",15,24,9,46.15,"overcount"
"337",2164,"Alaska","Lake and Peninsula Borough","A_A",42,7,-35,-142.86,"undercount"
"338",2164,"Alaska","Lake and Peninsula Borough","A_AIC",81,22,-59,-114.56,"undercount"
"339",2164,"Alaska","Lake and Peninsula Borough","NHPI_A",5,0,-5,-200,"undercount"
"340",2164,"Alaska","Lake and Peninsula Borough","NHPI_AIC",12,13,1,8,"overcount"
"341",2170,"Alaska","Matanuska-Susitna Borough","A_A",1851,1571,-280,-16.36,"undercount"
"342",2170,"Alaska","Matanuska-Susitna Borough","A_AIC",3905,3329,-576,-15.92,"undercount"
"343",2170,"Alaska","Matanuska-Susitna Borough","NHPI_A",496,477,-19,-3.91,"undercount"
"344",2170,"Alaska","Matanuska-Susitna Borough","NHPI_AIC",1133,1117,-16,-1.42,"undercount"
"345",2180,"Alaska","Nome Census Area","A_A",174,109,-65,-45.94,"undercount"
"346",2180,"Alaska","Nome Census Area","A_AIC",260,214,-46,-19.41,"undercount"
"347",2180,"Alaska","Nome Census Area","NHPI_A",18,5,-13,-113.04,"undercount"
"348",2180,"Alaska","Nome Census Area","NHPI_AIC",50,34,-16,-38.1,"undercount"
"349",2185,"Alaska","North Slope Borough","A_A",545,641,96,16.19,"overcount"
"350",2185,"Alaska","North Slope Borough","A_AIC",676,766,90,12.48,"overcount"
"351",2185,"Alaska","North Slope Borough","NHPI_A",174,321,147,59.39,"overcount"
"352",2185,"Alaska","North Slope Borough","NHPI_AIC",236,439,203,60.15,"overcount"
"353",2188,"Alaska","Northwest Arctic Borough","A_A",89,53,-36,-50.7,"undercount"
"354",2188,"Alaska","Northwest Arctic Borough","A_AIC",156,100,-56,-43.75,"undercount"
"355",2188,"Alaska","Northwest Arctic Borough","NHPI_A",17,11,-6,-42.86,"undercount"
"356",2188,"Alaska","Northwest Arctic Borough","NHPI_AIC",39,32,-7,-19.72,"undercount"
"357",2195,"Alaska","Petersburg Borough","A_A",177,117,-60,-40.82,"undercount"
"358",2195,"Alaska","Petersburg Borough","A_AIC",246,193,-53,-24.15,"undercount"
"359",2195,"Alaska","Petersburg Borough","NHPI_A",26,12,-14,-73.68,"undercount"
"360",2195,"Alaska","Petersburg Borough","NHPI_AIC",44,47,3,6.59,"overcount"
"361",2198,"Alaska","Prince of Wales-Hyder Census Area","A_A",91,29,-62,-103.33,"undercount"
"362",2198,"Alaska","Prince of Wales-Hyder Census Area","A_AIC",207,94,-113,-75.08,"undercount"
"363",2198,"Alaska","Prince of Wales-Hyder Census Area","NHPI_A",31,30,-1,-3.28,"undercount"
"364",2198,"Alaska","Prince of Wales-Hyder Census Area","NHPI_AIC",75,60,-15,-22.22,"undercount"
"365",2220,"Alaska","Sitka City and Borough","A_A",661,584,-77,-12.37,"undercount"
"366",2220,"Alaska","Sitka City and Borough","A_AIC",875,774,-101,-12.25,"undercount"
"367",2220,"Alaska","Sitka City and Borough","NHPI_A",33,14,-19,-80.85,"undercount"
"368",2220,"Alaska","Sitka City and Borough","NHPI_AIC",102,60,-42,-51.85,"undercount"
"369",2230,"Alaska","Skagway Municipality","A_A",32,40,8,22.22,"overcount"
"370",2230,"Alaska","Skagway Municipality","A_AIC",57,61,4,6.78,"overcount"
"371",2230,"Alaska","Skagway Municipality","NHPI_A",4,0,-4,-200,"undercount"
"372",2230,"Alaska","Skagway Municipality","NHPI_AIC",7,10,3,35.29,"overcount"
"373",2240,"Alaska","Southeast Fairbanks Census Area","A_A",174,87,-87,-66.67,"undercount"
"374",2240,"Alaska","Southeast Fairbanks Census Area","A_AIC",241,172,-69,-33.41,"undercount"
"375",2240,"Alaska","Southeast Fairbanks Census Area","NHPI_A",77,13,-64,-142.22,"undercount"
"376",2240,"Alaska","Southeast Fairbanks Census Area","NHPI_AIC",100,58,-42,-53.16,"undercount"
"377",2275,"Alaska","Wrangell City and Borough","A_A",82,25,-57,-106.54,"undercount"
"378",2275,"Alaska","Wrangell City and Borough","A_AIC",119,61,-58,-64.44,"undercount"
"379",2275,"Alaska","Wrangell City and Borough","NHPI_A",1,2,1,66.67,"overcount"
"380",2275,"Alaska","Wrangell City and Borough","NHPI_AIC",15,25,10,50,"overcount"
"381",2282,"Alaska","Yakutat City and Borough","A_A",43,32,-11,-29.33,"undercount"
"382",2282,"Alaska","Yakutat City and Borough","A_AIC",65,54,-11,-18.49,"undercount"
"383",2282,"Alaska","Yakutat City and Borough","NHPI_A",7,1,-6,-150,"undercount"
"384",2282,"Alaska","Yakutat City and Borough","NHPI_AIC",8,11,3,31.58,"overcount"
"385",2290,"Alaska","Yukon-Koyukuk Census Area","A_A",32,8,-24,-120,"undercount"
"386",2290,"Alaska","Yukon-Koyukuk Census Area","A_AIC",71,33,-38,-73.08,"undercount"
"387",2290,"Alaska","Yukon-Koyukuk Census Area","NHPI_A",9,3,-6,-100,"undercount"
"388",2290,"Alaska","Yukon-Koyukuk Census Area","NHPI_AIC",16,16,0,0,"equal"
"389",4001,"Arizona","Apache County","A_A",311,309,-2,-0.65,"undercount"
"390",4001,"Arizona","Apache County","A_AIC",502,441,-61,-12.94,"undercount"
"391",4001,"Arizona","Apache County","NHPI_A",47,18,-29,-89.23,"undercount"
"392",4001,"Arizona","Apache County","NHPI_AIC",137,95,-42,-36.21,"undercount"
"393",4003,"Arizona","Cochise County","A_A",2894,2614,-280,-10.17,"undercount"
"394",4003,"Arizona","Cochise County","A_AIC",4598,3974,-624,-14.56,"undercount"
"395",4003,"Arizona","Cochise County","NHPI_A",511,425,-86,-18.38,"undercount"
"396",4003,"Arizona","Cochise County","NHPI_AIC",996,798,-198,-22.07,"undercount"
"397",4005,"Arizona","Coconino County","A_A",2976,2606,-370,-13.26,"undercount"
"398",4005,"Arizona","Coconino County","A_AIC",4476,4156,-320,-7.41,"undercount"
"399",4005,"Arizona","Coconino County","NHPI_A",246,256,10,3.98,"overcount"
"400",4005,"Arizona","Coconino County","NHPI_AIC",683,607,-76,-11.78,"undercount"
"401",4007,"Arizona","Gila County","A_A",483,443,-40,-8.64,"undercount"
"402",4007,"Arizona","Gila County","A_AIC",626,651,25,3.92,"overcount"
"403",4007,"Arizona","Gila County","NHPI_A",87,46,-41,-61.65,"undercount"
"404",4007,"Arizona","Gila County","NHPI_AIC",144,147,3,2.06,"overcount"
"405",4009,"Arizona","Graham County","A_A",312,172,-140,-57.85,"undercount"
"406",4009,"Arizona","Graham County","A_AIC",472,295,-177,-46.15,"undercount"
"407",4009,"Arizona","Graham County","NHPI_A",83,16,-67,-135.35,"undercount"
"408",4009,"Arizona","Graham County","NHPI_AIC",166,87,-79,-62.45,"undercount"
"409",4011,"Arizona","Greenlee County","A_A",97,68,-29,-35.15,"undercount"
"410",4011,"Arizona","Greenlee County","A_AIC",129,105,-24,-20.51,"undercount"
"411",4011,"Arizona","Greenlee County","NHPI_A",10,1,-9,-163.64,"undercount"
"412",4011,"Arizona","Greenlee County","NHPI_AIC",23,31,8,29.63,"overcount"
"413",4012,"Arizona","La Paz County","A_A",208,115,-93,-57.59,"undercount"
"414",4012,"Arizona","La Paz County","A_AIC",298,187,-111,-45.77,"undercount"
"415",4012,"Arizona","La Paz County","NHPI_A",36,41,5,12.99,"overcount"
"416",4012,"Arizona","La Paz County","NHPI_AIC",68,78,10,13.7,"overcount"
"417",4013,"Arizona","Maricopa County","A_A",218410,200031,-18379,-8.78,"undercount"
"418",4013,"Arizona","Maricopa County","A_AIC",275931,251338,-24593,-9.33,"undercount"
"419",4013,"Arizona","Maricopa County","NHPI_A",13547,9874,-3673,-31.37,"undercount"
"420",4013,"Arizona","Maricopa County","NHPI_AIC",25264,20128,-5136,-22.63,"undercount"
"421",4015,"Arizona","Mohave County","A_A",2878,2643,-235,-8.51,"undercount"
"422",4015,"Arizona","Mohave County","A_AIC",4472,4178,-294,-6.8,"undercount"
"423",4015,"Arizona","Mohave County","NHPI_A",583,382,-201,-41.66,"undercount"
"424",4015,"Arizona","Mohave County","NHPI_AIC",1098,911,-187,-18.62,"undercount"
"425",4017,"Arizona","Navajo County","A_A",709,548,-161,-25.62,"undercount"
"426",4017,"Arizona","Navajo County","A_AIC",1137,880,-257,-25.48,"undercount"
"427",4017,"Arizona","Navajo County","NHPI_A",195,69,-126,-95.45,"undercount"
"428",4017,"Arizona","Navajo County","NHPI_AIC",357,223,-134,-46.21,"undercount"
"429",4019,"Arizona","Pima County","A_A",35726,30209,-5517,-16.73,"undercount"
"430",4019,"Arizona","Pima County","A_AIC",48344,41404,-6940,-15.47,"undercount"
"431",4019,"Arizona","Pima County","NHPI_A",2585,2004,-581,-25.32,"undercount"
"432",4019,"Arizona","Pima County","NHPI_AIC",4693,3737,-956,-22.68,"undercount"
"433",4021,"Arizona","Pinal County","A_A",9357,6417,-2940,-37.28,"undercount"
"434",4021,"Arizona","Pinal County","A_AIC",13817,10281,-3536,-29.35,"undercount"
"435",4021,"Arizona","Pinal County","NHPI_A",1992,1090,-902,-58.53,"undercount"
"436",4021,"Arizona","Pinal County","NHPI_AIC",3262,2756,-506,-16.82,"undercount"
"437",4023,"Arizona","Santa Cruz County","A_A",381,274,-107,-32.67,"undercount"
"438",4023,"Arizona","Santa Cruz County","A_AIC",473,326,-147,-36.8,"undercount"
"439",4023,"Arizona","Santa Cruz County","NHPI_A",66,13,-53,-134.18,"undercount"
"440",4023,"Arizona","Santa Cruz County","NHPI_AIC",93,43,-50,-73.53,"undercount"
"441",4025,"Arizona","Yavapai County","A_A",3042,2832,-210,-7.15,"undercount"
"442",4025,"Arizona","Yavapai County","A_AIC",4571,4387,-184,-4.11,"undercount"
"443",4025,"Arizona","Yavapai County","NHPI_A",394,270,-124,-37.35,"undercount"
"444",4025,"Arizona","Yavapai County","NHPI_AIC",888,740,-148,-18.18,"undercount"
"445",4027,"Arizona","Yuma County","A_A",3379,2364,-1015,-35.35,"undercount"
"446",4027,"Arizona","Yuma County","A_AIC",5043,3322,-1721,-41.15,"undercount"
"447",4027,"Arizona","Yuma County","NHPI_A",567,221,-346,-87.82,"undercount"
"448",4027,"Arizona","Yuma County","NHPI_AIC",1031,493,-538,-70.6,"undercount"
"449",5001,"Arkansas","Arkansas County","A_A",124,94,-30,-27.52,"undercount"
"450",5001,"Arkansas","Arkansas County","A_AIC",161,140,-21,-13.95,"undercount"
"451",5001,"Arkansas","Arkansas County","NHPI_A",9,9,0,0,"equal"
"452",5001,"Arkansas","Arkansas County","NHPI_AIC",17,20,3,16.22,"overcount"
"453",5003,"Arkansas","Ashley County","A_A",61,41,-20,-39.22,"undercount"
"454",5003,"Arkansas","Ashley County","A_AIC",105,57,-48,-59.26,"undercount"
"455",5003,"Arkansas","Ashley County","NHPI_A",17,8,-9,-72,"undercount"
"456",5003,"Arkansas","Ashley County","NHPI_AIC",23,14,-9,-48.65,"undercount"
"457",5005,"Arkansas","Baxter County","A_A",228,239,11,4.71,"overcount"
"458",5005,"Arkansas","Baxter County","A_AIC",333,365,32,9.17,"overcount"
"459",5005,"Arkansas","Baxter County","NHPI_A",33,9,-24,-114.29,"undercount"
"460",5005,"Arkansas","Baxter County","NHPI_AIC",52,47,-5,-10.1,"undercount"
"461",5007,"Arkansas","Benton County","A_A",13414,13667,253,1.87,"overcount"
"462",5007,"Arkansas","Benton County","A_AIC",15500,16013,513,3.26,"overcount"
"463",5007,"Arkansas","Benton County","NHPI_A",2240,2601,361,14.91,"overcount"
"464",5007,"Arkansas","Benton County","NHPI_AIC",2616,3075,459,16.13,"overcount"
"465",5009,"Arkansas","Boone County","A_A",244,233,-11,-4.61,"undercount"
"466",5009,"Arkansas","Boone County","A_AIC",340,365,25,7.09,"overcount"
"467",5009,"Arkansas","Boone County","NHPI_A",29,27,-2,-7.14,"undercount"
"468",5009,"Arkansas","Boone County","NHPI_AIC",43,36,-7,-17.72,"undercount"
"469",5011,"Arkansas","Bradley County","A_A",50,27,-23,-59.74,"undercount"
"470",5011,"Arkansas","Bradley County","A_AIC",75,42,-33,-56.41,"undercount"
"471",5011,"Arkansas","Bradley County","NHPI_A",5,1,-4,-133.33,"undercount"
"472",5011,"Arkansas","Bradley County","NHPI_AIC",11,8,-3,-31.58,"undercount"
"473",5013,"Arkansas","Calhoun County","A_A",12,6,-6,-66.67,"undercount"
"474",5013,"Arkansas","Calhoun County","A_AIC",32,20,-12,-46.15,"undercount"
"475",5013,"Arkansas","Calhoun County","NHPI_A",1,9,8,160,"overcount"
"476",5013,"Arkansas","Calhoun County","NHPI_AIC",5,9,4,57.14,"overcount"
"477",5015,"Arkansas","Carroll County","A_A",631,571,-60,-9.98,"undercount"
"478",5015,"Arkansas","Carroll County","A_AIC",718,667,-51,-7.36,"undercount"
"479",5015,"Arkansas","Carroll County","NHPI_A",394,432,38,9.2,"overcount"
"480",5015,"Arkansas","Carroll County","NHPI_AIC",408,463,55,12.63,"overcount"
"481",5017,"Arkansas","Chicot County","A_A",78,45,-33,-53.66,"undercount"
"482",5017,"Arkansas","Chicot County","A_AIC",100,55,-45,-58.06,"undercount"
"483",5017,"Arkansas","Chicot County","NHPI_A",4,9,5,76.92,"overcount"
"484",5017,"Arkansas","Chicot County","NHPI_AIC",8,19,11,81.48,"overcount"
"485",5019,"Arkansas","Clark County","A_A",155,155,0,0,"equal"
"486",5019,"Arkansas","Clark County","A_AIC",210,210,0,0,"equal"
"487",5019,"Arkansas","Clark County","NHPI_A",99,17,-82,-141.38,"undercount"
"488",5019,"Arkansas","Clark County","NHPI_AIC",113,29,-84,-118.31,"undercount"
"489",5021,"Arkansas","Clay County","A_A",33,14,-19,-80.85,"undercount"
"490",5021,"Arkansas","Clay County","A_AIC",69,47,-22,-37.93,"undercount"
"491",5021,"Arkansas","Clay County","NHPI_A",4,5,1,22.22,"overcount"
"492",5021,"Arkansas","Clay County","NHPI_AIC",11,11,0,0,"equal"
"493",5023,"Arkansas","Cleburne County","A_A",118,96,-22,-20.56,"undercount"
"494",5023,"Arkansas","Cleburne County","A_AIC",160,148,-12,-7.79,"undercount"
"495",5023,"Arkansas","Cleburne County","NHPI_A",10,12,2,18.18,"overcount"
"496",5023,"Arkansas","Cleburne County","NHPI_AIC",15,20,5,28.57,"overcount"
"497",5025,"Arkansas","Cleveland County","A_A",14,7,-7,-66.67,"undercount"
"498",5025,"Arkansas","Cleveland County","A_AIC",31,34,3,9.23,"overcount"
"499",5025,"Arkansas","Cleveland County","NHPI_A",3,1,-2,-100,"undercount"
"500",5025,"Arkansas","Cleveland County","NHPI_AIC",6,6,0,0,"equal"
"501",5027,"Arkansas","Columbia County","A_A",208,172,-36,-18.95,"undercount"
"502",5027,"Arkansas","Columbia County","A_AIC",272,226,-46,-18.47,"undercount"
"503",5027,"Arkansas","Columbia County","NHPI_A",11,0,-11,-200,"undercount"
"504",5027,"Arkansas","Columbia County","NHPI_AIC",26,10,-16,-88.89,"undercount"
"505",5029,"Arkansas","Conway County","A_A",102,89,-13,-13.61,"undercount"
"506",5029,"Arkansas","Conway County","A_AIC",176,138,-38,-24.2,"undercount"
"507",5029,"Arkansas","Conway County","NHPI_A",7,8,1,13.33,"overcount"
"508",5029,"Arkansas","Conway County","NHPI_AIC",23,42,19,58.46,"overcount"
"509",5031,"Arkansas","Craighead County","A_A",1521,1692,171,10.64,"overcount"
"510",5031,"Arkansas","Craighead County","A_AIC",1900,2134,234,11.6,"overcount"
"511",5031,"Arkansas","Craighead County","NHPI_A",67,55,-12,-19.67,"undercount"
"512",5031,"Arkansas","Craighead County","NHPI_AIC",142,135,-7,-5.05,"undercount"
"513",5033,"Arkansas","Crawford County","A_A",1010,950,-60,-6.12,"undercount"
"514",5033,"Arkansas","Crawford County","A_AIC",1354,1308,-46,-3.46,"undercount"
"515",5033,"Arkansas","Crawford County","NHPI_A",40,30,-10,-28.57,"undercount"
"516",5033,"Arkansas","Crawford County","NHPI_AIC",102,85,-17,-18.18,"undercount"
"517",5035,"Arkansas","Crittenden County","A_A",324,324,0,0,"equal"
"518",5035,"Arkansas","Crittenden County","A_AIC",460,439,-21,-4.67,"undercount"
"519",5035,"Arkansas","Crittenden County","NHPI_A",25,18,-7,-32.56,"undercount"
"520",5035,"Arkansas","Crittenden County","NHPI_AIC",66,34,-32,-64,"undercount"
"521",5037,"Arkansas","Cross County","A_A",122,103,-19,-16.89,"undercount"
"522",5037,"Arkansas","Cross County","A_AIC",164,135,-29,-19.4,"undercount"
"523",5037,"Arkansas","Cross County","NHPI_A",9,5,-4,-57.14,"undercount"
"524",5037,"Arkansas","Cross County","NHPI_AIC",21,18,-3,-15.38,"undercount"
"525",5039,"Arkansas","Dallas County","A_A",23,7,-16,-106.67,"undercount"
"526",5039,"Arkansas","Dallas County","A_AIC",43,31,-12,-32.43,"undercount"
"527",5039,"Arkansas","Dallas County","NHPI_A",6,0,-6,-200,"undercount"
"528",5039,"Arkansas","Dallas County","NHPI_AIC",10,14,4,33.33,"overcount"
"529",5041,"Arkansas","Desha County","A_A",105,61,-44,-53.01,"undercount"
"530",5041,"Arkansas","Desha County","A_AIC",126,87,-39,-36.62,"undercount"
"531",5041,"Arkansas","Desha County","NHPI_A",17,0,-17,-200,"undercount"
"532",5041,"Arkansas","Desha County","NHPI_AIC",23,6,-17,-117.24,"undercount"
"533",5043,"Arkansas","Drew County","A_A",132,122,-10,-7.87,"undercount"
"534",5043,"Arkansas","Drew County","A_AIC",162,157,-5,-3.13,"undercount"
"535",5043,"Arkansas","Drew County","NHPI_A",7,16,9,78.26,"overcount"
"536",5043,"Arkansas","Drew County","NHPI_AIC",17,32,15,61.22,"overcount"
"537",5045,"Arkansas","Faulkner County","A_A",1628,1484,-144,-9.25,"undercount"
"538",5045,"Arkansas","Faulkner County","A_AIC",2286,2248,-38,-1.68,"undercount"
"539",5045,"Arkansas","Faulkner County","NHPI_A",93,65,-28,-35.44,"undercount"
"540",5045,"Arkansas","Faulkner County","NHPI_AIC",362,177,-185,-68.65,"undercount"
"541",5047,"Arkansas","Franklin County","A_A",184,162,-22,-12.72,"undercount"
"542",5047,"Arkansas","Franklin County","A_AIC",217,217,0,0,"equal"
"543",5047,"Arkansas","Franklin County","NHPI_A",37,10,-27,-114.89,"undercount"
"544",5047,"Arkansas","Franklin County","NHPI_AIC",45,27,-18,-50,"undercount"
"545",5049,"Arkansas","Fulton County","A_A",36,38,2,5.41,"overcount"
"546",5049,"Arkansas","Fulton County","A_AIC",60,84,24,33.33,"overcount"
"547",5049,"Arkansas","Fulton County","NHPI_A",3,0,-3,-200,"undercount"
"548",5049,"Arkansas","Fulton County","NHPI_AIC",13,4,-9,-105.88,"undercount"
"549",5051,"Arkansas","Garland County","A_A",844,976,132,14.51,"overcount"
"550",5051,"Arkansas","Garland County","A_AIC",1261,1468,207,15.17,"overcount"
"551",5051,"Arkansas","Garland County","NHPI_A",75,73,-2,-2.7,"undercount"
"552",5051,"Arkansas","Garland County","NHPI_AIC",181,169,-12,-6.86,"undercount"
"553",5053,"Arkansas","Grant County","A_A",78,76,-2,-2.6,"undercount"
"554",5053,"Arkansas","Grant County","A_AIC",122,125,3,2.43,"overcount"
"555",5053,"Arkansas","Grant County","NHPI_A",12,1,-11,-169.23,"undercount"
"556",5053,"Arkansas","Grant County","NHPI_AIC",22,15,-7,-37.84,"undercount"
"557",5055,"Arkansas","Greene County","A_A",207,211,4,1.91,"overcount"
"558",5055,"Arkansas","Greene County","A_AIC",299,330,31,9.86,"overcount"
"559",5055,"Arkansas","Greene County","NHPI_A",190,289,99,41.34,"overcount"
"560",5055,"Arkansas","Greene County","NHPI_AIC",209,309,100,38.61,"overcount"
"561",5057,"Arkansas","Hempstead County","A_A",117,95,-22,-20.75,"undercount"
"562",5057,"Arkansas","Hempstead County","A_AIC",182,146,-36,-21.95,"undercount"
"563",5057,"Arkansas","Hempstead County","NHPI_A",46,5,-41,-160.78,"undercount"
"564",5057,"Arkansas","Hempstead County","NHPI_AIC",67,16,-51,-122.89,"undercount"
"565",5059,"Arkansas","Hot Spring County","A_A",137,118,-19,-14.9,"undercount"
"566",5059,"Arkansas","Hot Spring County","A_AIC",248,216,-32,-13.79,"undercount"
"567",5059,"Arkansas","Hot Spring County","NHPI_A",27,11,-16,-84.21,"undercount"
"568",5059,"Arkansas","Hot Spring County","NHPI_AIC",55,51,-4,-7.55,"undercount"
"569",5061,"Arkansas","Howard County","A_A",88,62,-26,-34.67,"undercount"
"570",5061,"Arkansas","Howard County","A_AIC",121,95,-26,-24.07,"undercount"
"571",5061,"Arkansas","Howard County","NHPI_A",17,5,-12,-109.09,"undercount"
"572",5061,"Arkansas","Howard County","NHPI_AIC",29,12,-17,-82.93,"undercount"
"573",5063,"Arkansas","Independence County","A_A",336,366,30,8.55,"overcount"
"574",5063,"Arkansas","Independence County","A_AIC",452,513,61,12.64,"overcount"
"575",5063,"Arkansas","Independence County","NHPI_A",94,30,-64,-103.23,"undercount"
"576",5063,"Arkansas","Independence County","NHPI_AIC",131,50,-81,-89.5,"undercount"
"577",5065,"Arkansas","Izard County","A_A",66,27,-39,-83.87,"undercount"
"578",5065,"Arkansas","Izard County","A_AIC",92,65,-27,-34.39,"undercount"
"579",5065,"Arkansas","Izard County","NHPI_A",2,9,7,127.27,"overcount"
"580",5065,"Arkansas","Izard County","NHPI_AIC",7,15,8,72.73,"overcount"
"581",5067,"Arkansas","Jackson County","A_A",84,65,-19,-25.5,"undercount"
"582",5067,"Arkansas","Jackson County","A_AIC",119,96,-23,-21.4,"undercount"
"583",5067,"Arkansas","Jackson County","NHPI_A",38,5,-33,-153.49,"undercount"
"584",5067,"Arkansas","Jackson County","NHPI_AIC",50,15,-35,-107.69,"undercount"
"585",5069,"Arkansas","Jefferson County","A_A",633,677,44,6.72,"overcount"
"586",5069,"Arkansas","Jefferson County","A_AIC",768,831,63,7.88,"overcount"
"587",5069,"Arkansas","Jefferson County","NHPI_A",85,93,8,8.99,"overcount"
"588",5069,"Arkansas","Jefferson County","NHPI_AIC",147,121,-26,-19.4,"undercount"
"589",5071,"Arkansas","Johnson County","A_A",807,918,111,12.87,"overcount"
"590",5071,"Arkansas","Johnson County","A_AIC",891,979,88,9.41,"overcount"
"591",5071,"Arkansas","Johnson County","NHPI_A",41,30,-11,-30.99,"undercount"
"592",5071,"Arkansas","Johnson County","NHPI_AIC",55,49,-6,-11.54,"undercount"
"593",5073,"Arkansas","Lafayette County","A_A",47,32,-15,-37.97,"undercount"
"594",5073,"Arkansas","Lafayette County","A_AIC",60,50,-10,-18.18,"undercount"
"595",5073,"Arkansas","Lafayette County","NHPI_A",1,8,7,155.56,"overcount"
"596",5073,"Arkansas","Lafayette County","NHPI_AIC",5,14,9,94.74,"overcount"
"597",5075,"Arkansas","Lawrence County","A_A",47,39,-8,-18.6,"undercount"
"598",5075,"Arkansas","Lawrence County","A_AIC",91,54,-37,-51.03,"undercount"
"599",5075,"Arkansas","Lawrence County","NHPI_A",7,10,3,35.29,"overcount"
"600",5075,"Arkansas","Lawrence County","NHPI_AIC",17,20,3,16.22,"overcount"
"601",5077,"Arkansas","Lee County","A_A",50,14,-36,-112.5,"undercount"
"602",5077,"Arkansas","Lee County","A_AIC",64,25,-39,-87.64,"undercount"
"603",5077,"Arkansas","Lee County","NHPI_A",2,1,-1,-66.67,"undercount"
"604",5077,"Arkansas","Lee County","NHPI_AIC",9,19,10,71.43,"overcount"
"605",5079,"Arkansas","Lincoln County","A_A",50,23,-27,-73.97,"undercount"
"606",5079,"Arkansas","Lincoln County","A_AIC",72,58,-14,-21.54,"undercount"
"607",5079,"Arkansas","Lincoln County","NHPI_A",1,9,8,160,"overcount"
"608",5079,"Arkansas","Lincoln County","NHPI_AIC",6,26,20,125,"overcount"
"609",5081,"Arkansas","Little River County","A_A",62,20,-42,-102.44,"undercount"
"610",5081,"Arkansas","Little River County","A_AIC",96,56,-40,-52.63,"undercount"
"611",5081,"Arkansas","Little River County","NHPI_A",13,9,-4,-36.36,"undercount"
"612",5081,"Arkansas","Little River County","NHPI_AIC",22,15,-7,-37.84,"undercount"
"613",5083,"Arkansas","Logan County","A_A",457,329,-128,-32.57,"undercount"
"614",5083,"Arkansas","Logan County","A_AIC",508,399,-109,-24.04,"undercount"
"615",5083,"Arkansas","Logan County","NHPI_A",9,9,0,0,"equal"
"616",5083,"Arkansas","Logan County","NHPI_AIC",24,20,-4,-18.18,"undercount"
"617",5085,"Arkansas","Lonoke County","A_A",670,721,51,7.33,"overcount"
"618",5085,"Arkansas","Lonoke County","A_AIC",1165,1333,168,13.45,"overcount"
"619",5085,"Arkansas","Lonoke County","NHPI_A",63,49,-14,-25,"undercount"
"620",5085,"Arkansas","Lonoke County","NHPI_AIC",144,128,-16,-11.76,"undercount"
"621",5087,"Arkansas","Madison County","A_A",143,102,-41,-33.47,"undercount"
"622",5087,"Arkansas","Madison County","A_AIC",179,154,-25,-15.02,"undercount"
"623",5087,"Arkansas","Madison County","NHPI_A",123,238,115,63.71,"overcount"
"624",5087,"Arkansas","Madison County","NHPI_AIC",136,246,110,57.59,"overcount"
"625",5089,"Arkansas","Marion County","A_A",105,56,-49,-60.87,"undercount"
"626",5089,"Arkansas","Marion County","A_AIC",159,106,-53,-40,"undercount"
"627",5089,"Arkansas","Marion County","NHPI_A",11,0,-11,-200,"undercount"
"628",5089,"Arkansas","Marion County","NHPI_AIC",25,22,-3,-12.77,"undercount"
"629",5091,"Arkansas","Miller County","A_A",247,205,-42,-18.58,"undercount"
"630",5091,"Arkansas","Miller County","A_AIC",378,321,-57,-16.31,"undercount"
"631",5091,"Arkansas","Miller County","NHPI_A",37,4,-33,-160.98,"undercount"
"632",5091,"Arkansas","Miller County","NHPI_AIC",87,50,-37,-54.01,"undercount"
"633",5093,"Arkansas","Mississippi County","A_A",218,242,24,10.43,"overcount"
"634",5093,"Arkansas","Mississippi County","A_AIC",292,310,18,5.98,"overcount"
"635",5093,"Arkansas","Mississippi County","NHPI_A",13,3,-10,-125,"undercount"
"636",5093,"Arkansas","Mississippi County","NHPI_AIC",41,11,-30,-115.38,"undercount"
"637",5095,"Arkansas","Monroe County","A_A",55,29,-26,-61.9,"undercount"
"638",5095,"Arkansas","Monroe County","A_AIC",80,31,-49,-88.29,"undercount"
"639",5095,"Arkansas","Monroe County","NHPI_A",0,8,8,200,"overcount"
"640",5095,"Arkansas","Monroe County","NHPI_AIC",5,9,4,57.14,"overcount"
"641",5097,"Arkansas","Montgomery County","A_A",116,48,-68,-82.93,"undercount"
"642",5097,"Arkansas","Montgomery County","A_AIC",143,74,-69,-63.59,"undercount"
"643",5097,"Arkansas","Montgomery County","NHPI_A",3,5,2,50,"overcount"
"644",5097,"Arkansas","Montgomery County","NHPI_AIC",6,16,10,90.91,"overcount"
"645",5099,"Arkansas","Nevada County","A_A",43,42,-1,-2.35,"undercount"
"646",5099,"Arkansas","Nevada County","A_AIC",60,56,-4,-6.9,"undercount"
"647",5099,"Arkansas","Nevada County","NHPI_A",2,0,-2,-200,"undercount"
"648",5099,"Arkansas","Nevada County","NHPI_AIC",6,5,-1,-18.18,"undercount"
"649",5101,"Arkansas","Newton County","A_A",44,24,-20,-58.82,"undercount"
"650",5101,"Arkansas","Newton County","A_AIC",59,47,-12,-22.64,"undercount"
"651",5101,"Arkansas","Newton County","NHPI_A",1,1,0,0,"equal"
"652",5101,"Arkansas","Newton County","NHPI_AIC",3,22,19,152,"overcount"
"653",5103,"Arkansas","Ouachita County","A_A",116,123,7,5.86,"overcount"
"654",5103,"Arkansas","Ouachita County","A_AIC",182,203,21,10.91,"overcount"
"655",5103,"Arkansas","Ouachita County","NHPI_A",9,3,-6,-100,"undercount"
"656",5103,"Arkansas","Ouachita County","NHPI_AIC",40,29,-11,-31.88,"undercount"
"657",5105,"Arkansas","Perry County","A_A",33,12,-21,-93.33,"undercount"
"658",5105,"Arkansas","Perry County","A_AIC",68,48,-20,-34.48,"undercount"
"659",5105,"Arkansas","Perry County","NHPI_A",2,0,-2,-200,"undercount"
"660",5105,"Arkansas","Perry County","NHPI_AIC",8,0,-8,-200,"undercount"
"661",5107,"Arkansas","Phillips County","A_A",77,64,-13,-18.44,"undercount"
"662",5107,"Arkansas","Phillips County","A_AIC",109,81,-28,-29.47,"undercount"
"663",5107,"Arkansas","Phillips County","NHPI_A",3,4,1,28.57,"overcount"
"664",5107,"Arkansas","Phillips County","NHPI_AIC",17,11,-6,-42.86,"undercount"
"665",5109,"Arkansas","Pike County","A_A",87,16,-71,-137.86,"undercount"
"666",5109,"Arkansas","Pike County","A_AIC",119,43,-76,-93.83,"undercount"
"667",5109,"Arkansas","Pike County","NHPI_A",4,0,-4,-200,"undercount"
"668",5109,"Arkansas","Pike County","NHPI_AIC",14,12,-2,-15.38,"undercount"
"669",5111,"Arkansas","Poinsett County","A_A",90,56,-34,-46.58,"undercount"
"670",5111,"Arkansas","Poinsett County","A_AIC",141,115,-26,-20.31,"undercount"
"671",5111,"Arkansas","Poinsett County","NHPI_A",9,1,-8,-160,"undercount"
"672",5111,"Arkansas","Poinsett County","NHPI_AIC",23,13,-10,-55.56,"undercount"
"673",5113,"Arkansas","Polk County","A_A",180,120,-60,-40,"undercount"
"674",5113,"Arkansas","Polk County","A_AIC",224,166,-58,-29.74,"undercount"
"675",5113,"Arkansas","Polk County","NHPI_A",11,9,-2,-20,"undercount"
"676",5113,"Arkansas","Polk County","NHPI_AIC",17,33,16,64,"overcount"
"677",5115,"Arkansas","Pope County","A_A",812,664,-148,-20.05,"undercount"
"678",5115,"Arkansas","Pope County","A_AIC",1065,1010,-55,-5.3,"undercount"
"679",5115,"Arkansas","Pope County","NHPI_A",68,48,-20,-34.48,"undercount"
"680",5115,"Arkansas","Pope County","NHPI_AIC",105,86,-19,-19.9,"undercount"
"681",5117,"Arkansas","Prairie County","A_A",14,21,7,40,"overcount"
"682",5117,"Arkansas","Prairie County","A_AIC",31,27,-4,-13.79,"undercount"
"683",5117,"Arkansas","Prairie County","NHPI_A",6,3,-3,-66.67,"undercount"
"684",5117,"Arkansas","Prairie County","NHPI_AIC",8,16,8,66.67,"overcount"
"685",5119,"Arkansas","Pulaski County","A_A",9141,10036,895,9.33,"overcount"
"686",5119,"Arkansas","Pulaski County","A_AIC",11428,12801,1373,11.33,"overcount"
"687",5119,"Arkansas","Pulaski County","NHPI_A",191,208,17,8.52,"overcount"
"688",5119,"Arkansas","Pulaski County","NHPI_AIC",530,513,-17,-3.26,"undercount"
"689",5121,"Arkansas","Randolph County","A_A",87,73,-14,-17.5,"undercount"
"690",5121,"Arkansas","Randolph County","A_AIC",149,140,-9,-6.23,"undercount"
"691",5121,"Arkansas","Randolph County","NHPI_A",394,596,202,40.81,"overcount"
"692",5121,"Arkansas","Randolph County","NHPI_AIC",406,614,208,40.78,"overcount"
"693",5123,"Arkansas","St. Francis County","A_A",159,122,-37,-26.33,"undercount"
"694",5123,"Arkansas","St. Francis County","A_AIC",237,145,-92,-48.17,"undercount"
"695",5123,"Arkansas","St. Francis County","NHPI_A",16,0,-16,-200,"undercount"
"696",5123,"Arkansas","St. Francis County","NHPI_AIC",51,16,-35,-104.48,"undercount"
"697",5125,"Arkansas","Saline County","A_A",1694,1454,-240,-15.25,"undercount"
"698",5125,"Arkansas","Saline County","A_AIC",2176,1974,-202,-9.73,"undercount"
"699",5125,"Arkansas","Saline County","NHPI_A",74,70,-4,-5.56,"undercount"
"700",5125,"Arkansas","Saline County","NHPI_AIC",151,127,-24,-17.27,"undercount"
"701",5127,"Arkansas","Scott County","A_A",328,296,-32,-10.26,"undercount"
"702",5127,"Arkansas","Scott County","A_AIC",368,317,-51,-14.89,"undercount"
"703",5127,"Arkansas","Scott County","NHPI_A",5,5,0,0,"equal"
"704",5127,"Arkansas","Scott County","NHPI_AIC",9,6,-3,-40,"undercount"
"705",5129,"Arkansas","Searcy County","A_A",31,20,-11,-43.14,"undercount"
"706",5129,"Arkansas","Searcy County","A_AIC",51,27,-24,-61.54,"undercount"
"707",5129,"Arkansas","Searcy County","NHPI_A",2,5,3,85.71,"overcount"
"708",5129,"Arkansas","Searcy County","NHPI_AIC",8,6,-2,-28.57,"undercount"
"709",5131,"Arkansas","Sebastian County","A_A",6037,5745,-292,-4.96,"undercount"
"710",5131,"Arkansas","Sebastian County","A_AIC",7037,6750,-287,-4.16,"undercount"
"711",5131,"Arkansas","Sebastian County","NHPI_A",283,93,-190,-101.06,"undercount"
"712",5131,"Arkansas","Sebastian County","NHPI_AIC",460,211,-249,-74.22,"undercount"
"713",5133,"Arkansas","Sevier County","A_A",109,61,-48,-56.47,"undercount"
"714",5133,"Arkansas","Sevier County","A_AIC",156,102,-54,-41.86,"undercount"
"715",5133,"Arkansas","Sevier County","NHPI_A",180,241,61,28.98,"overcount"
"716",5133,"Arkansas","Sevier County","NHPI_AIC",192,243,51,23.45,"overcount"
"717",5135,"Arkansas","Sharp County","A_A",93,57,-36,-48,"undercount"
"718",5135,"Arkansas","Sharp County","A_AIC",127,104,-23,-19.91,"undercount"
"719",5135,"Arkansas","Sharp County","NHPI_A",16,20,4,22.22,"overcount"
"720",5135,"Arkansas","Sharp County","NHPI_AIC",23,27,4,16,"overcount"
"721",5137,"Arkansas","Stone County","A_A",59,25,-34,-80.95,"undercount"
"722",5137,"Arkansas","Stone County","A_AIC",84,44,-40,-62.5,"undercount"
"723",5137,"Arkansas","Stone County","NHPI_A",5,2,-3,-85.71,"undercount"
"724",5137,"Arkansas","Stone County","NHPI_AIC",7,7,0,0,"equal"
"725",5139,"Arkansas","Union County","A_A",310,273,-37,-12.69,"undercount"
"726",5139,"Arkansas","Union County","A_AIC",389,340,-49,-13.44,"undercount"
"727",5139,"Arkansas","Union County","NHPI_A",20,16,-4,-22.22,"undercount"
"728",5139,"Arkansas","Union County","NHPI_AIC",48,33,-15,-37.04,"undercount"
"729",5141,"Arkansas","Van Buren County","A_A",70,56,-14,-22.22,"undercount"
"730",5141,"Arkansas","Van Buren County","A_AIC",97,95,-2,-2.08,"undercount"
"731",5141,"Arkansas","Van Buren County","NHPI_A",4,2,-2,-66.67,"undercount"
"732",5141,"Arkansas","Van Buren County","NHPI_AIC",9,6,-3,-40,"undercount"
"733",5143,"Arkansas","Washington County","A_A",6416,5704,-712,-11.75,"undercount"
"734",5143,"Arkansas","Washington County","A_AIC",8191,7665,-526,-6.63,"undercount"
"735",5143,"Arkansas","Washington County","NHPI_A",7358,8844,1486,18.34,"overcount"
"736",5143,"Arkansas","Washington County","NHPI_AIC",7689,9310,1621,19.07,"overcount"
"737",5145,"Arkansas","White County","A_A",668,629,-39,-6.01,"undercount"
"738",5145,"Arkansas","White County","A_AIC",900,952,52,5.62,"overcount"
"739",5145,"Arkansas","White County","NHPI_A",66,25,-41,-90.11,"undercount"
"740",5145,"Arkansas","White County","NHPI_AIC",106,98,-8,-7.84,"undercount"
"741",5147,"Arkansas","Woodruff County","A_A",19,22,3,14.63,"overcount"
"742",5147,"Arkansas","Woodruff County","A_AIC",29,30,1,3.39,"overcount"
"743",5147,"Arkansas","Woodruff County","NHPI_A",5,3,-2,-50,"undercount"
"744",5147,"Arkansas","Woodruff County","NHPI_AIC",7,21,14,100,"overcount"
"745",5149,"Arkansas","Yell County","A_A",308,203,-105,-41.1,"undercount"
"746",5149,"Arkansas","Yell County","A_AIC",359,277,-82,-25.79,"undercount"
"747",5149,"Arkansas","Yell County","NHPI_A",21,11,-10,-62.5,"undercount"
"748",5149,"Arkansas","Yell County","NHPI_AIC",31,28,-3,-10.17,"undercount"
"749",6001,"California","Alameda County","A_A",551814,544341,-7473,-1.36,"undercount"
"750",6001,"California","Alameda County","A_AIC",607245,594258,-12987,-2.16,"undercount"
"751",6001,"California","Alameda County","NHPI_A",15772,13911,-1861,-12.54,"undercount"
"752",6001,"California","Alameda County","NHPI_AIC",27153,22164,-4989,-20.23,"undercount"
"753",6003,"California","Alpine County","A_A",21,13,-8,-47.06,"undercount"
"754",6003,"California","Alpine County","A_AIC",27,31,4,13.79,"overcount"
"755",6003,"California","Alpine County","NHPI_A",0,0,0,0,"equal"
"756",6003,"California","Alpine County","NHPI_AIC",7,12,5,52.63,"overcount"
"757",6005,"California","Amador County","A_A",691,561,-130,-20.77,"undercount"
"758",6005,"California","Amador County","A_AIC",1086,975,-111,-10.77,"undercount"
"759",6005,"California","Amador County","NHPI_A",134,75,-59,-56.46,"undercount"
"760",6005,"California","Amador County","NHPI_AIC",244,237,-7,-2.91,"undercount"
"761",6007,"California","Butte County","A_A",11077,10414,-663,-6.17,"undercount"
"762",6007,"California","Butte County","A_AIC",14515,13380,-1135,-8.14,"undercount"
"763",6007,"California","Butte County","NHPI_A",621,524,-97,-16.94,"undercount"
"764",6007,"California","Butte County","NHPI_AIC",1504,1367,-137,-9.54,"undercount"
"765",6009,"California","Calaveras County","A_A",850,733,-117,-14.78,"undercount"
"766",6009,"California","Calaveras County","A_AIC",1424,1247,-177,-13.25,"undercount"
"767",6009,"California","Calaveras County","NHPI_A",130,78,-52,-50,"undercount"
"768",6009,"California","Calaveras County","NHPI_AIC",254,296,42,15.27,"overcount"
"769",6011,"California","Colusa County","A_A",354,257,-97,-31.75,"undercount"
"770",6011,"California","Colusa County","A_AIC",503,388,-115,-25.81,"undercount"
"771",6011,"California","Colusa County","NHPI_A",135,76,-59,-55.92,"undercount"
"772",6011,"California","Colusa County","NHPI_AIC",207,133,-74,-43.53,"undercount"
"773",6013,"California","Contra Costa County","A_A",217402,216685,-717,-0.33,"undercount"
"774",6013,"California","Contra Costa County","A_AIC",256553,251208,-5345,-2.11,"undercount"
"775",6013,"California","Contra Costa County","NHPI_A",7188,6005,-1183,-17.93,"undercount"
"776",6013,"California","Contra Costa County","NHPI_AIC",13941,11578,-2363,-18.52,"undercount"
"777",6015,"California","Del Norte County","A_A",893,833,-60,-6.95,"undercount"
"778",6015,"California","Del Norte County","A_AIC",1265,1142,-123,-10.22,"undercount"
"779",6015,"California","Del Norte County","NHPI_A",58,29,-29,-66.67,"undercount"
"780",6015,"California","Del Norte County","NHPI_AIC",138,155,17,11.6,"overcount"
"781",6017,"California","El Dorado County","A_A",9716,9161,-555,-5.88,"undercount"
"782",6017,"California","El Dorado County","A_AIC",13496,12776,-720,-5.48,"undercount"
"783",6017,"California","El Dorado County","NHPI_A",460,279,-181,-48.99,"undercount"
"784",6017,"California","El Dorado County","NHPI_AIC",1153,968,-185,-17.44,"undercount"
"785",6019,"California","Fresno County","A_A",115563,111019,-4544,-4.01,"undercount"
"786",6019,"California","Fresno County","A_AIC",129461,121270,-8191,-6.53,"undercount"
"787",6019,"California","Fresno County","NHPI_A",2992,1298,-1694,-78.97,"undercount"
"788",6019,"California","Fresno County","NHPI_AIC",5632,3204,-2428,-54.96,"undercount"
"789",6021,"California","Glenn County","A_A",845,626,-219,-29.78,"undercount"
"790",6021,"California","Glenn County","A_AIC",1014,802,-212,-23.35,"undercount"
"791",6021,"California","Glenn County","NHPI_A",62,39,-23,-45.54,"undercount"
"792",6021,"California","Glenn County","NHPI_AIC",125,82,-43,-41.55,"undercount"
"793",6023,"California","Humboldt County","A_A",3962,3553,-409,-10.88,"undercount"
"794",6023,"California","Humboldt County","A_AIC",6399,5517,-882,-14.8,"undercount"
"795",6023,"California","Humboldt County","NHPI_A",479,444,-35,-7.58,"undercount"
"796",6023,"California","Humboldt County","NHPI_AIC",1115,1083,-32,-2.91,"undercount"
"797",6025,"California","Imperial County","A_A",3874,2288,-1586,-51.48,"undercount"
"798",6025,"California","Imperial County","A_AIC",4968,2778,-2190,-56.55,"undercount"
"799",6025,"California","Imperial County","NHPI_A",384,92,-292,-122.69,"undercount"
"800",6025,"California","Imperial County","NHPI_AIC",674,262,-412,-88.03,"undercount"
"801",6027,"California","Inyo County","A_A",298,273,-25,-8.76,"undercount"
"802",6027,"California","Inyo County","A_AIC",465,411,-54,-12.33,"undercount"
"803",6027,"California","Inyo County","NHPI_A",28,13,-15,-73.17,"undercount"
"804",6027,"California","Inyo County","NHPI_AIC",70,65,-5,-7.41,"undercount"
"805",6029,"California","Kern County","A_A",50168,44945,-5223,-10.98,"undercount"
"806",6029,"California","Kern County","A_AIC",61098,52296,-8802,-15.52,"undercount"
"807",6029,"California","Kern County","NHPI_A",2487,1161,-1326,-72.7,"undercount"
"808",6029,"California","Kern County","NHPI_AIC",4471,2965,-1506,-40.51,"undercount"
"809",6031,"California","Kings County","A_A",6757,5622,-1135,-18.34,"undercount"
"810",6031,"California","Kings County","A_AIC",9217,7435,-1782,-21.4,"undercount"
"811",6031,"California","Kings County","NHPI_A",545,338,-207,-46.89,"undercount"
"812",6031,"California","Kings County","NHPI_AIC",1059,842,-217,-22.83,"undercount"
"813",6033,"California","Lake County","A_A",926,964,38,4.02,"overcount"
"814",6033,"California","Lake County","A_AIC",1698,1643,-55,-3.29,"undercount"
"815",6033,"California","Lake County","NHPI_A",214,100,-114,-72.61,"undercount"
"816",6033,"California","Lake County","NHPI_AIC",562,350,-212,-46.49,"undercount"
"817",6035,"California","Lassen County","A_A",501,475,-26,-5.33,"undercount"
"818",6035,"California","Lassen County","A_AIC",802,865,63,7.56,"overcount"
"819",6035,"California","Lassen County","NHPI_A",260,285,25,9.17,"overcount"
"820",6035,"California","Lassen County","NHPI_AIC",340,517,177,41.31,"overcount"
"821",6037,"California","Los Angeles County","A_A",1558134,1489041,-69093,-4.53,"undercount"
"822",6037,"California","Los Angeles County","A_AIC",1735159,1639661,-95498,-5.66,"undercount"
"823",6037,"California","Los Angeles County","NHPI_A",36483,21327,-15156,-52.43,"undercount"
"824",6037,"California","Los Angeles County","NHPI_AIC",67865,44206,-23659,-42.22,"undercount"
"825",6039,"California","Madera County","A_A",4137,3615,-522,-13.47,"undercount"
"826",6039,"California","Madera County","A_AIC",5300,4584,-716,-14.49,"undercount"
"827",6039,"California","Madera County","NHPI_A",473,125,-348,-116.39,"undercount"
"828",6039,"California","Madera County","NHPI_AIC",821,418,-403,-65.05,"undercount"
"829",6041,"California","Marin County","A_A",17380,16530,-850,-5.01,"undercount"
"830",6041,"California","Marin County","A_AIC",23815,23442,-373,-1.58,"undercount"
"831",6041,"California","Marin County","NHPI_A",693,473,-220,-37.74,"undercount"
"832",6041,"California","Marin County","NHPI_AIC",1479,1318,-161,-11.51,"undercount"
"833",6043,"California","Mariposa County","A_A",283,297,14,4.83,"overcount"
"834",6043,"California","Mariposa County","A_AIC",412,454,42,9.7,"overcount"
"835",6043,"California","Mariposa County","NHPI_A",37,15,-22,-84.62,"undercount"
"836",6043,"California","Mariposa County","NHPI_AIC",83,75,-8,-10.13,"undercount"
"837",6045,"California","Mendocino County","A_A",1957,1779,-178,-9.53,"undercount"
"838",6045,"California","Mendocino County","A_AIC",2757,2659,-98,-3.62,"undercount"
"839",6045,"California","Mendocino County","NHPI_A",233,116,-117,-67.05,"undercount"
"840",6045,"California","Mendocino County","NHPI_AIC",478,344,-134,-32.6,"undercount"
"841",6047,"California","Merced County","A_A",22218,20143,-2075,-9.8,"undercount"
"842",6047,"California","Merced County","A_AIC",25899,22468,-3431,-14.19,"undercount"
"843",6047,"California","Merced County","NHPI_A",1120,644,-476,-53.97,"undercount"
"844",6047,"California","Merced County","NHPI_AIC",2169,1253,-916,-53.54,"undercount"
"845",6049,"California","Modoc County","A_A",108,74,-34,-37.36,"undercount"
"846",6049,"California","Modoc County","A_AIC",164,120,-44,-30.99,"undercount"
"847",6049,"California","Modoc County","NHPI_A",32,13,-19,-84.44,"undercount"
"848",6049,"California","Modoc County","NHPI_AIC",49,44,-5,-10.75,"undercount"
"849",6051,"California","Mono County","A_A",354,161,-193,-74.95,"undercount"
"850",6051,"California","Mono County","A_AIC",506,304,-202,-49.88,"undercount"
"851",6051,"California","Mono County","NHPI_A",52,26,-26,-66.67,"undercount"
"852",6051,"California","Mono County","NHPI_AIC",91,72,-19,-23.31,"undercount"
"853",6053,"California","Monterey County","A_A",29240,25513,-3727,-13.61,"undercount"
"854",6053,"California","Monterey County","A_AIC",38528,32581,-5947,-16.73,"undercount"
"855",6053,"California","Monterey County","NHPI_A",2552,1940,-612,-27.25,"undercount"
"856",6053,"California","Monterey County","NHPI_AIC",4602,3596,-1006,-24.54,"undercount"
"857",6055,"California","Napa County","A_A",12288,10622,-1666,-14.54,"undercount"
"858",6055,"California","Napa County","A_AIC",14482,12854,-1628,-11.91,"undercount"
"859",6055,"California","Napa County","NHPI_A",580,338,-242,-52.72,"undercount"
"860",6055,"California","Napa County","NHPI_AIC",1100,805,-295,-30.97,"undercount"
"861",6057,"California","Nevada County","A_A",1461,1386,-75,-5.27,"undercount"
"862",6057,"California","Nevada County","A_AIC",2573,2706,133,5.04,"overcount"
"863",6057,"California","Nevada County","NHPI_A",215,121,-94,-55.95,"undercount"
"864",6057,"California","Nevada County","NHPI_AIC",486,450,-36,-7.69,"undercount"
"865",6059,"California","Orange County","A_A",711753,703747,-8006,-1.13,"undercount"
"866",6059,"California","Orange County","A_AIC",789787,773767,-16020,-2.05,"undercount"
"867",6059,"California","Orange County","NHPI_A",12233,7890,-4343,-43.16,"undercount"
"868",6059,"California","Orange County","NHPI_AIC",24851,18243,-6608,-30.67,"undercount"
"869",6061,"California","Placer County","A_A",35079,35196,117,0.33,"overcount"
"870",6061,"California","Placer County","A_AIC",45799,45335,-464,-1.02,"undercount"
"871",6061,"California","Placer County","NHPI_A",1183,1043,-140,-12.58,"undercount"
"872",6061,"California","Placer County","NHPI_AIC",2994,2912,-82,-2.78,"undercount"
"873",6063,"California","Plumas County","A_A",207,147,-60,-33.9,"undercount"
"874",6063,"California","Plumas County","A_AIC",389,327,-62,-17.32,"undercount"
"875",6063,"California","Plumas County","NHPI_A",40,46,6,13.95,"overcount"
"876",6063,"California","Plumas County","NHPI_AIC",82,100,18,19.78,"overcount"
"877",6065,"California","Riverside County","A_A",184017,166841,-17176,-9.79,"undercount"
"878",6065,"California","Riverside County","A_AIC",225711,199081,-26630,-12.54,"undercount"
"879",6065,"California","Riverside County","NHPI_A",11766,7005,-4761,-50.73,"undercount"
"880",6065,"California","Riverside County","NHPI_AIC",20817,14670,-6147,-34.64,"undercount"
"881",6067,"California","Sacramento County","A_A",272822,278616,5794,2.1,"overcount"
"882",6067,"California","Sacramento County","A_AIC",325384,322059,-3325,-1.03,"undercount"
"883",6067,"California","Sacramento County","NHPI_A",20270,19410,-860,-4.33,"undercount"
"884",6067,"California","Sacramento County","NHPI_AIC",32510,28994,-3516,-11.43,"undercount"
"885",6069,"California","San Benito County","A_A",2756,2229,-527,-21.14,"undercount"
"886",6069,"California","San Benito County","A_AIC",3696,2968,-728,-21.85,"undercount"
"887",6069,"California","San Benito County","NHPI_A",350,145,-205,-82.83,"undercount"
"888",6069,"California","San Benito County","NHPI_AIC",565,342,-223,-49.17,"undercount"
"889",6071,"California","San Bernardino County","A_A",183209,178290,-4919,-2.72,"undercount"
"890",6071,"California","San Bernardino County","A_AIC",215062,201247,-13815,-6.64,"undercount"
"891",6071,"California","San Bernardino County","NHPI_A",10879,6317,-4562,-53.06,"undercount"
"892",6071,"California","San Bernardino County","NHPI_AIC",18344,11925,-6419,-42.41,"undercount"
"893",6073,"California","San Diego County","A_A",427698,404249,-23449,-5.64,"undercount"
"894",6073,"California","San Diego County","A_AIC",522833,488904,-33929,-6.71,"undercount"
"895",6073,"California","San Diego County","NHPI_A",19979,13179,-6800,-41.02,"undercount"
"896",6073,"California","San Diego County","NHPI_AIC",38780,29045,-9735,-28.71,"undercount"
"897",6075,"California","San Francisco County","A_A",316220,296560,-19660,-6.42,"undercount"
"898",6075,"California","San Francisco County","A_AIC",342760,323737,-19023,-5.71,"undercount"
"899",6075,"California","San Francisco County","NHPI_A",3942,3315,-627,-17.28,"undercount"
"900",6075,"California","San Francisco County","NHPI_AIC",7640,6373,-1267,-18.08,"undercount"
"901",6077,"California","San Joaquin County","A_A",138774,135843,-2931,-2.13,"undercount"
"902",6077,"California","San Joaquin County","A_AIC",162585,150694,-11891,-7.59,"undercount"
"903",6077,"California","San Joaquin County","NHPI_A",6651,5227,-1424,-23.98,"undercount"
"904",6077,"California","San Joaquin County","NHPI_AIC",11486,8852,-2634,-25.9,"undercount"
"905",6079,"California","San Luis Obispo County","A_A",11420,10086,-1334,-12.41,"undercount"
"906",6079,"California","San Luis Obispo County","A_AIC",16309,14831,-1478,-9.49,"undercount"
"907",6079,"California","San Luis Obispo County","NHPI_A",532,342,-190,-43.48,"undercount"
"908",6079,"California","San Luis Obispo County","NHPI_AIC",1398,1252,-146,-11.02,"undercount"
"909",6081,"California","San Mateo County","A_A",238884,229962,-8922,-3.81,"undercount"
"910",6081,"California","San Mateo County","A_AIC",265589,254287,-11302,-4.35,"undercount"
"911",6081,"California","San Mateo County","NHPI_A",11036,9344,-1692,-16.6,"undercount"
"912",6081,"California","San Mateo County","NHPI_AIC",16478,13051,-3427,-23.21,"undercount"
"913",6083,"California","Santa Barbara County","A_A",26860,25710,-1150,-4.38,"undercount"
"914",6083,"California","Santa Barbara County","A_AIC",35668,32524,-3144,-9.22,"undercount"
"915",6083,"California","Santa Barbara County","NHPI_A",1234,549,-685,-76.84,"undercount"
"916",6083,"California","Santa Barbara County","NHPI_AIC",2788,1731,-1057,-46.78,"undercount"
"917",6085,"California","Santa Clara County","A_A",764100,757909,-6191,-0.81,"undercount"
"918",6085,"California","Santa Clara County","A_AIC",820079,807249,-12830,-1.58,"undercount"
"919",6085,"California","Santa Clara County","NHPI_A",9825,6152,-3673,-45.98,"undercount"
"920",6085,"California","Santa Clara County","NHPI_AIC",18484,12655,-5829,-37.44,"undercount"
"921",6087,"California","Santa Cruz County","A_A",14299,12298,-2001,-15.05,"undercount"
"922",6087,"California","Santa Cruz County","A_AIC",20300,17589,-2711,-14.31,"undercount"
"923",6087,"California","Santa Cruz County","NHPI_A",551,305,-246,-57.48,"undercount"
"924",6087,"California","Santa Cruz County","NHPI_AIC",1649,1235,-414,-28.71,"undercount"
"925",6089,"California","Shasta County","A_A",5710,5974,264,4.52,"overcount"
"926",6089,"California","Shasta County","A_AIC",8278,8140,-138,-1.68,"undercount"
"927",6089,"California","Shasta County","NHPI_A",435,328,-107,-28.05,"undercount"
"928",6089,"California","Shasta County","NHPI_AIC",1061,878,-183,-18.88,"undercount"
"929",6091,"California","Sierra County","A_A",29,7,-22,-122.22,"undercount"
"930",6091,"California","Sierra County","A_AIC",49,37,-12,-27.91,"undercount"
"931",6091,"California","Sierra County","NHPI_A",5,1,-4,-133.33,"undercount"
"932",6091,"California","Sierra County","NHPI_AIC",14,19,5,30.3,"overcount"
"933",6093,"California","Siskiyou County","A_A",680,882,202,25.86,"overcount"
"934",6093,"California","Siskiyou County","A_AIC",1252,1284,32,2.52,"overcount"
"935",6093,"California","Siskiyou County","NHPI_A",174,46,-128,-116.36,"undercount"
"936",6093,"California","Siskiyou County","NHPI_AIC",358,204,-154,-54.8,"undercount"
"937",6095,"California","Solano County","A_A",73665,71512,-2153,-2.97,"undercount"
"938",6095,"California","Solano County","A_AIC",91704,86017,-5687,-6.4,"undercount"
"939",6095,"California","Solano County","NHPI_A",4801,3918,-883,-20.25,"undercount"
"940",6095,"California","Solano County","NHPI_AIC",9788,7994,-1794,-20.18,"undercount"
"941",6097,"California","Sonoma County","A_A",22963,22610,-353,-1.55,"undercount"
"942",6097,"California","Sonoma County","A_AIC",31964,31027,-937,-2.98,"undercount"
"943",6097,"California","Sonoma County","NHPI_A",2031,1750,-281,-14.86,"undercount"
"944",6097,"California","Sonoma County","NHPI_AIC",4164,3549,-615,-15.95,"undercount"
"945",6099,"California","Stanislaus County","A_A",34169,33604,-565,-1.67,"undercount"
"946",6099,"California","Stanislaus County","A_AIC",45056,41059,-3997,-9.28,"undercount"
"947",6099,"California","Stanislaus County","NHPI_A",5240,4089,-1151,-24.68,"undercount"
"948",6099,"California","Stanislaus County","NHPI_AIC",8612,6272,-2340,-31.44,"undercount"
"949",6101,"California","Sutter County","A_A",16921,18316,1395,7.92,"overcount"
"950",6101,"California","Sutter County","A_AIC",19055,19907,852,4.37,"overcount"
"951",6101,"California","Sutter County","NHPI_A",401,290,-111,-32.13,"undercount"
"952",6101,"California","Sutter County","NHPI_AIC",884,619,-265,-35.26,"undercount"
"953",6103,"California","Tehama County","A_A",948,999,51,5.24,"overcount"
"954",6103,"California","Tehama County","A_AIC",1496,1463,-33,-2.23,"undercount"
"955",6103,"California","Tehama County","NHPI_A",164,100,-64,-48.48,"undercount"
"956",6103,"California","Tehama County","NHPI_AIC",334,248,-86,-29.55,"undercount"
"957",6105,"California","Trinity County","A_A",235,2212,1977,161.59,"overcount"
"958",6105,"California","Trinity County","A_AIC",350,2342,1992,147.99,"overcount"
"959",6105,"California","Trinity County","NHPI_A",32,24,-8,-28.57,"undercount"
"960",6105,"California","Trinity County","NHPI_AIC",76,69,-7,-9.66,"undercount"
"961",6107,"California","Tulare County","A_A",19281,16322,-2959,-16.62,"undercount"
"962",6107,"California","Tulare County","A_AIC",24051,19203,-4848,-22.42,"undercount"
"963",6107,"California","Tulare County","NHPI_A",1202,535,-667,-76.8,"undercount"
"964",6107,"California","Tulare County","NHPI_AIC",2371,1199,-1172,-65.66,"undercount"
"965",6109,"California","Tuolumne County","A_A",814,779,-35,-4.39,"undercount"
"966",6109,"California","Tuolumne County","A_AIC",1351,1375,24,1.76,"overcount"
"967",6109,"California","Tuolumne County","NHPI_A",158,115,-43,-31.5,"undercount"
"968",6109,"California","Tuolumne County","NHPI_AIC",309,350,41,12.44,"overcount"
"969",6111,"California","Ventura County","A_A",67005,64109,-2896,-4.42,"undercount"
"970",6111,"California","Ventura County","A_AIC",83716,78997,-4719,-5.8,"undercount"
"971",6111,"California","Ventura County","NHPI_A",2491,1493,-998,-50.1,"undercount"
"972",6111,"California","Ventura County","NHPI_AIC",5451,4025,-1426,-30.1,"undercount"
"973",6113,"California","Yolo County","A_A",33380,30182,-3198,-10.06,"undercount"
"974",6113,"California","Yolo County","A_AIC",41066,35999,-5067,-13.15,"undercount"
"975",6113,"California","Yolo County","NHPI_A",1267,1147,-120,-9.94,"undercount"
"976",6113,"California","Yolo County","NHPI_AIC",2657,2023,-634,-27.09,"undercount"
"977",6115,"California","Yuba County","A_A",6127,5618,-509,-8.67,"undercount"
"978",6115,"California","Yuba County","A_AIC",7927,7015,-912,-12.21,"undercount"
"979",6115,"California","Yuba County","NHPI_A",483,373,-110,-25.7,"undercount"
"980",6115,"California","Yuba County","NHPI_AIC",960,745,-215,-25.22,"undercount"
"981",8001,"Colorado","Adams County","A_A",23533,22771,-762,-3.29,"undercount"
"982",8001,"Colorado","Adams County","A_AIC",29308,28005,-1303,-4.55,"undercount"
"983",8001,"Colorado","Adams County","NHPI_A",1269,754,-515,-50.91,"undercount"
"984",8001,"Colorado","Adams County","NHPI_AIC",2363,1562,-801,-40.82,"undercount"
"985",8003,"Colorado","Alamosa County","A_A",267,142,-125,-61.12,"undercount"
"986",8003,"Colorado","Alamosa County","A_AIC",367,211,-156,-53.98,"undercount"
"987",8003,"Colorado","Alamosa County","NHPI_A",51,20,-31,-87.32,"undercount"
"988",8003,"Colorado","Alamosa County","NHPI_AIC",86,34,-52,-86.67,"undercount"
"989",8005,"Colorado","Arapahoe County","A_A",43578,42232,-1346,-3.14,"undercount"
"990",8005,"Colorado","Arapahoe County","A_AIC",53580,52743,-837,-1.57,"undercount"
"991",8005,"Colorado","Arapahoe County","NHPI_A",2196,1652,-544,-28.27,"undercount"
"992",8005,"Colorado","Arapahoe County","NHPI_AIC",3845,3157,-688,-19.65,"undercount"
"993",8007,"Colorado","Archuleta County","A_A",169,103,-66,-48.53,"undercount"
"994",8007,"Colorado","Archuleta County","A_AIC",249,208,-41,-17.94,"undercount"
"995",8007,"Colorado","Archuleta County","NHPI_A",18,6,-12,-100,"undercount"
"996",8007,"Colorado","Archuleta County","NHPI_AIC",42,37,-5,-12.66,"undercount"
"997",8009,"Colorado","Baca County","A_A",15,8,-7,-60.87,"undercount"
"998",8009,"Colorado","Baca County","A_AIC",28,11,-17,-87.18,"undercount"
"999",8009,"Colorado","Baca County","NHPI_A",0,0,0,0,"equal"
"1000",8009,"Colorado","Baca County","NHPI_AIC",5,2,-3,-85.71,"undercount"
"1001",8011,"Colorado","Bent County","A_A",80,39,-41,-68.91,"undercount"
"1002",8011,"Colorado","Bent County","A_AIC",101,60,-41,-50.93,"undercount"
"1003",8011,"Colorado","Bent County","NHPI_A",8,0,-8,-200,"undercount"
"1004",8011,"Colorado","Bent County","NHPI_AIC",10,3,-7,-107.69,"undercount"
"1005",8013,"Colorado","Boulder County","A_A",16259,16470,211,1.29,"overcount"
"1006",8013,"Colorado","Boulder County","A_AIC",21262,21777,515,2.39,"overcount"
"1007",8013,"Colorado","Boulder County","NHPI_A",251,243,-8,-3.24,"undercount"
"1008",8013,"Colorado","Boulder County","NHPI_AIC",738,648,-90,-12.99,"undercount"
"1009",8014,"Colorado","Broomfield County","A_A",5080,5118,38,0.75,"overcount"
"1010",8014,"Colorado","Broomfield County","A_AIC",6249,6482,233,3.66,"overcount"
"1011",8014,"Colorado","Broomfield County","NHPI_A",94,80,-14,-16.09,"undercount"
"1012",8014,"Colorado","Broomfield County","NHPI_AIC",203,210,7,3.39,"overcount"
"1013",8015,"Colorado","Chaffee County","A_A",192,133,-59,-36.31,"undercount"
"1014",8015,"Colorado","Chaffee County","A_AIC",285,258,-27,-9.94,"undercount"
"1015",8015,"Colorado","Chaffee County","NHPI_A",22,11,-11,-66.67,"undercount"
"1016",8015,"Colorado","Chaffee County","NHPI_AIC",36,35,-1,-2.82,"undercount"
"1017",8017,"Colorado","Cheyenne County","A_A",37,3,-34,-170,"undercount"
"1018",8017,"Colorado","Cheyenne County","A_AIC",42,8,-34,-136,"undercount"
"1019",8017,"Colorado","Cheyenne County","NHPI_A",1,0,-1,-200,"undercount"
"1020",8017,"Colorado","Cheyenne County","NHPI_AIC",2,4,2,66.67,"overcount"
"1021",8019,"Colorado","Clear Creek County","A_A",120,82,-38,-37.62,"undercount"
"1022",8019,"Colorado","Clear Creek County","A_AIC",177,154,-23,-13.9,"undercount"
"1023",8019,"Colorado","Clear Creek County","NHPI_A",7,10,3,35.29,"overcount"
"1024",8019,"Colorado","Clear Creek County","NHPI_AIC",17,17,0,0,"equal"
"1025",8021,"Colorado","Conejos County","A_A",72,21,-51,-109.68,"undercount"
"1026",8021,"Colorado","Conejos County","A_AIC",99,34,-65,-97.74,"undercount"
"1027",8021,"Colorado","Conejos County","NHPI_A",14,2,-12,-150,"undercount"
"1028",8021,"Colorado","Conejos County","NHPI_AIC",16,16,0,0,"equal"
"1029",8023,"Colorado","Costilla County","A_A",57,57,0,0,"equal"
"1030",8023,"Colorado","Costilla County","A_AIC",79,76,-3,-3.87,"undercount"
"1031",8023,"Colorado","Costilla County","NHPI_A",11,0,-11,-200,"undercount"
"1032",8023,"Colorado","Costilla County","NHPI_AIC",15,4,-11,-115.79,"undercount"
"1033",8025,"Colorado","Crowley County","A_A",71,69,-2,-2.86,"undercount"
"1034",8025,"Colorado","Crowley County","A_AIC",88,83,-5,-5.85,"undercount"
"1035",8025,"Colorado","Crowley County","NHPI_A",1,2,1,66.67,"overcount"
"1036",8025,"Colorado","Crowley County","NHPI_AIC",2,6,4,100,"overcount"
"1037",8027,"Colorado","Custer County","A_A",25,23,-2,-8.33,"undercount"
"1038",8027,"Colorado","Custer County","A_AIC",39,36,-3,-8,"undercount"
"1039",8027,"Colorado","Custer County","NHPI_A",1,0,-1,-200,"undercount"
"1040",8027,"Colorado","Custer County","NHPI_AIC",5,12,7,82.35,"overcount"
"1041",8029,"Colorado","Delta County","A_A",253,237,-16,-6.53,"undercount"
"1042",8029,"Colorado","Delta County","A_AIC",361,354,-7,-1.96,"undercount"
"1043",8029,"Colorado","Delta County","NHPI_A",29,9,-20,-105.26,"undercount"
"1044",8029,"Colorado","Delta County","NHPI_AIC",60,28,-32,-72.73,"undercount"
"1045",8031,"Colorado","Denver County","A_A",30001,27500,-2501,-8.7,"undercount"
"1046",8031,"Colorado","Denver County","A_AIC",38262,37611,-651,-1.72,"undercount"
"1047",8031,"Colorado","Denver County","NHPI_A",1616,1412,-204,-13.47,"undercount"
"1048",8031,"Colorado","Denver County","NHPI_AIC",2924,2528,-396,-14.53,"undercount"
"1049",8033,"Colorado","Dolores County","A_A",8,6,-2,-28.57,"undercount"
"1050",8033,"Colorado","Dolores County","A_AIC",18,13,-5,-32.26,"undercount"
"1051",8033,"Colorado","Dolores County","NHPI_A",2,5,3,85.71,"overcount"
"1052",8033,"Colorado","Dolores County","NHPI_AIC",5,14,9,94.74,"overcount"
"1053",8035,"Colorado","Douglas County","A_A",20214,19946,-268,-1.33,"undercount"
"1054",8035,"Colorado","Douglas County","A_AIC",25983,26381,398,1.52,"overcount"
"1055",8035,"Colorado","Douglas County","NHPI_A",420,295,-125,-34.97,"undercount"
"1056",8035,"Colorado","Douglas County","NHPI_AIC",1145,1159,14,1.22,"overcount"
"1057",8037,"Colorado","Eagle County","A_A",803,729,-74,-9.66,"undercount"
"1058",8037,"Colorado","Eagle County","A_AIC",1062,1091,29,2.69,"overcount"
"1059",8037,"Colorado","Eagle County","NHPI_A",64,27,-37,-81.32,"undercount"
"1060",8037,"Colorado","Eagle County","NHPI_AIC",137,93,-44,-38.26,"undercount"
"1061",8039,"Colorado","Elbert County","A_A",283,191,-92,-38.82,"undercount"
"1062",8039,"Colorado","Elbert County","A_AIC",454,451,-3,-0.66,"undercount"
"1063",8039,"Colorado","Elbert County","NHPI_A",59,21,-38,-95,"undercount"
"1064",8039,"Colorado","Elbert County","NHPI_AIC",95,62,-33,-42.04,"undercount"
"1065",8041,"Colorado","El Paso County","A_A",23307,21945,-1362,-6.02,"undercount"
"1066",8041,"Colorado","El Paso County","A_AIC",37967,36177,-1790,-4.83,"undercount"
"1067",8041,"Colorado","El Paso County","NHPI_A",2978,2772,-206,-7.17,"undercount"
"1068",8041,"Colorado","El Paso County","NHPI_AIC",6021,5761,-260,-4.41,"undercount"
"1069",8043,"Colorado","Fremont County","A_A",449,338,-111,-28.21,"undercount"
"1070",8043,"Colorado","Fremont County","A_AIC",627,483,-144,-25.95,"undercount"
"1071",8043,"Colorado","Fremont County","NHPI_A",42,30,-12,-33.33,"undercount"
"1072",8043,"Colorado","Fremont County","NHPI_AIC",79,93,14,16.28,"overcount"
"1073",8045,"Colorado","Garfield County","A_A",580,402,-178,-36.25,"undercount"
"1074",8045,"Colorado","Garfield County","A_AIC",863,755,-108,-13.35,"undercount"
"1075",8045,"Colorado","Garfield County","NHPI_A",110,34,-76,-105.56,"undercount"
"1076",8045,"Colorado","Garfield County","NHPI_AIC",173,107,-66,-47.14,"undercount"
"1077",8047,"Colorado","Gilpin County","A_A",94,85,-9,-10.06,"undercount"
"1078",8047,"Colorado","Gilpin County","A_AIC",138,146,8,5.63,"overcount"
"1079",8047,"Colorado","Gilpin County","NHPI_A",14,4,-10,-111.11,"undercount"
"1080",8047,"Colorado","Gilpin County","NHPI_AIC",26,36,10,32.26,"overcount"
"1081",8049,"Colorado","Grand County","A_A",140,83,-57,-51.12,"undercount"
"1082",8049,"Colorado","Grand County","A_AIC",207,161,-46,-25,"undercount"
"1083",8049,"Colorado","Grand County","NHPI_A",26,17,-9,-41.86,"undercount"
"1084",8049,"Colorado","Grand County","NHPI_AIC",44,44,0,0,"equal"
"1085",8051,"Colorado","Gunnison County","A_A",156,121,-35,-25.27,"undercount"
"1086",8051,"Colorado","Gunnison County","A_AIC",253,232,-21,-8.66,"undercount"
"1087",8051,"Colorado","Gunnison County","NHPI_A",4,7,3,54.55,"overcount"
"1088",8051,"Colorado","Gunnison County","NHPI_AIC",25,34,9,30.51,"overcount"
"1089",8053,"Colorado","Hinsdale County","A_A",8,2,-6,-120,"undercount"
"1090",8053,"Colorado","Hinsdale County","A_AIC",12,22,10,58.82,"overcount"
"1091",8053,"Colorado","Hinsdale County","NHPI_A",0,1,1,200,"overcount"
"1092",8053,"Colorado","Hinsdale County","NHPI_AIC",0,12,12,200,"overcount"
"1093",8055,"Colorado","Huerfano County","A_A",67,24,-43,-94.51,"undercount"
"1094",8055,"Colorado","Huerfano County","A_AIC",102,60,-42,-51.85,"undercount"
"1095",8055,"Colorado","Huerfano County","NHPI_A",27,0,-27,-200,"undercount"
"1096",8055,"Colorado","Huerfano County","NHPI_AIC",39,4,-35,-162.79,"undercount"
"1097",8057,"Colorado","Jackson County","A_A",9,2,-7,-127.27,"undercount"
"1098",8057,"Colorado","Jackson County","A_AIC",10,9,-1,-10.53,"undercount"
"1099",8057,"Colorado","Jackson County","NHPI_A",0,2,2,200,"overcount"
"1100",8057,"Colorado","Jackson County","NHPI_AIC",1,6,5,142.86,"overcount"
"1101",8059,"Colorado","Jefferson County","A_A",18467,17881,-586,-3.22,"undercount"
"1102",8059,"Colorado","Jefferson County","A_AIC",24746,24846,100,0.4,"overcount"
"1103",8059,"Colorado","Jefferson County","NHPI_A",787,479,-308,-48.66,"undercount"
"1104",8059,"Colorado","Jefferson County","NHPI_AIC",1742,1328,-414,-26.97,"undercount"
"1105",8061,"Colorado","Kiowa County","A_A",7,9,2,25,"overcount"
"1106",8061,"Colorado","Kiowa County","A_AIC",12,21,9,54.55,"overcount"
"1107",8061,"Colorado","Kiowa County","NHPI_A",4,1,-3,-120,"undercount"
"1108",8061,"Colorado","Kiowa County","NHPI_AIC",5,9,4,57.14,"overcount"
"1109",8063,"Colorado","Kit Carson County","A_A",58,30,-28,-63.64,"undercount"
"1110",8063,"Colorado","Kit Carson County","A_AIC",78,65,-13,-18.18,"undercount"
"1111",8063,"Colorado","Kit Carson County","NHPI_A",15,5,-10,-100,"undercount"
"1112",8063,"Colorado","Kit Carson County","NHPI_AIC",26,10,-16,-88.89,"undercount"
"1113",8065,"Colorado","Lake County","A_A",73,63,-10,-14.71,"undercount"
"1114",8065,"Colorado","Lake County","A_AIC",101,110,9,8.53,"overcount"
"1115",8065,"Colorado","Lake County","NHPI_A",5,8,3,46.15,"overcount"
"1116",8065,"Colorado","Lake County","NHPI_AIC",19,17,-2,-11.11,"undercount"
"1117",8067,"Colorado","La Plata County","A_A",420,389,-31,-7.66,"undercount"
"1118",8067,"Colorado","La Plata County","A_AIC",723,747,24,3.27,"overcount"
"1119",8067,"Colorado","La Plata County","NHPI_A",57,33,-24,-53.33,"undercount"
"1120",8067,"Colorado","La Plata County","NHPI_AIC",138,92,-46,-40,"undercount"
"1121",8069,"Colorado","Larimer County","A_A",8550,8575,25,0.29,"overcount"
"1122",8069,"Colorado","Larimer County","A_AIC",12670,12765,95,0.75,"overcount"
"1123",8069,"Colorado","Larimer County","NHPI_A",381,298,-83,-24.45,"undercount"
"1124",8069,"Colorado","Larimer County","NHPI_AIC",977,927,-50,-5.25,"undercount"
"1125",8071,"Colorado","Las Animas County","A_A",218,108,-110,-67.48,"undercount"
"1126",8071,"Colorado","Las Animas County","A_AIC",274,164,-110,-50.23,"undercount"
"1127",8071,"Colorado","Las Animas County","NHPI_A",21,12,-9,-54.55,"undercount"
"1128",8071,"Colorado","Las Animas County","NHPI_AIC",40,41,1,2.47,"overcount"
"1129",8073,"Colorado","Lincoln County","A_A",61,40,-21,-41.58,"undercount"
"1130",8073,"Colorado","Lincoln County","A_AIC",88,58,-30,-41.1,"undercount"
"1131",8073,"Colorado","Lincoln County","NHPI_A",10,22,12,75,"overcount"
"1132",8073,"Colorado","Lincoln County","NHPI_AIC",17,36,19,71.7,"overcount"
"1133",8075,"Colorado","Logan County","A_A",214,130,-84,-48.84,"undercount"
"1134",8075,"Colorado","Logan County","A_AIC",272,225,-47,-18.91,"undercount"
"1135",8075,"Colorado","Logan County","NHPI_A",27,18,-9,-40,"undercount"
"1136",8075,"Colorado","Logan County","NHPI_AIC",42,33,-9,-24,"undercount"
"1137",8077,"Colorado","Mesa County","A_A",1614,1645,31,1.9,"overcount"
"1138",8077,"Colorado","Mesa County","A_AIC",2712,2780,68,2.48,"overcount"
"1139",8077,"Colorado","Mesa County","NHPI_A",213,189,-24,-11.94,"undercount"
"1140",8077,"Colorado","Mesa County","NHPI_AIC",492,479,-13,-2.68,"undercount"
"1141",8079,"Colorado","Mineral County","A_A",5,3,-2,-50,"undercount"
"1142",8079,"Colorado","Mineral County","A_AIC",8,7,-1,-13.33,"undercount"
"1143",8079,"Colorado","Mineral County","NHPI_A",0,0,0,0,"equal"
"1144",8079,"Colorado","Mineral County","NHPI_AIC",2,6,4,100,"overcount"
"1145",8081,"Colorado","Moffat County","A_A",100,52,-48,-63.16,"undercount"
"1146",8081,"Colorado","Moffat County","A_AIC",180,113,-67,-45.73,"undercount"
"1147",8081,"Colorado","Moffat County","NHPI_A",12,2,-10,-142.86,"undercount"
"1148",8081,"Colorado","Moffat County","NHPI_AIC",32,13,-19,-84.44,"undercount"
"1149",8083,"Colorado","Montezuma County","A_A",169,128,-41,-27.61,"undercount"
"1150",8083,"Colorado","Montezuma County","A_AIC",297,245,-52,-19.19,"undercount"
"1151",8083,"Colorado","Montezuma County","NHPI_A",32,24,-8,-28.57,"undercount"
"1152",8083,"Colorado","Montezuma County","NHPI_AIC",57,70,13,20.47,"overcount"
"1153",8085,"Colorado","Montrose County","A_A",369,345,-24,-6.72,"undercount"
"1154",8085,"Colorado","Montrose County","A_AIC",579,536,-43,-7.71,"undercount"
"1155",8085,"Colorado","Montrose County","NHPI_A",75,27,-48,-94.12,"undercount"
"1156",8085,"Colorado","Montrose County","NHPI_AIC",115,90,-25,-24.39,"undercount"
"1157",8087,"Colorado","Morgan County","A_A",236,160,-76,-38.38,"undercount"
"1158",8087,"Colorado","Morgan County","A_AIC",340,248,-92,-31.29,"undercount"
"1159",8087,"Colorado","Morgan County","NHPI_A",125,11,-114,-167.65,"undercount"
"1160",8087,"Colorado","Morgan County","NHPI_AIC",163,16,-147,-164.25,"undercount"
"1161",8089,"Colorado","Otero County","A_A",173,99,-74,-54.41,"undercount"
"1162",8089,"Colorado","Otero County","A_AIC",275,157,-118,-54.63,"undercount"
"1163",8089,"Colorado","Otero County","NHPI_A",44,28,-16,-44.44,"undercount"
"1164",8089,"Colorado","Otero County","NHPI_AIC",78,42,-36,-60,"undercount"
"1165",8091,"Colorado","Ouray County","A_A",39,28,-11,-32.84,"undercount"
"1166",8091,"Colorado","Ouray County","A_AIC",61,55,-6,-10.34,"undercount"
"1167",8091,"Colorado","Ouray County","NHPI_A",9,2,-7,-127.27,"undercount"
"1168",8091,"Colorado","Ouray County","NHPI_AIC",12,7,-5,-52.63,"undercount"
"1169",8093,"Colorado","Park County","A_A",175,99,-76,-55.47,"undercount"
"1170",8093,"Colorado","Park County","A_AIC",307,229,-78,-29.1,"undercount"
"1171",8093,"Colorado","Park County","NHPI_A",10,9,-1,-10.53,"undercount"
"1172",8093,"Colorado","Park County","NHPI_AIC",35,31,-4,-12.12,"undercount"
"1173",8095,"Colorado","Phillips County","A_A",25,22,-3,-12.77,"undercount"
"1174",8095,"Colorado","Phillips County","A_AIC",37,44,7,17.28,"overcount"
"1175",8095,"Colorado","Phillips County","NHPI_A",7,1,-6,-150,"undercount"
"1176",8095,"Colorado","Phillips County","NHPI_AIC",11,10,-1,-9.52,"undercount"
"1177",8097,"Colorado","Pitkin County","A_A",372,283,-89,-27.18,"undercount"
"1178",8097,"Colorado","Pitkin County","A_AIC",488,451,-37,-7.88,"undercount"
"1179",8097,"Colorado","Pitkin County","NHPI_A",22,7,-15,-103.45,"undercount"
"1180",8097,"Colorado","Pitkin County","NHPI_AIC",48,31,-17,-43.04,"undercount"
"1181",8099,"Colorado","Prowers County","A_A",69,35,-34,-65.38,"undercount"
"1182",8099,"Colorado","Prowers County","A_AIC",110,48,-62,-78.48,"undercount"
"1183",8099,"Colorado","Prowers County","NHPI_A",6,6,0,0,"equal"
"1184",8099,"Colorado","Prowers County","NHPI_AIC",27,14,-13,-63.41,"undercount"
"1185",8101,"Colorado","Pueblo County","A_A",1985,1653,-332,-18.25,"undercount"
"1186",8101,"Colorado","Pueblo County","A_AIC",3059,2470,-589,-21.31,"undercount"
"1187",8101,"Colorado","Pueblo County","NHPI_A",319,149,-170,-72.65,"undercount"
"1188",8101,"Colorado","Pueblo County","NHPI_AIC",621,362,-259,-52.7,"undercount"
"1189",8103,"Colorado","Rio Blanco County","A_A",47,24,-23,-64.79,"undercount"
"1190",8103,"Colorado","Rio Blanco County","A_AIC",94,57,-37,-49.01,"undercount"
"1191",8103,"Colorado","Rio Blanco County","NHPI_A",10,4,-6,-85.71,"undercount"
"1192",8103,"Colorado","Rio Blanco County","NHPI_AIC",23,12,-11,-62.86,"undercount"
"1193",8105,"Colorado","Rio Grande County","A_A",75,36,-39,-70.27,"undercount"
"1194",8105,"Colorado","Rio Grande County","A_AIC",133,81,-52,-48.6,"undercount"
"1195",8105,"Colorado","Rio Grande County","NHPI_A",11,8,-3,-31.58,"undercount"
"1196",8105,"Colorado","Rio Grande County","NHPI_AIC",29,30,1,3.39,"overcount"
"1197",8107,"Colorado","Routt County","A_A",242,177,-65,-31.03,"undercount"
"1198",8107,"Colorado","Routt County","A_AIC",390,360,-30,-8,"undercount"
"1199",8107,"Colorado","Routt County","NHPI_A",24,37,13,42.62,"overcount"
"1200",8107,"Colorado","Routt County","NHPI_AIC",64,77,13,18.44,"overcount"
"1201",8109,"Colorado","Saguache County","A_A",64,63,-1,-1.57,"undercount"
"1202",8109,"Colorado","Saguache County","A_AIC",105,92,-13,-13.2,"undercount"
"1203",8109,"Colorado","Saguache County","NHPI_A",2,2,0,0,"equal"
"1204",8109,"Colorado","Saguache County","NHPI_AIC",13,17,4,26.67,"overcount"
"1205",8111,"Colorado","San Juan County","A_A",6,2,-4,-100,"undercount"
"1206",8111,"Colorado","San Juan County","A_AIC",9,9,0,0,"equal"
"1207",8111,"Colorado","San Juan County","NHPI_A",0,0,0,0,"equal"
"1208",8111,"Colorado","San Juan County","NHPI_AIC",1,5,4,133.33,"overcount"
"1209",8113,"Colorado","San Miguel County","A_A",78,56,-22,-32.84,"undercount"
"1210",8113,"Colorado","San Miguel County","A_AIC",119,94,-25,-23.47,"undercount"
"1211",8113,"Colorado","San Miguel County","NHPI_A",5,0,-5,-200,"undercount"
"1212",8113,"Colorado","San Miguel County","NHPI_AIC",19,10,-9,-62.07,"undercount"
"1213",8115,"Colorado","Sedgwick County","A_A",32,12,-20,-90.91,"undercount"
"1214",8115,"Colorado","Sedgwick County","A_AIC",40,29,-11,-31.88,"undercount"
"1215",8115,"Colorado","Sedgwick County","NHPI_A",5,0,-5,-200,"undercount"
"1216",8115,"Colorado","Sedgwick County","NHPI_AIC",7,8,1,13.33,"overcount"
"1217",8117,"Colorado","Summit County","A_A",419,412,-7,-1.68,"undercount"
"1218",8117,"Colorado","Summit County","A_AIC",591,721,130,19.82,"overcount"
"1219",8117,"Colorado","Summit County","NHPI_A",54,20,-34,-91.89,"undercount"
"1220",8117,"Colorado","Summit County","NHPI_AIC",87,86,-1,-1.16,"undercount"
"1221",8119,"Colorado","Teller County","A_A",281,202,-79,-32.71,"undercount"
"1222",8119,"Colorado","Teller County","A_AIC",469,389,-80,-18.65,"undercount"
"1223",8119,"Colorado","Teller County","NHPI_A",34,12,-22,-95.65,"undercount"
"1224",8119,"Colorado","Teller County","NHPI_AIC",67,54,-13,-21.49,"undercount"
"1225",8121,"Colorado","Washington County","A_A",25,15,-10,-50,"undercount"
"1226",8121,"Colorado","Washington County","A_AIC",40,30,-10,-28.57,"undercount"
"1227",8121,"Colorado","Washington County","NHPI_A",4,10,6,85.71,"overcount"
"1228",8121,"Colorado","Washington County","NHPI_AIC",9,13,4,36.36,"overcount"
"1229",8123,"Colorado","Weld County","A_A",6255,5748,-507,-8.45,"undercount"
"1230",8123,"Colorado","Weld County","A_AIC",8751,8419,-332,-3.87,"undercount"
"1231",8123,"Colorado","Weld County","NHPI_A",597,311,-286,-63,"undercount"
"1232",8123,"Colorado","Weld County","NHPI_AIC",1069,852,-217,-22.59,"undercount"
"1233",8125,"Colorado","Yuma County","A_A",57,26,-31,-74.7,"undercount"
"1234",8125,"Colorado","Yuma County","A_AIC",72,41,-31,-54.87,"undercount"
"1235",8125,"Colorado","Yuma County","NHPI_A",23,3,-20,-153.85,"undercount"
"1236",8125,"Colorado","Yuma County","NHPI_AIC",27,11,-16,-84.21,"undercount"
"1237",9001,"Connecticut","Fairfield County","A_A",55786,51779,-4007,-7.45,"undercount"
"1238",9001,"Connecticut","Fairfield County","A_AIC",62914,60756,-2158,-3.49,"undercount"
"1239",9001,"Connecticut","Fairfield County","NHPI_A",1121,224,-897,-133.38,"undercount"
"1240",9001,"Connecticut","Fairfield County","NHPI_AIC",2653,771,-1882,-109.93,"undercount"
"1241",9003,"Connecticut","Hartford County","A_A",55386,54142,-1244,-2.27,"undercount"
"1242",9003,"Connecticut","Hartford County","A_AIC",61505,60742,-763,-1.25,"undercount"
"1243",9003,"Connecticut","Hartford County","NHPI_A",1135,247,-888,-128.51,"undercount"
"1244",9003,"Connecticut","Hartford County","NHPI_AIC",2075,811,-1264,-87.6,"undercount"
"1245",9005,"Connecticut","Litchfield County","A_A",3906,3528,-378,-10.17,"undercount"
"1246",9005,"Connecticut","Litchfield County","A_AIC",4819,4686,-133,-2.8,"undercount"
"1247",9005,"Connecticut","Litchfield County","NHPI_A",141,64,-77,-75.12,"undercount"
"1248",9005,"Connecticut","Litchfield County","NHPI_AIC",288,170,-118,-51.53,"undercount"
"1249",9007,"Connecticut","Middlesex County","A_A",5392,4982,-410,-7.9,"undercount"
"1250",9007,"Connecticut","Middlesex County","A_AIC",6560,6242,-318,-4.97,"undercount"
"1251",9007,"Connecticut","Middlesex County","NHPI_A",114,45,-69,-86.79,"undercount"
"1252",9007,"Connecticut","Middlesex County","NHPI_AIC",298,185,-113,-46.79,"undercount"
"1253",9009,"Connecticut","New Haven County","A_A",37268,37746,478,1.27,"overcount"
"1254",9009,"Connecticut","New Haven County","A_AIC",42760,43583,823,1.91,"overcount"
"1255",9009,"Connecticut","New Haven County","NHPI_A",979,334,-645,-98.25,"undercount"
"1256",9009,"Connecticut","New Haven County","NHPI_AIC",1723,806,-917,-72.52,"undercount"
"1257",9011,"Connecticut","New London County","A_A",11342,10768,-574,-5.19,"undercount"
"1258",9011,"Connecticut","New London County","A_AIC",14313,13636,-677,-4.84,"undercount"
"1259",9011,"Connecticut","New London County","NHPI_A",394,232,-162,-51.76,"undercount"
"1260",9011,"Connecticut","New London County","NHPI_AIC",910,827,-83,-9.56,"undercount"
"1261",9013,"Connecticut","Tolland County","A_A",7798,8560,762,9.32,"overcount"
"1262",9013,"Connecticut","Tolland County","A_AIC",9082,9782,700,7.42,"overcount"
"1263",9013,"Connecticut","Tolland County","NHPI_A",116,48,-68,-82.93,"undercount"
"1264",9013,"Connecticut","Tolland County","NHPI_AIC",301,175,-126,-52.94,"undercount"
"1265",9015,"Connecticut","Windham County","A_A",1709,1983,274,14.84,"overcount"
"1266",9015,"Connecticut","Windham County","A_AIC",2331,2716,385,15.26,"overcount"
"1267",9015,"Connecticut","Windham County","NHPI_A",106,17,-89,-144.72,"undercount"
"1268",9015,"Connecticut","Windham County","NHPI_AIC",254,120,-134,-71.66,"undercount"
"1269",10001,"Delaware","Kent County","A_A",4364,4450,86,1.95,"overcount"
"1270",10001,"Delaware","Kent County","A_AIC",6298,6190,-108,-1.73,"undercount"
"1271",10001,"Delaware","Kent County","NHPI_A",219,115,-104,-62.28,"undercount"
"1272",10001,"Delaware","Kent County","NHPI_AIC",679,367,-312,-59.66,"undercount"
"1273",10003,"Delaware","New Castle County","A_A",33840,35302,1462,4.23,"overcount"
"1274",10003,"Delaware","New Castle County","A_AIC",38108,39895,1787,4.58,"overcount"
"1275",10003,"Delaware","New Castle County","NHPI_A",407,144,-263,-95.46,"undercount"
"1276",10003,"Delaware","New Castle County","NHPI_AIC",797,607,-190,-27.07,"undercount"
"1277",10005,"Delaware","Sussex County","A_A",3339,3090,-249,-7.75,"undercount"
"1278",10005,"Delaware","Sussex County","A_AIC",4228,4160,-68,-1.62,"undercount"
"1279",10005,"Delaware","Sussex County","NHPI_A",510,100,-410,-134.43,"undercount"
"1280",10005,"Delaware","Sussex County","NHPI_AIC",716,284,-432,-86.4,"undercount"
"1281",11001,"District of Columbia","District of Columbia","A_A",32460,33647,1187,3.59,"overcount"
"1282",11001,"District of Columbia","District of Columbia","A_AIC",40951,44516,3565,8.34,"overcount"
"1283",11001,"District of Columbia","District of Columbia","NHPI_A",1089,352,-737,-102.29,"undercount"
"1284",11001,"District of Columbia","District of Columbia","NHPI_AIC",2085,1139,-946,-58.68,"undercount"
"1285",12001,"Florida","Alachua County","A_A",16666,18138,1472,8.46,"overcount"
"1286",12001,"Florida","Alachua County","A_AIC",19873,21731,1858,8.93,"overcount"
"1287",12001,"Florida","Alachua County","NHPI_A",200,106,-94,-61.44,"undercount"
"1288",12001,"Florida","Alachua County","NHPI_AIC",576,393,-183,-37.77,"undercount"
"1289",12003,"Florida","Baker County","A_A",219,159,-60,-31.75,"undercount"
"1290",12003,"Florida","Baker County","A_AIC",302,258,-44,-15.71,"undercount"
"1291",12003,"Florida","Baker County","NHPI_A",11,14,3,24,"overcount"
"1292",12003,"Florida","Baker County","NHPI_AIC",37,41,4,10.26,"overcount"
"1293",12005,"Florida","Bay County","A_A",4066,4113,47,1.15,"overcount"
"1294",12005,"Florida","Bay County","A_AIC",6245,6307,62,0.99,"overcount"
"1295",12005,"Florida","Bay County","NHPI_A",299,194,-105,-42.6,"undercount"
"1296",12005,"Florida","Bay County","NHPI_AIC",632,569,-63,-10.49,"undercount"
"1297",12007,"Florida","Bradford County","A_A",184,139,-45,-27.86,"undercount"
"1298",12007,"Florida","Bradford County","A_AIC",291,233,-58,-22.14,"undercount"
"1299",12007,"Florida","Bradford County","NHPI_A",12,12,0,0,"equal"
"1300",12007,"Florida","Bradford County","NHPI_AIC",59,30,-29,-65.17,"undercount"
"1301",12009,"Florida","Brevard County","A_A",16186,15839,-347,-2.17,"undercount"
"1302",12009,"Florida","Brevard County","A_AIC",22714,22549,-165,-0.73,"undercount"
"1303",12009,"Florida","Brevard County","NHPI_A",758,498,-260,-41.4,"undercount"
"1304",12009,"Florida","Brevard County","NHPI_AIC",1831,1455,-376,-22.88,"undercount"
"1305",12011,"Florida","Broward County","A_A",76405,76607,202,0.26,"overcount"
"1306",12011,"Florida","Broward County","A_AIC",93971,91468,-2503,-2.7,"undercount"
"1307",12011,"Florida","Broward County","NHPI_A",2420,984,-1436,-84.37,"undercount"
"1308",12011,"Florida","Broward County","NHPI_AIC",7106,3030,-4076,-80.43,"undercount"
"1309",12013,"Florida","Calhoun County","A_A",121,48,-73,-86.39,"undercount"
"1310",12013,"Florida","Calhoun County","A_AIC",172,125,-47,-31.65,"undercount"
"1311",12013,"Florida","Calhoun County","NHPI_A",22,0,-22,-200,"undercount"
"1312",12013,"Florida","Calhoun County","NHPI_AIC",36,57,21,45.16,"overcount"
"1313",12015,"Florida","Charlotte County","A_A",2785,2617,-168,-6.22,"undercount"
"1314",12015,"Florida","Charlotte County","A_AIC",3652,3532,-120,-3.34,"undercount"
"1315",12015,"Florida","Charlotte County","NHPI_A",135,106,-29,-24.07,"undercount"
"1316",12015,"Florida","Charlotte County","NHPI_AIC",339,261,-78,-26,"undercount"
"1317",12017,"Florida","Citrus County","A_A",2614,2466,-148,-5.83,"undercount"
"1318",12017,"Florida","Citrus County","A_AIC",3223,3151,-72,-2.26,"undercount"
"1319",12017,"Florida","Citrus County","NHPI_A",82,46,-36,-56.25,"undercount"
"1320",12017,"Florida","Citrus County","NHPI_AIC",252,179,-73,-33.87,"undercount"
"1321",12019,"Florida","Clay County","A_A",7011,6704,-307,-4.48,"undercount"
"1322",12019,"Florida","Clay County","A_AIC",10160,9611,-549,-5.55,"undercount"
"1323",12019,"Florida","Clay County","NHPI_A",385,367,-18,-4.79,"undercount"
"1324",12019,"Florida","Clay County","NHPI_AIC",846,858,12,1.41,"overcount"
"1325",12021,"Florida","Collier County","A_A",6289,5503,-786,-13.33,"undercount"
"1326",12021,"Florida","Collier County","A_AIC",7954,7138,-816,-10.81,"undercount"
"1327",12021,"Florida","Collier County","NHPI_A",374,80,-294,-129.52,"undercount"
"1328",12021,"Florida","Collier County","NHPI_AIC",1079,308,-771,-111.18,"undercount"
"1329",12023,"Florida","Columbia County","A_A",759,880,121,14.77,"overcount"
"1330",12023,"Florida","Columbia County","A_AIC",1017,1122,105,9.82,"overcount"
"1331",12023,"Florida","Columbia County","NHPI_A",63,27,-36,-80,"undercount"
"1332",12023,"Florida","Columbia County","NHPI_AIC",136,65,-71,-70.65,"undercount"
"1333",12027,"Florida","DeSoto County","A_A",245,199,-46,-20.72,"undercount"
"1334",12027,"Florida","DeSoto County","A_AIC",310,254,-56,-19.86,"undercount"
"1335",12027,"Florida","DeSoto County","NHPI_A",79,8,-71,-163.22,"undercount"
"1336",12027,"Florida","DeSoto County","NHPI_AIC",107,37,-70,-97.22,"undercount"
"1337",12029,"Florida","Dixie County","A_A",79,78,-1,-1.27,"undercount"
"1338",12029,"Florida","Dixie County","A_AIC",110,114,4,3.57,"overcount"
"1339",12029,"Florida","Dixie County","NHPI_A",5,0,-5,-200,"undercount"
"1340",12029,"Florida","Dixie County","NHPI_AIC",27,18,-9,-40,"undercount"
"1341",12031,"Florida","Duval County","A_A",48906,49291,385,0.78,"overcount"
"1342",12031,"Florida","Duval County","A_AIC",60977,61315,338,0.55,"overcount"
"1343",12031,"Florida","Duval County","NHPI_A",1182,988,-194,-17.88,"undercount"
"1344",12031,"Florida","Duval County","NHPI_AIC",3096,2660,-436,-15.15,"undercount"
"1345",12033,"Florida","Escambia County","A_A",10751,9970,-781,-7.54,"undercount"
"1346",12033,"Florida","Escambia County","A_AIC",15459,14401,-1058,-7.09,"undercount"
"1347",12033,"Florida","Escambia County","NHPI_A",614,424,-190,-36.61,"undercount"
"1348",12033,"Florida","Escambia County","NHPI_AIC",1456,1137,-319,-24.6,"undercount"
"1349",12035,"Florida","Flagler County","A_A",2990,2489,-501,-18.29,"undercount"
"1350",12035,"Florida","Flagler County","A_AIC",3779,3317,-462,-13.02,"undercount"
"1351",12035,"Florida","Flagler County","NHPI_A",109,64,-45,-52.02,"undercount"
"1352",12035,"Florida","Flagler County","NHPI_AIC",318,175,-143,-58.01,"undercount"
"1353",12037,"Florida","Franklin County","A_A",56,34,-22,-48.89,"undercount"
"1354",12037,"Florida","Franklin County","A_AIC",75,55,-20,-30.77,"undercount"
"1355",12037,"Florida","Franklin County","NHPI_A",12,4,-8,-100,"undercount"
"1356",12037,"Florida","Franklin County","NHPI_AIC",29,11,-18,-90,"undercount"
"1357",12039,"Florida","Gadsden County","A_A",314,161,-153,-64.42,"undercount"
"1358",12039,"Florida","Gadsden County","A_AIC",414,260,-154,-45.7,"undercount"
"1359",12039,"Florida","Gadsden County","NHPI_A",66,7,-59,-161.64,"undercount"
"1360",12039,"Florida","Gadsden County","NHPI_AIC",113,33,-80,-109.59,"undercount"
"1361",12041,"Florida","Gilchrist County","A_A",106,64,-42,-49.41,"undercount"
"1362",12041,"Florida","Gilchrist County","A_AIC",139,149,10,6.94,"overcount"
"1363",12041,"Florida","Gilchrist County","NHPI_A",19,4,-15,-130.43,"undercount"
"1364",12041,"Florida","Gilchrist County","NHPI_AIC",37,21,-16,-55.17,"undercount"
"1365",12043,"Florida","Glades County","A_A",83,34,-49,-83.76,"undercount"
"1366",12043,"Florida","Glades County","A_AIC",111,72,-39,-42.62,"undercount"
"1367",12043,"Florida","Glades County","NHPI_A",17,0,-17,-200,"undercount"
"1368",12043,"Florida","Glades County","NHPI_AIC",29,12,-17,-82.93,"undercount"
"1369",12045,"Florida","Gulf County","A_A",83,59,-24,-33.8,"undercount"
"1370",12045,"Florida","Gulf County","A_AIC",122,100,-22,-19.82,"undercount"
"1371",12045,"Florida","Gulf County","NHPI_A",5,0,-5,-200,"undercount"
"1372",12045,"Florida","Gulf County","NHPI_AIC",18,16,-2,-11.76,"undercount"
"1373",12047,"Florida","Hamilton County","A_A",105,45,-60,-80,"undercount"
"1374",12047,"Florida","Hamilton County","A_AIC",153,108,-45,-34.48,"undercount"
"1375",12047,"Florida","Hamilton County","NHPI_A",9,0,-9,-200,"undercount"
"1376",12047,"Florida","Hamilton County","NHPI_AIC",24,16,-8,-40,"undercount"
"1377",12049,"Florida","Hardee County","A_A",300,167,-133,-56.96,"undercount"
"1378",12049,"Florida","Hardee County","A_AIC",378,212,-166,-56.27,"undercount"
"1379",12049,"Florida","Hardee County","NHPI_A",43,3,-40,-173.91,"undercount"
"1380",12049,"Florida","Hardee County","NHPI_AIC",70,12,-58,-141.46,"undercount"
"1381",12051,"Florida","Hendry County","A_A",428,362,-66,-16.71,"undercount"
"1382",12051,"Florida","Hendry County","A_AIC",577,449,-128,-24.95,"undercount"
"1383",12051,"Florida","Hendry County","NHPI_A",92,4,-88,-183.33,"undercount"
"1384",12051,"Florida","Hendry County","NHPI_AIC",146,38,-108,-117.39,"undercount"
"1385",12053,"Florida","Hernando County","A_A",2941,2627,-314,-11.28,"undercount"
"1386",12053,"Florida","Hernando County","A_AIC",3992,3723,-269,-6.97,"undercount"
"1387",12053,"Florida","Hernando County","NHPI_A",189,101,-88,-60.69,"undercount"
"1388",12053,"Florida","Hernando County","NHPI_AIC",439,302,-137,-36.98,"undercount"
"1389",12055,"Florida","Highlands County","A_A",1708,1623,-85,-5.1,"undercount"
"1390",12055,"Florida","Highlands County","A_AIC",2089,1956,-133,-6.58,"undercount"
"1391",12055,"Florida","Highlands County","NHPI_A",105,60,-45,-54.55,"undercount"
"1392",12055,"Florida","Highlands County","NHPI_AIC",239,151,-88,-45.13,"undercount"
"1393",12057,"Florida","Hillsborough County","A_A",68404,71024,2620,3.76,"overcount"
"1394",12057,"Florida","Hillsborough County","A_AIC",82898,85518,2620,3.11,"overcount"
"1395",12057,"Florida","Hillsborough County","NHPI_A",2038,1008,-1030,-67.63,"undercount"
"1396",12057,"Florida","Hillsborough County","NHPI_AIC",4477,2722,-1755,-48.76,"undercount"
"1397",12059,"Florida","Holmes County","A_A",141,82,-59,-52.91,"undercount"
"1398",12059,"Florida","Holmes County","A_AIC",190,142,-48,-28.92,"undercount"
"1399",12059,"Florida","Holmes County","NHPI_A",34,13,-21,-89.36,"undercount"
"1400",12059,"Florida","Holmes County","NHPI_AIC",53,36,-17,-38.2,"undercount"
"1401",12061,"Florida","Indian River County","A_A",2718,2365,-353,-13.89,"undercount"
"1402",12061,"Florida","Indian River County","A_AIC",3389,3113,-276,-8.49,"undercount"
"1403",12061,"Florida","Indian River County","NHPI_A",96,52,-44,-59.46,"undercount"
"1404",12061,"Florida","Indian River County","NHPI_AIC",266,157,-109,-51.54,"undercount"
"1405",12063,"Florida","Jackson County","A_A",329,295,-34,-10.9,"undercount"
"1406",12063,"Florida","Jackson County","A_AIC",471,411,-60,-13.61,"undercount"
"1407",12063,"Florida","Jackson County","NHPI_A",116,18,-98,-146.27,"undercount"
"1408",12063,"Florida","Jackson County","NHPI_AIC",173,62,-111,-94.47,"undercount"
"1409",12065,"Florida","Jefferson County","A_A",102,34,-68,-100,"undercount"
"1410",12065,"Florida","Jefferson County","A_AIC",137,111,-26,-20.97,"undercount"
"1411",12065,"Florida","Jefferson County","NHPI_A",5,3,-2,-50,"undercount"
"1412",12065,"Florida","Jefferson County","NHPI_AIC",19,23,4,19.05,"overcount"
"1413",12067,"Florida","Lafayette County","A_A",27,10,-17,-91.89,"undercount"
"1414",12067,"Florida","Lafayette County","A_AIC",48,22,-26,-74.29,"undercount"
"1415",12067,"Florida","Lafayette County","NHPI_A",9,1,-8,-160,"undercount"
"1416",12067,"Florida","Lafayette County","NHPI_AIC",15,13,-2,-14.29,"undercount"
"1417",12069,"Florida","Lake County","A_A",8789,9014,225,2.53,"overcount"
"1418",12069,"Florida","Lake County","A_AIC",10954,11451,497,4.44,"overcount"
"1419",12069,"Florida","Lake County","NHPI_A",682,403,-279,-51.43,"undercount"
"1420",12069,"Florida","Lake County","NHPI_AIC",1183,838,-345,-34.14,"undercount"
"1421",12071,"Florida","Lee County","A_A",14080,13062,-1018,-7.5,"undercount"
"1422",12071,"Florida","Lee County","A_AIC",18133,16829,-1304,-7.46,"undercount"
"1423",12071,"Florida","Lee County","NHPI_A",878,251,-627,-111.07,"undercount"
"1424",12071,"Florida","Lee County","NHPI_AIC",1838,719,-1119,-87.52,"undercount"
"1425",12073,"Florida","Leon County","A_A",10695,10549,-146,-1.37,"undercount"
"1426",12073,"Florida","Leon County","A_AIC",13231,13297,66,0.5,"overcount"
"1427",12073,"Florida","Leon County","NHPI_A",216,165,-51,-26.77,"undercount"
"1428",12073,"Florida","Leon County","NHPI_AIC",575,454,-121,-23.52,"undercount"
"1429",12075,"Florida","Levy County","A_A",407,307,-100,-28.01,"undercount"
"1430",12075,"Florida","Levy County","A_AIC",522,461,-61,-12.41,"undercount"
"1431",12075,"Florida","Levy County","NHPI_A",41,11,-30,-115.38,"undercount"
"1432",12075,"Florida","Levy County","NHPI_AIC",80,45,-35,-56,"undercount"
"1433",12077,"Florida","Liberty County","A_A",39,18,-21,-73.68,"undercount"
"1434",12077,"Florida","Liberty County","A_AIC",66,43,-23,-42.2,"undercount"
"1435",12077,"Florida","Liberty County","NHPI_A",4,1,-3,-120,"undercount"
"1436",12077,"Florida","Liberty County","NHPI_AIC",5,16,11,104.76,"overcount"
"1437",12079,"Florida","Madison County","A_A",89,46,-43,-63.7,"undercount"
"1438",12079,"Florida","Madison County","A_AIC",126,97,-29,-26.01,"undercount"
"1439",12079,"Florida","Madison County","NHPI_A",5,0,-5,-200,"undercount"
"1440",12079,"Florida","Madison County","NHPI_AIC",23,21,-2,-9.09,"undercount"
"1441",12081,"Florida","Manatee County","A_A",9692,8501,-1191,-13.09,"undercount"
"1442",12081,"Florida","Manatee County","A_AIC",11752,10789,-963,-8.54,"undercount"
"1443",12081,"Florida","Manatee County","NHPI_A",403,255,-148,-44.98,"undercount"
"1444",12081,"Florida","Manatee County","NHPI_AIC",833,561,-272,-39.02,"undercount"
"1445",12083,"Florida","Marion County","A_A",6731,6175,-556,-8.62,"undercount"
"1446",12083,"Florida","Marion County","A_AIC",8460,8020,-440,-5.34,"undercount"
"1447",12083,"Florida","Marion County","NHPI_A",336,213,-123,-44.81,"undercount"
"1448",12083,"Florida","Marion County","NHPI_AIC",800,581,-219,-31.72,"undercount"
"1449",12085,"Florida","Martin County","A_A",2545,2296,-249,-10.29,"undercount"
"1450",12085,"Florida","Martin County","A_AIC",3289,3120,-169,-5.27,"undercount"
"1451",12085,"Florida","Martin County","NHPI_A",300,55,-245,-138.03,"undercount"
"1452",12085,"Florida","Martin County","NHPI_AIC",466,171,-295,-92.62,"undercount"
"1453",12086,"Florida","Miami-Dade County","A_A",44548,43394,-1154,-2.62,"undercount"
"1454",12086,"Florida","Miami-Dade County","A_AIC",56659,51937,-4722,-8.7,"undercount"
"1455",12086,"Florida","Miami-Dade County","NHPI_A",1408,527,-881,-91.06,"undercount"
"1456",12086,"Florida","Miami-Dade County","NHPI_AIC",5170,1537,-3633,-108.33,"undercount"
"1457",12087,"Florida","Monroe County","A_A",1101,1142,41,3.66,"overcount"
"1458",12087,"Florida","Monroe County","A_AIC",1465,1632,167,10.78,"overcount"
"1459",12087,"Florida","Monroe County","NHPI_A",129,63,-66,-68.75,"undercount"
"1460",12087,"Florida","Monroe County","NHPI_AIC",216,158,-58,-31.02,"undercount"
"1461",12089,"Florida","Nassau County","A_A",991,887,-104,-11.08,"undercount"
"1462",12089,"Florida","Nassau County","A_AIC",1529,1544,15,0.98,"overcount"
"1463",12089,"Florida","Nassau County","NHPI_A",78,52,-26,-40,"undercount"
"1464",12089,"Florida","Nassau County","NHPI_AIC",166,173,7,4.13,"overcount"
"1465",12091,"Florida","Okaloosa County","A_A",6931,6704,-227,-3.33,"undercount"
"1466",12091,"Florida","Okaloosa County","A_AIC",11611,11287,-324,-2.83,"undercount"
"1467",12091,"Florida","Okaloosa County","NHPI_A",473,453,-20,-4.32,"undercount"
"1468",12091,"Florida","Okaloosa County","NHPI_AIC",1031,1071,40,3.81,"overcount"
"1469",12093,"Florida","Okeechobee County","A_A",398,332,-66,-18.08,"undercount"
"1470",12093,"Florida","Okeechobee County","A_AIC",516,418,-98,-20.99,"undercount"
"1471",12093,"Florida","Okeechobee County","NHPI_A",61,14,-47,-125.33,"undercount"
"1472",12093,"Florida","Okeechobee County","NHPI_AIC",99,55,-44,-57.14,"undercount"
"1473",12095,"Florida","Orange County","A_A",81076,79751,-1325,-1.65,"undercount"
"1474",12095,"Florida","Orange County","A_AIC",95146,94340,-806,-0.85,"undercount"
"1475",12095,"Florida","Orange County","NHPI_A",2855,1444,-1411,-65.64,"undercount"
"1476",12095,"Florida","Orange County","NHPI_AIC",5864,3351,-2513,-54.54,"undercount"
"1477",12097,"Florida","Osceola County","A_A",11564,11989,425,3.61,"overcount"
"1478",12097,"Florida","Osceola County","A_AIC",14337,14692,355,2.45,"overcount"
"1479",12097,"Florida","Osceola County","NHPI_A",975,354,-621,-93.45,"undercount"
"1480",12097,"Florida","Osceola County","NHPI_AIC",1642,743,-899,-75.39,"undercount"
"1481",12099,"Florida","Palm Beach County","A_A",45271,44327,-944,-2.11,"undercount"
"1482",12099,"Florida","Palm Beach County","A_AIC",55343,54259,-1084,-1.98,"undercount"
"1483",12099,"Florida","Palm Beach County","NHPI_A",1792,593,-1199,-100.55,"undercount"
"1484",12099,"Florida","Palm Beach County","NHPI_AIC",4508,1928,-2580,-80.17,"undercount"
"1485",12101,"Florida","Pasco County","A_A",17052,16760,-292,-1.73,"undercount"
"1486",12101,"Florida","Pasco County","A_AIC",21871,21373,-498,-2.3,"undercount"
"1487",12101,"Florida","Pasco County","NHPI_A",597,330,-267,-57.61,"undercount"
"1488",12101,"Florida","Pasco County","NHPI_AIC",1209,877,-332,-31.83,"undercount"
"1489",12103,"Florida","Pinellas County","A_A",35489,34223,-1266,-3.63,"undercount"
"1490",12103,"Florida","Pinellas County","A_AIC",43526,42728,-798,-1.85,"undercount"
"1491",12103,"Florida","Pinellas County","NHPI_A",1196,855,-341,-33.25,"undercount"
"1492",12103,"Florida","Pinellas County","NHPI_AIC",2290,1799,-491,-24.02,"undercount"
"1493",12105,"Florida","Polk County","A_A",14305,13625,-680,-4.87,"undercount"
"1494",12105,"Florida","Polk County","A_AIC",18284,17111,-1173,-6.63,"undercount"
"1495",12105,"Florida","Polk County","NHPI_A",934,375,-559,-85.41,"undercount"
"1496",12105,"Florida","Polk County","NHPI_AIC",1939,988,-951,-64.98,"undercount"
"1497",12107,"Florida","Putnam County","A_A",518,471,-47,-9.5,"undercount"
"1498",12107,"Florida","Putnam County","A_AIC",713,706,-7,-0.99,"undercount"
"1499",12107,"Florida","Putnam County","NHPI_A",106,39,-67,-92.41,"undercount"
"1500",12107,"Florida","Putnam County","NHPI_AIC",166,122,-44,-30.56,"undercount"
"1501",12109,"Florida","St. Johns County","A_A",9691,9910,219,2.23,"overcount"
"1502",12109,"Florida","St. Johns County","A_AIC",12388,13219,831,6.49,"overcount"
"1503",12109,"Florida","St. Johns County","NHPI_A",255,156,-99,-48.18,"undercount"
"1504",12109,"Florida","St. Johns County","NHPI_AIC",571,493,-78,-14.66,"undercount"
"1505",12111,"Florida","St. Lucie County","A_A",6762,5885,-877,-13.87,"undercount"
"1506",12111,"Florida","St. Lucie County","A_AIC",8959,7871,-1088,-12.93,"undercount"
"1507",12111,"Florida","St. Lucie County","NHPI_A",385,172,-213,-76.48,"undercount"
"1508",12111,"Florida","St. Lucie County","NHPI_AIC",1009,546,-463,-59.55,"undercount"
"1509",12113,"Florida","Santa Rosa County","A_A",4192,3869,-323,-8.01,"undercount"
"1510",12113,"Florida","Santa Rosa County","A_AIC",7126,6887,-239,-3.41,"undercount"
"1511",12113,"Florida","Santa Rosa County","NHPI_A",343,362,19,5.39,"overcount"
"1512",12113,"Florida","Santa Rosa County","NHPI_AIC",721,809,88,11.5,"overcount"
"1513",12115,"Florida","Sarasota County","A_A",8457,8521,64,0.75,"overcount"
"1514",12115,"Florida","Sarasota County","A_AIC",10732,10954,222,2.05,"overcount"
"1515",12115,"Florida","Sarasota County","NHPI_A",294,175,-119,-50.75,"undercount"
"1516",12115,"Florida","Sarasota County","NHPI_AIC",655,481,-174,-30.63,"undercount"
"1517",12117,"Florida","Seminole County","A_A",24274,25557,1283,5.15,"overcount"
"1518",12117,"Florida","Seminole County","A_AIC",29452,31006,1554,5.14,"overcount"
"1519",12117,"Florida","Seminole County","NHPI_A",593,275,-318,-73.27,"undercount"
"1520",12117,"Florida","Seminole County","NHPI_AIC",1284,856,-428,-40,"undercount"
"1521",12119,"Florida","Sumter County","A_A",1414,1263,-151,-11.28,"undercount"
"1522",12119,"Florida","Sumter County","A_AIC",1714,1563,-151,-9.22,"undercount"
"1523",12119,"Florida","Sumter County","NHPI_A",123,34,-89,-113.38,"undercount"
"1524",12119,"Florida","Sumter County","NHPI_AIC",231,110,-121,-70.97,"undercount"
"1525",12121,"Florida","Suwannee County","A_A",291,275,-16,-5.65,"undercount"
"1526",12121,"Florida","Suwannee County","A_AIC",413,401,-12,-2.95,"undercount"
"1527",12121,"Florida","Suwannee County","NHPI_A",42,16,-26,-89.66,"undercount"
"1528",12121,"Florida","Suwannee County","NHPI_AIC",75,58,-17,-25.56,"undercount"
"1529",12123,"Florida","Taylor County","A_A",195,228,33,15.6,"overcount"
"1530",12123,"Florida","Taylor County","A_AIC",260,286,26,9.52,"overcount"
"1531",12123,"Florida","Taylor County","NHPI_A",11,0,-11,-200,"undercount"
"1532",12123,"Florida","Taylor County","NHPI_AIC",29,19,-10,-41.67,"undercount"
"1533",12125,"Florida","Union County","A_A",97,36,-61,-91.73,"undercount"
"1534",12125,"Florida","Union County","A_AIC",134,75,-59,-56.46,"undercount"
"1535",12125,"Florida","Union County","NHPI_A",6,0,-6,-200,"undercount"
"1536",12125,"Florida","Union County","NHPI_AIC",17,15,-2,-12.5,"undercount"
"1537",12127,"Florida","Volusia County","A_A",11000,10729,-271,-2.49,"undercount"
"1538",12127,"Florida","Volusia County","A_AIC",14465,13978,-487,-3.42,"undercount"
"1539",12127,"Florida","Volusia County","NHPI_A",483,287,-196,-50.91,"undercount"
"1540",12127,"Florida","Volusia County","NHPI_AIC",1060,777,-283,-30.81,"undercount"
"1541",12129,"Florida","Wakulla County","A_A",242,211,-31,-13.69,"undercount"
"1542",12129,"Florida","Wakulla County","A_AIC",377,368,-9,-2.42,"undercount"
"1543",12129,"Florida","Wakulla County","NHPI_A",33,21,-12,-44.44,"undercount"
"1544",12129,"Florida","Wakulla County","NHPI_AIC",72,53,-19,-30.4,"undercount"
"1545",12131,"Florida","Walton County","A_A",1011,912,-99,-10.3,"undercount"
"1546",12131,"Florida","Walton County","A_AIC",1555,1547,-8,-0.52,"undercount"
"1547",12131,"Florida","Walton County","NHPI_A",150,49,-101,-101.51,"undercount"
"1548",12131,"Florida","Walton County","NHPI_AIC",222,161,-61,-31.85,"undercount"
"1549",12133,"Florida","Washington County","A_A",186,138,-48,-29.63,"undercount"
"1550",12133,"Florida","Washington County","A_AIC",289,273,-16,-5.69,"undercount"
"1551",12133,"Florida","Washington County","NHPI_A",99,28,-71,-111.81,"undercount"
"1552",12133,"Florida","Washington County","NHPI_AIC",138,71,-67,-64.11,"undercount"
"1553",13001,"Georgia","Appling County","A_A",162,123,-39,-27.37,"undercount"
"1554",13001,"Georgia","Appling County","A_AIC",186,159,-27,-15.65,"undercount"
"1555",13001,"Georgia","Appling County","NHPI_A",42,1,-41,-190.7,"undercount"
"1556",13001,"Georgia","Appling County","NHPI_AIC",47,10,-37,-129.82,"undercount"
"1557",13003,"Georgia","Atkinson County","A_A",85,12,-73,-150.52,"undercount"
"1558",13003,"Georgia","Atkinson County","A_AIC",101,40,-61,-86.52,"undercount"
"1559",13003,"Georgia","Atkinson County","NHPI_A",95,4,-91,-183.84,"undercount"
"1560",13003,"Georgia","Atkinson County","NHPI_AIC",99,17,-82,-141.38,"undercount"
"1561",13005,"Georgia","Bacon County","A_A",89,40,-49,-75.97,"undercount"
"1562",13005,"Georgia","Bacon County","A_AIC",105,58,-47,-57.67,"undercount"
"1563",13005,"Georgia","Bacon County","NHPI_A",17,4,-13,-123.81,"undercount"
"1564",13005,"Georgia","Bacon County","NHPI_AIC",21,9,-12,-80,"undercount"
"1565",13007,"Georgia","Baker County","A_A",41,18,-23,-77.97,"undercount"
"1566",13007,"Georgia","Baker County","A_AIC",46,42,-4,-9.09,"undercount"
"1567",13007,"Georgia","Baker County","NHPI_A",2,0,-2,-200,"undercount"
"1568",13007,"Georgia","Baker County","NHPI_AIC",2,5,3,85.71,"overcount"
"1569",13009,"Georgia","Baldwin County","A_A",748,606,-142,-20.97,"undercount"
"1570",13009,"Georgia","Baldwin County","A_AIC",886,726,-160,-19.85,"undercount"
"1571",13009,"Georgia","Baldwin County","NHPI_A",36,27,-9,-28.57,"undercount"
"1572",13009,"Georgia","Baldwin County","NHPI_AIC",67,56,-11,-17.89,"undercount"
"1573",13011,"Georgia","Banks County","A_A",204,195,-9,-4.51,"undercount"
"1574",13011,"Georgia","Banks County","A_AIC",262,242,-20,-7.94,"undercount"
"1575",13011,"Georgia","Banks County","NHPI_A",22,8,-14,-93.33,"undercount"
"1576",13011,"Georgia","Banks County","NHPI_AIC",37,16,-21,-79.25,"undercount"
"1577",13013,"Georgia","Barrow County","A_A",3473,3276,-197,-5.84,"undercount"
"1578",13013,"Georgia","Barrow County","A_AIC",3910,3776,-134,-3.49,"undercount"
"1579",13013,"Georgia","Barrow County","NHPI_A",102,21,-81,-131.71,"undercount"
"1580",13013,"Georgia","Barrow County","NHPI_AIC",189,119,-70,-45.45,"undercount"
"1581",13015,"Georgia","Bartow County","A_A",1197,1193,-4,-0.33,"undercount"
"1582",13015,"Georgia","Bartow County","A_AIC",1627,1635,8,0.49,"overcount"
"1583",13015,"Georgia","Bartow County","NHPI_A",145,40,-105,-113.51,"undercount"
"1584",13015,"Georgia","Bartow County","NHPI_AIC",229,120,-109,-62.46,"undercount"
"1585",13017,"Georgia","Ben Hill County","A_A",143,116,-27,-20.85,"undercount"
"1586",13017,"Georgia","Ben Hill County","A_AIC",185,149,-36,-21.56,"undercount"
"1587",13017,"Georgia","Ben Hill County","NHPI_A",7,2,-5,-111.11,"undercount"
"1588",13017,"Georgia","Ben Hill County","NHPI_AIC",10,6,-4,-50,"undercount"
"1589",13019,"Georgia","Berrien County","A_A",202,82,-120,-84.51,"undercount"
"1590",13019,"Georgia","Berrien County","A_AIC",269,140,-129,-63.08,"undercount"
"1591",13019,"Georgia","Berrien County","NHPI_A",13,10,-3,-26.09,"undercount"
"1592",13019,"Georgia","Berrien County","NHPI_AIC",25,28,3,11.32,"overcount"
"1593",13021,"Georgia","Bibb County","A_A",3383,3283,-100,-3,"undercount"
"1594",13021,"Georgia","Bibb County","A_AIC",4040,3971,-69,-1.72,"undercount"
"1595",13021,"Georgia","Bibb County","NHPI_A",202,48,-154,-123.2,"undercount"
"1596",13021,"Georgia","Bibb County","NHPI_AIC",371,147,-224,-86.49,"undercount"
"1597",13023,"Georgia","Bleckley County","A_A",144,153,9,6.06,"overcount"
"1598",13023,"Georgia","Bleckley County","A_AIC",174,187,13,7.2,"overcount"
"1599",13023,"Georgia","Bleckley County","NHPI_A",3,9,6,100,"overcount"
"1600",13023,"Georgia","Bleckley County","NHPI_AIC",7,14,7,66.67,"overcount"
"1601",13025,"Georgia","Brantley County","A_A",62,43,-19,-36.19,"undercount"
"1602",13025,"Georgia","Brantley County","A_AIC",101,98,-3,-3.02,"undercount"
"1603",13025,"Georgia","Brantley County","NHPI_A",5,3,-2,-50,"undercount"
"1604",13025,"Georgia","Brantley County","NHPI_AIC",11,26,15,81.08,"overcount"
"1605",13027,"Georgia","Brooks County","A_A",212,67,-145,-103.94,"undercount"
"1606",13027,"Georgia","Brooks County","A_AIC",266,112,-154,-81.48,"undercount"
"1607",13027,"Georgia","Brooks County","NHPI_A",35,6,-29,-141.46,"undercount"
"1608",13027,"Georgia","Brooks County","NHPI_AIC",47,17,-30,-93.75,"undercount"
"1609",13029,"Georgia","Bryan County","A_A",970,1043,73,7.25,"overcount"
"1610",13029,"Georgia","Bryan County","A_AIC",1386,1657,271,17.81,"overcount"
"1611",13029,"Georgia","Bryan County","NHPI_A",64,53,-11,-18.8,"undercount"
"1612",13029,"Georgia","Bryan County","NHPI_AIC",145,172,27,17.03,"overcount"
"1613",13031,"Georgia","Bulloch County","A_A",1072,1337,265,22,"overcount"
"1614",13031,"Georgia","Bulloch County","A_AIC",1466,1737,271,16.92,"overcount"
"1615",13031,"Georgia","Bulloch County","NHPI_A",101,64,-37,-44.85,"undercount"
"1616",13031,"Georgia","Bulloch County","NHPI_AIC",185,151,-34,-20.24,"undercount"
"1617",13033,"Georgia","Burke County","A_A",139,100,-39,-32.64,"undercount"
"1618",13033,"Georgia","Burke County","A_AIC",195,169,-26,-14.29,"undercount"
"1619",13033,"Georgia","Burke County","NHPI_A",29,12,-17,-82.93,"undercount"
"1620",13033,"Georgia","Burke County","NHPI_AIC",43,29,-14,-38.89,"undercount"
"1621",13035,"Georgia","Butts County","A_A",187,103,-84,-57.93,"undercount"
"1622",13035,"Georgia","Butts County","A_AIC",265,190,-75,-32.97,"undercount"
"1623",13035,"Georgia","Butts County","NHPI_A",11,9,-2,-20,"undercount"
"1624",13035,"Georgia","Butts County","NHPI_AIC",20,22,2,9.52,"overcount"
"1625",13037,"Georgia","Calhoun County","A_A",58,19,-39,-101.3,"undercount"
"1626",13037,"Georgia","Calhoun County","A_AIC",73,30,-43,-83.5,"undercount"
"1627",13037,"Georgia","Calhoun County","NHPI_A",20,0,-20,-200,"undercount"
"1628",13037,"Georgia","Calhoun County","NHPI_AIC",22,2,-20,-166.67,"undercount"
"1629",13039,"Georgia","Camden County","A_A",919,864,-55,-6.17,"undercount"
"1630",13039,"Georgia","Camden County","A_AIC",1500,1448,-52,-3.53,"undercount"
"1631",13039,"Georgia","Camden County","NHPI_A",117,67,-50,-54.35,"undercount"
"1632",13039,"Georgia","Camden County","NHPI_AIC",219,185,-34,-16.83,"undercount"
"1633",13043,"Georgia","Candler County","A_A",122,65,-57,-60.96,"undercount"
"1634",13043,"Georgia","Candler County","A_AIC",144,77,-67,-60.63,"undercount"
"1635",13043,"Georgia","Candler County","NHPI_A",16,3,-13,-136.84,"undercount"
"1636",13043,"Georgia","Candler County","NHPI_AIC",21,10,-11,-70.97,"undercount"
"1637",13045,"Georgia","Carroll County","A_A",1313,1119,-194,-15.95,"undercount"
"1638",13045,"Georgia","Carroll County","A_AIC",1753,1629,-124,-7.33,"undercount"
"1639",13045,"Georgia","Carroll County","NHPI_A",117,22,-95,-136.69,"undercount"
"1640",13045,"Georgia","Carroll County","NHPI_AIC",218,99,-119,-75.08,"undercount"
"1641",13047,"Georgia","Catoosa County","A_A",1036,1025,-11,-1.07,"undercount"
"1642",13047,"Georgia","Catoosa County","A_AIC",1296,1282,-14,-1.09,"undercount"
"1643",13047,"Georgia","Catoosa County","NHPI_A",114,84,-30,-30.3,"undercount"
"1644",13047,"Georgia","Catoosa County","NHPI_AIC",149,160,11,7.12,"overcount"
"1645",13049,"Georgia","Charlton County","A_A",95,109,14,13.73,"overcount"
"1646",13049,"Georgia","Charlton County","A_AIC",139,154,15,10.24,"overcount"
"1647",13049,"Georgia","Charlton County","NHPI_A",13,2,-11,-146.67,"undercount"
"1648",13049,"Georgia","Charlton County","NHPI_AIC",19,18,-1,-5.41,"undercount"
"1649",13051,"Georgia","Chatham County","A_A",8866,10682,1816,18.58,"overcount"
"1650",13051,"Georgia","Chatham County","A_AIC",11122,13129,2007,16.55,"overcount"
"1651",13051,"Georgia","Chatham County","NHPI_A",461,418,-43,-9.78,"undercount"
"1652",13051,"Georgia","Chatham County","NHPI_AIC",821,776,-45,-5.64,"undercount"
"1653",13053,"Georgia","Chattahoochee County","A_A",328,305,-23,-7.27,"undercount"
"1654",13053,"Georgia","Chattahoochee County","A_AIC",511,500,-11,-2.18,"undercount"
"1655",13053,"Georgia","Chattahoochee County","NHPI_A",113,106,-7,-6.39,"undercount"
"1656",13053,"Georgia","Chattahoochee County","NHPI_AIC",155,168,13,8.05,"overcount"
"1657",13055,"Georgia","Chattooga County","A_A",146,102,-44,-35.48,"undercount"
"1658",13055,"Georgia","Chattooga County","A_AIC",205,132,-73,-43.32,"undercount"
"1659",13055,"Georgia","Chattooga County","NHPI_A",92,0,-92,-200,"undercount"
"1660",13055,"Georgia","Chattooga County","NHPI_AIC",99,14,-85,-150.44,"undercount"
"1661",13057,"Georgia","Cherokee County","A_A",5918,5525,-393,-6.87,"undercount"
"1662",13057,"Georgia","Cherokee County","A_AIC",7912,7932,20,0.25,"overcount"
"1663",13057,"Georgia","Cherokee County","NHPI_A",297,107,-190,-94.06,"undercount"
"1664",13057,"Georgia","Cherokee County","NHPI_AIC",570,320,-250,-56.18,"undercount"
"1665",13059,"Georgia","Clarke County","A_A",5153,5035,-118,-2.32,"undercount"
"1666",13059,"Georgia","Clarke County","A_AIC",6326,6216,-110,-1.75,"undercount"
"1667",13059,"Georgia","Clarke County","NHPI_A",173,74,-99,-80.16,"undercount"
"1668",13059,"Georgia","Clarke County","NHPI_AIC",320,185,-135,-53.47,"undercount"
"1669",13061,"Georgia","Clay County","A_A",35,6,-29,-141.46,"undercount"
"1670",13061,"Georgia","Clay County","A_AIC",41,19,-22,-73.33,"undercount"
"1671",13061,"Georgia","Clay County","NHPI_A",2,1,-1,-66.67,"undercount"
"1672",13061,"Georgia","Clay County","NHPI_AIC",2,6,4,100,"overcount"
"1673",13063,"Georgia","Clayton County","A_A",14848,13594,-1254,-8.82,"undercount"
"1674",13063,"Georgia","Clayton County","A_AIC",16225,14716,-1509,-9.75,"undercount"
"1675",13063,"Georgia","Clayton County","NHPI_A",451,129,-322,-111.03,"undercount"
"1676",13063,"Georgia","Clayton County","NHPI_AIC",885,331,-554,-91.12,"undercount"
"1677",13065,"Georgia","Clinch County","A_A",25,22,-3,-12.77,"undercount"
"1678",13065,"Georgia","Clinch County","A_AIC",36,29,-7,-21.54,"undercount"
"1679",13065,"Georgia","Clinch County","NHPI_A",8,7,-1,-13.33,"undercount"
"1680",13065,"Georgia","Clinch County","NHPI_AIC",9,13,4,36.36,"overcount"
"1681",13067,"Georgia","Cobb County","A_A",43675,43211,-464,-1.07,"undercount"
"1682",13067,"Georgia","Cobb County","A_AIC",50498,50909,411,0.81,"overcount"
"1683",13067,"Georgia","Cobb County","NHPI_A",624,320,-304,-64.41,"undercount"
"1684",13067,"Georgia","Cobb County","NHPI_AIC",1348,981,-367,-31.52,"undercount"
"1685",13069,"Georgia","Coffee County","A_A",375,307,-68,-19.94,"undercount"
"1686",13069,"Georgia","Coffee County","A_AIC",462,404,-58,-13.39,"undercount"
"1687",13069,"Georgia","Coffee County","NHPI_A",44,17,-27,-88.52,"undercount"
"1688",13069,"Georgia","Coffee County","NHPI_AIC",66,54,-12,-20,"undercount"
"1689",13071,"Georgia","Colquitt County","A_A",450,389,-61,-14.54,"undercount"
"1690",13071,"Georgia","Colquitt County","A_AIC",538,486,-52,-10.16,"undercount"
"1691",13071,"Georgia","Colquitt County","NHPI_A",79,15,-64,-136.17,"undercount"
"1692",13071,"Georgia","Colquitt County","NHPI_AIC",106,32,-74,-107.25,"undercount"
"1693",13073,"Georgia","Columbia County","A_A",7153,7205,52,0.72,"overcount"
"1694",13073,"Georgia","Columbia County","A_AIC",9460,9991,531,5.46,"overcount"
"1695",13073,"Georgia","Columbia County","NHPI_A",318,284,-34,-11.3,"undercount"
"1696",13073,"Georgia","Columbia County","NHPI_AIC",570,613,43,7.27,"overcount"
"1697",13075,"Georgia","Cook County","A_A",126,100,-26,-23.01,"undercount"
"1698",13075,"Georgia","Cook County","A_AIC",172,171,-1,-0.58,"undercount"
"1699",13075,"Georgia","Cook County","NHPI_A",11,4,-7,-93.33,"undercount"
"1700",13075,"Georgia","Cook County","NHPI_AIC",20,17,-3,-16.22,"undercount"
"1701",13077,"Georgia","Coweta County","A_A",3478,3399,-79,-2.3,"undercount"
"1702",13077,"Georgia","Coweta County","A_AIC",4418,4514,96,2.15,"overcount"
"1703",13077,"Georgia","Coweta County","NHPI_A",183,69,-114,-90.48,"undercount"
"1704",13077,"Georgia","Coweta County","NHPI_AIC",318,165,-153,-63.35,"undercount"
"1705",13079,"Georgia","Crawford County","A_A",106,31,-75,-109.49,"undercount"
"1706",13079,"Georgia","Crawford County","A_AIC",127,94,-33,-29.86,"undercount"
"1707",13079,"Georgia","Crawford County","NHPI_A",6,3,-3,-66.67,"undercount"
"1708",13079,"Georgia","Crawford County","NHPI_AIC",10,21,11,70.97,"overcount"
"1709",13081,"Georgia","Crisp County","A_A",226,180,-46,-22.66,"undercount"
"1710",13081,"Georgia","Crisp County","A_AIC",266,244,-22,-8.63,"undercount"
"1711",13081,"Georgia","Crisp County","NHPI_A",21,4,-17,-136,"undercount"
"1712",13081,"Georgia","Crisp County","NHPI_AIC",30,12,-18,-85.71,"undercount"
"1713",13083,"Georgia","Dade County","A_A",162,140,-22,-14.57,"undercount"
"1714",13083,"Georgia","Dade County","A_AIC",214,193,-21,-10.32,"undercount"
"1715",13083,"Georgia","Dade County","NHPI_A",12,5,-7,-82.35,"undercount"
"1716",13083,"Georgia","Dade County","NHPI_AIC",18,12,-6,-40,"undercount"
"1717",13085,"Georgia","Dawson County","A_A",287,239,-48,-18.25,"undercount"
"1718",13085,"Georgia","Dawson County","A_AIC",360,381,21,5.67,"overcount"
"1719",13085,"Georgia","Dawson County","NHPI_A",19,14,-5,-30.3,"undercount"
"1720",13085,"Georgia","Dawson County","NHPI_AIC",29,37,8,24.24,"overcount"
"1721",13087,"Georgia","Decatur County","A_A",185,194,9,4.75,"overcount"
"1722",13087,"Georgia","Decatur County","A_AIC",239,263,24,9.56,"overcount"
"1723",13087,"Georgia","Decatur County","NHPI_A",41,16,-25,-87.72,"undercount"
"1724",13087,"Georgia","Decatur County","NHPI_AIC",55,31,-24,-55.81,"undercount"
"1725",13089,"Georgia","DeKalb County","A_A",50310,50872,562,1.11,"overcount"
"1726",13089,"Georgia","DeKalb County","A_AIC",56180,58001,1821,3.19,"overcount"
"1727",13089,"Georgia","DeKalb County","NHPI_A",953,238,-715,-120.07,"undercount"
"1728",13089,"Georgia","DeKalb County","NHPI_AIC",1764,843,-921,-70.66,"undercount"
"1729",13091,"Georgia","Dodge County","A_A",115,95,-20,-19.05,"undercount"
"1730",13091,"Georgia","Dodge County","A_AIC",153,133,-20,-13.99,"undercount"
"1731",13091,"Georgia","Dodge County","NHPI_A",43,8,-35,-137.25,"undercount"
"1732",13091,"Georgia","Dodge County","NHPI_AIC",48,13,-35,-114.75,"undercount"
"1733",13093,"Georgia","Dooly County","A_A",98,51,-47,-63.09,"undercount"
"1734",13093,"Georgia","Dooly County","A_AIC",124,78,-46,-45.54,"undercount"
"1735",13093,"Georgia","Dooly County","NHPI_A",10,2,-8,-133.33,"undercount"
"1736",13093,"Georgia","Dooly County","NHPI_AIC",15,7,-8,-72.73,"undercount"
"1737",13095,"Georgia","Dougherty County","A_A",779,654,-125,-17.45,"undercount"
"1738",13095,"Georgia","Dougherty County","A_AIC",1039,925,-114,-11.61,"undercount"
"1739",13095,"Georgia","Dougherty County","NHPI_A",186,20,-166,-161.17,"undercount"
"1740",13095,"Georgia","Dougherty County","NHPI_AIC",255,86,-169,-99.12,"undercount"
"1741",13097,"Georgia","Douglas County","A_A",2517,2339,-178,-7.33,"undercount"
"1742",13097,"Georgia","Douglas County","A_AIC",3332,3056,-276,-8.64,"undercount"
"1743",13097,"Georgia","Douglas County","NHPI_A",253,111,-142,-78.02,"undercount"
"1744",13097,"Georgia","Douglas County","NHPI_AIC",441,230,-211,-62.89,"undercount"
"1745",13099,"Georgia","Early County","A_A",80,47,-33,-51.97,"undercount"
"1746",13099,"Georgia","Early County","A_AIC",103,70,-33,-38.15,"undercount"
"1747",13099,"Georgia","Early County","NHPI_A",7,0,-7,-200,"undercount"
"1748",13099,"Georgia","Early County","NHPI_AIC",11,8,-3,-31.58,"undercount"
"1749",13101,"Georgia","Echols County","A_A",32,8,-24,-120,"undercount"
"1750",13101,"Georgia","Echols County","A_AIC",51,23,-28,-75.68,"undercount"
"1751",13101,"Georgia","Echols County","NHPI_A",10,2,-8,-133.33,"undercount"
"1752",13101,"Georgia","Echols County","NHPI_AIC",12,14,2,15.38,"overcount"
"1753",13103,"Georgia","Effingham County","A_A",760,678,-82,-11.4,"undercount"
"1754",13103,"Georgia","Effingham County","A_AIC",1100,1208,108,9.36,"overcount"
"1755",13103,"Georgia","Effingham County","NHPI_A",80,28,-52,-96.3,"undercount"
"1756",13103,"Georgia","Effingham County","NHPI_AIC",158,82,-76,-63.33,"undercount"
"1757",13105,"Georgia","Elbert County","A_A",213,182,-31,-15.7,"undercount"
"1758",13105,"Georgia","Elbert County","A_AIC",261,233,-28,-11.34,"undercount"
"1759",13105,"Georgia","Elbert County","NHPI_A",11,3,-8,-114.29,"undercount"
"1760",13105,"Georgia","Elbert County","NHPI_AIC",21,20,-1,-4.88,"undercount"
"1761",13107,"Georgia","Emanuel County","A_A",184,141,-43,-26.46,"undercount"
"1762",13107,"Georgia","Emanuel County","A_AIC",220,155,-65,-34.67,"undercount"
"1763",13107,"Georgia","Emanuel County","NHPI_A",17,2,-15,-157.89,"undercount"
"1764",13107,"Georgia","Emanuel County","NHPI_AIC",30,9,-21,-107.69,"undercount"
"1765",13109,"Georgia","Evans County","A_A",129,79,-50,-48.08,"undercount"
"1766",13109,"Georgia","Evans County","A_AIC",162,92,-70,-55.12,"undercount"
"1767",13109,"Georgia","Evans County","NHPI_A",46,11,-35,-122.81,"undercount"
"1768",13109,"Georgia","Evans County","NHPI_AIC",52,16,-36,-105.88,"undercount"
"1769",13111,"Georgia","Fannin County","A_A",174,113,-61,-42.51,"undercount"
"1770",13111,"Georgia","Fannin County","A_AIC",233,170,-63,-31.27,"undercount"
"1771",13111,"Georgia","Fannin County","NHPI_A",14,3,-11,-129.41,"undercount"
"1772",13111,"Georgia","Fannin County","NHPI_AIC",29,7,-22,-122.22,"undercount"
"1773",13113,"Georgia","Fayette County","A_A",5925,6468,543,8.76,"overcount"
"1774",13113,"Georgia","Fayette County","A_AIC",6990,7683,693,9.45,"overcount"
"1775",13113,"Georgia","Fayette County","NHPI_A",163,44,-119,-114.98,"undercount"
"1776",13113,"Georgia","Fayette County","NHPI_AIC",318,162,-156,-65,"undercount"
"1777",13115,"Georgia","Floyd County","A_A",1541,1310,-231,-16.2,"undercount"
"1778",13115,"Georgia","Floyd County","A_AIC",1926,1698,-228,-12.58,"undercount"
"1779",13115,"Georgia","Floyd County","NHPI_A",298,24,-274,-170.19,"undercount"
"1780",13115,"Georgia","Floyd County","NHPI_AIC",372,79,-293,-129.93,"undercount"
"1781",13117,"Georgia","Forsyth County","A_A",42329,45357,3028,6.91,"overcount"
"1782",13117,"Georgia","Forsyth County","A_AIC",44652,48065,3413,7.36,"overcount"
"1783",13117,"Georgia","Forsyth County","NHPI_A",180,89,-91,-67.66,"undercount"
"1784",13117,"Georgia","Forsyth County","NHPI_AIC",430,280,-150,-42.25,"undercount"
"1785",13119,"Georgia","Franklin County","A_A",360,302,-58,-17.52,"undercount"
"1786",13119,"Georgia","Franklin County","A_AIC",420,352,-68,-17.62,"undercount"
"1787",13119,"Georgia","Franklin County","NHPI_A",13,3,-10,-125,"undercount"
"1788",13119,"Georgia","Franklin County","NHPI_AIC",26,21,-5,-21.28,"undercount"
"1789",13121,"Georgia","Fulton County","A_A",84277,81449,-2828,-3.41,"undercount"
"1790",13121,"Georgia","Fulton County","A_AIC",93739,91953,-1786,-1.92,"undercount"
"1791",13121,"Georgia","Fulton County","NHPI_A",455,425,-30,-6.82,"undercount"
"1792",13121,"Georgia","Fulton County","NHPI_AIC",1479,1322,-157,-11.21,"undercount"
"1793",13123,"Georgia","Gilmer County","A_A",212,141,-71,-40.23,"undercount"
"1794",13123,"Georgia","Gilmer County","A_AIC",272,213,-59,-24.33,"undercount"
"1795",13123,"Georgia","Gilmer County","NHPI_A",169,0,-169,-200,"undercount"
"1796",13123,"Georgia","Gilmer County","NHPI_AIC",181,4,-177,-191.35,"undercount"
"1797",13125,"Georgia","Glascock County","A_A",5,7,2,33.33,"overcount"
"1798",13125,"Georgia","Glascock County","A_AIC",9,18,9,66.67,"overcount"
"1799",13125,"Georgia","Glascock County","NHPI_A",2,2,0,0,"equal"
"1800",13125,"Georgia","Glascock County","NHPI_AIC",4,8,4,66.67,"overcount"
"1801",13127,"Georgia","Glynn County","A_A",1418,1178,-240,-18.49,"undercount"
"1802",13127,"Georgia","Glynn County","A_AIC",1811,1630,-181,-10.52,"undercount"
"1803",13127,"Georgia","Glynn County","NHPI_A",169,97,-72,-54.14,"undercount"
"1804",13127,"Georgia","Glynn County","NHPI_AIC",242,182,-60,-28.3,"undercount"
"1805",13129,"Georgia","Gordon County","A_A",866,722,-144,-18.14,"undercount"
"1806",13129,"Georgia","Gordon County","A_AIC",1050,910,-140,-14.29,"undercount"
"1807",13129,"Georgia","Gordon County","NHPI_A",257,17,-240,-175.18,"undercount"
"1808",13129,"Georgia","Gordon County","NHPI_AIC",286,60,-226,-130.64,"undercount"
"1809",13131,"Georgia","Grady County","A_A",182,111,-71,-48.46,"undercount"
"1810",13131,"Georgia","Grady County","A_AIC",251,168,-83,-39.62,"undercount"
"1811",13131,"Georgia","Grady County","NHPI_A",73,6,-67,-169.62,"undercount"
"1812",13131,"Georgia","Grady County","NHPI_AIC",93,19,-74,-132.14,"undercount"
"1813",13133,"Georgia","Greene County","A_A",208,174,-34,-17.8,"undercount"
"1814",13133,"Georgia","Greene County","A_AIC",255,230,-25,-10.31,"undercount"
"1815",13133,"Georgia","Greene County","NHPI_A",28,2,-26,-173.33,"undercount"
"1816",13133,"Georgia","Greene County","NHPI_AIC",39,20,-19,-64.41,"undercount"
"1817",13135,"Georgia","Gwinnett County","A_A",122404,127704,5300,4.24,"overcount"
"1818",13135,"Georgia","Gwinnett County","A_AIC",132715,137420,4705,3.48,"overcount"
"1819",13135,"Georgia","Gwinnett County","NHPI_A",1157,489,-668,-81.17,"undercount"
"1820",13135,"Georgia","Gwinnett County","NHPI_AIC",2496,1334,-1162,-60.68,"undercount"
"1821",13137,"Georgia","Habersham County","A_A",1087,1014,-73,-6.95,"undercount"
"1822",13137,"Georgia","Habersham County","A_AIC",1262,1189,-73,-5.96,"undercount"
"1823",13137,"Georgia","Habersham County","NHPI_A",401,40,-361,-163.72,"undercount"
"1824",13137,"Georgia","Habersham County","NHPI_AIC",422,74,-348,-140.32,"undercount"
"1825",13139,"Georgia","Hall County","A_A",4628,4230,-398,-8.99,"undercount"
"1826",13139,"Georgia","Hall County","A_AIC",5454,5152,-302,-5.69,"undercount"
"1827",13139,"Georgia","Hall County","NHPI_A",391,85,-306,-128.57,"undercount"
"1828",13139,"Georgia","Hall County","NHPI_AIC",527,176,-351,-99.86,"undercount"
"1829",13141,"Georgia","Hancock County","A_A",90,38,-52,-81.25,"undercount"
"1830",13141,"Georgia","Hancock County","A_AIC",107,54,-53,-65.84,"undercount"
"1831",13141,"Georgia","Hancock County","NHPI_A",3,1,-2,-100,"undercount"
"1832",13141,"Georgia","Hancock County","NHPI_AIC",5,5,0,0,"equal"
"1833",13143,"Georgia","Haralson County","A_A",242,186,-56,-26.17,"undercount"
"1834",13143,"Georgia","Haralson County","A_AIC",344,263,-81,-26.69,"undercount"
"1835",13143,"Georgia","Haralson County","NHPI_A",15,9,-6,-50,"undercount"
"1836",13143,"Georgia","Haralson County","NHPI_AIC",32,22,-10,-37.04,"undercount"
"1837",13145,"Georgia","Harris County","A_A",485,409,-76,-17,"undercount"
"1838",13145,"Georgia","Harris County","A_AIC",715,708,-7,-0.98,"undercount"
"1839",13145,"Georgia","Harris County","NHPI_A",58,21,-37,-93.67,"undercount"
"1840",13145,"Georgia","Harris County","NHPI_AIC",89,60,-29,-38.93,"undercount"
"1841",13147,"Georgia","Hart County","A_A",335,335,0,0,"equal"
"1842",13147,"Georgia","Hart County","A_AIC",394,424,30,7.33,"overcount"
"1843",13147,"Georgia","Hart County","NHPI_A",10,3,-7,-107.69,"undercount"
"1844",13147,"Georgia","Hart County","NHPI_AIC",19,23,4,19.05,"overcount"
"1845",13149,"Georgia","Heard County","A_A",62,54,-8,-13.79,"undercount"
"1846",13149,"Georgia","Heard County","A_AIC",100,81,-19,-20.99,"undercount"
"1847",13149,"Georgia","Heard County","NHPI_A",2,4,2,66.67,"overcount"
"1848",13149,"Georgia","Heard County","NHPI_AIC",12,10,-2,-18.18,"undercount"
"1849",13151,"Georgia","Henry County","A_A",8124,8084,-40,-0.49,"undercount"
"1850",13151,"Georgia","Henry County","A_AIC",10041,9676,-365,-3.7,"undercount"
"1851",13151,"Georgia","Henry County","NHPI_A",281,129,-152,-74.15,"undercount"
"1852",13151,"Georgia","Henry County","NHPI_AIC",654,360,-294,-57.99,"undercount"
"1853",13153,"Georgia","Houston County","A_A",5034,4977,-57,-1.14,"undercount"
"1854",13153,"Georgia","Houston County","A_AIC",7024,6913,-111,-1.59,"undercount"
"1855",13153,"Georgia","Houston County","NHPI_A",333,124,-209,-91.47,"undercount"
"1856",13153,"Georgia","Houston County","NHPI_AIC",568,342,-226,-49.67,"undercount"
"1857",13155,"Georgia","Irwin County","A_A",77,119,42,42.86,"overcount"
"1858",13155,"Georgia","Irwin County","A_AIC",97,144,47,39,"overcount"
"1859",13155,"Georgia","Irwin County","NHPI_A",2,1,-1,-66.67,"undercount"
"1860",13155,"Georgia","Irwin County","NHPI_AIC",6,14,8,80,"overcount"
"1861",13157,"Georgia","Jackson County","A_A",1688,1764,76,4.4,"overcount"
"1862",13157,"Georgia","Jackson County","A_AIC",2021,2210,189,8.93,"overcount"
"1863",13157,"Georgia","Jackson County","NHPI_A",67,30,-37,-76.29,"undercount"
"1864",13157,"Georgia","Jackson County","NHPI_AIC",131,64,-67,-68.72,"undercount"
"1865",13159,"Georgia","Jasper County","A_A",52,30,-22,-53.66,"undercount"
"1866",13159,"Georgia","Jasper County","A_AIC",96,68,-28,-34.15,"undercount"
"1867",13159,"Georgia","Jasper County","NHPI_A",2,1,-1,-66.67,"undercount"
"1868",13159,"Georgia","Jasper County","NHPI_AIC",18,25,7,32.56,"overcount"
"1869",13161,"Georgia","Jeff Davis County","A_A",111,50,-61,-75.78,"undercount"
"1870",13161,"Georgia","Jeff Davis County","A_AIC",139,70,-69,-66.03,"undercount"
"1871",13161,"Georgia","Jeff Davis County","NHPI_A",8,8,0,0,"equal"
"1872",13161,"Georgia","Jeff Davis County","NHPI_AIC",17,18,1,5.71,"overcount"
"1873",13163,"Georgia","Jefferson County","A_A",111,70,-41,-45.3,"undercount"
"1874",13163,"Georgia","Jefferson County","A_AIC",135,109,-26,-21.31,"undercount"
"1875",13163,"Georgia","Jefferson County","NHPI_A",13,0,-13,-200,"undercount"
"1876",13163,"Georgia","Jefferson County","NHPI_AIC",21,24,3,13.33,"overcount"
"1877",13165,"Georgia","Jenkins County","A_A",105,15,-90,-150,"undercount"
"1878",13165,"Georgia","Jenkins County","A_AIC",116,25,-91,-129.08,"undercount"
"1879",13165,"Georgia","Jenkins County","NHPI_A",20,5,-15,-120,"undercount"
"1880",13165,"Georgia","Jenkins County","NHPI_AIC",24,7,-17,-109.68,"undercount"
"1881",13167,"Georgia","Johnson County","A_A",45,33,-12,-30.77,"undercount"
"1882",13167,"Georgia","Johnson County","A_AIC",68,40,-28,-51.85,"undercount"
"1883",13167,"Georgia","Johnson County","NHPI_A",3,15,12,133.33,"overcount"
"1884",13167,"Georgia","Johnson County","NHPI_AIC",8,17,9,72,"overcount"
"1885",13169,"Georgia","Jones County","A_A",174,138,-36,-23.08,"undercount"
"1886",13169,"Georgia","Jones County","A_AIC",260,208,-52,-22.22,"undercount"
"1887",13169,"Georgia","Jones County","NHPI_A",5,7,2,33.33,"overcount"
"1888",13169,"Georgia","Jones County","NHPI_AIC",32,16,-16,-66.67,"undercount"
"1889",13171,"Georgia","Lamar County","A_A",145,102,-43,-34.82,"undercount"
"1890",13171,"Georgia","Lamar County","A_AIC",199,179,-20,-10.58,"undercount"
"1891",13171,"Georgia","Lamar County","NHPI_A",7,4,-3,-54.55,"undercount"
"1892",13171,"Georgia","Lamar County","NHPI_AIC",28,8,-20,-111.11,"undercount"
"1893",13173,"Georgia","Lanier County","A_A",126,81,-45,-43.48,"undercount"
"1894",13173,"Georgia","Lanier County","A_AIC",208,117,-91,-56,"undercount"
"1895",13173,"Georgia","Lanier County","NHPI_A",7,14,7,66.67,"overcount"
"1896",13173,"Georgia","Lanier County","NHPI_AIC",25,37,12,38.71,"overcount"
"1897",13175,"Georgia","Laurens County","A_A",508,512,4,0.78,"overcount"
"1898",13175,"Georgia","Laurens County","A_AIC",620,621,1,0.16,"overcount"
"1899",13175,"Georgia","Laurens County","NHPI_A",14,15,1,6.9,"overcount"
"1900",13175,"Georgia","Laurens County","NHPI_AIC",48,35,-13,-31.33,"undercount"
"1901",13177,"Georgia","Lee County","A_A",776,864,88,10.73,"overcount"
"1902",13177,"Georgia","Lee County","A_AIC",899,1076,177,17.92,"overcount"
"1903",13177,"Georgia","Lee County","NHPI_A",33,12,-21,-93.33,"undercount"
"1904",13177,"Georgia","Lee County","NHPI_AIC",76,42,-34,-57.63,"undercount"
"1905",13179,"Georgia","Liberty County","A_A",1322,1339,17,1.28,"overcount"
"1906",13179,"Georgia","Liberty County","A_AIC",2187,2105,-82,-3.82,"undercount"
"1907",13179,"Georgia","Liberty County","NHPI_A",376,458,82,19.66,"overcount"
"1908",13179,"Georgia","Liberty County","NHPI_AIC",591,680,89,14,"overcount"
"1909",13181,"Georgia","Lincoln County","A_A",39,20,-19,-64.41,"undercount"
"1910",13181,"Georgia","Lincoln County","A_AIC",68,49,-19,-32.48,"undercount"
"1911",13181,"Georgia","Lincoln County","NHPI_A",6,9,3,40,"overcount"
"1912",13181,"Georgia","Lincoln County","NHPI_AIC",15,32,17,72.34,"overcount"
"1913",13183,"Georgia","Long County","A_A",256,164,-92,-43.81,"undercount"
"1914",13183,"Georgia","Long County","A_AIC",489,326,-163,-40,"undercount"
"1915",13183,"Georgia","Long County","NHPI_A",104,88,-16,-16.67,"undercount"
"1916",13183,"Georgia","Long County","NHPI_AIC",171,136,-35,-22.8,"undercount"
"1917",13185,"Georgia","Lowndes County","A_A",2362,1932,-430,-20.03,"undercount"
"1918",13185,"Georgia","Lowndes County","A_AIC",3317,2748,-569,-18.76,"undercount"
"1919",13185,"Georgia","Lowndes County","NHPI_A",206,110,-96,-60.76,"undercount"
"1920",13185,"Georgia","Lowndes County","NHPI_AIC",398,280,-118,-34.81,"undercount"
"1921",13187,"Georgia","Lumpkin County","A_A",273,258,-15,-5.65,"undercount"
"1922",13187,"Georgia","Lumpkin County","A_AIC",410,448,38,8.86,"overcount"
"1923",13187,"Georgia","Lumpkin County","NHPI_A",49,23,-26,-72.22,"undercount"
"1924",13187,"Georgia","Lumpkin County","NHPI_AIC",82,46,-36,-56.25,"undercount"
"1925",13189,"Georgia","McDuffie County","A_A",126,77,-49,-48.28,"undercount"
"1926",13189,"Georgia","McDuffie County","A_AIC",186,161,-25,-14.41,"undercount"
"1927",13189,"Georgia","McDuffie County","NHPI_A",20,15,-5,-28.57,"undercount"
"1928",13189,"Georgia","McDuffie County","NHPI_AIC",37,34,-3,-8.45,"undercount"
"1929",13191,"Georgia","McIntosh County","A_A",77,45,-32,-52.46,"undercount"
"1930",13191,"Georgia","McIntosh County","A_AIC",120,95,-25,-23.26,"undercount"
"1931",13191,"Georgia","McIntosh County","NHPI_A",20,0,-20,-200,"undercount"
"1932",13191,"Georgia","McIntosh County","NHPI_AIC",36,9,-27,-120,"undercount"
"1933",13193,"Georgia","Macon County","A_A",188,161,-27,-15.47,"undercount"
"1934",13193,"Georgia","Macon County","A_AIC",219,179,-40,-20.1,"undercount"
"1935",13193,"Georgia","Macon County","NHPI_A",18,7,-11,-88,"undercount"
"1936",13193,"Georgia","Macon County","NHPI_AIC",32,9,-23,-112.2,"undercount"
"1937",13195,"Georgia","Madison County","A_A",627,531,-96,-16.58,"undercount"
"1938",13195,"Georgia","Madison County","A_AIC",738,647,-91,-13.14,"undercount"
"1939",13195,"Georgia","Madison County","NHPI_A",12,4,-8,-100,"undercount"
"1940",13195,"Georgia","Madison County","NHPI_AIC",34,17,-17,-66.67,"undercount"
"1941",13197,"Georgia","Marion County","A_A",80,55,-25,-37.04,"undercount"
"1942",13197,"Georgia","Marion County","A_AIC",117,84,-33,-32.84,"undercount"
"1943",13197,"Georgia","Marion County","NHPI_A",62,16,-46,-117.95,"undercount"
"1944",13197,"Georgia","Marion County","NHPI_AIC",71,36,-35,-65.42,"undercount"
"1945",13199,"Georgia","Meriwether County","A_A",139,78,-61,-56.22,"undercount"
"1946",13199,"Georgia","Meriwether County","A_AIC",190,117,-73,-47.56,"undercount"
"1947",13199,"Georgia","Meriwether County","NHPI_A",9,7,-2,-25,"undercount"
"1948",13199,"Georgia","Meriwether County","NHPI_AIC",24,20,-4,-18.18,"undercount"
"1949",13201,"Georgia","Miller County","A_A",37,26,-11,-34.92,"undercount"
"1950",13201,"Georgia","Miller County","A_AIC",62,41,-21,-40.78,"undercount"
"1951",13201,"Georgia","Miller County","NHPI_A",2,1,-1,-66.67,"undercount"
"1952",13201,"Georgia","Miller County","NHPI_AIC",4,3,-1,-28.57,"undercount"
"1953",13205,"Georgia","Mitchell County","A_A",200,108,-92,-59.74,"undercount"
"1954",13205,"Georgia","Mitchell County","A_AIC",250,152,-98,-48.76,"undercount"
"1955",13205,"Georgia","Mitchell County","NHPI_A",20,0,-20,-200,"undercount"
"1956",13205,"Georgia","Mitchell County","NHPI_AIC",32,21,-11,-41.51,"undercount"
"1957",13207,"Georgia","Monroe County","A_A",280,240,-40,-15.38,"undercount"
"1958",13207,"Georgia","Monroe County","A_AIC",354,328,-26,-7.62,"undercount"
"1959",13207,"Georgia","Monroe County","NHPI_A",10,0,-10,-200,"undercount"
"1960",13207,"Georgia","Monroe County","NHPI_AIC",29,14,-15,-69.77,"undercount"
"1961",13209,"Georgia","Montgomery County","A_A",57,34,-23,-50.55,"undercount"
"1962",13209,"Georgia","Montgomery County","A_AIC",78,42,-36,-60,"undercount"
"1963",13209,"Georgia","Montgomery County","NHPI_A",2,0,-2,-200,"undercount"
"1964",13209,"Georgia","Montgomery County","NHPI_AIC",3,6,3,66.67,"overcount"
"1965",13211,"Georgia","Morgan County","A_A",125,125,0,0,"equal"
"1966",13211,"Georgia","Morgan County","A_AIC",186,194,8,4.21,"overcount"
"1967",13211,"Georgia","Morgan County","NHPI_A",7,1,-6,-150,"undercount"
"1968",13211,"Georgia","Morgan County","NHPI_AIC",19,8,-11,-81.48,"undercount"
"1969",13213,"Georgia","Murray County","A_A",233,140,-93,-49.87,"undercount"
"1970",13213,"Georgia","Murray County","A_AIC",343,205,-138,-50.36,"undercount"
"1971",13213,"Georgia","Murray County","NHPI_A",129,2,-127,-193.89,"undercount"
"1972",13213,"Georgia","Murray County","NHPI_AIC",154,17,-137,-160.23,"undercount"
"1973",13215,"Georgia","Muscogee County","A_A",5635,5601,-34,-0.61,"undercount"
"1974",13215,"Georgia","Muscogee County","A_AIC",7620,7814,194,2.51,"overcount"
"1975",13215,"Georgia","Muscogee County","NHPI_A",526,527,1,0.19,"overcount"
"1976",13215,"Georgia","Muscogee County","NHPI_AIC",922,939,17,1.83,"overcount"
"1977",13217,"Georgia","Newton County","A_A",1355,1063,-292,-24.15,"undercount"
"1978",13217,"Georgia","Newton County","A_AIC",1871,1531,-340,-19.99,"undercount"
"1979",13217,"Georgia","Newton County","NHPI_A",150,114,-36,-27.27,"undercount"
"1980",13217,"Georgia","Newton County","NHPI_AIC",286,231,-55,-21.28,"undercount"
"1981",13219,"Georgia","Oconee County","A_A",1808,2080,272,13.99,"overcount"
"1982",13219,"Georgia","Oconee County","A_AIC",2141,2466,325,14.11,"overcount"
"1983",13219,"Georgia","Oconee County","NHPI_A",32,0,-32,-200,"undercount"
"1984",13219,"Georgia","Oconee County","NHPI_AIC",63,18,-45,-111.11,"undercount"
"1985",13221,"Georgia","Oglethorpe County","A_A",166,134,-32,-21.33,"undercount"
"1986",13221,"Georgia","Oglethorpe County","A_AIC",205,194,-11,-5.51,"undercount"
"1987",13221,"Georgia","Oglethorpe County","NHPI_A",9,5,-4,-57.14,"undercount"
"1988",13221,"Georgia","Oglethorpe County","NHPI_AIC",15,20,5,28.57,"overcount"
"1989",13223,"Georgia","Paulding County","A_A",2194,1993,-201,-9.6,"undercount"
"1990",13223,"Georgia","Paulding County","A_AIC",3312,3112,-200,-6.23,"undercount"
"1991",13223,"Georgia","Paulding County","NHPI_A",142,117,-25,-19.31,"undercount"
"1992",13223,"Georgia","Paulding County","NHPI_AIC",344,247,-97,-32.83,"undercount"
"1993",13225,"Georgia","Peach County","A_A",319,194,-125,-48.73,"undercount"
"1994",13225,"Georgia","Peach County","A_AIC",441,314,-127,-33.64,"undercount"
"1995",13225,"Georgia","Peach County","NHPI_A",26,6,-20,-125,"undercount"
"1996",13225,"Georgia","Peach County","NHPI_AIC",62,35,-27,-55.67,"undercount"
"1997",13227,"Georgia","Pickens County","A_A",267,194,-73,-31.67,"undercount"
"1998",13227,"Georgia","Pickens County","A_AIC",347,264,-83,-27.17,"undercount"
"1999",13227,"Georgia","Pickens County","NHPI_A",16,7,-9,-78.26,"undercount"
"2000",13227,"Georgia","Pickens County","NHPI_AIC",30,16,-14,-60.87,"undercount"
"2001",13229,"Georgia","Pierce County","A_A",127,82,-45,-43.06,"undercount"
"2002",13229,"Georgia","Pierce County","A_AIC",199,144,-55,-32.07,"undercount"
"2003",13229,"Georgia","Pierce County","NHPI_A",15,2,-13,-152.94,"undercount"
"2004",13229,"Georgia","Pierce County","NHPI_AIC",27,14,-13,-63.41,"undercount"
"2005",13231,"Georgia","Pike County","A_A",95,77,-18,-20.93,"undercount"
"2006",13231,"Georgia","Pike County","A_AIC",158,149,-9,-5.86,"undercount"
"2007",13231,"Georgia","Pike County","NHPI_A",6,0,-6,-200,"undercount"
"2008",13231,"Georgia","Pike County","NHPI_AIC",22,20,-2,-9.52,"undercount"
"2009",13233,"Georgia","Polk County","A_A",328,239,-89,-31.39,"undercount"
"2010",13233,"Georgia","Polk County","A_AIC",422,325,-97,-25.97,"undercount"
"2011",13233,"Georgia","Polk County","NHPI_A",100,24,-76,-122.58,"undercount"
"2012",13233,"Georgia","Polk County","NHPI_AIC",122,42,-80,-97.56,"undercount"
"2013",13235,"Georgia","Pulaski County","A_A",133,103,-30,-25.42,"undercount"
"2014",13235,"Georgia","Pulaski County","A_AIC",169,123,-46,-31.51,"undercount"
"2015",13235,"Georgia","Pulaski County","NHPI_A",10,3,-7,-107.69,"undercount"
"2016",13235,"Georgia","Pulaski County","NHPI_AIC",22,10,-12,-75,"undercount"
"2017",13237,"Georgia","Putnam County","A_A",127,117,-10,-8.2,"undercount"
"2018",13237,"Georgia","Putnam County","A_AIC",193,175,-18,-9.78,"undercount"
"2019",13237,"Georgia","Putnam County","NHPI_A",52,2,-50,-185.19,"undercount"
"2020",13237,"Georgia","Putnam County","NHPI_AIC",69,17,-52,-120.93,"undercount"
"2021",13239,"Georgia","Quitman County","A_A",14,13,-1,-7.41,"undercount"
"2022",13239,"Georgia","Quitman County","A_AIC",21,17,-4,-21.05,"undercount"
"2023",13239,"Georgia","Quitman County","NHPI_A",0,0,0,0,"equal"
"2024",13239,"Georgia","Quitman County","NHPI_AIC",2,1,-1,-66.67,"undercount"
"2025",13241,"Georgia","Rabun County","A_A",180,60,-120,-100,"undercount"
"2026",13241,"Georgia","Rabun County","A_AIC",227,103,-124,-75.15,"undercount"
"2027",13241,"Georgia","Rabun County","NHPI_A",11,1,-10,-166.67,"undercount"
"2028",13241,"Georgia","Rabun County","NHPI_AIC",21,11,-10,-62.5,"undercount"
"2029",13243,"Georgia","Randolph County","A_A",35,21,-14,-50,"undercount"
"2030",13243,"Georgia","Randolph County","A_AIC",43,38,-5,-12.35,"undercount"
"2031",13243,"Georgia","Randolph County","NHPI_A",7,3,-4,-80,"undercount"
"2032",13243,"Georgia","Randolph County","NHPI_AIC",9,5,-4,-57.14,"undercount"
"2033",13245,"Georgia","Richmond County","A_A",3553,3984,431,11.44,"overcount"
"2034",13245,"Georgia","Richmond County","A_AIC",5308,5489,181,3.35,"overcount"
"2035",13245,"Georgia","Richmond County","NHPI_A",463,427,-36,-8.09,"undercount"
"2036",13245,"Georgia","Richmond County","NHPI_AIC",826,704,-122,-15.95,"undercount"
"2037",13247,"Georgia","Rockdale County","A_A",1614,1583,-31,-1.94,"undercount"
"2038",13247,"Georgia","Rockdale County","A_AIC",2188,1954,-234,-11.3,"undercount"
"2039",13247,"Georgia","Rockdale County","NHPI_A",170,75,-95,-77.55,"undercount"
"2040",13247,"Georgia","Rockdale County","NHPI_AIC",337,154,-183,-74.54,"undercount"
"2041",13249,"Georgia","Schley County","A_A",49,21,-28,-80,"undercount"
"2042",13249,"Georgia","Schley County","A_AIC",81,40,-41,-67.77,"undercount"
"2043",13249,"Georgia","Schley County","NHPI_A",0,2,2,200,"overcount"
"2044",13249,"Georgia","Schley County","NHPI_AIC",8,2,-6,-120,"undercount"
"2045",13251,"Georgia","Screven County","A_A",96,61,-35,-44.59,"undercount"
"2046",13251,"Georgia","Screven County","A_AIC",137,86,-51,-45.74,"undercount"
"2047",13251,"Georgia","Screven County","NHPI_A",3,3,0,0,"equal"
"2048",13251,"Georgia","Screven County","NHPI_AIC",12,14,2,15.38,"overcount"
"2049",13253,"Georgia","Seminole County","A_A",66,61,-5,-7.87,"undercount"
"2050",13253,"Georgia","Seminole County","A_AIC",87,83,-4,-4.71,"undercount"
"2051",13253,"Georgia","Seminole County","NHPI_A",2,0,-2,-200,"undercount"
"2052",13253,"Georgia","Seminole County","NHPI_AIC",7,3,-4,-80,"undercount"
"2053",13255,"Georgia","Spalding County","A_A",659,649,-10,-1.53,"undercount"
"2054",13255,"Georgia","Spalding County","A_AIC",906,835,-71,-8.16,"undercount"
"2055",13255,"Georgia","Spalding County","NHPI_A",80,27,-53,-99.07,"undercount"
"2056",13255,"Georgia","Spalding County","NHPI_AIC",156,58,-98,-91.59,"undercount"
"2057",13257,"Georgia","Stephens County","A_A",265,235,-30,-12,"undercount"
"2058",13257,"Georgia","Stephens County","A_AIC",362,309,-53,-15.8,"undercount"
"2059",13257,"Georgia","Stephens County","NHPI_A",50,9,-41,-138.98,"undercount"
"2060",13257,"Georgia","Stephens County","NHPI_AIC",73,27,-46,-92,"undercount"
"2061",13259,"Georgia","Stewart County","A_A",236,171,-65,-31.94,"undercount"
"2062",13259,"Georgia","Stewart County","A_AIC",273,182,-91,-40,"undercount"
"2063",13259,"Georgia","Stewart County","NHPI_A",1,5,4,133.33,"overcount"
"2064",13259,"Georgia","Stewart County","NHPI_AIC",6,15,9,85.71,"overcount"
"2065",13261,"Georgia","Sumter County","A_A",387,504,117,26.26,"overcount"
"2066",13261,"Georgia","Sumter County","A_AIC",461,585,124,23.71,"overcount"
"2067",13261,"Georgia","Sumter County","NHPI_A",54,4,-50,-172.41,"undercount"
"2068",13261,"Georgia","Sumter County","NHPI_AIC",84,37,-47,-77.69,"undercount"
"2069",13263,"Georgia","Talbot County","A_A",18,17,-1,-5.71,"undercount"
"2070",13263,"Georgia","Talbot County","A_AIC",32,24,-8,-28.57,"undercount"
"2071",13263,"Georgia","Talbot County","NHPI_A",4,1,-3,-120,"undercount"
"2072",13263,"Georgia","Talbot County","NHPI_AIC",7,6,-1,-15.38,"undercount"
"2073",13265,"Georgia","Taliaferro County","A_A",27,6,-21,-127.27,"undercount"
"2074",13265,"Georgia","Taliaferro County","A_AIC",36,16,-20,-76.92,"undercount"
"2075",13265,"Georgia","Taliaferro County","NHPI_A",0,0,0,0,"equal"
"2076",13265,"Georgia","Taliaferro County","NHPI_AIC",4,4,0,0,"equal"
"2077",13267,"Georgia","Tattnall County","A_A",169,127,-42,-28.38,"undercount"
"2078",13267,"Georgia","Tattnall County","A_AIC",229,189,-40,-19.14,"undercount"
"2079",13267,"Georgia","Tattnall County","NHPI_A",49,7,-42,-150,"undercount"
"2080",13267,"Georgia","Tattnall County","NHPI_AIC",69,29,-40,-81.63,"undercount"
"2081",13269,"Georgia","Taylor County","A_A",73,29,-44,-86.27,"undercount"
"2082",13269,"Georgia","Taylor County","A_AIC",92,39,-53,-80.92,"undercount"
"2083",13269,"Georgia","Taylor County","NHPI_A",3,2,-1,-40,"undercount"
"2084",13269,"Georgia","Taylor County","NHPI_AIC",8,10,2,22.22,"overcount"
"2085",13271,"Georgia","Telfair County","A_A",117,30,-87,-118.37,"undercount"
"2086",13271,"Georgia","Telfair County","A_AIC",170,41,-129,-122.27,"undercount"
"2087",13271,"Georgia","Telfair County","NHPI_A",11,0,-11,-200,"undercount"
"2088",13271,"Georgia","Telfair County","NHPI_AIC",36,3,-33,-169.23,"undercount"
"2089",13273,"Georgia","Terrell County","A_A",42,61,19,36.89,"overcount"
"2090",13273,"Georgia","Terrell County","A_AIC",75,85,10,12.5,"overcount"
"2091",13273,"Georgia","Terrell County","NHPI_A",16,1,-15,-176.47,"undercount"
"2092",13273,"Georgia","Terrell County","NHPI_AIC",27,15,-12,-57.14,"undercount"
"2093",13275,"Georgia","Thomas County","A_A",449,412,-37,-8.59,"undercount"
"2094",13275,"Georgia","Thomas County","A_AIC",580,527,-53,-9.58,"undercount"
"2095",13275,"Georgia","Thomas County","NHPI_A",33,9,-24,-114.29,"undercount"
"2096",13275,"Georgia","Thomas County","NHPI_AIC",73,26,-47,-94.95,"undercount"
"2097",13277,"Georgia","Tift County","A_A",653,653,0,0,"equal"
"2098",13277,"Georgia","Tift County","A_AIC",782,789,7,0.89,"overcount"
"2099",13277,"Georgia","Tift County","NHPI_A",26,2,-24,-171.43,"undercount"
"2100",13277,"Georgia","Tift County","NHPI_AIC",59,7,-52,-157.58,"undercount"
"2101",13279,"Georgia","Toombs County","A_A",243,207,-36,-16,"undercount"
"2102",13279,"Georgia","Toombs County","A_AIC",309,264,-45,-15.71,"undercount"
"2103",13279,"Georgia","Toombs County","NHPI_A",35,6,-29,-141.46,"undercount"
"2104",13279,"Georgia","Toombs County","NHPI_AIC",60,9,-51,-147.83,"undercount"
"2105",13281,"Georgia","Towns County","A_A",133,81,-52,-48.6,"undercount"
"2106",13281,"Georgia","Towns County","A_AIC",160,113,-47,-34.43,"undercount"
"2107",13281,"Georgia","Towns County","NHPI_A",9,5,-4,-57.14,"undercount"
"2108",13281,"Georgia","Towns County","NHPI_AIC",15,17,2,12.5,"overcount"
"2109",13283,"Georgia","Treutlen County","A_A",24,8,-16,-100,"undercount"
"2110",13283,"Georgia","Treutlen County","A_AIC",35,23,-12,-41.38,"undercount"
"2111",13283,"Georgia","Treutlen County","NHPI_A",2,0,-2,-200,"undercount"
"2112",13283,"Georgia","Treutlen County","NHPI_AIC",3,9,6,100,"overcount"
"2113",13285,"Georgia","Troup County","A_A",1683,1611,-72,-4.37,"undercount"
"2114",13285,"Georgia","Troup County","A_AIC",1898,1826,-72,-3.87,"undercount"
"2115",13285,"Georgia","Troup County","NHPI_A",131,36,-95,-113.77,"undercount"
"2116",13285,"Georgia","Troup County","NHPI_AIC",197,85,-112,-79.43,"undercount"
"2117",13287,"Georgia","Turner County","A_A",83,49,-34,-51.52,"undercount"
"2118",13287,"Georgia","Turner County","A_AIC",97,61,-36,-45.57,"undercount"
"2119",13287,"Georgia","Turner County","NHPI_A",14,0,-14,-200,"undercount"
"2120",13287,"Georgia","Turner County","NHPI_AIC",16,2,-14,-155.56,"undercount"
"2121",13289,"Georgia","Twiggs County","A_A",33,37,4,11.43,"overcount"
"2122",13289,"Georgia","Twiggs County","A_AIC",52,62,10,17.54,"overcount"
"2123",13289,"Georgia","Twiggs County","NHPI_A",3,0,-3,-200,"undercount"
"2124",13289,"Georgia","Twiggs County","NHPI_AIC",8,5,-3,-46.15,"undercount"
"2125",13291,"Georgia","Union County","A_A",114,100,-14,-13.08,"undercount"
"2126",13291,"Georgia","Union County","A_AIC",181,171,-10,-5.68,"undercount"
"2127",13291,"Georgia","Union County","NHPI_A",10,0,-10,-200,"undercount"
"2128",13291,"Georgia","Union County","NHPI_AIC",21,13,-8,-47.06,"undercount"
"2129",13293,"Georgia","Upson County","A_A",170,157,-13,-7.95,"undercount"
"2130",13293,"Georgia","Upson County","A_AIC",235,232,-3,-1.28,"undercount"
"2131",13293,"Georgia","Upson County","NHPI_A",45,1,-44,-191.3,"undercount"
"2132",13293,"Georgia","Upson County","NHPI_AIC",61,15,-46,-121.05,"undercount"
"2133",13295,"Georgia","Walker County","A_A",534,301,-233,-55.81,"undercount"
"2134",13295,"Georgia","Walker County","A_AIC",680,494,-186,-31.69,"undercount"
"2135",13295,"Georgia","Walker County","NHPI_A",40,29,-11,-31.88,"undercount"
"2136",13295,"Georgia","Walker County","NHPI_AIC",73,61,-12,-17.91,"undercount"
"2137",13297,"Georgia","Walton County","A_A",1678,1453,-225,-14.37,"undercount"
"2138",13297,"Georgia","Walton County","A_AIC",2111,1965,-146,-7.16,"undercount"
"2139",13297,"Georgia","Walton County","NHPI_A",125,54,-71,-79.33,"undercount"
"2140",13297,"Georgia","Walton County","NHPI_AIC",231,122,-109,-61.76,"undercount"
"2141",13299,"Georgia","Ware County","A_A",435,337,-98,-25.39,"undercount"
"2142",13299,"Georgia","Ware County","A_AIC",549,405,-144,-30.19,"undercount"
"2143",13299,"Georgia","Ware County","NHPI_A",40,19,-21,-71.19,"undercount"
"2144",13299,"Georgia","Ware County","NHPI_AIC",70,34,-36,-69.23,"undercount"
"2145",13301,"Georgia","Warren County","A_A",34,15,-19,-77.55,"undercount"
"2146",13301,"Georgia","Warren County","A_AIC",41,26,-15,-44.78,"undercount"
"2147",13301,"Georgia","Warren County","NHPI_A",0,1,1,200,"overcount"
"2148",13301,"Georgia","Warren County","NHPI_AIC",3,4,1,28.57,"overcount"
"2149",13303,"Georgia","Washington County","A_A",129,76,-53,-51.71,"undercount"
"2150",13303,"Georgia","Washington County","A_AIC",161,99,-62,-47.69,"undercount"
"2151",13303,"Georgia","Washington County","NHPI_A",2,0,-2,-200,"undercount"
"2152",13303,"Georgia","Washington County","NHPI_AIC",11,13,2,16.67,"overcount"
"2153",13305,"Georgia","Wayne County","A_A",237,174,-63,-30.66,"undercount"
"2154",13305,"Georgia","Wayne County","A_AIC",335,275,-60,-19.67,"undercount"
"2155",13305,"Georgia","Wayne County","NHPI_A",35,5,-30,-150,"undercount"
"2156",13305,"Georgia","Wayne County","NHPI_AIC",60,25,-35,-82.35,"undercount"
"2157",13307,"Georgia","Webster County","A_A",14,12,-2,-15.38,"undercount"
"2158",13307,"Georgia","Webster County","A_AIC",19,21,2,10,"overcount"
"2159",13307,"Georgia","Webster County","NHPI_A",0,6,6,200,"overcount"
"2160",13307,"Georgia","Webster County","NHPI_AIC",1,17,16,177.78,"overcount"
"2161",13309,"Georgia","Wheeler County","A_A",30,17,-13,-55.32,"undercount"
"2162",13309,"Georgia","Wheeler County","A_AIC",44,28,-16,-44.44,"undercount"
"2163",13309,"Georgia","Wheeler County","NHPI_A",3,0,-3,-200,"undercount"
"2164",13309,"Georgia","Wheeler County","NHPI_AIC",5,8,3,46.15,"overcount"
"2165",13311,"Georgia","White County","A_A",184,159,-25,-14.58,"undercount"
"2166",13311,"Georgia","White County","A_AIC",224,263,39,16.02,"overcount"
"2167",13311,"Georgia","White County","NHPI_A",32,2,-30,-176.47,"undercount"
"2168",13311,"Georgia","White County","NHPI_AIC",46,8,-38,-140.74,"undercount"
"2169",13313,"Georgia","Whitfield County","A_A",1692,1427,-265,-16.99,"undercount"
"2170",13313,"Georgia","Whitfield County","A_AIC",1982,1686,-296,-16.14,"undercount"
"2171",13313,"Georgia","Whitfield County","NHPI_A",264,19,-245,-173.14,"undercount"
"2172",13313,"Georgia","Whitfield County","NHPI_AIC",333,46,-287,-151.45,"undercount"
"2173",13315,"Georgia","Wilcox County","A_A",84,53,-31,-45.26,"undercount"
"2174",13315,"Georgia","Wilcox County","A_AIC",98,73,-25,-29.24,"undercount"
"2175",13315,"Georgia","Wilcox County","NHPI_A",3,4,1,28.57,"overcount"
"2176",13315,"Georgia","Wilcox County","NHPI_AIC",8,13,5,47.62,"overcount"
"2177",13317,"Georgia","Wilkes County","A_A",93,59,-34,-44.74,"undercount"
"2178",13317,"Georgia","Wilkes County","A_AIC",108,79,-29,-31.02,"undercount"
"2179",13317,"Georgia","Wilkes County","NHPI_A",3,0,-3,-200,"undercount"
"2180",13317,"Georgia","Wilkes County","NHPI_AIC",5,12,7,82.35,"overcount"
"2181",13319,"Georgia","Wilkinson County","A_A",40,22,-18,-58.06,"undercount"
"2182",13319,"Georgia","Wilkinson County","A_AIC",62,46,-16,-29.63,"undercount"
"2183",13319,"Georgia","Wilkinson County","NHPI_A",2,3,1,40,"overcount"
"2184",13319,"Georgia","Wilkinson County","NHPI_AIC",6,11,5,58.82,"overcount"
"2185",13321,"Georgia","Worth County","A_A",167,87,-80,-62.99,"undercount"
"2186",13321,"Georgia","Worth County","A_AIC",208,136,-72,-41.86,"undercount"
"2187",13321,"Georgia","Worth County","NHPI_A",14,10,-4,-33.33,"undercount"
"2188",13321,"Georgia","Worth County","NHPI_AIC",22,15,-7,-37.84,"undercount"
"2189",15001,"Hawaii","Hawaii County","A_A",42292,38632,-3660,-9.05,"undercount"
"2190",15001,"Hawaii","Hawaii County","A_AIC",92118,73414,-18704,-22.6,"undercount"
"2191",15001,"Hawaii","Hawaii County","NHPI_A",26557,26362,-195,-0.74,"undercount"
"2192",15001,"Hawaii","Hawaii County","NHPI_AIC",72834,59152,-13682,-20.73,"undercount"
"2193",15003,"Hawaii","Honolulu County","A_A",409654,431044,21390,5.09,"overcount"
"2194",15003,"Hawaii","Honolulu County","A_AIC",594370,593111,-1259,-0.21,"undercount"
"2195",15003,"Hawaii","Honolulu County","NHPI_A",96178,97596,1418,1.46,"overcount"
"2196",15003,"Hawaii","Honolulu County","NHPI_AIC",247618,228009,-19609,-8.25,"undercount"
"2197",15005,"Hawaii","Kalawao County","A_A",7,10,3,35.29,"overcount"
"2198",15005,"Hawaii","Kalawao County","A_AIC",14,14,0,0,"equal"
"2199",15005,"Hawaii","Kalawao County","NHPI_A",42,15,-27,-94.74,"undercount"
"2200",15005,"Hawaii","Kalawao County","NHPI_AIC",44,18,-26,-83.87,"undercount"
"2201",15007,"Hawaii","Kauai County","A_A",21918,20597,-1321,-6.21,"undercount"
"2202",15007,"Hawaii","Kauai County","A_AIC",37006,32995,-4011,-11.46,"undercount"
"2203",15007,"Hawaii","Kauai County","NHPI_A",6725,6884,159,2.34,"overcount"
"2204",15007,"Hawaii","Kauai County","NHPI_AIC",19392,17328,-2064,-11.24,"undercount"
"2205",15009,"Hawaii","Maui County","A_A",48220,43508,-4712,-10.27,"undercount"
"2206",15009,"Hawaii","Maui County","A_AIC",81346,67377,-13969,-18.79,"undercount"
"2207",15009,"Hawaii","Maui County","NHPI_A",17906,19092,1186,6.41,"overcount"
"2208",15009,"Hawaii","Maui County","NHPI_AIC",48222,40713,-7509,-16.89,"undercount"
"2209",16001,"Idaho","Ada County","A_A",13878,13850,-28,-0.2,"undercount"
"2210",16001,"Idaho","Ada County","A_AIC",21269,21358,89,0.42,"overcount"
"2211",16001,"Idaho","Ada County","NHPI_A",1134,1240,106,8.93,"overcount"
"2212",16001,"Idaho","Ada County","NHPI_AIC",2639,2722,83,3.1,"overcount"
"2213",16003,"Idaho","Adams County","A_A",40,8,-32,-133.33,"undercount"
"2214",16003,"Idaho","Adams County","A_AIC",63,22,-41,-96.47,"undercount"
"2215",16003,"Idaho","Adams County","NHPI_A",19,0,-19,-200,"undercount"
"2216",16003,"Idaho","Adams County","NHPI_AIC",22,2,-20,-166.67,"undercount"
"2217",16005,"Idaho","Bannock County","A_A",1568,1159,-409,-30,"undercount"
"2218",16005,"Idaho","Bannock County","A_AIC",2416,1994,-422,-19.14,"undercount"
"2219",16005,"Idaho","Bannock County","NHPI_A",248,249,1,0.4,"overcount"
"2220",16005,"Idaho","Bannock County","NHPI_AIC",494,539,45,8.71,"overcount"
"2221",16007,"Idaho","Bear Lake County","A_A",29,13,-16,-76.19,"undercount"
"2222",16007,"Idaho","Bear Lake County","A_AIC",51,40,-11,-24.18,"undercount"
"2223",16007,"Idaho","Bear Lake County","NHPI_A",4,2,-2,-66.67,"undercount"
"2224",16007,"Idaho","Bear Lake County","NHPI_AIC",7,6,-1,-15.38,"undercount"
"2225",16009,"Idaho","Benewah County","A_A",35,30,-5,-15.38,"undercount"
"2226",16009,"Idaho","Benewah County","A_AIC",95,58,-37,-48.37,"undercount"
"2227",16009,"Idaho","Benewah County","NHPI_A",7,15,8,72.73,"overcount"
"2228",16009,"Idaho","Benewah County","NHPI_AIC",25,35,10,33.33,"overcount"
"2229",16011,"Idaho","Bingham County","A_A",421,192,-229,-74.71,"undercount"
"2230",16011,"Idaho","Bingham County","A_AIC",697,479,-218,-37.07,"undercount"
"2231",16011,"Idaho","Bingham County","NHPI_A",92,38,-54,-83.08,"undercount"
"2232",16011,"Idaho","Bingham County","NHPI_AIC",165,121,-44,-30.77,"undercount"
"2233",16013,"Idaho","Blaine County","A_A",343,211,-132,-47.65,"undercount"
"2234",16013,"Idaho","Blaine County","A_AIC",458,368,-90,-21.79,"undercount"
"2235",16013,"Idaho","Blaine County","NHPI_A",30,22,-8,-30.77,"undercount"
"2236",16013,"Idaho","Blaine County","NHPI_AIC",55,63,8,13.56,"overcount"
"2237",16015,"Idaho","Boise County","A_A",113,39,-74,-97.37,"undercount"
"2238",16015,"Idaho","Boise County","A_AIC",147,80,-67,-59.03,"undercount"
"2239",16015,"Idaho","Boise County","NHPI_A",17,4,-13,-123.81,"undercount"
"2240",16015,"Idaho","Boise County","NHPI_AIC",23,20,-3,-13.95,"undercount"
"2241",16017,"Idaho","Bonner County","A_A",323,260,-63,-21.61,"undercount"
"2242",16017,"Idaho","Bonner County","A_AIC",603,550,-53,-9.19,"undercount"
"2243",16017,"Idaho","Bonner County","NHPI_A",67,39,-28,-52.83,"undercount"
"2244",16017,"Idaho","Bonner County","NHPI_AIC",113,127,14,11.67,"overcount"
"2245",16019,"Idaho","Bonneville County","A_A",1514,1409,-105,-7.18,"undercount"
"2246",16019,"Idaho","Bonneville County","A_AIC",2358,2313,-45,-1.93,"undercount"
"2247",16019,"Idaho","Bonneville County","NHPI_A",191,151,-40,-23.39,"undercount"
"2248",16019,"Idaho","Bonneville County","NHPI_AIC",399,399,0,0,"equal"
"2249",16021,"Idaho","Boundary County","A_A",149,72,-77,-69.68,"undercount"
"2250",16021,"Idaho","Boundary County","A_AIC",211,158,-53,-28.73,"undercount"
"2251",16021,"Idaho","Boundary County","NHPI_A",15,9,-6,-50,"undercount"
"2252",16021,"Idaho","Boundary County","NHPI_AIC",39,34,-5,-13.7,"undercount"
"2253",16023,"Idaho","Butte County","A_A",10,4,-6,-85.71,"undercount"
"2254",16023,"Idaho","Butte County","A_AIC",21,8,-13,-89.66,"undercount"
"2255",16023,"Idaho","Butte County","NHPI_A",5,2,-3,-85.71,"undercount"
"2256",16023,"Idaho","Butte County","NHPI_AIC",11,4,-7,-93.33,"undercount"
"2257",16025,"Idaho","Camas County","A_A",4,8,4,66.67,"overcount"
"2258",16025,"Idaho","Camas County","A_AIC",11,22,11,66.67,"overcount"
"2259",16025,"Idaho","Camas County","NHPI_A",0,0,0,0,"equal"
"2260",16025,"Idaho","Camas County","NHPI_AIC",2,3,1,40,"overcount"
"2261",16027,"Idaho","Canyon County","A_A",2639,2002,-637,-27.45,"undercount"
"2262",16027,"Idaho","Canyon County","A_AIC",4986,4197,-789,-17.18,"undercount"
"2263",16027,"Idaho","Canyon County","NHPI_A",804,628,-176,-24.58,"undercount"
"2264",16027,"Idaho","Canyon County","NHPI_AIC",1411,1249,-162,-12.18,"undercount"
"2265",16029,"Idaho","Caribou County","A_A",30,10,-20,-100,"undercount"
"2266",16029,"Idaho","Caribou County","A_AIC",50,25,-25,-66.67,"undercount"
"2267",16029,"Idaho","Caribou County","NHPI_A",26,15,-11,-53.66,"undercount"
"2268",16029,"Idaho","Caribou County","NHPI_AIC",31,44,13,34.67,"overcount"
"2269",16031,"Idaho","Cassia County","A_A",198,160,-38,-21.23,"undercount"
"2270",16031,"Idaho","Cassia County","A_AIC",316,275,-41,-13.87,"undercount"
"2271",16031,"Idaho","Cassia County","NHPI_A",64,29,-35,-75.27,"undercount"
"2272",16031,"Idaho","Cassia County","NHPI_AIC",102,67,-35,-41.42,"undercount"
"2273",16033,"Idaho","Clark County","A_A",7,1,-6,-150,"undercount"
"2274",16033,"Idaho","Clark County","A_AIC",12,11,-1,-8.7,"undercount"
"2275",16033,"Idaho","Clark County","NHPI_A",2,0,-2,-200,"undercount"
"2276",16033,"Idaho","Clark County","NHPI_AIC",4,5,1,22.22,"overcount"
"2277",16035,"Idaho","Clearwater County","A_A",71,46,-25,-42.74,"undercount"
"2278",16035,"Idaho","Clearwater County","A_AIC",112,81,-31,-32.12,"undercount"
"2279",16035,"Idaho","Clearwater County","NHPI_A",27,5,-22,-137.5,"undercount"
"2280",16035,"Idaho","Clearwater County","NHPI_AIC",39,24,-15,-47.62,"undercount"
"2281",16037,"Idaho","Custer County","A_A",14,16,2,13.33,"overcount"
"2282",16037,"Idaho","Custer County","A_AIC",33,35,2,5.88,"overcount"
"2283",16037,"Idaho","Custer County","NHPI_A",2,3,1,40,"overcount"
"2284",16037,"Idaho","Custer County","NHPI_AIC",7,14,7,66.67,"overcount"
"2285",16039,"Idaho","Elmore County","A_A",783,776,-7,-0.9,"undercount"
"2286",16039,"Idaho","Elmore County","A_AIC",1243,1179,-64,-5.28,"undercount"
"2287",16039,"Idaho","Elmore County","NHPI_A",111,105,-6,-5.56,"undercount"
"2288",16039,"Idaho","Elmore County","NHPI_AIC",223,219,-4,-1.81,"undercount"
"2289",16041,"Idaho","Franklin County","A_A",35,29,-6,-18.75,"undercount"
"2290",16041,"Idaho","Franklin County","A_AIC",76,96,20,23.26,"overcount"
"2291",16041,"Idaho","Franklin County","NHPI_A",12,7,-5,-52.63,"undercount"
"2292",16041,"Idaho","Franklin County","NHPI_AIC",34,49,15,36.14,"overcount"
"2293",16043,"Idaho","Fremont County","A_A",57,49,-8,-15.09,"undercount"
"2294",16043,"Idaho","Fremont County","A_AIC",99,102,3,2.99,"overcount"
"2295",16043,"Idaho","Fremont County","NHPI_A",62,24,-38,-88.37,"undercount"
"2296",16043,"Idaho","Fremont County","NHPI_AIC",74,37,-37,-66.67,"undercount"
"2297",16045,"Idaho","Gem County","A_A",194,99,-95,-64.85,"undercount"
"2298",16045,"Idaho","Gem County","A_AIC",302,243,-59,-21.65,"undercount"
"2299",16045,"Idaho","Gem County","NHPI_A",45,20,-25,-76.92,"undercount"
"2300",16045,"Idaho","Gem County","NHPI_AIC",80,55,-25,-37.04,"undercount"
"2301",16047,"Idaho","Gooding County","A_A",132,45,-87,-98.31,"undercount"
"2302",16047,"Idaho","Gooding County","A_AIC",214,114,-100,-60.98,"undercount"
"2303",16047,"Idaho","Gooding County","NHPI_A",37,7,-30,-136.36,"undercount"
"2304",16047,"Idaho","Gooding County","NHPI_AIC",55,36,-19,-41.76,"undercount"
"2305",16049,"Idaho","Idaho County","A_A",97,59,-38,-48.72,"undercount"
"2306",16049,"Idaho","Idaho County","A_AIC",162,154,-8,-5.06,"undercount"
"2307",16049,"Idaho","Idaho County","NHPI_A",12,5,-7,-82.35,"undercount"
"2308",16049,"Idaho","Idaho County","NHPI_AIC",41,49,8,17.78,"overcount"
"2309",16051,"Idaho","Jefferson County","A_A",181,119,-62,-41.33,"undercount"
"2310",16051,"Idaho","Jefferson County","A_AIC",364,290,-74,-22.63,"undercount"
"2311",16051,"Idaho","Jefferson County","NHPI_A",53,30,-23,-55.42,"undercount"
"2312",16051,"Idaho","Jefferson County","NHPI_AIC",114,97,-17,-16.11,"undercount"
"2313",16053,"Idaho","Jerome County","A_A",129,80,-49,-46.89,"undercount"
"2314",16053,"Idaho","Jerome County","A_AIC",207,152,-55,-30.64,"undercount"
"2315",16053,"Idaho","Jerome County","NHPI_A",62,24,-38,-88.37,"undercount"
"2316",16053,"Idaho","Jerome County","NHPI_AIC",87,54,-33,-46.81,"undercount"
"2317",16055,"Idaho","Kootenai County","A_A",1627,1376,-251,-16.72,"undercount"
"2318",16055,"Idaho","Kootenai County","A_AIC",3047,3141,94,3.04,"overcount"
"2319",16055,"Idaho","Kootenai County","NHPI_A",284,195,-89,-37.16,"undercount"
"2320",16055,"Idaho","Kootenai County","NHPI_AIC",650,684,34,5.1,"overcount"
"2321",16057,"Idaho","Latah County","A_A",1018,994,-24,-2.39,"undercount"
"2322",16057,"Idaho","Latah County","A_AIC",1520,1526,6,0.39,"overcount"
"2323",16057,"Idaho","Latah County","NHPI_A",65,48,-17,-30.09,"undercount"
"2324",16057,"Idaho","Latah County","NHPI_AIC",147,145,-2,-1.37,"undercount"
"2325",16059,"Idaho","Lemhi County","A_A",32,28,-4,-13.33,"undercount"
"2326",16059,"Idaho","Lemhi County","A_AIC",64,41,-23,-43.81,"undercount"
"2327",16059,"Idaho","Lemhi County","NHPI_A",2,6,4,100,"overcount"
"2328",16059,"Idaho","Lemhi County","NHPI_AIC",12,13,1,8,"overcount"
"2329",16061,"Idaho","Lewis County","A_A",57,11,-46,-135.29,"undercount"
"2330",16061,"Idaho","Lewis County","A_AIC",86,30,-56,-96.55,"undercount"
"2331",16061,"Idaho","Lewis County","NHPI_A",10,1,-9,-163.64,"undercount"
"2332",16061,"Idaho","Lewis County","NHPI_AIC",18,11,-7,-48.28,"undercount"
"2333",16063,"Idaho","Lincoln County","A_A",30,10,-20,-100,"undercount"
"2334",16063,"Idaho","Lincoln County","A_AIC",57,47,-10,-19.23,"undercount"
"2335",16063,"Idaho","Lincoln County","NHPI_A",14,5,-9,-94.74,"undercount"
"2336",16063,"Idaho","Lincoln County","NHPI_AIC",26,18,-8,-36.36,"undercount"
"2337",16065,"Idaho","Madison County","A_A",625,937,312,39.95,"overcount"
"2338",16065,"Idaho","Madison County","A_AIC",993,1422,429,35.53,"overcount"
"2339",16065,"Idaho","Madison County","NHPI_A",132,215,83,47.84,"overcount"
"2340",16065,"Idaho","Madison County","NHPI_AIC",256,421,165,48.74,"overcount"
"2341",16067,"Idaho","Minidoka County","A_A",150,53,-97,-95.57,"undercount"
"2342",16067,"Idaho","Minidoka County","A_AIC",257,165,-92,-43.6,"undercount"
"2343",16067,"Idaho","Minidoka County","NHPI_A",21,12,-9,-54.55,"undercount"
"2344",16067,"Idaho","Minidoka County","NHPI_AIC",64,37,-27,-53.47,"undercount"
"2345",16069,"Idaho","Nez Perce County","A_A",366,326,-40,-11.56,"undercount"
"2346",16069,"Idaho","Nez Perce County","A_AIC",648,642,-6,-0.93,"undercount"
"2347",16069,"Idaho","Nez Perce County","NHPI_A",63,32,-31,-65.26,"undercount"
"2348",16069,"Idaho","Nez Perce County","NHPI_AIC",151,134,-17,-11.93,"undercount"
"2349",16071,"Idaho","Oneida County","A_A",27,16,-11,-51.16,"undercount"
"2350",16071,"Idaho","Oneida County","A_AIC",41,35,-6,-15.79,"undercount"
"2351",16071,"Idaho","Oneida County","NHPI_A",3,4,1,28.57,"overcount"
"2352",16071,"Idaho","Oneida County","NHPI_AIC",8,11,3,31.58,"overcount"
"2353",16073,"Idaho","Owyhee County","A_A",94,42,-52,-76.47,"undercount"
"2354",16073,"Idaho","Owyhee County","A_AIC",155,89,-66,-54.1,"undercount"
"2355",16073,"Idaho","Owyhee County","NHPI_A",26,8,-18,-105.88,"undercount"
"2356",16073,"Idaho","Owyhee County","NHPI_AIC",42,22,-20,-62.5,"undercount"
"2357",16075,"Idaho","Payette County","A_A",263,207,-56,-23.83,"undercount"
"2358",16075,"Idaho","Payette County","A_AIC",471,428,-43,-9.57,"undercount"
"2359",16075,"Idaho","Payette County","NHPI_A",28,31,3,10.17,"overcount"
"2360",16075,"Idaho","Payette County","NHPI_AIC",80,67,-13,-17.69,"undercount"
"2361",16077,"Idaho","Power County","A_A",42,19,-23,-75.41,"undercount"
"2362",16077,"Idaho","Power County","A_AIC",80,46,-34,-53.97,"undercount"
"2363",16077,"Idaho","Power County","NHPI_A",17,8,-9,-72,"undercount"
"2364",16077,"Idaho","Power County","NHPI_AIC",34,31,-3,-9.23,"undercount"
"2365",16079,"Idaho","Shoshone County","A_A",80,53,-27,-40.6,"undercount"
"2366",16079,"Idaho","Shoshone County","A_AIC",128,103,-25,-21.65,"undercount"
"2367",16079,"Idaho","Shoshone County","NHPI_A",23,6,-17,-117.24,"undercount"
"2368",16079,"Idaho","Shoshone County","NHPI_AIC",46,20,-26,-78.79,"undercount"
"2369",16081,"Idaho","Teton County","A_A",86,54,-32,-45.71,"undercount"
"2370",16081,"Idaho","Teton County","A_AIC",120,126,6,4.88,"overcount"
"2371",16081,"Idaho","Teton County","NHPI_A",18,0,-18,-200,"undercount"
"2372",16081,"Idaho","Teton County","NHPI_AIC",27,17,-10,-45.45,"undercount"
"2373",16083,"Idaho","Twin Falls County","A_A",1618,1424,-194,-12.75,"undercount"
"2374",16083,"Idaho","Twin Falls County","A_AIC",2197,2099,-98,-4.56,"undercount"
"2375",16083,"Idaho","Twin Falls County","NHPI_A",231,201,-30,-13.89,"undercount"
"2376",16083,"Idaho","Twin Falls County","NHPI_AIC",359,345,-14,-3.98,"undercount"
"2377",16085,"Idaho","Valley County","A_A",65,55,-10,-16.67,"undercount"
"2378",16085,"Idaho","Valley County","A_AIC",115,106,-9,-8.14,"undercount"
"2379",16085,"Idaho","Valley County","NHPI_A",11,8,-3,-31.58,"undercount"
"2380",16085,"Idaho","Valley County","NHPI_AIC",22,29,7,27.45,"overcount"
"2381",16087,"Idaho","Washington County","A_A",108,81,-27,-28.57,"undercount"
"2382",16087,"Idaho","Washington County","A_AIC",154,163,9,5.68,"overcount"
"2383",16087,"Idaho","Washington County","NHPI_A",16,7,-9,-78.26,"undercount"
"2384",16087,"Idaho","Washington County","NHPI_AIC",24,26,2,8,"overcount"
"2385",17001,"Illinois","Adams County","A_A",596,500,-96,-17.52,"undercount"
"2386",17001,"Illinois","Adams County","A_AIC",815,743,-72,-9.24,"undercount"
"2387",17001,"Illinois","Adams County","NHPI_A",26,33,7,23.73,"overcount"
"2388",17001,"Illinois","Adams County","NHPI_AIC",60,102,42,51.85,"overcount"
"2389",17003,"Illinois","Alexander County","A_A",16,6,-10,-90.91,"undercount"
"2390",17003,"Illinois","Alexander County","A_AIC",32,17,-15,-61.22,"undercount"
"2391",17003,"Illinois","Alexander County","NHPI_A",10,0,-10,-200,"undercount"
"2392",17003,"Illinois","Alexander County","NHPI_AIC",15,3,-12,-133.33,"undercount"
"2393",17005,"Illinois","Bond County","A_A",132,94,-38,-33.63,"undercount"
"2394",17005,"Illinois","Bond County","A_AIC",191,143,-48,-28.74,"undercount"
"2395",17005,"Illinois","Bond County","NHPI_A",10,11,1,9.52,"overcount"
"2396",17005,"Illinois","Bond County","NHPI_AIC",21,27,6,25,"overcount"
"2397",17007,"Illinois","Boone County","A_A",760,644,-116,-16.52,"undercount"
"2398",17007,"Illinois","Boone County","A_AIC",1032,938,-94,-9.54,"undercount"
"2399",17007,"Illinois","Boone County","NHPI_A",50,10,-40,-133.33,"undercount"
"2400",17007,"Illinois","Boone County","NHPI_AIC",80,37,-43,-73.5,"undercount"
"2401",17009,"Illinois","Brown County","A_A",20,11,-9,-58.06,"undercount"
"2402",17009,"Illinois","Brown County","A_AIC",38,34,-4,-11.11,"undercount"
"2403",17009,"Illinois","Brown County","NHPI_A",3,0,-3,-200,"undercount"
"2404",17009,"Illinois","Brown County","NHPI_AIC",8,14,6,54.55,"overcount"
"2405",17011,"Illinois","Bureau County","A_A",359,298,-61,-18.57,"undercount"
"2406",17011,"Illinois","Bureau County","A_AIC",433,399,-34,-8.17,"undercount"
"2407",17011,"Illinois","Bureau County","NHPI_A",16,21,5,27.03,"overcount"
"2408",17011,"Illinois","Bureau County","NHPI_AIC",25,42,17,50.75,"overcount"
"2409",17013,"Illinois","Calhoun County","A_A",14,7,-7,-66.67,"undercount"
"2410",17013,"Illinois","Calhoun County","A_AIC",20,20,0,0,"equal"
"2411",17013,"Illinois","Calhoun County","NHPI_A",2,0,-2,-200,"undercount"
"2412",17013,"Illinois","Calhoun County","NHPI_AIC",6,7,1,15.38,"overcount"
"2413",17015,"Illinois","Carroll County","A_A",90,40,-50,-76.92,"undercount"
"2414",17015,"Illinois","Carroll County","A_AIC",151,89,-62,-51.67,"undercount"
"2415",17015,"Illinois","Carroll County","NHPI_A",4,8,4,66.67,"overcount"
"2416",17015,"Illinois","Carroll County","NHPI_AIC",13,26,13,66.67,"overcount"
"2417",17017,"Illinois","Cass County","A_A",93,117,24,22.86,"overcount"
"2418",17017,"Illinois","Cass County","A_AIC",118,135,17,13.44,"overcount"
"2419",17017,"Illinois","Cass County","NHPI_A",18,33,15,58.82,"overcount"
"2420",17017,"Illinois","Cass County","NHPI_AIC",23,38,15,49.18,"overcount"
"2421",17019,"Illinois","Champaign County","A_A",22571,24569,1998,8.48,"overcount"
"2422",17019,"Illinois","Champaign County","A_AIC",25276,27147,1871,7.14,"overcount"
"2423",17019,"Illinois","Champaign County","NHPI_A",228,69,-159,-107.07,"undercount"
"2424",17019,"Illinois","Champaign County","NHPI_AIC",540,282,-258,-62.77,"undercount"
"2425",17021,"Illinois","Christian County","A_A",247,181,-66,-30.84,"undercount"
"2426",17021,"Illinois","Christian County","A_AIC",309,270,-39,-13.47,"undercount"
"2427",17021,"Illinois","Christian County","NHPI_A",14,1,-13,-173.33,"undercount"
"2428",17021,"Illinois","Christian County","NHPI_AIC",21,14,-7,-40,"undercount"
"2429",17023,"Illinois","Clark County","A_A",57,53,-4,-7.27,"undercount"
"2430",17023,"Illinois","Clark County","A_AIC",88,90,2,2.25,"overcount"
"2431",17023,"Illinois","Clark County","NHPI_A",5,0,-5,-200,"undercount"
"2432",17023,"Illinois","Clark County","NHPI_AIC",9,10,1,10.53,"overcount"
"2433",17025,"Illinois","Clay County","A_A",113,80,-33,-34.2,"undercount"
"2434",17025,"Illinois","Clay County","A_AIC",139,108,-31,-25.1,"undercount"
"2435",17025,"Illinois","Clay County","NHPI_A",2,0,-2,-200,"undercount"
"2436",17025,"Illinois","Clay County","NHPI_AIC",5,6,1,18.18,"overcount"
"2437",17027,"Illinois","Clinton County","A_A",226,181,-45,-22.11,"undercount"
"2438",17027,"Illinois","Clinton County","A_AIC",379,352,-27,-7.39,"undercount"
"2439",17027,"Illinois","Clinton County","NHPI_A",24,5,-19,-131.03,"undercount"
"2440",17027,"Illinois","Clinton County","NHPI_AIC",35,33,-2,-5.88,"undercount"
"2441",17029,"Illinois","Coles County","A_A",500,618,118,21.11,"overcount"
"2442",17029,"Illinois","Coles County","A_AIC",711,852,141,18.04,"overcount"
"2443",17029,"Illinois","Coles County","NHPI_A",64,24,-40,-90.91,"undercount"
"2444",17029,"Illinois","Coles County","NHPI_AIC",103,63,-40,-48.19,"undercount"
"2445",17031,"Illinois","Cook County","A_A",413443,411944,-1499,-0.36,"undercount"
"2446",17031,"Illinois","Cook County","A_AIC",458257,460698,2441,0.53,"overcount"
"2447",17031,"Illinois","Cook County","NHPI_A",3735,1107,-2628,-108.55,"undercount"
"2448",17031,"Illinois","Cook County","NHPI_AIC",8533,4342,-4191,-65.1,"undercount"
"2449",17033,"Illinois","Crawford County","A_A",115,76,-39,-40.84,"undercount"
"2450",17033,"Illinois","Crawford County","A_AIC",165,157,-8,-4.97,"undercount"
"2451",17033,"Illinois","Crawford County","NHPI_A",9,2,-7,-127.27,"undercount"
"2452",17033,"Illinois","Crawford County","NHPI_AIC",16,14,-2,-13.33,"undercount"
"2453",17035,"Illinois","Cumberland County","A_A",67,21,-46,-104.55,"undercount"
"2454",17035,"Illinois","Cumberland County","A_AIC",92,29,-63,-104.13,"undercount"
"2455",17035,"Illinois","Cumberland County","NHPI_A",8,0,-8,-200,"undercount"
"2456",17035,"Illinois","Cumberland County","NHPI_AIC",9,5,-4,-57.14,"undercount"
"2457",17037,"Illinois","DeKalb County","A_A",2893,2297,-596,-22.97,"undercount"
"2458",17037,"Illinois","DeKalb County","A_AIC",3628,3055,-573,-17.15,"undercount"
"2459",17037,"Illinois","DeKalb County","NHPI_A",97,29,-68,-107.94,"undercount"
"2460",17037,"Illinois","DeKalb County","NHPI_AIC",178,105,-73,-51.59,"undercount"
"2461",17039,"Illinois","De Witt County","A_A",69,44,-25,-44.25,"undercount"
"2462",17039,"Illinois","De Witt County","A_AIC",116,110,-6,-5.31,"undercount"
"2463",17039,"Illinois","De Witt County","NHPI_A",8,16,8,66.67,"overcount"
"2464",17039,"Illinois","De Witt County","NHPI_AIC",16,42,26,89.66,"overcount"
"2465",17041,"Illinois","Douglas County","A_A",141,103,-38,-31.15,"undercount"
"2466",17041,"Illinois","Douglas County","A_AIC",196,157,-39,-22.1,"undercount"
"2467",17041,"Illinois","Douglas County","NHPI_A",0,6,6,200,"overcount"
"2468",17041,"Illinois","Douglas County","NHPI_AIC",8,25,17,103.03,"overcount"
"2469",17043,"Illinois","DuPage County","A_A",120081,119903,-178,-0.15,"undercount"
"2470",17043,"Illinois","DuPage County","A_AIC",130337,131392,1055,0.81,"overcount"
"2471",17043,"Illinois","DuPage County","NHPI_A",506,232,-274,-74.25,"undercount"
"2472",17043,"Illinois","DuPage County","NHPI_AIC",1405,984,-421,-35.24,"undercount"
"2473",17045,"Illinois","Edgar County","A_A",66,51,-15,-25.64,"undercount"
"2474",17045,"Illinois","Edgar County","A_AIC",85,82,-3,-3.59,"undercount"
"2475",17045,"Illinois","Edgar County","NHPI_A",5,0,-5,-200,"undercount"
"2476",17045,"Illinois","Edgar County","NHPI_AIC",9,14,5,43.48,"overcount"
"2477",17047,"Illinois","Edwards County","A_A",29,25,-4,-14.81,"undercount"
"2478",17047,"Illinois","Edwards County","A_AIC",47,42,-5,-11.24,"undercount"
"2479",17047,"Illinois","Edwards County","NHPI_A",0,4,4,200,"overcount"
"2480",17047,"Illinois","Edwards County","NHPI_AIC",3,7,4,80,"overcount"
"2481",17049,"Illinois","Effingham County","A_A",282,249,-33,-12.43,"undercount"
"2482",17049,"Illinois","Effingham County","A_AIC",342,355,13,3.73,"overcount"
"2483",17049,"Illinois","Effingham County","NHPI_A",9,6,-3,-40,"undercount"
"2484",17049,"Illinois","Effingham County","NHPI_AIC",23,33,10,35.71,"overcount"
"2485",17051,"Illinois","Fayette County","A_A",82,68,-14,-18.67,"undercount"
"2486",17051,"Illinois","Fayette County","A_AIC",135,116,-19,-15.14,"undercount"
"2487",17051,"Illinois","Fayette County","NHPI_A",5,1,-4,-133.33,"undercount"
"2488",17051,"Illinois","Fayette County","NHPI_AIC",14,17,3,19.35,"overcount"
"2489",17053,"Illinois","Ford County","A_A",66,57,-9,-14.63,"undercount"
"2490",17053,"Illinois","Ford County","A_AIC",130,114,-16,-13.11,"undercount"
"2491",17053,"Illinois","Ford County","NHPI_A",9,0,-9,-200,"undercount"
"2492",17053,"Illinois","Ford County","NHPI_AIC",19,9,-10,-71.43,"undercount"
"2493",17055,"Illinois","Franklin County","A_A",151,121,-30,-22.06,"undercount"
"2494",17055,"Illinois","Franklin County","A_AIC",248,252,4,1.6,"overcount"
"2495",17055,"Illinois","Franklin County","NHPI_A",6,4,-2,-40,"undercount"
"2496",17055,"Illinois","Franklin County","NHPI_AIC",16,48,32,100,"overcount"
"2497",17057,"Illinois","Fulton County","A_A",108,72,-36,-40,"undercount"
"2498",17057,"Illinois","Fulton County","A_AIC",188,147,-41,-24.48,"undercount"
"2499",17057,"Illinois","Fulton County","NHPI_A",8,6,-2,-28.57,"undercount"
"2500",17057,"Illinois","Fulton County","NHPI_AIC",27,17,-10,-45.45,"undercount"
"2501",17059,"Illinois","Gallatin County","A_A",14,23,9,48.65,"overcount"
"2502",17059,"Illinois","Gallatin County","A_AIC",30,58,28,63.64,"overcount"
"2503",17059,"Illinois","Gallatin County","NHPI_A",0,0,0,0,"equal"
"2504",17059,"Illinois","Gallatin County","NHPI_AIC",3,8,5,90.91,"overcount"
"2505",17061,"Illinois","Greene County","A_A",33,21,-12,-44.44,"undercount"
"2506",17061,"Illinois","Greene County","A_AIC",46,43,-3,-6.74,"undercount"
"2507",17061,"Illinois","Greene County","NHPI_A",2,4,2,66.67,"overcount"
"2508",17061,"Illinois","Greene County","NHPI_AIC",6,10,4,50,"overcount"
"2509",17063,"Illinois","Grundy County","A_A",484,466,-18,-3.79,"undercount"
"2510",17063,"Illinois","Grundy County","A_AIC",705,711,6,0.85,"overcount"
"2511",17063,"Illinois","Grundy County","NHPI_A",51,16,-35,-104.48,"undercount"
"2512",17063,"Illinois","Grundy County","NHPI_AIC",84,50,-34,-50.75,"undercount"
"2513",17065,"Illinois","Hamilton County","A_A",59,14,-45,-123.29,"undercount"
"2514",17065,"Illinois","Hamilton County","A_AIC",80,50,-30,-46.15,"undercount"
"2515",17065,"Illinois","Hamilton County","NHPI_A",1,0,-1,-200,"undercount"
"2516",17065,"Illinois","Hamilton County","NHPI_AIC",1,9,8,160,"overcount"
"2517",17067,"Illinois","Hancock County","A_A",57,58,1,1.74,"overcount"
"2518",17067,"Illinois","Hancock County","A_AIC",95,109,14,13.73,"overcount"
"2519",17067,"Illinois","Hancock County","NHPI_A",16,4,-12,-120,"undercount"
"2520",17067,"Illinois","Hancock County","NHPI_AIC",24,15,-9,-46.15,"undercount"
"2521",17069,"Illinois","Hardin County","A_A",19,29,10,41.67,"overcount"
"2522",17069,"Illinois","Hardin County","A_AIC",34,40,6,16.22,"overcount"
"2523",17069,"Illinois","Hardin County","NHPI_A",5,2,-3,-85.71,"undercount"
"2524",17069,"Illinois","Hardin County","NHPI_AIC",8,12,4,40,"overcount"
"2525",17071,"Illinois","Henderson County","A_A",35,14,-21,-85.71,"undercount"
"2526",17071,"Illinois","Henderson County","A_AIC",49,28,-21,-54.55,"undercount"
"2527",17071,"Illinois","Henderson County","NHPI_A",5,5,0,0,"equal"
"2528",17071,"Illinois","Henderson County","NHPI_AIC",8,8,0,0,"equal"
"2529",17073,"Illinois","Henry County","A_A",241,192,-49,-22.63,"undercount"
"2530",17073,"Illinois","Henry County","A_AIC",382,373,-9,-2.38,"undercount"
"2531",17073,"Illinois","Henry County","NHPI_A",19,12,-7,-45.16,"undercount"
"2532",17073,"Illinois","Henry County","NHPI_AIC",48,44,-4,-8.7,"undercount"
"2533",17075,"Illinois","Iroquois County","A_A",153,105,-48,-37.21,"undercount"
"2534",17075,"Illinois","Iroquois County","A_AIC",214,183,-31,-15.62,"undercount"
"2535",17075,"Illinois","Iroquois County","NHPI_A",9,0,-9,-200,"undercount"
"2536",17075,"Illinois","Iroquois County","NHPI_AIC",19,15,-4,-23.53,"undercount"
"2537",17077,"Illinois","Jackson County","A_A",1945,2061,116,5.79,"overcount"
"2538",17077,"Illinois","Jackson County","A_AIC",2397,2459,62,2.55,"overcount"
"2539",17077,"Illinois","Jackson County","NHPI_A",55,24,-31,-78.48,"undercount"
"2540",17077,"Illinois","Jackson County","NHPI_AIC",138,82,-56,-50.91,"undercount"
"2541",17079,"Illinois","Jasper County","A_A",30,15,-15,-66.67,"undercount"
"2542",17079,"Illinois","Jasper County","A_AIC",37,22,-15,-50.85,"undercount"
"2543",17079,"Illinois","Jasper County","NHPI_A",2,4,2,66.67,"overcount"
"2544",17079,"Illinois","Jasper County","NHPI_AIC",3,7,4,80,"overcount"
"2545",17081,"Illinois","Jefferson County","A_A",443,354,-89,-22.33,"undercount"
"2546",17081,"Illinois","Jefferson County","A_AIC",579,479,-100,-18.9,"undercount"
"2547",17081,"Illinois","Jefferson County","NHPI_A",14,7,-7,-66.67,"undercount"
"2548",17081,"Illinois","Jefferson County","NHPI_AIC",37,43,6,15,"overcount"
"2549",17083,"Illinois","Jersey County","A_A",164,75,-89,-74.48,"undercount"
"2550",17083,"Illinois","Jersey County","A_AIC",231,150,-81,-42.52,"undercount"
"2551",17083,"Illinois","Jersey County","NHPI_A",7,3,-4,-80,"undercount"
"2552",17083,"Illinois","Jersey County","NHPI_AIC",21,21,0,0,"equal"
"2553",17085,"Illinois","Jo Daviess County","A_A",105,98,-7,-6.9,"undercount"
"2554",17085,"Illinois","Jo Daviess County","A_AIC",149,156,7,4.59,"overcount"
"2555",17085,"Illinois","Jo Daviess County","NHPI_A",14,6,-8,-80,"undercount"
"2556",17085,"Illinois","Jo Daviess County","NHPI_AIC",22,11,-11,-66.67,"undercount"
"2557",17087,"Illinois","Johnson County","A_A",37,18,-19,-69.09,"undercount"
"2558",17087,"Illinois","Johnson County","A_AIC",71,39,-32,-58.18,"undercount"
"2559",17087,"Illinois","Johnson County","NHPI_A",4,4,0,0,"equal"
"2560",17087,"Illinois","Johnson County","NHPI_AIC",9,7,-2,-25,"undercount"
"2561",17089,"Illinois","Kane County","A_A",23657,21362,-2295,-10.2,"undercount"
"2562",17089,"Illinois","Kane County","A_AIC",27112,25602,-1510,-5.73,"undercount"
"2563",17089,"Illinois","Kane County","NHPI_A",433,121,-312,-112.64,"undercount"
"2564",17089,"Illinois","Kane County","NHPI_AIC",754,395,-359,-62.49,"undercount"
"2565",17091,"Illinois","Kankakee County","A_A",1138,1083,-55,-4.95,"undercount"
"2566",17091,"Illinois","Kankakee County","A_AIC",1545,1512,-33,-2.16,"undercount"
"2567",17091,"Illinois","Kankakee County","NHPI_A",50,13,-37,-117.46,"undercount"
"2568",17091,"Illinois","Kankakee County","NHPI_AIC",130,76,-54,-52.43,"undercount"
"2569",17093,"Illinois","Kendall County","A_A",4677,4681,4,0.09,"overcount"
"2570",17093,"Illinois","Kendall County","A_AIC",5839,5985,146,2.47,"overcount"
"2571",17093,"Illinois","Kendall County","NHPI_A",109,12,-97,-160.33,"undercount"
"2572",17093,"Illinois","Kendall County","NHPI_AIC",216,117,-99,-59.46,"undercount"
"2573",17095,"Illinois","Knox County","A_A",464,385,-79,-18.61,"undercount"
"2574",17095,"Illinois","Knox County","A_AIC",663,710,47,6.85,"overcount"
"2575",17095,"Illinois","Knox County","NHPI_A",22,12,-10,-58.82,"undercount"
"2576",17095,"Illinois","Knox County","NHPI_AIC",61,185,124,100.81,"overcount"
"2577",17097,"Illinois","Lake County","A_A",60961,59221,-1740,-2.9,"undercount"
"2578",17097,"Illinois","Lake County","A_AIC",68072,67099,-973,-1.44,"undercount"
"2579",17097,"Illinois","Lake County","NHPI_A",689,343,-346,-67.05,"undercount"
"2580",17097,"Illinois","Lake County","NHPI_AIC",1550,1119,-431,-32.3,"undercount"
"2581",17099,"Illinois","LaSalle County","A_A",1081,863,-218,-22.43,"undercount"
"2582",17099,"Illinois","LaSalle County","A_AIC",1426,1266,-160,-11.89,"undercount"
"2583",17099,"Illinois","LaSalle County","NHPI_A",42,8,-34,-136,"undercount"
"2584",17099,"Illinois","LaSalle County","NHPI_AIC",82,29,-53,-95.5,"undercount"
"2585",17101,"Illinois","Lawrence County","A_A",80,58,-22,-31.88,"undercount"
"2586",17101,"Illinois","Lawrence County","A_AIC",105,90,-15,-15.38,"undercount"
"2587",17101,"Illinois","Lawrence County","NHPI_A",6,7,1,15.38,"overcount"
"2588",17101,"Illinois","Lawrence County","NHPI_AIC",10,14,4,33.33,"overcount"
"2589",17103,"Illinois","Lee County","A_A",274,248,-26,-9.96,"undercount"
"2590",17103,"Illinois","Lee County","A_AIC",376,352,-24,-6.59,"undercount"
"2591",17103,"Illinois","Lee County","NHPI_A",17,10,-7,-51.85,"undercount"
"2592",17103,"Illinois","Lee County","NHPI_AIC",32,31,-1,-3.17,"undercount"
"2593",17105,"Illinois","Livingston County","A_A",249,171,-78,-37.14,"undercount"
"2594",17105,"Illinois","Livingston County","A_AIC",360,269,-91,-28.93,"undercount"
"2595",17105,"Illinois","Livingston County","NHPI_A",7,1,-6,-150,"undercount"
"2596",17105,"Illinois","Livingston County","NHPI_AIC",28,32,4,13.33,"overcount"
"2597",17107,"Illinois","Logan County","A_A",201,178,-23,-12.14,"undercount"
"2598",17107,"Illinois","Logan County","A_AIC",323,285,-38,-12.5,"undercount"
"2599",17107,"Illinois","Logan County","NHPI_A",6,1,-5,-142.86,"undercount"
"2600",17107,"Illinois","Logan County","NHPI_AIC",21,36,15,52.63,"overcount"
"2601",17109,"Illinois","McDonough County","A_A",685,572,-113,-17.98,"undercount"
"2602",17109,"Illinois","McDonough County","A_AIC",837,698,-139,-18.11,"undercount"
"2603",17109,"Illinois","McDonough County","NHPI_A",6,6,0,0,"equal"
"2604",17109,"Illinois","McDonough County","NHPI_AIC",26,40,14,42.42,"overcount"
"2605",17111,"Illinois","McHenry County","A_A",9295,8800,-495,-5.47,"undercount"
"2606",17111,"Illinois","McHenry County","A_AIC",11585,11420,-165,-1.43,"undercount"
"2607",17111,"Illinois","McHenry County","NHPI_A",173,47,-126,-114.55,"undercount"
"2608",17111,"Illinois","McHenry County","NHPI_AIC",367,249,-118,-38.31,"undercount"
"2609",17113,"Illinois","McLean County","A_A",8519,8179,-340,-4.07,"undercount"
"2610",17113,"Illinois","McLean County","A_AIC",9749,9485,-264,-2.75,"undercount"
"2611",17113,"Illinois","McLean County","NHPI_A",98,38,-60,-88.24,"undercount"
"2612",17113,"Illinois","McLean County","NHPI_AIC",226,154,-72,-37.89,"undercount"
"2613",17115,"Illinois","Macon County","A_A",1199,1517,318,23.42,"overcount"
"2614",17115,"Illinois","Macon County","A_AIC",1701,1959,258,14.1,"overcount"
"2615",17115,"Illinois","Macon County","NHPI_A",54,31,-23,-54.12,"undercount"
"2616",17115,"Illinois","Macon County","NHPI_AIC",169,88,-81,-63.04,"undercount"
"2617",17117,"Illinois","Macoupin County","A_A",174,179,5,2.83,"overcount"
"2618",17117,"Illinois","Macoupin County","A_AIC",289,347,58,18.24,"overcount"
"2619",17117,"Illinois","Macoupin County","NHPI_A",15,0,-15,-200,"undercount"
"2620",17117,"Illinois","Macoupin County","NHPI_AIC",33,36,3,8.7,"overcount"
"2621",17119,"Illinois","Madison County","A_A",2781,2807,26,0.93,"overcount"
"2622",17119,"Illinois","Madison County","A_AIC",4207,4400,193,4.48,"overcount"
"2623",17119,"Illinois","Madison County","NHPI_A",174,99,-75,-54.95,"undercount"
"2624",17119,"Illinois","Madison County","NHPI_AIC",359,306,-53,-15.94,"undercount"
"2625",17121,"Illinois","Marion County","A_A",226,349,123,42.78,"overcount"
"2626",17121,"Illinois","Marion County","A_AIC",315,460,145,37.42,"overcount"
"2627",17121,"Illinois","Marion County","NHPI_A",10,1,-9,-163.64,"undercount"
"2628",17121,"Illinois","Marion County","NHPI_AIC",28,30,2,6.9,"overcount"
"2629",17123,"Illinois","Marshall County","A_A",57,43,-14,-28,"undercount"
"2630",17123,"Illinois","Marshall County","A_AIC",106,79,-27,-29.19,"undercount"
"2631",17123,"Illinois","Marshall County","NHPI_A",3,0,-3,-200,"undercount"
"2632",17123,"Illinois","Marshall County","NHPI_AIC",8,19,11,81.48,"overcount"
"2633",17125,"Illinois","Mason County","A_A",74,26,-48,-96,"undercount"
"2634",17125,"Illinois","Mason County","A_AIC",112,63,-49,-56,"undercount"
"2635",17125,"Illinois","Mason County","NHPI_A",1,1,0,0,"equal"
"2636",17125,"Illinois","Mason County","NHPI_AIC",5,4,-1,-22.22,"undercount"
"2637",17127,"Illinois","Massac County","A_A",72,43,-29,-50.43,"undercount"
"2638",17127,"Illinois","Massac County","A_AIC",117,94,-23,-21.8,"undercount"
"2639",17127,"Illinois","Massac County","NHPI_A",2,6,4,100,"overcount"
"2640",17127,"Illinois","Massac County","NHPI_AIC",8,17,9,72,"overcount"
"2641",17129,"Illinois","Menard County","A_A",52,49,-3,-5.94,"undercount"
"2642",17129,"Illinois","Menard County","A_AIC",88,90,2,2.25,"overcount"
"2643",17129,"Illinois","Menard County","NHPI_A",5,2,-3,-85.71,"undercount"
"2644",17129,"Illinois","Menard County","NHPI_AIC",9,9,0,0,"equal"
"2645",17131,"Illinois","Mercer County","A_A",78,39,-39,-66.67,"undercount"
"2646",17131,"Illinois","Mercer County","A_AIC",112,85,-27,-27.41,"undercount"
"2647",17131,"Illinois","Mercer County","NHPI_A",3,2,-1,-40,"undercount"
"2648",17131,"Illinois","Mercer County","NHPI_AIC",7,12,5,52.63,"overcount"
"2649",17133,"Illinois","Monroe County","A_A",222,208,-14,-6.51,"undercount"
"2650",17133,"Illinois","Monroe County","A_AIC",351,371,20,5.54,"overcount"
"2651",17133,"Illinois","Monroe County","NHPI_A",12,2,-10,-142.86,"undercount"
"2652",17133,"Illinois","Monroe County","NHPI_AIC",22,11,-11,-66.67,"undercount"
"2653",17135,"Illinois","Montgomery County","A_A",136,131,-5,-3.75,"undercount"
"2654",17135,"Illinois","Montgomery County","A_AIC",195,211,16,7.88,"overcount"
"2655",17135,"Illinois","Montgomery County","NHPI_A",12,7,-5,-52.63,"undercount"
"2656",17135,"Illinois","Montgomery County","NHPI_AIC",23,25,2,8.33,"overcount"
"2657",17137,"Illinois","Morgan County","A_A",273,268,-5,-1.85,"undercount"
"2658",17137,"Illinois","Morgan County","A_AIC",363,352,-11,-3.08,"undercount"
"2659",17137,"Illinois","Morgan County","NHPI_A",21,18,-3,-15.38,"undercount"
"2660",17137,"Illinois","Morgan County","NHPI_AIC",35,37,2,5.56,"overcount"
"2661",17139,"Illinois","Moultrie County","A_A",42,49,7,15.38,"overcount"
"2662",17139,"Illinois","Moultrie County","A_AIC",71,82,11,14.38,"overcount"
"2663",17139,"Illinois","Moultrie County","NHPI_A",5,0,-5,-200,"undercount"
"2664",17139,"Illinois","Moultrie County","NHPI_AIC",11,7,-4,-44.44,"undercount"
"2665",17141,"Illinois","Ogle County","A_A",323,259,-64,-21.99,"undercount"
"2666",17141,"Illinois","Ogle County","A_AIC",488,465,-23,-4.83,"undercount"
"2667",17141,"Illinois","Ogle County","NHPI_A",41,0,-41,-200,"undercount"
"2668",17141,"Illinois","Ogle County","NHPI_AIC",64,37,-27,-53.47,"undercount"
"2669",17143,"Illinois","Peoria County","A_A",7533,7768,235,3.07,"overcount"
"2670",17143,"Illinois","Peoria County","A_AIC",8649,8913,264,3.01,"overcount"
"2671",17143,"Illinois","Peoria County","NHPI_A",129,62,-67,-70.16,"undercount"
"2672",17143,"Illinois","Peoria County","NHPI_AIC",295,163,-132,-57.64,"undercount"
"2673",17145,"Illinois","Perry County","A_A",117,127,10,8.2,"overcount"
"2674",17145,"Illinois","Perry County","A_AIC",183,154,-29,-17.21,"undercount"
"2675",17145,"Illinois","Perry County","NHPI_A",14,1,-13,-173.33,"undercount"
"2676",17145,"Illinois","Perry County","NHPI_AIC",22,20,-2,-9.52,"undercount"
"2677",17147,"Illinois","Piatt County","A_A",82,80,-2,-2.47,"undercount"
"2678",17147,"Illinois","Piatt County","A_AIC",153,140,-13,-8.87,"undercount"
"2679",17147,"Illinois","Piatt County","NHPI_A",7,2,-5,-111.11,"undercount"
"2680",17147,"Illinois","Piatt County","NHPI_AIC",17,15,-2,-12.5,"undercount"
"2681",17149,"Illinois","Pike County","A_A",50,47,-3,-6.19,"undercount"
"2682",17149,"Illinois","Pike County","A_AIC",73,68,-5,-7.09,"undercount"
"2683",17149,"Illinois","Pike County","NHPI_A",7,6,-1,-15.38,"undercount"
"2684",17149,"Illinois","Pike County","NHPI_AIC",9,11,2,20,"overcount"
"2685",17151,"Illinois","Pope County","A_A",15,16,1,6.45,"overcount"
"2686",17151,"Illinois","Pope County","A_AIC",23,38,15,49.18,"overcount"
"2687",17151,"Illinois","Pope County","NHPI_A",5,0,-5,-200,"undercount"
"2688",17151,"Illinois","Pope County","NHPI_AIC",5,5,0,0,"equal"
"2689",17153,"Illinois","Pulaski County","A_A",23,13,-10,-55.56,"undercount"
"2690",17153,"Illinois","Pulaski County","A_AIC",55,35,-20,-44.44,"undercount"
"2691",17153,"Illinois","Pulaski County","NHPI_A",3,0,-3,-200,"undercount"
"2692",17153,"Illinois","Pulaski County","NHPI_AIC",6,7,1,15.38,"overcount"
"2693",17155,"Illinois","Putnam County","A_A",34,18,-16,-61.54,"undercount"
"2694",17155,"Illinois","Putnam County","A_AIC",48,35,-13,-31.33,"undercount"
"2695",17155,"Illinois","Putnam County","NHPI_A",5,4,-1,-22.22,"undercount"
"2696",17155,"Illinois","Putnam County","NHPI_AIC",8,6,-2,-28.57,"undercount"
"2697",17157,"Illinois","Randolph County","A_A",162,89,-73,-58.17,"undercount"
"2698",17157,"Illinois","Randolph County","A_AIC",242,166,-76,-37.25,"undercount"
"2699",17157,"Illinois","Randolph County","NHPI_A",23,7,-16,-106.67,"undercount"
"2700",17157,"Illinois","Randolph County","NHPI_AIC",37,18,-19,-69.09,"undercount"
"2701",17159,"Illinois","Richland County","A_A",144,123,-21,-15.73,"undercount"
"2702",17159,"Illinois","Richland County","A_AIC",194,196,2,1.03,"overcount"
"2703",17159,"Illinois","Richland County","NHPI_A",5,7,2,33.33,"overcount"
"2704",17159,"Illinois","Richland County","NHPI_AIC",11,12,1,8.7,"overcount"
"2705",17161,"Illinois","Rock Island County","A_A",3765,4054,289,7.39,"overcount"
"2706",17161,"Illinois","Rock Island County","A_AIC",4566,4717,151,3.25,"overcount"
"2707",17161,"Illinois","Rock Island County","NHPI_A",63,39,-24,-47.06,"undercount"
"2708",17161,"Illinois","Rock Island County","NHPI_AIC",226,110,-116,-69.05,"undercount"
"2709",17163,"Illinois","St. Clair County","A_A",3987,3660,-327,-8.55,"undercount"
"2710",17163,"Illinois","St. Clair County","A_AIC",6426,6246,-180,-2.84,"undercount"
"2711",17163,"Illinois","St. Clair County","NHPI_A",241,185,-56,-26.29,"undercount"
"2712",17163,"Illinois","St. Clair County","NHPI_AIC",549,553,4,0.73,"overcount"
"2713",17165,"Illinois","Saline County","A_A",146,123,-23,-17.1,"undercount"
"2714",17165,"Illinois","Saline County","A_AIC",232,186,-46,-22.01,"undercount"
"2715",17165,"Illinois","Saline County","NHPI_A",24,1,-23,-184,"undercount"
"2716",17165,"Illinois","Saline County","NHPI_AIC",41,7,-34,-141.67,"undercount"
"2717",17167,"Illinois","Sangamon County","A_A",4286,4300,14,0.33,"overcount"
"2718",17167,"Illinois","Sangamon County","A_AIC",5324,5420,96,1.79,"overcount"
"2719",17167,"Illinois","Sangamon County","NHPI_A",68,55,-13,-21.14,"undercount"
"2720",17167,"Illinois","Sangamon County","NHPI_AIC",226,211,-15,-6.86,"undercount"
"2721",17169,"Illinois","Schuyler County","A_A",25,25,0,0,"equal"
"2722",17169,"Illinois","Schuyler County","A_AIC",35,46,11,27.16,"overcount"
"2723",17169,"Illinois","Schuyler County","NHPI_A",0,2,2,200,"overcount"
"2724",17169,"Illinois","Schuyler County","NHPI_AIC",1,8,7,155.56,"overcount"
"2725",17171,"Illinois","Scott County","A_A",13,13,0,0,"equal"
"2726",17171,"Illinois","Scott County","A_AIC",25,21,-4,-17.39,"undercount"
"2727",17171,"Illinois","Scott County","NHPI_A",36,1,-35,-189.19,"undercount"
"2728",17171,"Illinois","Scott County","NHPI_AIC",40,10,-30,-120,"undercount"
"2729",17173,"Illinois","Shelby County","A_A",77,83,6,7.5,"overcount"
"2730",17173,"Illinois","Shelby County","A_AIC",129,129,0,0,"equal"
"2731",17173,"Illinois","Shelby County","NHPI_A",10,1,-9,-163.64,"undercount"
"2732",17173,"Illinois","Shelby County","NHPI_AIC",17,12,-5,-34.48,"undercount"
"2733",17175,"Illinois","Stark County","A_A",40,23,-17,-53.97,"undercount"
"2734",17175,"Illinois","Stark County","A_AIC",62,36,-26,-53.06,"undercount"
"2735",17175,"Illinois","Stark County","NHPI_A",5,0,-5,-200,"undercount"
"2736",17175,"Illinois","Stark County","NHPI_AIC",9,4,-5,-76.92,"undercount"
"2737",17177,"Illinois","Stephenson County","A_A",337,306,-31,-9.64,"undercount"
"2738",17177,"Illinois","Stephenson County","A_AIC",532,489,-43,-8.42,"undercount"
"2739",17177,"Illinois","Stephenson County","NHPI_A",21,11,-10,-62.5,"undercount"
"2740",17177,"Illinois","Stephenson County","NHPI_AIC",54,43,-11,-22.68,"undercount"
"2741",17179,"Illinois","Tazewell County","A_A",1232,1090,-142,-12.23,"undercount"
"2742",17179,"Illinois","Tazewell County","A_AIC",1806,1728,-78,-4.41,"undercount"
"2743",17179,"Illinois","Tazewell County","NHPI_A",52,49,-3,-5.94,"undercount"
"2744",17179,"Illinois","Tazewell County","NHPI_AIC",105,142,37,29.96,"overcount"
"2745",17181,"Illinois","Union County","A_A",85,69,-16,-20.78,"undercount"
"2746",17181,"Illinois","Union County","A_AIC",139,132,-7,-5.17,"undercount"
"2747",17181,"Illinois","Union County","NHPI_A",7,11,4,44.44,"overcount"
"2748",17181,"Illinois","Union County","NHPI_AIC",26,25,-1,-3.92,"undercount"
"2749",17183,"Illinois","Vermilion County","A_A",660,573,-87,-14.11,"undercount"
"2750",17183,"Illinois","Vermilion County","A_AIC",917,767,-150,-17.81,"undercount"
"2751",17183,"Illinois","Vermilion County","NHPI_A",44,11,-33,-120,"undercount"
"2752",17183,"Illinois","Vermilion County","NHPI_AIC",101,30,-71,-108.4,"undercount"
"2753",17185,"Illinois","Wabash County","A_A",144,266,122,59.51,"overcount"
"2754",17185,"Illinois","Wabash County","A_AIC",174,292,118,50.64,"overcount"
"2755",17185,"Illinois","Wabash County","NHPI_A",6,6,0,0,"equal"
"2756",17185,"Illinois","Wabash County","NHPI_AIC",14,12,-2,-15.38,"undercount"
"2757",17187,"Illinois","Warren County","A_A",403,329,-74,-20.22,"undercount"
"2758",17187,"Illinois","Warren County","A_AIC",454,400,-54,-12.65,"undercount"
"2759",17187,"Illinois","Warren County","NHPI_A",38,15,-23,-86.79,"undercount"
"2760",17187,"Illinois","Warren County","NHPI_AIC",49,38,-11,-25.29,"undercount"
"2761",17189,"Illinois","Washington County","A_A",71,65,-6,-8.82,"undercount"
"2762",17189,"Illinois","Washington County","A_AIC",87,83,-4,-4.71,"undercount"
"2763",17189,"Illinois","Washington County","NHPI_A",3,20,17,147.83,"overcount"
"2764",17189,"Illinois","Washington County","NHPI_AIC",5,27,22,137.5,"overcount"
"2765",17191,"Illinois","Wayne County","A_A",95,50,-45,-62.07,"undercount"
"2766",17191,"Illinois","Wayne County","A_AIC",130,86,-44,-40.74,"undercount"
"2767",17191,"Illinois","Wayne County","NHPI_A",2,5,3,85.71,"overcount"
"2768",17191,"Illinois","Wayne County","NHPI_AIC",6,9,3,40,"overcount"
"2769",17193,"Illinois","White County","A_A",71,65,-6,-8.82,"undercount"
"2770",17193,"Illinois","White County","A_AIC",101,112,11,10.33,"overcount"
"2771",17193,"Illinois","White County","NHPI_A",7,18,11,88,"overcount"
"2772",17193,"Illinois","White County","NHPI_AIC",14,22,8,44.44,"overcount"
"2773",17195,"Illinois","Whiteside County","A_A",336,310,-26,-8.05,"undercount"
"2774",17195,"Illinois","Whiteside County","A_AIC",477,472,-5,-1.05,"undercount"
"2775",17195,"Illinois","Whiteside County","NHPI_A",14,9,-5,-43.48,"undercount"
"2776",17195,"Illinois","Whiteside County","NHPI_AIC",45,34,-11,-27.85,"undercount"
"2777",17197,"Illinois","Will County","A_A",42986,42650,-336,-0.78,"undercount"
"2778",17197,"Illinois","Will County","A_AIC",48239,48355,116,0.24,"overcount"
"2779",17197,"Illinois","Will County","NHPI_A",366,113,-253,-105.64,"undercount"
"2780",17197,"Illinois","Will County","NHPI_AIC",793,511,-282,-43.25,"undercount"
"2781",17199,"Illinois","Williamson County","A_A",895,775,-120,-14.37,"undercount"
"2782",17199,"Illinois","Williamson County","A_AIC",1142,1065,-77,-6.98,"undercount"
"2783",17199,"Illinois","Williamson County","NHPI_A",20,9,-11,-75.86,"undercount"
"2784",17199,"Illinois","Williamson County","NHPI_AIC",57,24,-33,-81.48,"undercount"
"2785",17201,"Illinois","Winnebago County","A_A",7983,8062,79,0.98,"overcount"
"2786",17201,"Illinois","Winnebago County","A_AIC",9916,10036,120,1.2,"overcount"
"2787",17201,"Illinois","Winnebago County","NHPI_A",173,66,-107,-89.54,"undercount"
"2788",17201,"Illinois","Winnebago County","NHPI_AIC",381,257,-124,-38.87,"undercount"
"2789",17203,"Illinois","Woodford County","A_A",296,217,-79,-30.8,"undercount"
"2790",17203,"Illinois","Woodford County","A_AIC",415,390,-25,-6.21,"undercount"
"2791",17203,"Illinois","Woodford County","NHPI_A",14,10,-4,-33.33,"undercount"
"2792",17203,"Illinois","Woodford County","NHPI_AIC",21,23,2,9.09,"overcount"
"2793",18001,"Indiana","Adams County","A_A",139,135,-4,-2.92,"undercount"
"2794",18001,"Indiana","Adams County","A_AIC",185,204,19,9.77,"overcount"
"2795",18001,"Indiana","Adams County","NHPI_A",15,4,-11,-115.79,"undercount"
"2796",18001,"Indiana","Adams County","NHPI_AIC",22,30,8,30.77,"overcount"
"2797",18003,"Indiana","Allen County","A_A",18537,18414,-123,-0.67,"undercount"
"2798",18003,"Indiana","Allen County","A_AIC",20974,21143,169,0.8,"overcount"
"2799",18003,"Indiana","Allen County","NHPI_A",412,141,-271,-98.01,"undercount"
"2800",18003,"Indiana","Allen County","NHPI_AIC",804,495,-309,-47.58,"undercount"
"2801",18005,"Indiana","Bartholomew County","A_A",7098,5426,-1672,-26.7,"undercount"
"2802",18005,"Indiana","Bartholomew County","A_AIC",7371,5825,-1546,-23.43,"undercount"
"2803",18005,"Indiana","Bartholomew County","NHPI_A",77,45,-32,-52.46,"undercount"
"2804",18005,"Indiana","Bartholomew County","NHPI_AIC",138,132,-6,-4.44,"undercount"
"2805",18007,"Indiana","Benton County","A_A",18,15,-3,-18.18,"undercount"
"2806",18007,"Indiana","Benton County","A_AIC",34,22,-12,-42.86,"undercount"
"2807",18007,"Indiana","Benton County","NHPI_A",5,7,2,33.33,"overcount"
"2808",18007,"Indiana","Benton County","NHPI_AIC",6,13,7,73.68,"overcount"
"2809",18009,"Indiana","Blackford County","A_A",68,24,-44,-95.65,"undercount"
"2810",18009,"Indiana","Blackford County","A_AIC",89,58,-31,-42.18,"undercount"
"2811",18009,"Indiana","Blackford County","NHPI_A",4,0,-4,-200,"undercount"
"2812",18009,"Indiana","Blackford County","NHPI_AIC",8,15,7,60.87,"overcount"
"2813",18011,"Indiana","Boone County","A_A",2494,2412,-82,-3.34,"undercount"
"2814",18011,"Indiana","Boone County","A_AIC",2937,3017,80,2.69,"overcount"
"2815",18011,"Indiana","Boone County","NHPI_A",24,19,-5,-23.26,"undercount"
"2816",18011,"Indiana","Boone County","NHPI_AIC",62,77,15,21.58,"overcount"
"2817",18013,"Indiana","Brown County","A_A",65,69,4,5.97,"overcount"
"2818",18013,"Indiana","Brown County","A_AIC",116,98,-18,-16.82,"undercount"
"2819",18013,"Indiana","Brown County","NHPI_A",4,6,2,40,"overcount"
"2820",18013,"Indiana","Brown County","NHPI_AIC",11,9,-2,-20,"undercount"
"2821",18015,"Indiana","Carroll County","A_A",41,48,7,15.73,"overcount"
"2822",18015,"Indiana","Carroll County","A_AIC",71,94,23,27.88,"overcount"
"2823",18015,"Indiana","Carroll County","NHPI_A",7,0,-7,-200,"undercount"
"2824",18015,"Indiana","Carroll County","NHPI_AIC",14,11,-3,-24,"undercount"
"2825",18017,"Indiana","Cass County","A_A",787,587,-200,-29.11,"undercount"
"2826",18017,"Indiana","Cass County","A_AIC",854,727,-127,-16.07,"undercount"
"2827",18017,"Indiana","Cass County","NHPI_A",78,8,-70,-162.79,"undercount"
"2828",18017,"Indiana","Cass County","NHPI_AIC",92,35,-57,-89.76,"undercount"
"2829",18019,"Indiana","Clark County","A_A",1450,1314,-136,-9.84,"undercount"
"2830",18019,"Indiana","Clark County","A_AIC",1997,2036,39,1.93,"overcount"
"2831",18019,"Indiana","Clark County","NHPI_A",112,127,15,12.55,"overcount"
"2832",18019,"Indiana","Clark County","NHPI_AIC",237,249,12,4.94,"overcount"
"2833",18021,"Indiana","Clay County","A_A",94,91,-3,-3.24,"undercount"
"2834",18021,"Indiana","Clay County","A_AIC",137,146,9,6.36,"overcount"
"2835",18021,"Indiana","Clay County","NHPI_A",14,6,-8,-80,"undercount"
"2836",18021,"Indiana","Clay County","NHPI_AIC",19,25,6,27.27,"overcount"
"2837",18023,"Indiana","Clinton County","A_A",153,70,-83,-74.44,"undercount"
"2838",18023,"Indiana","Clinton County","A_AIC",203,155,-48,-26.82,"undercount"
"2839",18023,"Indiana","Clinton County","NHPI_A",13,13,0,0,"equal"
"2840",18023,"Indiana","Clinton County","NHPI_AIC",22,40,18,58.06,"overcount"
"2841",18025,"Indiana","Crawford County","A_A",24,17,-7,-34.15,"undercount"
"2842",18025,"Indiana","Crawford County","A_AIC",50,25,-25,-66.67,"undercount"
"2843",18025,"Indiana","Crawford County","NHPI_A",10,1,-9,-163.64,"undercount"
"2844",18025,"Indiana","Crawford County","NHPI_AIC",17,15,-2,-12.5,"undercount"
"2845",18027,"Indiana","Daviess County","A_A",157,132,-25,-17.3,"undercount"
"2846",18027,"Indiana","Daviess County","A_AIC",212,224,12,5.5,"overcount"
"2847",18027,"Indiana","Daviess County","NHPI_A",40,8,-32,-133.33,"undercount"
"2848",18027,"Indiana","Daviess County","NHPI_AIC",45,23,-22,-64.71,"undercount"
"2849",18029,"Indiana","Dearborn County","A_A",233,211,-22,-9.91,"undercount"
"2850",18029,"Indiana","Dearborn County","A_AIC",353,400,47,12.48,"overcount"
"2851",18029,"Indiana","Dearborn County","NHPI_A",33,22,-11,-40,"undercount"
"2852",18029,"Indiana","Dearborn County","NHPI_AIC",53,73,20,31.75,"overcount"
"2853",18031,"Indiana","Decatur County","A_A",349,154,-195,-77.53,"undercount"
"2854",18031,"Indiana","Decatur County","A_AIC",411,211,-200,-64.31,"undercount"
"2855",18031,"Indiana","Decatur County","NHPI_A",14,8,-6,-54.55,"undercount"
"2856",18031,"Indiana","Decatur County","NHPI_AIC",30,27,-3,-10.53,"undercount"
"2857",18033,"Indiana","DeKalb County","A_A",214,229,15,6.77,"overcount"
"2858",18033,"Indiana","DeKalb County","A_AIC",323,342,19,5.71,"overcount"
"2859",18033,"Indiana","DeKalb County","NHPI_A",29,39,10,29.41,"overcount"
"2860",18033,"Indiana","DeKalb County","NHPI_AIC",48,82,34,52.31,"overcount"
"2861",18035,"Indiana","Delaware County","A_A",1555,1401,-154,-10.42,"undercount"
"2862",18035,"Indiana","Delaware County","A_AIC",2136,1909,-227,-11.22,"undercount"
"2863",18035,"Indiana","Delaware County","NHPI_A",67,58,-9,-14.4,"undercount"
"2864",18035,"Indiana","Delaware County","NHPI_AIC",214,145,-69,-38.44,"undercount"
"2865",18037,"Indiana","Dubois County","A_A",301,266,-35,-12.35,"undercount"
"2866",18037,"Indiana","Dubois County","A_AIC",377,364,-13,-3.51,"undercount"
"2867",18037,"Indiana","Dubois County","NHPI_A",72,5,-67,-174.03,"undercount"
"2868",18037,"Indiana","Dubois County","NHPI_AIC",79,32,-47,-84.68,"undercount"
"2869",18039,"Indiana","Elkhart County","A_A",2614,2264,-350,-14.35,"undercount"
"2870",18039,"Indiana","Elkhart County","A_AIC",3488,3176,-312,-9.36,"undercount"
"2871",18039,"Indiana","Elkhart County","NHPI_A",185,56,-129,-107.05,"undercount"
"2872",18039,"Indiana","Elkhart County","NHPI_AIC",355,183,-172,-63.94,"undercount"
"2873",18041,"Indiana","Fayette County","A_A",83,58,-25,-35.46,"undercount"
"2874",18041,"Indiana","Fayette County","A_AIC",118,120,2,1.68,"overcount"
"2875",18041,"Indiana","Fayette County","NHPI_A",3,4,1,28.57,"overcount"
"2876",18041,"Indiana","Fayette County","NHPI_AIC",11,10,-1,-9.52,"undercount"
"2877",18043,"Indiana","Floyd County","A_A",1022,981,-41,-4.09,"undercount"
"2878",18043,"Indiana","Floyd County","A_AIC",1378,1425,47,3.35,"overcount"
"2879",18043,"Indiana","Floyd County","NHPI_A",42,21,-21,-66.67,"undercount"
"2880",18043,"Indiana","Floyd County","NHPI_AIC",112,79,-33,-34.55,"undercount"
"2881",18045,"Indiana","Fountain County","A_A",77,43,-34,-56.67,"undercount"
"2882",18045,"Indiana","Fountain County","A_AIC",120,77,-43,-43.65,"undercount"
"2883",18045,"Indiana","Fountain County","NHPI_A",15,6,-9,-85.71,"undercount"
"2884",18045,"Indiana","Fountain County","NHPI_AIC",24,16,-8,-40,"undercount"
"2885",18047,"Indiana","Franklin County","A_A",168,91,-77,-59.46,"undercount"
"2886",18047,"Indiana","Franklin County","A_AIC",205,129,-76,-45.51,"undercount"
"2887",18047,"Indiana","Franklin County","NHPI_A",3,1,-2,-100,"undercount"
"2888",18047,"Indiana","Franklin County","NHPI_AIC",10,11,1,9.52,"overcount"
"2889",18049,"Indiana","Fulton County","A_A",139,76,-63,-58.6,"undercount"
"2890",18049,"Indiana","Fulton County","A_AIC",172,146,-26,-16.35,"undercount"
"2891",18049,"Indiana","Fulton County","NHPI_A",6,0,-6,-200,"undercount"
"2892",18049,"Indiana","Fulton County","NHPI_AIC",13,9,-4,-36.36,"undercount"
"2893",18051,"Indiana","Gibson County","A_A",186,218,32,15.84,"overcount"
"2894",18051,"Indiana","Gibson County","A_AIC",273,301,28,9.76,"overcount"
"2895",18051,"Indiana","Gibson County","NHPI_A",22,16,-6,-31.58,"undercount"
"2896",18051,"Indiana","Gibson County","NHPI_AIC",47,30,-17,-44.16,"undercount"
"2897",18053,"Indiana","Grant County","A_A",587,527,-60,-10.77,"undercount"
"2898",18053,"Indiana","Grant County","A_AIC",860,727,-133,-16.76,"undercount"
"2899",18053,"Indiana","Grant County","NHPI_A",29,22,-7,-27.45,"undercount"
"2900",18053,"Indiana","Grant County","NHPI_AIC",79,49,-30,-46.88,"undercount"
"2901",18055,"Indiana","Greene County","A_A",129,104,-25,-21.46,"undercount"
"2902",18055,"Indiana","Greene County","A_AIC",192,190,-2,-1.05,"undercount"
"2903",18055,"Indiana","Greene County","NHPI_A",8,4,-4,-66.67,"undercount"
"2904",18055,"Indiana","Greene County","NHPI_AIC",20,28,8,33.33,"overcount"
"2905",18057,"Indiana","Hamilton County","A_A",23458,23680,222,0.94,"overcount"
"2906",18057,"Indiana","Hamilton County","A_AIC",27045,27700,655,2.39,"overcount"
"2907",18057,"Indiana","Hamilton County","NHPI_A",159,138,-21,-14.14,"undercount"
"2908",18057,"Indiana","Hamilton County","NHPI_AIC",459,417,-42,-9.59,"undercount"
"2909",18059,"Indiana","Hancock County","A_A",764,768,4,0.52,"overcount"
"2910",18059,"Indiana","Hancock County","A_AIC",1148,1353,205,16.39,"overcount"
"2911",18059,"Indiana","Hancock County","NHPI_A",34,45,11,27.85,"overcount"
"2912",18059,"Indiana","Hancock County","NHPI_AIC",83,97,14,15.56,"overcount"
"2913",18061,"Indiana","Harrison County","A_A",203,198,-5,-2.49,"undercount"
"2914",18061,"Indiana","Harrison County","A_AIC",325,326,1,0.31,"overcount"
"2915",18061,"Indiana","Harrison County","NHPI_A",20,17,-3,-16.22,"undercount"
"2916",18061,"Indiana","Harrison County","NHPI_AIC",46,33,-13,-32.91,"undercount"
"2917",18063,"Indiana","Hendricks County","A_A",5599,5749,150,2.64,"overcount"
"2918",18063,"Indiana","Hendricks County","A_AIC",6850,7130,280,4.01,"overcount"
"2919",18063,"Indiana","Hendricks County","NHPI_A",111,66,-45,-50.85,"undercount"
"2920",18063,"Indiana","Hendricks County","NHPI_AIC",275,241,-34,-13.18,"undercount"
"2921",18065,"Indiana","Henry County","A_A",233,197,-36,-16.74,"undercount"
"2922",18065,"Indiana","Henry County","A_AIC",371,347,-24,-6.69,"undercount"
"2923",18065,"Indiana","Henry County","NHPI_A",20,6,-14,-107.69,"undercount"
"2924",18065,"Indiana","Henry County","NHPI_AIC",57,36,-21,-45.16,"undercount"
"2925",18067,"Indiana","Howard County","A_A",1150,1047,-103,-9.38,"undercount"
"2926",18067,"Indiana","Howard County","A_AIC",1510,1453,-57,-3.85,"undercount"
"2927",18067,"Indiana","Howard County","NHPI_A",40,19,-21,-71.19,"undercount"
"2928",18067,"Indiana","Howard County","NHPI_AIC",113,94,-19,-18.36,"undercount"
"2929",18069,"Indiana","Huntington County","A_A",236,177,-59,-28.57,"undercount"
"2930",18069,"Indiana","Huntington County","A_AIC",336,289,-47,-15.04,"undercount"
"2931",18069,"Indiana","Huntington County","NHPI_A",27,7,-20,-117.65,"undercount"
"2932",18069,"Indiana","Huntington County","NHPI_AIC",37,23,-14,-46.67,"undercount"
"2933",18071,"Indiana","Jackson County","A_A",1166,479,-687,-83.53,"undercount"
"2934",18071,"Indiana","Jackson County","A_AIC",1266,602,-664,-71.09,"undercount"
"2935",18071,"Indiana","Jackson County","NHPI_A",78,5,-73,-175.9,"undercount"
"2936",18071,"Indiana","Jackson County","NHPI_AIC",88,21,-67,-122.94,"undercount"
"2937",18073,"Indiana","Jasper County","A_A",169,91,-78,-60,"undercount"
"2938",18073,"Indiana","Jasper County","A_AIC",248,173,-75,-35.63,"undercount"
"2939",18073,"Indiana","Jasper County","NHPI_A",15,10,-5,-40,"undercount"
"2940",18073,"Indiana","Jasper County","NHPI_AIC",32,30,-2,-6.45,"undercount"
"2941",18075,"Indiana","Jay County","A_A",86,69,-17,-21.94,"undercount"
"2942",18075,"Indiana","Jay County","A_AIC",144,126,-18,-13.33,"undercount"
"2943",18075,"Indiana","Jay County","NHPI_A",7,12,5,52.63,"overcount"
"2944",18075,"Indiana","Jay County","NHPI_AIC",16,16,0,0,"equal"
"2945",18077,"Indiana","Jefferson County","A_A",273,301,28,9.76,"overcount"
"2946",18077,"Indiana","Jefferson County","A_AIC",346,385,39,10.67,"overcount"
"2947",18077,"Indiana","Jefferson County","NHPI_A",46,10,-36,-128.57,"undercount"
"2948",18077,"Indiana","Jefferson County","NHPI_AIC",56,42,-14,-28.57,"undercount"
"2949",18079,"Indiana","Jennings County","A_A",100,49,-51,-68.46,"undercount"
"2950",18079,"Indiana","Jennings County","A_AIC",155,108,-47,-35.74,"undercount"
"2951",18079,"Indiana","Jennings County","NHPI_A",19,2,-17,-161.9,"undercount"
"2952",18079,"Indiana","Jennings County","NHPI_AIC",28,7,-21,-120,"undercount"
"2953",18081,"Indiana","Johnson County","A_A",7138,7490,352,4.81,"overcount"
"2954",18081,"Indiana","Johnson County","A_AIC",8059,8625,566,6.78,"overcount"
"2955",18081,"Indiana","Johnson County","NHPI_A",129,73,-56,-55.45,"undercount"
"2956",18081,"Indiana","Johnson County","NHPI_AIC",242,187,-55,-25.64,"undercount"
"2957",18083,"Indiana","Knox County","A_A",350,283,-67,-21.17,"undercount"
"2958",18083,"Indiana","Knox County","A_AIC",438,360,-78,-19.55,"undercount"
"2959",18083,"Indiana","Knox County","NHPI_A",18,13,-5,-32.26,"undercount"
"2960",18083,"Indiana","Knox County","NHPI_AIC",41,52,11,23.66,"overcount"
"2961",18085,"Indiana","Kosciusko County","A_A",1402,1343,-59,-4.3,"undercount"
"2962",18085,"Indiana","Kosciusko County","A_AIC",1651,1638,-13,-0.79,"undercount"
"2963",18085,"Indiana","Kosciusko County","NHPI_A",53,16,-37,-107.25,"undercount"
"2964",18085,"Indiana","Kosciusko County","NHPI_AIC",78,62,-16,-22.86,"undercount"
"2965",18087,"Indiana","LaGrange County","A_A",179,75,-104,-81.89,"undercount"
"2966",18087,"Indiana","LaGrange County","A_AIC",285,113,-172,-86.43,"undercount"
"2967",18087,"Indiana","LaGrange County","NHPI_A",10,1,-9,-163.64,"undercount"
"2968",18087,"Indiana","LaGrange County","NHPI_AIC",27,24,-3,-11.76,"undercount"
"2969",18089,"Indiana","Lake County","A_A",8253,7397,-856,-10.94,"undercount"
"2970",18089,"Indiana","Lake County","A_AIC",10487,9693,-794,-7.87,"undercount"
"2971",18089,"Indiana","Lake County","NHPI_A",335,109,-226,-101.8,"undercount"
"2972",18089,"Indiana","Lake County","NHPI_AIC",726,342,-384,-71.91,"undercount"
"2973",18091,"Indiana","LaPorte County","A_A",718,753,35,4.76,"overcount"
"2974",18091,"Indiana","LaPorte County","A_AIC",1163,1163,0,0,"equal"
"2975",18091,"Indiana","LaPorte County","NHPI_A",32,20,-12,-46.15,"undercount"
"2976",18091,"Indiana","LaPorte County","NHPI_AIC",134,108,-26,-21.49,"undercount"
"2977",18093,"Indiana","Lawrence County","A_A",298,209,-89,-35.11,"undercount"
"2978",18093,"Indiana","Lawrence County","A_AIC",416,364,-52,-13.33,"undercount"
"2979",18093,"Indiana","Lawrence County","NHPI_A",14,4,-10,-111.11,"undercount"
"2980",18093,"Indiana","Lawrence County","NHPI_AIC",35,33,-2,-5.88,"undercount"
"2981",18095,"Indiana","Madison County","A_A",791,669,-122,-16.71,"undercount"
"2982",18095,"Indiana","Madison County","A_AIC",1199,1093,-106,-9.25,"undercount"
"2983",18095,"Indiana","Madison County","NHPI_A",83,42,-41,-65.6,"undercount"
"2984",18095,"Indiana","Madison County","NHPI_AIC",175,99,-76,-55.47,"undercount"
"2985",18097,"Indiana","Marion County","A_A",38921,40206,1285,3.25,"overcount"
"2986",18097,"Indiana","Marion County","A_AIC",45211,46668,1457,3.17,"overcount"
"2987",18097,"Indiana","Marion County","NHPI_A",637,398,-239,-46.18,"undercount"
"2988",18097,"Indiana","Marion County","NHPI_AIC",1676,1274,-402,-27.25,"undercount"
"2989",18099,"Indiana","Marshall County","A_A",311,295,-16,-5.28,"undercount"
"2990",18099,"Indiana","Marshall County","A_AIC",441,431,-10,-2.29,"undercount"
"2991",18099,"Indiana","Marshall County","NHPI_A",39,11,-28,-112,"undercount"
"2992",18099,"Indiana","Marshall County","NHPI_AIC",63,16,-47,-118.99,"undercount"
"2993",18101,"Indiana","Martin County","A_A",51,33,-18,-42.86,"undercount"
"2994",18101,"Indiana","Martin County","A_AIC",70,73,3,4.2,"overcount"
"2995",18101,"Indiana","Martin County","NHPI_A",4,6,2,40,"overcount"
"2996",18101,"Indiana","Martin County","NHPI_AIC",11,16,5,37.04,"overcount"
"2997",18103,"Indiana","Miami County","A_A",169,130,-39,-26.09,"undercount"
"2998",18103,"Indiana","Miami County","A_AIC",282,239,-43,-16.51,"undercount"
"2999",18103,"Indiana","Miami County","NHPI_A",15,4,-11,-115.79,"undercount"
"3000",18103,"Indiana","Miami County","NHPI_AIC",35,36,1,2.82,"overcount"
"3001",18105,"Indiana","Monroe County","A_A",10292,8449,-1843,-19.67,"undercount"
"3002",18105,"Indiana","Monroe County","A_AIC",11956,10139,-1817,-16.45,"undercount"
"3003",18105,"Indiana","Monroe County","NHPI_A",114,37,-77,-101.99,"undercount"
"3004",18105,"Indiana","Monroe County","NHPI_AIC",270,188,-82,-35.81,"undercount"
"3005",18107,"Indiana","Montgomery County","A_A",351,236,-115,-39.18,"undercount"
"3006",18107,"Indiana","Montgomery County","A_AIC",460,375,-85,-20.36,"undercount"
"3007",18107,"Indiana","Montgomery County","NHPI_A",16,13,-3,-20.69,"undercount"
"3008",18107,"Indiana","Montgomery County","NHPI_AIC",32,47,15,37.97,"overcount"
"3009",18109,"Indiana","Morgan County","A_A",523,276,-247,-61.83,"undercount"
"3010",18109,"Indiana","Morgan County","A_AIC",712,478,-234,-39.33,"undercount"
"3011",18109,"Indiana","Morgan County","NHPI_A",36,11,-25,-106.38,"undercount"
"3012",18109,"Indiana","Morgan County","NHPI_AIC",61,50,-11,-19.82,"undercount"
"3013",18111,"Indiana","Newton County","A_A",68,37,-31,-59.05,"undercount"
"3014",18111,"Indiana","Newton County","A_AIC",101,55,-46,-58.97,"undercount"
"3015",18111,"Indiana","Newton County","NHPI_A",18,2,-16,-160,"undercount"
"3016",18111,"Indiana","Newton County","NHPI_AIC",23,20,-3,-13.95,"undercount"
"3017",18113,"Indiana","Noble County","A_A",261,228,-33,-13.5,"undercount"
"3018",18113,"Indiana","Noble County","A_AIC",425,444,19,4.37,"overcount"
"3019",18113,"Indiana","Noble County","NHPI_A",31,1,-30,-187.5,"undercount"
"3020",18113,"Indiana","Noble County","NHPI_AIC",50,36,-14,-32.56,"undercount"
"3021",18115,"Indiana","Ohio County","A_A",17,31,14,58.33,"overcount"
"3022",18115,"Indiana","Ohio County","A_AIC",33,41,8,21.62,"overcount"
"3023",18115,"Indiana","Ohio County","NHPI_A",1,0,-1,-200,"undercount"
"3024",18115,"Indiana","Ohio County","NHPI_AIC",2,13,11,146.67,"overcount"
"3025",18117,"Indiana","Orange County","A_A",90,62,-28,-36.84,"undercount"
"3026",18117,"Indiana","Orange County","A_AIC",134,98,-36,-31.03,"undercount"
"3027",18117,"Indiana","Orange County","NHPI_A",4,11,7,93.33,"overcount"
"3028",18117,"Indiana","Orange County","NHPI_AIC",11,34,23,102.22,"overcount"
"3029",18119,"Indiana","Owen County","A_A",123,62,-61,-65.95,"undercount"
"3030",18119,"Indiana","Owen County","A_AIC",194,154,-40,-22.99,"undercount"
"3031",18119,"Indiana","Owen County","NHPI_A",1,0,-1,-200,"undercount"
"3032",18119,"Indiana","Owen County","NHPI_AIC",11,18,7,48.28,"overcount"
"3033",18121,"Indiana","Parke County","A_A",32,30,-2,-6.45,"undercount"
"3034",18121,"Indiana","Parke County","A_AIC",53,58,5,9.01,"overcount"
"3035",18121,"Indiana","Parke County","NHPI_A",4,0,-4,-200,"undercount"
"3036",18121,"Indiana","Parke County","NHPI_AIC",6,0,-6,-200,"undercount"
"3037",18123,"Indiana","Perry County","A_A",144,99,-45,-37.04,"undercount"
"3038",18123,"Indiana","Perry County","A_AIC",187,188,1,0.53,"overcount"
"3039",18123,"Indiana","Perry County","NHPI_A",11,3,-8,-114.29,"undercount"
"3040",18123,"Indiana","Perry County","NHPI_AIC",16,12,-4,-28.57,"undercount"
"3041",18125,"Indiana","Pike County","A_A",63,15,-48,-123.08,"undercount"
"3042",18125,"Indiana","Pike County","A_AIC",98,34,-64,-96.97,"undercount"
"3043",18125,"Indiana","Pike County","NHPI_A",7,0,-7,-200,"undercount"
"3044",18125,"Indiana","Pike County","NHPI_AIC",13,15,2,14.29,"overcount"
"3045",18127,"Indiana","Porter County","A_A",2526,2210,-316,-13.34,"undercount"
"3046",18127,"Indiana","Porter County","A_AIC",3457,3290,-167,-4.95,"undercount"
"3047",18127,"Indiana","Porter County","NHPI_A",66,51,-15,-25.64,"undercount"
"3048",18127,"Indiana","Porter County","NHPI_AIC",178,150,-28,-17.07,"undercount"
"3049",18129,"Indiana","Posey County","A_A",147,107,-40,-31.5,"undercount"
"3050",18129,"Indiana","Posey County","A_AIC",201,178,-23,-12.14,"undercount"
"3051",18129,"Indiana","Posey County","NHPI_A",6,3,-3,-66.67,"undercount"
"3052",18129,"Indiana","Posey County","NHPI_AIC",12,17,5,34.48,"overcount"
"3053",18131,"Indiana","Pulaski County","A_A",92,45,-47,-68.61,"undercount"
"3054",18131,"Indiana","Pulaski County","A_AIC",122,96,-26,-23.85,"undercount"
"3055",18131,"Indiana","Pulaski County","NHPI_A",3,3,0,0,"equal"
"3056",18131,"Indiana","Pulaski County","NHPI_AIC",6,12,6,66.67,"overcount"
"3057",18133,"Indiana","Putnam County","A_A",482,370,-112,-26.29,"undercount"
"3058",18133,"Indiana","Putnam County","A_AIC",622,553,-69,-11.74,"undercount"
"3059",18133,"Indiana","Putnam County","NHPI_A",17,15,-2,-12.5,"undercount"
"3060",18133,"Indiana","Putnam County","NHPI_AIC",39,92,53,80.92,"overcount"
"3061",18135,"Indiana","Randolph County","A_A",98,68,-30,-36.14,"undercount"
"3062",18135,"Indiana","Randolph County","A_AIC",158,136,-22,-14.97,"undercount"
"3063",18135,"Indiana","Randolph County","NHPI_A",18,0,-18,-200,"undercount"
"3064",18135,"Indiana","Randolph County","NHPI_AIC",34,15,-19,-77.55,"undercount"
"3065",18137,"Indiana","Ripley County","A_A",234,183,-51,-24.46,"undercount"
"3066",18137,"Indiana","Ripley County","A_AIC",301,256,-45,-16.16,"undercount"
"3067",18137,"Indiana","Ripley County","NHPI_A",6,0,-6,-200,"undercount"
"3068",18137,"Indiana","Ripley County","NHPI_AIC",23,3,-20,-153.85,"undercount"
"3069",18139,"Indiana","Rush County","A_A",69,54,-15,-24.39,"undercount"
"3070",18139,"Indiana","Rush County","A_AIC",99,84,-15,-16.39,"undercount"
"3071",18139,"Indiana","Rush County","NHPI_A",6,9,3,40,"overcount"
"3072",18139,"Indiana","Rush County","NHPI_AIC",15,15,0,0,"equal"
"3073",18141,"Indiana","St. Joseph County","A_A",7366,6639,-727,-10.38,"undercount"
"3074",18141,"Indiana","St. Joseph County","A_AIC",9280,8676,-604,-6.73,"undercount"
"3075",18141,"Indiana","St. Joseph County","NHPI_A",255,176,-79,-36.66,"undercount"
"3076",18141,"Indiana","St. Joseph County","NHPI_AIC",554,425,-129,-26.35,"undercount"
"3077",18143,"Indiana","Scott County","A_A",229,87,-142,-89.87,"undercount"
"3078",18143,"Indiana","Scott County","A_AIC",287,161,-126,-56.25,"undercount"
"3079",18143,"Indiana","Scott County","NHPI_A",20,11,-9,-58.06,"undercount"
"3080",18143,"Indiana","Scott County","NHPI_AIC",32,26,-6,-20.69,"undercount"
"3081",18145,"Indiana","Shelby County","A_A",359,344,-15,-4.27,"undercount"
"3082",18145,"Indiana","Shelby County","A_AIC",487,481,-6,-1.24,"undercount"
"3083",18145,"Indiana","Shelby County","NHPI_A",65,3,-62,-182.35,"undercount"
"3084",18145,"Indiana","Shelby County","NHPI_AIC",94,40,-54,-80.6,"undercount"
"3085",18147,"Indiana","Spencer County","A_A",67,73,6,8.57,"overcount"
"3086",18147,"Indiana","Spencer County","A_AIC",109,126,17,14.47,"overcount"
"3087",18147,"Indiana","Spencer County","NHPI_A",1,1,0,0,"equal"
"3088",18147,"Indiana","Spencer County","NHPI_AIC",17,5,-12,-109.09,"undercount"
"3089",18149,"Indiana","Starke County","A_A",65,47,-18,-32.14,"undercount"
"3090",18149,"Indiana","Starke County","A_AIC",119,119,0,0,"equal"
"3091",18149,"Indiana","Starke County","NHPI_A",0,4,4,200,"overcount"
"3092",18149,"Indiana","Starke County","NHPI_AIC",15,19,4,23.53,"overcount"
"3093",18151,"Indiana","Steuben County","A_A",246,187,-59,-27.25,"undercount"
"3094",18151,"Indiana","Steuben County","A_AIC",368,316,-52,-15.2,"undercount"
"3095",18151,"Indiana","Steuben County","NHPI_A",16,2,-14,-155.56,"undercount"
"3096",18151,"Indiana","Steuben County","NHPI_AIC",37,19,-18,-64.29,"undercount"
"3097",18153,"Indiana","Sullivan County","A_A",52,36,-16,-36.36,"undercount"
"3098",18153,"Indiana","Sullivan County","A_AIC",107,82,-25,-26.46,"undercount"
"3099",18153,"Indiana","Sullivan County","NHPI_A",1,8,7,155.56,"overcount"
"3100",18153,"Indiana","Sullivan County","NHPI_AIC",12,16,4,28.57,"overcount"
"3101",18155,"Indiana","Switzerland County","A_A",37,23,-14,-46.67,"undercount"
"3102",18155,"Indiana","Switzerland County","A_AIC",53,45,-8,-16.33,"undercount"
"3103",18155,"Indiana","Switzerland County","NHPI_A",5,0,-5,-200,"undercount"
"3104",18155,"Indiana","Switzerland County","NHPI_AIC",6,15,9,85.71,"overcount"
"3105",18157,"Indiana","Tippecanoe County","A_A",16224,13790,-2434,-16.22,"undercount"
"3106",18157,"Indiana","Tippecanoe County","A_AIC",17849,18253,404,2.24,"overcount"
"3107",18157,"Indiana","Tippecanoe County","NHPI_A",124,38,-86,-106.17,"undercount"
"3108",18157,"Indiana","Tippecanoe County","NHPI_AIC",338,2899,2561,158.23,"overcount"
"3109",18159,"Indiana","Tipton County","A_A",132,53,-79,-85.41,"undercount"
"3110",18159,"Indiana","Tipton County","A_AIC",165,91,-74,-57.81,"undercount"
"3111",18159,"Indiana","Tipton County","NHPI_A",5,2,-3,-85.71,"undercount"
"3112",18159,"Indiana","Tipton County","NHPI_AIC",16,17,1,6.06,"overcount"
"3113",18161,"Indiana","Union County","A_A",30,33,3,9.52,"overcount"
"3114",18161,"Indiana","Union County","A_AIC",63,60,-3,-4.88,"undercount"
"3115",18161,"Indiana","Union County","NHPI_A",5,8,3,46.15,"overcount"
"3116",18161,"Indiana","Union County","NHPI_AIC",10,16,6,46.15,"overcount"
"3117",18163,"Indiana","Vanderburgh County","A_A",2625,2433,-192,-7.59,"undercount"
"3118",18163,"Indiana","Vanderburgh County","A_AIC",3574,3427,-147,-4.2,"undercount"
"3119",18163,"Indiana","Vanderburgh County","NHPI_A",449,679,230,40.78,"overcount"
"3120",18163,"Indiana","Vanderburgh County","NHPI_AIC",614,823,209,29.09,"overcount"
"3121",18165,"Indiana","Vermillion County","A_A",47,46,-1,-2.15,"undercount"
"3122",18165,"Indiana","Vermillion County","A_AIC",91,94,3,3.24,"overcount"
"3123",18165,"Indiana","Vermillion County","NHPI_A",6,11,5,58.82,"overcount"
"3124",18165,"Indiana","Vermillion County","NHPI_AIC",16,28,12,54.55,"overcount"
"3125",18167,"Indiana","Vigo County","A_A",2269,2044,-225,-10.43,"undercount"
"3126",18167,"Indiana","Vigo County","A_AIC",2776,2604,-172,-6.39,"undercount"
"3127",18167,"Indiana","Vigo County","NHPI_A",58,25,-33,-79.52,"undercount"
"3128",18167,"Indiana","Vigo County","NHPI_AIC",152,109,-43,-32.95,"undercount"
"3129",18169,"Indiana","Wabash County","A_A",191,163,-28,-15.82,"undercount"
"3130",18169,"Indiana","Wabash County","A_AIC",245,240,-5,-2.06,"undercount"
"3131",18169,"Indiana","Wabash County","NHPI_A",8,9,1,11.76,"overcount"
"3132",18169,"Indiana","Wabash County","NHPI_AIC",22,34,12,42.86,"overcount"
"3133",18171,"Indiana","Warren County","A_A",48,29,-19,-49.35,"undercount"
"3134",18171,"Indiana","Warren County","A_AIC",67,54,-13,-21.49,"undercount"
"3135",18171,"Indiana","Warren County","NHPI_A",6,0,-6,-200,"undercount"
"3136",18171,"Indiana","Warren County","NHPI_AIC",9,4,-5,-76.92,"undercount"
"3137",18173,"Indiana","Warrick County","A_A",1770,1650,-120,-7.02,"undercount"
"3138",18173,"Indiana","Warrick County","A_AIC",2049,1996,-53,-2.62,"undercount"
"3139",18173,"Indiana","Warrick County","NHPI_A",41,13,-28,-103.7,"undercount"
"3140",18173,"Indiana","Warrick County","NHPI_AIC",76,41,-35,-59.83,"undercount"
"3141",18175,"Indiana","Washington County","A_A",81,99,18,20,"overcount"
"3142",18175,"Indiana","Washington County","A_AIC",135,173,38,24.68,"overcount"
"3143",18175,"Indiana","Washington County","NHPI_A",4,10,6,85.71,"overcount"
"3144",18175,"Indiana","Washington County","NHPI_AIC",16,22,6,31.58,"overcount"
"3145",18177,"Indiana","Wayne County","A_A",732,717,-15,-2.07,"undercount"
"3146",18177,"Indiana","Wayne County","A_AIC",1060,965,-95,-9.38,"undercount"
"3147",18177,"Indiana","Wayne County","NHPI_A",61,22,-39,-93.98,"undercount"
"3148",18177,"Indiana","Wayne County","NHPI_AIC",203,50,-153,-120.95,"undercount"
"3149",18179,"Indiana","Wells County","A_A",189,142,-47,-28.4,"undercount"
"3150",18179,"Indiana","Wells County","A_AIC",240,212,-28,-12.39,"undercount"
"3151",18179,"Indiana","Wells County","NHPI_A",12,5,-7,-82.35,"undercount"
"3152",18179,"Indiana","Wells County","NHPI_AIC",26,21,-5,-21.28,"undercount"
"3153",18181,"Indiana","White County","A_A",132,94,-38,-33.63,"undercount"
"3154",18181,"Indiana","White County","A_AIC",191,151,-40,-23.39,"undercount"
"3155",18181,"Indiana","White County","NHPI_A",13,6,-7,-73.68,"undercount"
"3156",18181,"Indiana","White County","NHPI_AIC",24,25,1,4.08,"overcount"
"3157",18183,"Indiana","Whitley County","A_A",182,194,12,6.38,"overcount"
"3158",18183,"Indiana","Whitley County","A_AIC",284,344,60,19.11,"overcount"
"3159",18183,"Indiana","Whitley County","NHPI_A",14,3,-11,-129.41,"undercount"
"3160",18183,"Indiana","Whitley County","NHPI_AIC",26,21,-5,-21.28,"undercount"
"3161",19001,"Iowa","Adair County","A_A",38,23,-15,-49.18,"undercount"
"3162",19001,"Iowa","Adair County","A_AIC",53,38,-15,-32.97,"undercount"
"3163",19001,"Iowa","Adair County","NHPI_A",3,1,-2,-100,"undercount"
"3164",19001,"Iowa","Adair County","NHPI_AIC",8,3,-5,-90.91,"undercount"
"3165",19003,"Iowa","Adams County","A_A",24,14,-10,-52.63,"undercount"
"3166",19003,"Iowa","Adams County","A_AIC",31,24,-7,-25.45,"undercount"
"3167",19003,"Iowa","Adams County","NHPI_A",1,0,-1,-200,"undercount"
"3168",19003,"Iowa","Adams County","NHPI_AIC",1,0,-1,-200,"undercount"
"3169",19005,"Iowa","Allamakee County","A_A",67,41,-26,-48.15,"undercount"
"3170",19005,"Iowa","Allamakee County","A_AIC",89,64,-25,-32.68,"undercount"
"3171",19005,"Iowa","Allamakee County","NHPI_A",38,5,-33,-153.49,"undercount"
"3172",19005,"Iowa","Allamakee County","NHPI_AIC",44,10,-34,-125.93,"undercount"
"3173",19007,"Iowa","Appanoose County","A_A",104,69,-35,-40.46,"undercount"
"3174",19007,"Iowa","Appanoose County","A_AIC",136,114,-22,-17.6,"undercount"
"3175",19007,"Iowa","Appanoose County","NHPI_A",8,7,-1,-13.33,"undercount"
"3176",19007,"Iowa","Appanoose County","NHPI_AIC",12,12,0,0,"equal"
"3177",19009,"Iowa","Audubon County","A_A",35,4,-31,-158.97,"undercount"
"3178",19009,"Iowa","Audubon County","A_AIC",50,30,-20,-50,"undercount"
"3179",19009,"Iowa","Audubon County","NHPI_A",2,1,-1,-66.67,"undercount"
"3180",19009,"Iowa","Audubon County","NHPI_AIC",4,9,5,76.92,"overcount"
"3181",19011,"Iowa","Benton County","A_A",124,88,-36,-33.96,"undercount"
"3182",19011,"Iowa","Benton County","A_AIC",168,150,-18,-11.32,"undercount"
"3183",19011,"Iowa","Benton County","NHPI_A",14,2,-12,-150,"undercount"
"3184",19011,"Iowa","Benton County","NHPI_AIC",19,14,-5,-30.3,"undercount"
"3185",19013,"Iowa","Black Hawk County","A_A",3511,3430,-81,-2.33,"undercount"
"3186",19013,"Iowa","Black Hawk County","A_AIC",4323,4211,-112,-2.62,"undercount"
"3187",19013,"Iowa","Black Hawk County","NHPI_A",601,848,247,34.09,"overcount"
"3188",19013,"Iowa","Black Hawk County","NHPI_AIC",724,954,230,27.41,"overcount"
"3189",19015,"Iowa","Boone County","A_A",138,102,-36,-30,"undercount"
"3190",19015,"Iowa","Boone County","A_AIC",223,198,-25,-11.88,"undercount"
"3191",19015,"Iowa","Boone County","NHPI_A",7,4,-3,-54.55,"undercount"
"3192",19015,"Iowa","Boone County","NHPI_AIC",31,28,-3,-10.17,"undercount"
"3193",19017,"Iowa","Bremer County","A_A",315,196,-119,-46.58,"undercount"
"3194",19017,"Iowa","Bremer County","A_AIC",387,293,-94,-27.65,"undercount"
"3195",19017,"Iowa","Bremer County","NHPI_A",6,2,-4,-100,"undercount"
"3196",19017,"Iowa","Bremer County","NHPI_AIC",18,11,-7,-48.28,"undercount"
"3197",19019,"Iowa","Buchanan County","A_A",134,52,-82,-88.17,"undercount"
"3198",19019,"Iowa","Buchanan County","A_AIC",182,113,-69,-46.78,"undercount"
"3199",19019,"Iowa","Buchanan County","NHPI_A",3,11,8,114.29,"overcount"
"3200",19019,"Iowa","Buchanan County","NHPI_AIC",15,16,1,6.45,"overcount"
"3201",19021,"Iowa","Buena Vista County","A_A",2186,1894,-292,-14.31,"undercount"
"3202",19021,"Iowa","Buena Vista County","A_AIC",2291,1979,-312,-14.61,"undercount"
"3203",19021,"Iowa","Buena Vista County","NHPI_A",427,622,195,37.18,"overcount"
"3204",19021,"Iowa","Buena Vista County","NHPI_AIC",438,640,202,37.48,"overcount"
"3205",19023,"Iowa","Butler County","A_A",140,29,-111,-131.36,"undercount"
"3206",19023,"Iowa","Butler County","A_AIC",174,73,-101,-81.78,"undercount"
"3207",19023,"Iowa","Butler County","NHPI_A",4,1,-3,-120,"undercount"
"3208",19023,"Iowa","Butler County","NHPI_AIC",9,16,7,56,"overcount"
"3209",19025,"Iowa","Calhoun County","A_A",36,24,-12,-40,"undercount"
"3210",19025,"Iowa","Calhoun County","A_AIC",58,53,-5,-9.01,"undercount"
"3211",19025,"Iowa","Calhoun County","NHPI_A",0,8,8,200,"overcount"
"3212",19025,"Iowa","Calhoun County","NHPI_AIC",2,15,13,152.94,"overcount"
"3213",19027,"Iowa","Carroll County","A_A",116,75,-41,-42.93,"undercount"
"3214",19027,"Iowa","Carroll County","A_AIC",165,121,-44,-30.77,"undercount"
"3215",19027,"Iowa","Carroll County","NHPI_A",4,0,-4,-200,"undercount"
"3216",19027,"Iowa","Carroll County","NHPI_AIC",14,9,-5,-43.48,"undercount"
"3217",19029,"Iowa","Cass County","A_A",59,36,-23,-48.42,"undercount"
"3218",19029,"Iowa","Cass County","A_AIC",78,88,10,12.05,"overcount"
"3219",19029,"Iowa","Cass County","NHPI_A",83,78,-5,-6.21,"undercount"
"3220",19029,"Iowa","Cass County","NHPI_AIC",88,90,2,2.25,"overcount"
"3221",19031,"Iowa","Cedar County","A_A",108,62,-46,-54.12,"undercount"
"3222",19031,"Iowa","Cedar County","A_AIC",180,139,-41,-25.71,"undercount"
"3223",19031,"Iowa","Cedar County","NHPI_A",12,2,-10,-142.86,"undercount"
"3224",19031,"Iowa","Cedar County","NHPI_AIC",17,17,0,0,"equal"
"3225",19033,"Iowa","Cerro Gordo County","A_A",513,535,22,4.2,"overcount"
"3226",19033,"Iowa","Cerro Gordo County","A_AIC",711,733,22,3.05,"overcount"
"3227",19033,"Iowa","Cerro Gordo County","NHPI_A",82,137,55,50.23,"overcount"
"3228",19033,"Iowa","Cerro Gordo County","NHPI_AIC",114,181,67,45.42,"overcount"
"3229",19035,"Iowa","Cherokee County","A_A",84,59,-25,-34.97,"undercount"
"3230",19035,"Iowa","Cherokee County","A_AIC",105,81,-24,-25.81,"undercount"
"3231",19035,"Iowa","Cherokee County","NHPI_A",22,14,-8,-44.44,"undercount"
"3232",19035,"Iowa","Cherokee County","NHPI_AIC",26,26,0,0,"equal"
"3233",19037,"Iowa","Chickasaw County","A_A",45,28,-17,-46.58,"undercount"
"3234",19037,"Iowa","Chickasaw County","A_AIC",66,40,-26,-49.06,"undercount"
"3235",19037,"Iowa","Chickasaw County","NHPI_A",3,0,-3,-200,"undercount"
"3236",19037,"Iowa","Chickasaw County","NHPI_AIC",4,8,4,66.67,"overcount"
"3237",19039,"Iowa","Clarke County","A_A",88,81,-7,-8.28,"undercount"
"3238",19039,"Iowa","Clarke County","A_AIC",132,93,-39,-34.67,"undercount"
"3239",19039,"Iowa","Clarke County","NHPI_A",24,40,16,50,"overcount"
"3240",19039,"Iowa","Clarke County","NHPI_AIC",28,52,24,60,"overcount"
"3241",19041,"Iowa","Clay County","A_A",125,105,-20,-17.39,"undercount"
"3242",19041,"Iowa","Clay County","A_AIC",175,162,-13,-7.72,"undercount"
"3243",19041,"Iowa","Clay County","NHPI_A",1,2,1,66.67,"overcount"
"3244",19041,"Iowa","Clay County","NHPI_AIC",15,4,-11,-115.79,"undercount"
"3245",19043,"Iowa","Clayton County","A_A",46,47,1,2.15,"overcount"
"3246",19043,"Iowa","Clayton County","A_AIC",93,90,-3,-3.28,"undercount"
"3247",19043,"Iowa","Clayton County","NHPI_A",17,6,-11,-95.65,"undercount"
"3248",19043,"Iowa","Clayton County","NHPI_AIC",33,26,-7,-23.73,"undercount"
"3249",19045,"Iowa","Clinton County","A_A",326,260,-66,-22.53,"undercount"
"3250",19045,"Iowa","Clinton County","A_AIC",502,450,-52,-10.92,"undercount"
"3251",19045,"Iowa","Clinton County","NHPI_A",27,10,-17,-91.89,"undercount"
"3252",19045,"Iowa","Clinton County","NHPI_AIC",63,27,-36,-80,"undercount"
"3253",19047,"Iowa","Crawford County","A_A",456,303,-153,-40.32,"undercount"
"3254",19047,"Iowa","Crawford County","A_AIC",482,330,-152,-37.44,"undercount"
"3255",19047,"Iowa","Crawford County","NHPI_A",51,6,-45,-157.89,"undercount"
"3256",19047,"Iowa","Crawford County","NHPI_AIC",62,12,-50,-135.14,"undercount"
"3257",19049,"Iowa","Dallas County","A_A",5066,5021,-45,-0.89,"undercount"
"3258",19049,"Iowa","Dallas County","A_AIC",5652,5959,307,5.29,"overcount"
"3259",19049,"Iowa","Dallas County","NHPI_A",75,32,-43,-80.37,"undercount"
"3260",19049,"Iowa","Dallas County","NHPI_AIC",148,133,-15,-10.68,"undercount"
"3261",19051,"Iowa","Davis County","A_A",38,16,-22,-81.48,"undercount"
"3262",19051,"Iowa","Davis County","A_AIC",62,50,-12,-21.43,"undercount"
"3263",19051,"Iowa","Davis County","NHPI_A",0,0,0,0,"equal"
"3264",19051,"Iowa","Davis County","NHPI_AIC",3,9,6,100,"overcount"
"3265",19053,"Iowa","Decatur County","A_A",71,39,-32,-58.18,"undercount"
"3266",19053,"Iowa","Decatur County","A_AIC",102,63,-39,-47.27,"undercount"
"3267",19053,"Iowa","Decatur County","NHPI_A",16,21,5,27.03,"overcount"
"3268",19053,"Iowa","Decatur County","NHPI_AIC",20,28,8,33.33,"overcount"
"3269",19055,"Iowa","Delaware County","A_A",64,39,-25,-48.54,"undercount"
"3270",19055,"Iowa","Delaware County","A_AIC",86,75,-11,-13.66,"undercount"
"3271",19055,"Iowa","Delaware County","NHPI_A",6,0,-6,-200,"undercount"
"3272",19055,"Iowa","Delaware County","NHPI_AIC",13,5,-8,-88.89,"undercount"
"3273",19057,"Iowa","Des Moines County","A_A",429,405,-24,-5.76,"undercount"
"3274",19057,"Iowa","Des Moines County","A_AIC",588,594,6,1.02,"overcount"
"3275",19057,"Iowa","Des Moines County","NHPI_A",22,21,-1,-4.65,"undercount"
"3276",19057,"Iowa","Des Moines County","NHPI_AIC",65,72,7,10.22,"overcount"
"3277",19059,"Iowa","Dickinson County","A_A",166,80,-86,-69.92,"undercount"
"3278",19059,"Iowa","Dickinson County","A_AIC",232,135,-97,-52.86,"undercount"
"3279",19059,"Iowa","Dickinson County","NHPI_A",8,1,-7,-155.56,"undercount"
"3280",19059,"Iowa","Dickinson County","NHPI_AIC",18,22,4,20,"overcount"
"3281",19061,"Iowa","Dubuque County","A_A",1313,1021,-292,-25.02,"undercount"
"3282",19061,"Iowa","Dubuque County","A_AIC",1756,1421,-335,-21.09,"undercount"
"3283",19061,"Iowa","Dubuque County","NHPI_A",668,814,146,19.7,"overcount"
"3284",19061,"Iowa","Dubuque County","NHPI_AIC",752,861,109,13.52,"overcount"
"3285",19063,"Iowa","Emmet County","A_A",61,32,-29,-62.37,"undercount"
"3286",19063,"Iowa","Emmet County","A_AIC",97,51,-46,-62.16,"undercount"
"3287",19063,"Iowa","Emmet County","NHPI_A",8,3,-5,-90.91,"undercount"
"3288",19063,"Iowa","Emmet County","NHPI_AIC",24,13,-11,-59.46,"undercount"
"3289",19065,"Iowa","Fayette County","A_A",206,78,-128,-90.14,"undercount"
"3290",19065,"Iowa","Fayette County","A_AIC",247,154,-93,-46.38,"undercount"
"3291",19065,"Iowa","Fayette County","NHPI_A",17,2,-15,-157.89,"undercount"
"3292",19065,"Iowa","Fayette County","NHPI_AIC",28,15,-13,-60.47,"undercount"
"3293",19067,"Iowa","Floyd County","A_A",242,296,54,20.07,"overcount"
"3294",19067,"Iowa","Floyd County","A_AIC",296,369,73,21.95,"overcount"
"3295",19067,"Iowa","Floyd County","NHPI_A",12,12,0,0,"equal"
"3296",19067,"Iowa","Floyd County","NHPI_AIC",19,21,2,10,"overcount"
"3297",19069,"Iowa","Franklin County","A_A",68,49,-19,-32.48,"undercount"
"3298",19069,"Iowa","Franklin County","A_AIC",86,70,-16,-20.51,"undercount"
"3299",19069,"Iowa","Franklin County","NHPI_A",12,0,-12,-200,"undercount"
"3300",19069,"Iowa","Franklin County","NHPI_AIC",15,11,-4,-30.77,"undercount"
"3301",19071,"Iowa","Fremont County","A_A",28,8,-20,-111.11,"undercount"
"3302",19071,"Iowa","Fremont County","A_AIC",43,30,-13,-35.62,"undercount"
"3303",19071,"Iowa","Fremont County","NHPI_A",2,5,3,85.71,"overcount"
"3304",19071,"Iowa","Fremont County","NHPI_AIC",5,16,11,104.76,"overcount"
"3305",19073,"Iowa","Greene County","A_A",57,53,-4,-7.27,"undercount"
"3306",19073,"Iowa","Greene County","A_AIC",74,72,-2,-2.74,"undercount"
"3307",19073,"Iowa","Greene County","NHPI_A",3,1,-2,-100,"undercount"
"3308",19073,"Iowa","Greene County","NHPI_AIC",9,18,9,66.67,"overcount"
"3309",19075,"Iowa","Grundy County","A_A",46,24,-22,-62.86,"undercount"
"3310",19075,"Iowa","Grundy County","A_AIC",64,77,13,18.44,"overcount"
"3311",19075,"Iowa","Grundy County","NHPI_A",7,2,-5,-111.11,"undercount"
"3312",19075,"Iowa","Grundy County","NHPI_AIC",9,9,0,0,"equal"
"3313",19077,"Iowa","Guthrie County","A_A",37,40,3,7.79,"overcount"
"3314",19077,"Iowa","Guthrie County","A_AIC",60,61,1,1.65,"overcount"
"3315",19077,"Iowa","Guthrie County","NHPI_A",7,16,9,78.26,"overcount"
"3316",19077,"Iowa","Guthrie County","NHPI_AIC",12,27,15,76.92,"overcount"
"3317",19079,"Iowa","Hamilton County","A_A",360,328,-32,-9.3,"undercount"
"3318",19079,"Iowa","Hamilton County","A_AIC",419,400,-19,-4.64,"undercount"
"3319",19079,"Iowa","Hamilton County","NHPI_A",1,0,-1,-200,"undercount"
"3320",19079,"Iowa","Hamilton County","NHPI_AIC",10,12,2,18.18,"overcount"
"3321",19081,"Iowa","Hancock County","A_A",65,25,-40,-88.89,"undercount"
"3322",19081,"Iowa","Hancock County","A_AIC",89,55,-34,-47.22,"undercount"
"3323",19081,"Iowa","Hancock County","NHPI_A",5,2,-3,-85.71,"undercount"
"3324",19081,"Iowa","Hancock County","NHPI_AIC",10,15,5,40,"overcount"
"3325",19083,"Iowa","Hardin County","A_A",171,94,-77,-58.11,"undercount"
"3326",19083,"Iowa","Hardin County","A_AIC",215,188,-27,-13.4,"undercount"
"3327",19083,"Iowa","Hardin County","NHPI_A",9,2,-7,-127.27,"undercount"
"3328",19083,"Iowa","Hardin County","NHPI_AIC",20,37,17,59.65,"overcount"
"3329",19085,"Iowa","Harrison County","A_A",55,51,-4,-7.55,"undercount"
"3330",19085,"Iowa","Harrison County","A_AIC",94,75,-19,-22.49,"undercount"
"3331",19085,"Iowa","Harrison County","NHPI_A",1,0,-1,-200,"undercount"
"3332",19085,"Iowa","Harrison County","NHPI_AIC",14,3,-11,-129.41,"undercount"
"3333",19087,"Iowa","Henry County","A_A",499,451,-48,-10.11,"undercount"
"3334",19087,"Iowa","Henry County","A_AIC",587,580,-7,-1.2,"undercount"
"3335",19087,"Iowa","Henry County","NHPI_A",31,8,-23,-117.95,"undercount"
"3336",19087,"Iowa","Henry County","NHPI_AIC",49,28,-21,-54.55,"undercount"
"3337",19089,"Iowa","Howard County","A_A",37,27,-10,-31.25,"undercount"
"3338",19089,"Iowa","Howard County","A_AIC",53,63,10,17.24,"overcount"
"3339",19089,"Iowa","Howard County","NHPI_A",6,7,1,15.38,"overcount"
"3340",19089,"Iowa","Howard County","NHPI_AIC",11,11,0,0,"equal"
"3341",19091,"Iowa","Humboldt County","A_A",46,24,-22,-62.86,"undercount"
"3342",19091,"Iowa","Humboldt County","A_AIC",76,54,-22,-33.85,"undercount"
"3343",19091,"Iowa","Humboldt County","NHPI_A",3,8,5,90.91,"overcount"
"3344",19091,"Iowa","Humboldt County","NHPI_AIC",5,18,13,113.04,"overcount"
"3345",19093,"Iowa","Ida County","A_A",40,18,-22,-75.86,"undercount"
"3346",19093,"Iowa","Ida County","A_AIC",64,39,-25,-48.54,"undercount"
"3347",19093,"Iowa","Ida County","NHPI_A",6,11,5,58.82,"overcount"
"3348",19093,"Iowa","Ida County","NHPI_AIC",8,21,13,89.66,"overcount"
"3349",19095,"Iowa","Iowa County","A_A",90,84,-6,-6.9,"undercount"
"3350",19095,"Iowa","Iowa County","A_AIC",120,151,31,22.88,"overcount"
"3351",19095,"Iowa","Iowa County","NHPI_A",6,3,-3,-66.67,"undercount"
"3352",19095,"Iowa","Iowa County","NHPI_AIC",14,28,14,66.67,"overcount"
"3353",19097,"Iowa","Jackson County","A_A",97,46,-51,-71.33,"undercount"
"3354",19097,"Iowa","Jackson County","A_AIC",156,89,-67,-54.69,"undercount"
"3355",19097,"Iowa","Jackson County","NHPI_A",123,190,67,42.81,"overcount"
"3356",19097,"Iowa","Jackson County","NHPI_AIC",136,210,74,42.77,"overcount"
"3357",19099,"Iowa","Jasper County","A_A",249,216,-33,-14.19,"undercount"
"3358",19099,"Iowa","Jasper County","A_AIC",381,361,-20,-5.39,"undercount"
"3359",19099,"Iowa","Jasper County","NHPI_A",23,30,7,26.42,"overcount"
"3360",19099,"Iowa","Jasper County","NHPI_AIC",46,62,16,29.63,"overcount"
"3361",19101,"Iowa","Jefferson County","A_A",2076,516,-1560,-120.37,"undercount"
"3362",19101,"Iowa","Jefferson County","A_AIC",2185,619,-1566,-111.7,"undercount"
"3363",19101,"Iowa","Jefferson County","NHPI_A",7,9,2,25,"overcount"
"3364",19101,"Iowa","Jefferson County","NHPI_AIC",29,32,3,9.84,"overcount"
"3365",19103,"Iowa","Johnson County","A_A",10040,8644,-1396,-14.94,"undercount"
"3366",19103,"Iowa","Johnson County","A_AIC",11614,10319,-1295,-11.81,"undercount"
"3367",19103,"Iowa","Johnson County","NHPI_A",94,41,-53,-78.52,"undercount"
"3368",19103,"Iowa","Johnson County","NHPI_AIC",264,183,-81,-36.24,"undercount"
"3369",19105,"Iowa","Jones County","A_A",125,58,-67,-73.22,"undercount"
"3370",19105,"Iowa","Jones County","A_AIC",162,120,-42,-29.79,"undercount"
"3371",19105,"Iowa","Jones County","NHPI_A",8,4,-4,-66.67,"undercount"
"3372",19105,"Iowa","Jones County","NHPI_AIC",18,28,10,43.48,"overcount"
"3373",19107,"Iowa","Keokuk County","A_A",32,16,-16,-66.67,"undercount"
"3374",19107,"Iowa","Keokuk County","A_AIC",53,41,-12,-25.53,"undercount"
"3375",19107,"Iowa","Keokuk County","NHPI_A",0,0,0,0,"equal"
"3376",19107,"Iowa","Keokuk County","NHPI_AIC",3,8,5,90.91,"overcount"
"3377",19109,"Iowa","Kossuth County","A_A",95,71,-24,-28.92,"undercount"
"3378",19109,"Iowa","Kossuth County","A_AIC",127,116,-11,-9.05,"undercount"
"3379",19109,"Iowa","Kossuth County","NHPI_A",19,5,-14,-116.67,"undercount"
"3380",19109,"Iowa","Kossuth County","NHPI_AIC",28,14,-14,-66.67,"undercount"
"3381",19111,"Iowa","Lee County","A_A",213,139,-74,-42.05,"undercount"
"3382",19111,"Iowa","Lee County","A_AIC",339,239,-100,-34.6,"undercount"
"3383",19111,"Iowa","Lee County","NHPI_A",28,12,-16,-80,"undercount"
"3384",19111,"Iowa","Lee County","NHPI_AIC",65,31,-34,-70.83,"undercount"
"3385",19113,"Iowa","Linn County","A_A",6007,5367,-640,-11.25,"undercount"
"3386",19113,"Iowa","Linn County","A_AIC",7605,6999,-606,-8.3,"undercount"
"3387",19113,"Iowa","Linn County","NHPI_A",398,522,124,26.96,"overcount"
"3388",19113,"Iowa","Linn County","NHPI_AIC",611,703,92,14,"overcount"
"3389",19115,"Iowa","Louisa County","A_A",406,267,-139,-41.31,"undercount"
"3390",19115,"Iowa","Louisa County","A_AIC",447,297,-150,-40.32,"undercount"
"3391",19115,"Iowa","Louisa County","NHPI_A",18,0,-18,-200,"undercount"
"3392",19115,"Iowa","Louisa County","NHPI_AIC",26,3,-23,-158.62,"undercount"
"3393",19117,"Iowa","Lucas County","A_A",34,30,-4,-12.5,"undercount"
"3394",19117,"Iowa","Lucas County","A_AIC",63,57,-6,-10,"undercount"
"3395",19117,"Iowa","Lucas County","NHPI_A",4,2,-2,-66.67,"undercount"
"3396",19117,"Iowa","Lucas County","NHPI_AIC",7,17,10,83.33,"overcount"
"3397",19119,"Iowa","Lyon County","A_A",46,24,-22,-62.86,"undercount"
"3398",19119,"Iowa","Lyon County","A_AIC",77,48,-29,-46.4,"undercount"
"3399",19119,"Iowa","Lyon County","NHPI_A",24,43,19,56.72,"overcount"
"3400",19119,"Iowa","Lyon County","NHPI_AIC",33,45,12,30.77,"overcount"
"3401",19121,"Iowa","Madison County","A_A",151,89,-62,-51.67,"undercount"
"3402",19121,"Iowa","Madison County","A_AIC",230,176,-54,-26.6,"undercount"
"3403",19121,"Iowa","Madison County","NHPI_A",4,14,10,111.11,"overcount"
"3404",19121,"Iowa","Madison County","NHPI_AIC",16,29,13,57.78,"overcount"
"3405",19123,"Iowa","Mahaska County","A_A",423,251,-172,-51.04,"undercount"
"3406",19123,"Iowa","Mahaska County","A_AIC",498,369,-129,-29.76,"undercount"
"3407",19123,"Iowa","Mahaska County","NHPI_A",9,17,8,61.54,"overcount"
"3408",19123,"Iowa","Mahaska County","NHPI_AIC",24,38,14,45.16,"overcount"
"3409",19125,"Iowa","Marion County","A_A",476,402,-74,-16.86,"undercount"
"3410",19125,"Iowa","Marion County","A_AIC",594,560,-34,-5.89,"undercount"
"3411",19125,"Iowa","Marion County","NHPI_A",20,22,2,9.52,"overcount"
"3412",19125,"Iowa","Marion County","NHPI_AIC",39,39,0,0,"equal"
"3413",19127,"Iowa","Marshall County","A_A",1490,1518,28,1.86,"overcount"
"3414",19127,"Iowa","Marshall County","A_AIC",1688,1689,1,0.06,"overcount"
"3415",19127,"Iowa","Marshall County","NHPI_A",79,33,-46,-82.14,"undercount"
"3416",19127,"Iowa","Marshall County","NHPI_AIC",109,42,-67,-88.74,"undercount"
"3417",19129,"Iowa","Mills County","A_A",63,48,-15,-27.03,"undercount"
"3418",19129,"Iowa","Mills County","A_AIC",102,103,1,0.98,"overcount"
"3419",19129,"Iowa","Mills County","NHPI_A",13,10,-3,-26.09,"undercount"
"3420",19129,"Iowa","Mills County","NHPI_AIC",24,21,-3,-13.33,"undercount"
"3421",19131,"Iowa","Mitchell County","A_A",54,46,-8,-16,"undercount"
"3422",19131,"Iowa","Mitchell County","A_AIC",77,80,3,3.82,"overcount"
"3423",19131,"Iowa","Mitchell County","NHPI_A",5,4,-1,-22.22,"undercount"
"3424",19131,"Iowa","Mitchell County","NHPI_AIC",8,14,6,54.55,"overcount"
"3425",19133,"Iowa","Monona County","A_A",27,29,2,7.14,"overcount"
"3426",19133,"Iowa","Monona County","A_AIC",43,46,3,6.74,"overcount"
"3427",19133,"Iowa","Monona County","NHPI_A",4,2,-2,-66.67,"undercount"
"3428",19133,"Iowa","Monona County","NHPI_AIC",7,10,3,35.29,"overcount"
"3429",19135,"Iowa","Monroe County","A_A",33,16,-17,-69.39,"undercount"
"3430",19135,"Iowa","Monroe County","A_AIC",56,50,-6,-11.32,"undercount"
"3431",19135,"Iowa","Monroe County","NHPI_A",1,3,2,100,"overcount"
"3432",19135,"Iowa","Monroe County","NHPI_AIC",4,7,3,54.55,"overcount"
"3433",19137,"Iowa","Montgomery County","A_A",38,28,-10,-30.3,"undercount"
"3434",19137,"Iowa","Montgomery County","A_AIC",66,45,-21,-37.84,"undercount"
"3435",19137,"Iowa","Montgomery County","NHPI_A",8,2,-6,-120,"undercount"
"3436",19137,"Iowa","Montgomery County","NHPI_AIC",14,4,-10,-111.11,"undercount"
"3437",19139,"Iowa","Muscatine County","A_A",482,416,-66,-14.7,"undercount"
"3438",19139,"Iowa","Muscatine County","A_AIC",621,544,-77,-13.22,"undercount"
"3439",19139,"Iowa","Muscatine County","NHPI_A",73,0,-73,-200,"undercount"
"3440",19139,"Iowa","Muscatine County","NHPI_AIC",104,4,-100,-185.19,"undercount"
"3441",19141,"Iowa","O'Brien County","A_A",113,81,-32,-32.99,"undercount"
"3442",19141,"Iowa","O'Brien County","A_AIC",150,133,-17,-12.01,"undercount"
"3443",19141,"Iowa","O'Brien County","NHPI_A",6,11,5,58.82,"overcount"
"3444",19141,"Iowa","O'Brien County","NHPI_AIC",17,19,2,11.11,"overcount"
"3445",19143,"Iowa","Osceola County","A_A",53,21,-32,-86.49,"undercount"
"3446",19143,"Iowa","Osceola County","A_AIC",73,51,-22,-35.48,"undercount"
"3447",19143,"Iowa","Osceola County","NHPI_A",17,36,19,71.7,"overcount"
"3448",19143,"Iowa","Osceola County","NHPI_AIC",19,41,22,73.33,"overcount"
"3449",19145,"Iowa","Page County","A_A",165,119,-46,-32.39,"undercount"
"3450",19145,"Iowa","Page County","A_AIC",227,203,-24,-11.16,"undercount"
"3451",19145,"Iowa","Page County","NHPI_A",14,0,-14,-200,"undercount"
"3452",19145,"Iowa","Page County","NHPI_AIC",29,15,-14,-63.64,"undercount"
"3453",19147,"Iowa","Palo Alto County","A_A",85,37,-48,-78.69,"undercount"
"3454",19147,"Iowa","Palo Alto County","A_AIC",115,65,-50,-55.56,"undercount"
"3455",19147,"Iowa","Palo Alto County","NHPI_A",9,6,-3,-40,"undercount"
"3456",19147,"Iowa","Palo Alto County","NHPI_AIC",15,14,-1,-6.9,"undercount"
"3457",19149,"Iowa","Plymouth County","A_A",169,114,-55,-38.87,"undercount"
"3458",19149,"Iowa","Plymouth County","A_AIC",261,189,-72,-32,"undercount"
"3459",19149,"Iowa","Plymouth County","NHPI_A",86,117,31,30.54,"overcount"
"3460",19149,"Iowa","Plymouth County","NHPI_AIC",99,134,35,30.04,"overcount"
"3461",19151,"Iowa","Pocahontas County","A_A",32,31,-1,-3.17,"undercount"
"3462",19151,"Iowa","Pocahontas County","A_AIC",57,57,0,0,"equal"
"3463",19151,"Iowa","Pocahontas County","NHPI_A",32,23,-9,-32.73,"undercount"
"3464",19151,"Iowa","Pocahontas County","NHPI_AIC",38,31,-7,-20.29,"undercount"
"3465",19153,"Iowa","Polk County","A_A",25578,24567,-1011,-4.03,"undercount"
"3466",19153,"Iowa","Polk County","A_AIC",29343,28791,-552,-1.9,"undercount"
"3467",19153,"Iowa","Polk County","NHPI_A",350,290,-60,-18.75,"undercount"
"3468",19153,"Iowa","Polk County","NHPI_AIC",799,768,-31,-3.96,"undercount"
"3469",19155,"Iowa","Pottawattamie County","A_A",937,797,-140,-16.15,"undercount"
"3470",19155,"Iowa","Pottawattamie County","A_AIC",1414,1183,-231,-17.79,"undercount"
"3471",19155,"Iowa","Pottawattamie County","NHPI_A",90,76,-14,-16.87,"undercount"
"3472",19155,"Iowa","Pottawattamie County","NHPI_AIC",173,140,-33,-21.09,"undercount"
"3473",19157,"Iowa","Poweshiek County","A_A",379,226,-153,-50.58,"undercount"
"3474",19157,"Iowa","Poweshiek County","A_AIC",494,323,-171,-41.86,"undercount"
"3475",19157,"Iowa","Poweshiek County","NHPI_A",26,21,-5,-21.28,"undercount"
"3476",19157,"Iowa","Poweshiek County","NHPI_AIC",40,29,-11,-31.88,"undercount"
"3477",19159,"Iowa","Ringgold County","A_A",36,8,-28,-127.27,"undercount"
"3478",19159,"Iowa","Ringgold County","A_AIC",47,28,-19,-50.67,"undercount"
"3479",19159,"Iowa","Ringgold County","NHPI_A",4,0,-4,-200,"undercount"
"3480",19159,"Iowa","Ringgold County","NHPI_AIC",6,0,-6,-200,"undercount"
"3481",19161,"Iowa","Sac County","A_A",52,31,-21,-50.6,"undercount"
"3482",19161,"Iowa","Sac County","A_AIC",72,44,-28,-48.28,"undercount"
"3483",19161,"Iowa","Sac County","NHPI_A",35,6,-29,-141.46,"undercount"
"3484",19161,"Iowa","Sac County","NHPI_AIC",37,14,-23,-90.2,"undercount"
"3485",19163,"Iowa","Scott County","A_A",5276,4887,-389,-7.66,"undercount"
"3486",19163,"Iowa","Scott County","A_AIC",6279,6108,-171,-2.76,"undercount"
"3487",19163,"Iowa","Scott County","NHPI_A",113,63,-50,-56.82,"undercount"
"3488",19163,"Iowa","Scott County","NHPI_AIC",288,185,-103,-43.55,"undercount"
"3489",19165,"Iowa","Shelby County","A_A",73,49,-24,-39.34,"undercount"
"3490",19165,"Iowa","Shelby County","A_AIC",106,72,-34,-38.2,"undercount"
"3491",19165,"Iowa","Shelby County","NHPI_A",11,3,-8,-114.29,"undercount"
"3492",19165,"Iowa","Shelby County","NHPI_AIC",15,10,-5,-40,"undercount"
"3493",19167,"Iowa","Sioux County","A_A",312,220,-92,-34.59,"undercount"
"3494",19167,"Iowa","Sioux County","A_AIC",395,341,-54,-14.67,"undercount"
"3495",19167,"Iowa","Sioux County","NHPI_A",27,5,-22,-137.5,"undercount"
"3496",19167,"Iowa","Sioux County","NHPI_AIC",38,16,-22,-81.48,"undercount"
"3497",19169,"Iowa","Story County","A_A",7956,5495,-2461,-36.59,"undercount"
"3498",19169,"Iowa","Story County","A_AIC",8771,7584,-1187,-14.52,"undercount"
"3499",19169,"Iowa","Story County","NHPI_A",32,29,-3,-9.84,"undercount"
"3500",19169,"Iowa","Story County","NHPI_AIC",110,1332,1222,169.49,"overcount"
"3501",19171,"Iowa","Tama County","A_A",87,80,-7,-8.38,"undercount"
"3502",19171,"Iowa","Tama County","A_AIC",189,132,-57,-35.51,"undercount"
"3503",19171,"Iowa","Tama County","NHPI_A",27,2,-25,-172.41,"undercount"
"3504",19171,"Iowa","Tama County","NHPI_AIC",40,43,3,7.23,"overcount"
"3505",19173,"Iowa","Taylor County","A_A",26,16,-10,-47.62,"undercount"
"3506",19173,"Iowa","Taylor County","A_AIC",38,24,-14,-45.16,"undercount"
"3507",19173,"Iowa","Taylor County","NHPI_A",6,1,-5,-142.86,"undercount"
"3508",19173,"Iowa","Taylor County","NHPI_AIC",8,4,-4,-66.67,"undercount"
"3509",19175,"Iowa","Union County","A_A",94,65,-29,-36.48,"undercount"
"3510",19175,"Iowa","Union County","A_AIC",129,97,-32,-28.32,"undercount"
"3511",19175,"Iowa","Union County","NHPI_A",7,7,0,0,"equal"
"3512",19175,"Iowa","Union County","NHPI_AIC",13,16,3,20.69,"overcount"
"3513",19177,"Iowa","Van Buren County","A_A",41,24,-17,-52.31,"undercount"
"3514",19177,"Iowa","Van Buren County","A_AIC",62,29,-33,-72.53,"undercount"
"3515",19177,"Iowa","Van Buren County","NHPI_A",2,0,-2,-200,"undercount"
"3516",19177,"Iowa","Van Buren County","NHPI_AIC",5,4,-1,-22.22,"undercount"
"3517",19179,"Iowa","Wapello County","A_A",676,632,-44,-6.73,"undercount"
"3518",19179,"Iowa","Wapello County","A_AIC",789,785,-4,-0.51,"undercount"
"3519",19179,"Iowa","Wapello County","NHPI_A",492,518,26,5.15,"overcount"
"3520",19179,"Iowa","Wapello County","NHPI_AIC",517,577,60,10.97,"overcount"
"3521",19181,"Iowa","Warren County","A_A",408,380,-28,-7.11,"undercount"
"3522",19181,"Iowa","Warren County","A_AIC",643,652,9,1.39,"overcount"
"3523",19181,"Iowa","Warren County","NHPI_A",68,17,-51,-120,"undercount"
"3524",19181,"Iowa","Warren County","NHPI_AIC",106,61,-45,-53.89,"undercount"
"3525",19183,"Iowa","Washington County","A_A",140,113,-27,-21.34,"undercount"
"3526",19183,"Iowa","Washington County","A_AIC",218,204,-14,-6.64,"undercount"
"3527",19183,"Iowa","Washington County","NHPI_A",23,3,-20,-153.85,"undercount"
"3528",19183,"Iowa","Washington County","NHPI_AIC",36,8,-28,-127.27,"undercount"
"3529",19185,"Iowa","Wayne County","A_A",36,25,-11,-36.07,"undercount"
"3530",19185,"Iowa","Wayne County","A_AIC",55,45,-10,-20,"undercount"
"3531",19185,"Iowa","Wayne County","NHPI_A",1,1,0,0,"equal"
"3532",19185,"Iowa","Wayne County","NHPI_AIC",1,13,12,171.43,"overcount"
"3533",19187,"Iowa","Webster County","A_A",424,298,-126,-34.9,"undercount"
"3534",19187,"Iowa","Webster County","A_AIC",561,426,-135,-27.36,"undercount"
"3535",19187,"Iowa","Webster County","NHPI_A",22,16,-6,-31.58,"undercount"
"3536",19187,"Iowa","Webster County","NHPI_AIC",55,56,1,1.8,"overcount"
"3537",19189,"Iowa","Winnebago County","A_A",93,95,2,2.13,"overcount"
"3538",19189,"Iowa","Winnebago County","A_AIC",135,128,-7,-5.32,"undercount"
"3539",19189,"Iowa","Winnebago County","NHPI_A",3,3,0,0,"equal"
"3540",19189,"Iowa","Winnebago County","NHPI_AIC",7,17,10,83.33,"overcount"
"3541",19191,"Iowa","Winneshiek County","A_A",228,178,-50,-24.63,"undercount"
"3542",19191,"Iowa","Winneshiek County","A_AIC",261,254,-7,-2.72,"undercount"
"3543",19191,"Iowa","Winneshiek County","NHPI_A",5,12,7,82.35,"overcount"
"3544",19191,"Iowa","Winneshiek County","NHPI_AIC",12,22,10,58.82,"overcount"
"3545",19193,"Iowa","Woodbury County","A_A",3076,3006,-70,-2.3,"undercount"
"3546",19193,"Iowa","Woodbury County","A_AIC",3753,3603,-150,-4.08,"undercount"
"3547",19193,"Iowa","Woodbury County","NHPI_A",664,651,-13,-1.98,"undercount"
"3548",19193,"Iowa","Woodbury County","NHPI_AIC",829,752,-77,-9.74,"undercount"
"3549",19195,"Iowa","Worth County","A_A",49,26,-23,-61.33,"undercount"
"3550",19195,"Iowa","Worth County","A_AIC",69,45,-24,-42.11,"undercount"
"3551",19195,"Iowa","Worth County","NHPI_A",2,1,-1,-66.67,"undercount"
"3552",19195,"Iowa","Worth County","NHPI_AIC",10,6,-4,-50,"undercount"
"3553",19197,"Iowa","Wright County","A_A",76,69,-7,-9.66,"undercount"
"3554",19197,"Iowa","Wright County","A_AIC",127,119,-8,-6.5,"undercount"
"3555",19197,"Iowa","Wright County","NHPI_A",29,8,-21,-113.51,"undercount"
"3556",19197,"Iowa","Wright County","NHPI_AIC",35,17,-18,-69.23,"undercount"
"3557",20001,"Kansas","Allen County","A_A",126,67,-59,-61.14,"undercount"
"3558",20001,"Kansas","Allen County","A_AIC",173,123,-50,-33.78,"undercount"
"3559",20001,"Kansas","Allen County","NHPI_A",4,2,-2,-66.67,"undercount"
"3560",20001,"Kansas","Allen County","NHPI_AIC",20,26,6,26.09,"overcount"
"3561",20003,"Kansas","Anderson County","A_A",59,73,14,21.21,"overcount"
"3562",20003,"Kansas","Anderson County","A_AIC",75,84,9,11.32,"overcount"
"3563",20003,"Kansas","Anderson County","NHPI_A",1,0,-1,-200,"undercount"
"3564",20003,"Kansas","Anderson County","NHPI_AIC",5,5,0,0,"equal"
"3565",20005,"Kansas","Atchison County","A_A",99,84,-15,-16.39,"undercount"
"3566",20005,"Kansas","Atchison County","A_AIC",155,160,5,3.17,"overcount"
"3567",20005,"Kansas","Atchison County","NHPI_A",13,10,-3,-26.09,"undercount"
"3568",20005,"Kansas","Atchison County","NHPI_AIC",30,37,7,20.9,"overcount"
"3569",20007,"Kansas","Barber County","A_A",21,16,-5,-27.03,"undercount"
"3570",20007,"Kansas","Barber County","A_AIC",31,39,8,22.86,"overcount"
"3571",20007,"Kansas","Barber County","NHPI_A",1,5,4,133.33,"overcount"
"3572",20007,"Kansas","Barber County","NHPI_AIC",5,8,3,46.15,"overcount"
"3573",20009,"Kansas","Barton County","A_A",81,80,-1,-1.24,"undercount"
"3574",20009,"Kansas","Barton County","A_AIC",132,134,2,1.5,"overcount"
"3575",20009,"Kansas","Barton County","NHPI_A",20,3,-17,-147.83,"undercount"
"3576",20009,"Kansas","Barton County","NHPI_AIC",32,5,-27,-145.95,"undercount"
"3577",20011,"Kansas","Bourbon County","A_A",166,98,-68,-51.52,"undercount"
"3578",20011,"Kansas","Bourbon County","A_AIC",211,163,-48,-25.67,"undercount"
"3579",20011,"Kansas","Bourbon County","NHPI_A",8,2,-6,-120,"undercount"
"3580",20011,"Kansas","Bourbon County","NHPI_AIC",18,20,2,10.53,"overcount"
"3581",20013,"Kansas","Brown County","A_A",74,42,-32,-55.17,"undercount"
"3582",20013,"Kansas","Brown County","A_AIC",97,82,-15,-16.76,"undercount"
"3583",20013,"Kansas","Brown County","NHPI_A",6,9,3,40,"overcount"
"3584",20013,"Kansas","Brown County","NHPI_AIC",9,19,10,71.43,"overcount"
"3585",20015,"Kansas","Butler County","A_A",985,996,11,1.11,"overcount"
"3586",20015,"Kansas","Butler County","A_AIC",1341,1412,71,5.16,"overcount"
"3587",20015,"Kansas","Butler County","NHPI_A",66,37,-29,-56.31,"undercount"
"3588",20015,"Kansas","Butler County","NHPI_AIC",116,106,-10,-9.01,"undercount"
"3589",20017,"Kansas","Chase County","A_A",8,11,3,31.58,"overcount"
"3590",20017,"Kansas","Chase County","A_AIC",14,14,0,0,"equal"
"3591",20017,"Kansas","Chase County","NHPI_A",0,1,1,200,"overcount"
"3592",20017,"Kansas","Chase County","NHPI_AIC",3,2,-1,-40,"undercount"
"3593",20019,"Kansas","Chautauqua County","A_A",8,19,11,81.48,"overcount"
"3594",20019,"Kansas","Chautauqua County","A_AIC",22,33,11,40,"overcount"
"3595",20019,"Kansas","Chautauqua County","NHPI_A",2,0,-2,-200,"undercount"
"3596",20019,"Kansas","Chautauqua County","NHPI_AIC",4,8,4,66.67,"overcount"
"3597",20021,"Kansas","Cherokee County","A_A",100,65,-35,-42.42,"undercount"
"3598",20021,"Kansas","Cherokee County","A_AIC",163,122,-41,-28.77,"undercount"
"3599",20021,"Kansas","Cherokee County","NHPI_A",97,26,-71,-115.45,"undercount"
"3600",20021,"Kansas","Cherokee County","NHPI_AIC",108,51,-57,-71.7,"undercount"
"3601",20023,"Kansas","Cheyenne County","A_A",30,12,-18,-85.71,"undercount"
"3602",20023,"Kansas","Cheyenne County","A_AIC",32,15,-17,-72.34,"undercount"
"3603",20023,"Kansas","Cheyenne County","NHPI_A",0,0,0,0,"equal"
"3604",20023,"Kansas","Cheyenne County","NHPI_AIC",2,13,11,146.67,"overcount"
"3605",20025,"Kansas","Clark County","A_A",29,24,-5,-18.87,"undercount"
"3606",20025,"Kansas","Clark County","A_AIC",36,32,-4,-11.76,"undercount"
"3607",20025,"Kansas","Clark County","NHPI_A",2,1,-1,-66.67,"undercount"
"3608",20025,"Kansas","Clark County","NHPI_AIC",3,5,2,50,"overcount"
"3609",20027,"Kansas","Clay County","A_A",44,54,10,20.41,"overcount"
"3610",20027,"Kansas","Clay County","A_AIC",79,87,8,9.64,"overcount"
"3611",20027,"Kansas","Clay County","NHPI_A",8,0,-8,-200,"undercount"
"3612",20027,"Kansas","Clay County","NHPI_AIC",14,3,-11,-129.41,"undercount"
"3613",20029,"Kansas","Cloud County","A_A",85,40,-45,-72,"undercount"
"3614",20029,"Kansas","Cloud County","A_AIC",122,71,-51,-52.85,"undercount"
"3615",20029,"Kansas","Cloud County","NHPI_A",4,4,0,0,"equal"
"3616",20029,"Kansas","Cloud County","NHPI_AIC",9,11,2,20,"overcount"
"3617",20031,"Kansas","Coffey County","A_A",73,51,-22,-35.48,"undercount"
"3618",20031,"Kansas","Coffey County","A_AIC",94,72,-22,-26.51,"undercount"
"3619",20031,"Kansas","Coffey County","NHPI_A",1,1,0,0,"equal"
"3620",20031,"Kansas","Coffey County","NHPI_AIC",3,3,0,0,"equal"
"3621",20033,"Kansas","Comanche County","A_A",7,0,-7,-200,"undercount"
"3622",20033,"Kansas","Comanche County","A_AIC",14,6,-8,-80,"undercount"
"3623",20033,"Kansas","Comanche County","NHPI_A",3,1,-2,-100,"undercount"
"3624",20033,"Kansas","Comanche County","NHPI_AIC",3,4,1,28.57,"overcount"
"3625",20035,"Kansas","Cowley County","A_A",707,507,-200,-32.95,"undercount"
"3626",20035,"Kansas","Cowley County","A_AIC",867,689,-178,-22.88,"undercount"
"3627",20035,"Kansas","Cowley County","NHPI_A",178,179,1,0.56,"overcount"
"3628",20035,"Kansas","Cowley County","NHPI_AIC",214,242,28,12.28,"overcount"
"3629",20037,"Kansas","Crawford County","A_A",724,462,-262,-44.18,"undercount"
"3630",20037,"Kansas","Crawford County","A_AIC",929,637,-292,-37.29,"undercount"
"3631",20037,"Kansas","Crawford County","NHPI_A",161,191,30,17.05,"overcount"
"3632",20037,"Kansas","Crawford County","NHPI_AIC",197,221,24,11.48,"overcount"
"3633",20039,"Kansas","Decatur County","A_A",7,10,3,35.29,"overcount"
"3634",20039,"Kansas","Decatur County","A_AIC",15,16,1,6.45,"overcount"
"3635",20039,"Kansas","Decatur County","NHPI_A",0,0,0,0,"equal"
"3636",20039,"Kansas","Decatur County","NHPI_AIC",0,1,1,200,"overcount"
"3637",20041,"Kansas","Dickinson County","A_A",122,74,-48,-48.98,"undercount"
"3638",20041,"Kansas","Dickinson County","A_AIC",194,143,-51,-30.27,"undercount"
"3639",20041,"Kansas","Dickinson County","NHPI_A",19,20,1,5.13,"overcount"
"3640",20041,"Kansas","Dickinson County","NHPI_AIC",34,29,-5,-15.87,"undercount"
"3641",20043,"Kansas","Doniphan County","A_A",41,32,-9,-24.66,"undercount"
"3642",20043,"Kansas","Doniphan County","A_AIC",66,48,-18,-31.58,"undercount"
"3643",20043,"Kansas","Doniphan County","NHPI_A",0,19,19,200,"overcount"
"3644",20043,"Kansas","Doniphan County","NHPI_AIC",2,26,24,171.43,"overcount"
"3645",20045,"Kansas","Douglas County","A_A",5886,4673,-1213,-22.98,"undercount"
"3646",20045,"Kansas","Douglas County","A_AIC",7417,6104,-1313,-19.42,"undercount"
"3647",20045,"Kansas","Douglas County","NHPI_A",115,89,-26,-25.49,"undercount"
"3648",20045,"Kansas","Douglas County","NHPI_AIC",334,204,-130,-48.33,"undercount"
"3649",20047,"Kansas","Edwards County","A_A",6,1,-5,-142.86,"undercount"
"3650",20047,"Kansas","Edwards County","A_AIC",17,9,-8,-61.54,"undercount"
"3651",20047,"Kansas","Edwards County","NHPI_A",0,1,1,200,"overcount"
"3652",20047,"Kansas","Edwards County","NHPI_AIC",2,5,3,85.71,"overcount"
"3653",20049,"Kansas","Elk County","A_A",13,3,-10,-125,"undercount"
"3654",20049,"Kansas","Elk County","A_AIC",30,18,-12,-50,"undercount"
"3655",20049,"Kansas","Elk County","NHPI_A",1,1,0,0,"equal"
"3656",20049,"Kansas","Elk County","NHPI_AIC",3,10,7,107.69,"overcount"
"3657",20051,"Kansas","Ellis County","A_A",424,265,-159,-46.15,"undercount"
"3658",20051,"Kansas","Ellis County","A_AIC",520,505,-15,-2.93,"undercount"
"3659",20051,"Kansas","Ellis County","NHPI_A",19,0,-19,-200,"undercount"
"3660",20051,"Kansas","Ellis County","NHPI_AIC",45,123,78,92.86,"overcount"
"3661",20053,"Kansas","Ellsworth County","A_A",39,23,-16,-51.61,"undercount"
"3662",20053,"Kansas","Ellsworth County","A_AIC",48,60,12,22.22,"overcount"
"3663",20053,"Kansas","Ellsworth County","NHPI_A",0,0,0,0,"equal"
"3664",20053,"Kansas","Ellsworth County","NHPI_AIC",4,6,2,40,"overcount"
"3665",20055,"Kansas","Finney County","A_A",1511,1534,23,1.51,"overcount"
"3666",20055,"Kansas","Finney County","A_AIC",1598,1653,55,3.38,"overcount"
"3667",20055,"Kansas","Finney County","NHPI_A",53,3,-50,-178.57,"undercount"
"3668",20055,"Kansas","Finney County","NHPI_AIC",78,32,-46,-83.64,"undercount"
"3669",20057,"Kansas","Ford County","A_A",485,411,-74,-16.52,"undercount"
"3670",20057,"Kansas","Ford County","A_AIC",598,510,-88,-15.88,"undercount"
"3671",20057,"Kansas","Ford County","NHPI_A",80,6,-74,-172.09,"undercount"
"3672",20057,"Kansas","Ford County","NHPI_AIC",110,31,-79,-112.06,"undercount"
"3673",20059,"Kansas","Franklin County","A_A",143,103,-40,-32.52,"undercount"
"3674",20059,"Kansas","Franklin County","A_AIC",231,194,-37,-17.41,"undercount"
"3675",20059,"Kansas","Franklin County","NHPI_A",5,7,2,33.33,"overcount"
"3676",20059,"Kansas","Franklin County","NHPI_AIC",22,22,0,0,"equal"
"3677",20061,"Kansas","Geary County","A_A",1079,1187,108,9.53,"overcount"
"3678",20061,"Kansas","Geary County","A_AIC",1778,2048,270,14.11,"overcount"
"3679",20061,"Kansas","Geary County","NHPI_A",439,458,19,4.24,"overcount"
"3680",20061,"Kansas","Geary County","NHPI_AIC",590,702,112,17.34,"overcount"
"3681",20063,"Kansas","Gove County","A_A",26,16,-10,-47.62,"undercount"
"3682",20063,"Kansas","Gove County","A_AIC",35,27,-8,-25.81,"undercount"
"3683",20063,"Kansas","Gove County","NHPI_A",1,1,0,0,"equal"
"3684",20063,"Kansas","Gove County","NHPI_AIC",2,8,6,120,"overcount"
"3685",20065,"Kansas","Graham County","A_A",43,14,-29,-101.75,"undercount"
"3686",20065,"Kansas","Graham County","A_AIC",59,22,-37,-91.36,"undercount"
"3687",20065,"Kansas","Graham County","NHPI_A",0,0,0,0,"equal"
"3688",20065,"Kansas","Graham County","NHPI_AIC",3,13,10,125,"overcount"
"3689",20067,"Kansas","Grant County","A_A",52,8,-44,-146.67,"undercount"
"3690",20067,"Kansas","Grant County","A_AIC",66,27,-39,-83.87,"undercount"
"3691",20067,"Kansas","Grant County","NHPI_A",0,3,3,200,"overcount"
"3692",20067,"Kansas","Grant County","NHPI_AIC",3,6,3,66.67,"overcount"
"3693",20069,"Kansas","Gray County","A_A",39,14,-25,-94.34,"undercount"
"3694",20069,"Kansas","Gray County","A_AIC",48,17,-31,-95.38,"undercount"
"3695",20069,"Kansas","Gray County","NHPI_A",2,0,-2,-200,"undercount"
"3696",20069,"Kansas","Gray County","NHPI_AIC",6,3,-3,-66.67,"undercount"
"3697",20071,"Kansas","Greeley County","A_A",5,5,0,0,"equal"
"3698",20071,"Kansas","Greeley County","A_AIC",8,13,5,47.62,"overcount"
"3699",20071,"Kansas","Greeley County","NHPI_A",0,0,0,0,"equal"
"3700",20071,"Kansas","Greeley County","NHPI_AIC",0,7,7,200,"overcount"
"3701",20073,"Kansas","Greenwood County","A_A",23,36,13,44.07,"overcount"
"3702",20073,"Kansas","Greenwood County","A_AIC",42,48,6,13.33,"overcount"
"3703",20073,"Kansas","Greenwood County","NHPI_A",0,1,1,200,"overcount"
"3704",20073,"Kansas","Greenwood County","NHPI_AIC",8,1,-7,-155.56,"undercount"
"3705",20075,"Kansas","Hamilton County","A_A",6,8,2,28.57,"overcount"
"3706",20075,"Kansas","Hamilton County","A_AIC",14,13,-1,-7.41,"undercount"
"3707",20075,"Kansas","Hamilton County","NHPI_A",6,0,-6,-200,"undercount"
"3708",20075,"Kansas","Hamilton County","NHPI_AIC",7,3,-4,-80,"undercount"
"3709",20077,"Kansas","Harper County","A_A",29,15,-14,-63.64,"undercount"
"3710",20077,"Kansas","Harper County","A_AIC",48,39,-9,-20.69,"undercount"
"3711",20077,"Kansas","Harper County","NHPI_A",12,2,-10,-142.86,"undercount"
"3712",20077,"Kansas","Harper County","NHPI_AIC",18,9,-9,-66.67,"undercount"
"3713",20079,"Kansas","Harvey County","A_A",381,260,-121,-37.75,"undercount"
"3714",20079,"Kansas","Harvey County","A_AIC",524,415,-109,-23.22,"undercount"
"3715",20079,"Kansas","Harvey County","NHPI_A",20,10,-10,-66.67,"undercount"
"3716",20079,"Kansas","Harvey County","NHPI_AIC",46,32,-14,-35.9,"undercount"
"3717",20081,"Kansas","Haskell County","A_A",30,1,-29,-187.1,"undercount"
"3718",20081,"Kansas","Haskell County","A_AIC",38,4,-34,-161.9,"undercount"
"3719",20081,"Kansas","Haskell County","NHPI_A",13,0,-13,-200,"undercount"
"3720",20081,"Kansas","Haskell County","NHPI_AIC",14,5,-9,-94.74,"undercount"
"3721",20083,"Kansas","Hodgeman County","A_A",67,10,-57,-148.05,"undercount"
"3722",20083,"Kansas","Hodgeman County","A_AIC",72,21,-51,-109.68,"undercount"
"3723",20083,"Kansas","Hodgeman County","NHPI_A",0,1,1,200,"overcount"
"3724",20083,"Kansas","Hodgeman County","NHPI_AIC",3,3,0,0,"equal"
"3725",20085,"Kansas","Jackson County","A_A",71,29,-42,-84,"undercount"
"3726",20085,"Kansas","Jackson County","A_AIC",114,54,-60,-71.43,"undercount"
"3727",20085,"Kansas","Jackson County","NHPI_A",5,19,14,116.67,"overcount"
"3728",20085,"Kansas","Jackson County","NHPI_AIC",14,33,19,80.85,"overcount"
"3729",20087,"Kansas","Jefferson County","A_A",57,41,-16,-32.65,"undercount"
"3730",20087,"Kansas","Jefferson County","A_AIC",108,108,0,0,"equal"
"3731",20087,"Kansas","Jefferson County","NHPI_A",28,27,-1,-3.64,"undercount"
"3732",20087,"Kansas","Jefferson County","NHPI_AIC",38,46,8,19.05,"overcount"
"3733",20089,"Kansas","Jewell County","A_A",14,10,-4,-33.33,"undercount"
"3734",20089,"Kansas","Jewell County","A_AIC",18,27,9,40,"overcount"
"3735",20089,"Kansas","Jewell County","NHPI_A",0,0,0,0,"equal"
"3736",20089,"Kansas","Jewell County","NHPI_AIC",2,8,6,120,"overcount"
"3737",20091,"Kansas","Johnson County","A_A",32971,33142,171,0.52,"overcount"
"3738",20091,"Kansas","Johnson County","A_AIC",38912,40337,1425,3.6,"overcount"
"3739",20091,"Kansas","Johnson County","NHPI_A",259,354,95,31,"overcount"
"3740",20091,"Kansas","Johnson County","NHPI_AIC",889,1012,123,12.94,"overcount"
"3741",20093,"Kansas","Kearny County","A_A",30,10,-20,-100,"undercount"
"3742",20093,"Kansas","Kearny County","A_AIC",39,32,-7,-19.72,"undercount"
"3743",20093,"Kansas","Kearny County","NHPI_A",4,1,-3,-120,"undercount"
"3744",20093,"Kansas","Kearny County","NHPI_AIC",9,10,1,10.53,"overcount"
"3745",20095,"Kansas","Kingman County","A_A",46,35,-11,-27.16,"undercount"
"3746",20095,"Kansas","Kingman County","A_AIC",66,48,-18,-31.58,"undercount"
"3747",20095,"Kansas","Kingman County","NHPI_A",2,4,2,66.67,"overcount"
"3748",20095,"Kansas","Kingman County","NHPI_AIC",8,12,4,40,"overcount"
"3749",20097,"Kansas","Kiowa County","A_A",46,16,-30,-96.77,"undercount"
"3750",20097,"Kansas","Kiowa County","A_AIC",53,27,-26,-65,"undercount"
"3751",20097,"Kansas","Kiowa County","NHPI_A",1,4,3,120,"overcount"
"3752",20097,"Kansas","Kiowa County","NHPI_AIC",2,5,3,85.71,"overcount"
"3753",20099,"Kansas","Labette County","A_A",87,94,7,7.73,"overcount"
"3754",20099,"Kansas","Labette County","A_AIC",174,172,-2,-1.16,"undercount"
"3755",20099,"Kansas","Labette County","NHPI_A",15,9,-6,-50,"undercount"
"3756",20099,"Kansas","Labette County","NHPI_AIC",50,25,-25,-66.67,"undercount"
"3757",20101,"Kansas","Lane County","A_A",4,0,-4,-200,"undercount"
"3758",20101,"Kansas","Lane County","A_AIC",8,3,-5,-90.91,"undercount"
"3759",20101,"Kansas","Lane County","NHPI_A",1,2,1,66.67,"overcount"
"3760",20101,"Kansas","Lane County","NHPI_AIC",3,8,5,90.91,"overcount"
"3761",20103,"Kansas","Leavenworth County","A_A",1271,1074,-197,-16.8,"undercount"
"3762",20103,"Kansas","Leavenworth County","A_AIC",2160,1959,-201,-9.76,"undercount"
"3763",20103,"Kansas","Leavenworth County","NHPI_A",178,139,-39,-24.61,"undercount"
"3764",20103,"Kansas","Leavenworth County","NHPI_AIC",349,288,-61,-19.15,"undercount"
"3765",20105,"Kansas","Lincoln County","A_A",15,8,-7,-60.87,"undercount"
"3766",20105,"Kansas","Lincoln County","A_AIC",24,12,-12,-66.67,"undercount"
"3767",20105,"Kansas","Lincoln County","NHPI_A",0,0,0,0,"equal"
"3768",20105,"Kansas","Lincoln County","NHPI_AIC",1,5,4,133.33,"overcount"
"3769",20107,"Kansas","Linn County","A_A",36,20,-16,-57.14,"undercount"
"3770",20107,"Kansas","Linn County","A_AIC",77,36,-41,-72.57,"undercount"
"3771",20107,"Kansas","Linn County","NHPI_A",3,10,7,107.69,"overcount"
"3772",20107,"Kansas","Linn County","NHPI_AIC",10,18,8,57.14,"overcount"
"3773",20109,"Kansas","Logan County","A_A",29,11,-18,-90,"undercount"
"3774",20109,"Kansas","Logan County","A_AIC",37,29,-8,-24.24,"undercount"
"3775",20109,"Kansas","Logan County","NHPI_A",0,2,2,200,"overcount"
"3776",20109,"Kansas","Logan County","NHPI_AIC",2,5,3,85.71,"overcount"
"3777",20111,"Kansas","Lyon County","A_A",833,632,-201,-27.44,"undercount"
"3778",20111,"Kansas","Lyon County","A_AIC",1032,787,-245,-26.94,"undercount"
"3779",20111,"Kansas","Lyon County","NHPI_A",51,5,-46,-164.29,"undercount"
"3780",20111,"Kansas","Lyon County","NHPI_AIC",91,28,-63,-105.88,"undercount"
"3781",20113,"Kansas","McPherson County","A_A",287,213,-74,-29.6,"undercount"
"3782",20113,"Kansas","McPherson County","A_AIC",375,342,-33,-9.21,"undercount"
"3783",20113,"Kansas","McPherson County","NHPI_A",28,8,-20,-111.11,"undercount"
"3784",20113,"Kansas","McPherson County","NHPI_AIC",56,37,-19,-40.86,"undercount"
"3785",20115,"Kansas","Marion County","A_A",64,39,-25,-48.54,"undercount"
"3786",20115,"Kansas","Marion County","A_AIC",110,64,-46,-52.87,"undercount"
"3787",20115,"Kansas","Marion County","NHPI_A",10,7,-3,-35.29,"undercount"
"3788",20115,"Kansas","Marion County","NHPI_AIC",20,10,-10,-66.67,"undercount"
"3789",20117,"Kansas","Marshall County","A_A",47,41,-6,-13.64,"undercount"
"3790",20117,"Kansas","Marshall County","A_AIC",81,65,-16,-21.92,"undercount"
"3791",20117,"Kansas","Marshall County","NHPI_A",5,0,-5,-200,"undercount"
"3792",20117,"Kansas","Marshall County","NHPI_AIC",16,5,-11,-104.76,"undercount"
"3793",20119,"Kansas","Meade County","A_A",34,13,-21,-89.36,"undercount"
"3794",20119,"Kansas","Meade County","A_AIC",46,31,-15,-38.96,"undercount"
"3795",20119,"Kansas","Meade County","NHPI_A",0,0,0,0,"equal"
"3796",20119,"Kansas","Meade County","NHPI_AIC",1,5,4,133.33,"overcount"
"3797",20121,"Kansas","Miami County","A_A",218,163,-55,-28.87,"undercount"
"3798",20121,"Kansas","Miami County","A_AIC",352,300,-52,-15.95,"undercount"
"3799",20121,"Kansas","Miami County","NHPI_A",15,8,-7,-60.87,"undercount"
"3800",20121,"Kansas","Miami County","NHPI_AIC",41,34,-7,-18.67,"undercount"
"3801",20123,"Kansas","Mitchell County","A_A",45,13,-32,-110.34,"undercount"
"3802",20123,"Kansas","Mitchell County","A_AIC",65,28,-37,-79.57,"undercount"
"3803",20123,"Kansas","Mitchell County","NHPI_A",12,0,-12,-200,"undercount"
"3804",20123,"Kansas","Mitchell County","NHPI_AIC",17,6,-11,-95.65,"undercount"
"3805",20125,"Kansas","Montgomery County","A_A",316,191,-125,-49.31,"undercount"
"3806",20125,"Kansas","Montgomery County","A_AIC",496,298,-198,-49.87,"undercount"
"3807",20125,"Kansas","Montgomery County","NHPI_A",47,24,-23,-64.79,"undercount"
"3808",20125,"Kansas","Montgomery County","NHPI_AIC",110,64,-46,-52.87,"undercount"
"3809",20127,"Kansas","Morris County","A_A",39,19,-20,-68.97,"undercount"
"3810",20127,"Kansas","Morris County","A_AIC",65,26,-39,-85.71,"undercount"
"3811",20127,"Kansas","Morris County","NHPI_A",2,1,-1,-66.67,"undercount"
"3812",20127,"Kansas","Morris County","NHPI_AIC",9,5,-4,-57.14,"undercount"
"3813",20129,"Kansas","Morton County","A_A",46,34,-12,-30,"undercount"
"3814",20129,"Kansas","Morton County","A_AIC",56,51,-5,-9.35,"undercount"
"3815",20129,"Kansas","Morton County","NHPI_A",5,9,4,57.14,"overcount"
"3816",20129,"Kansas","Morton County","NHPI_AIC",8,20,12,85.71,"overcount"
"3817",20131,"Kansas","Nemaha County","A_A",33,35,2,5.88,"overcount"
"3818",20131,"Kansas","Nemaha County","A_AIC",63,79,16,22.54,"overcount"
"3819",20131,"Kansas","Nemaha County","NHPI_A",11,7,-4,-44.44,"undercount"
"3820",20131,"Kansas","Nemaha County","NHPI_AIC",16,20,4,22.22,"overcount"
"3821",20133,"Kansas","Neosho County","A_A",111,84,-27,-27.69,"undercount"
"3822",20133,"Kansas","Neosho County","A_AIC",184,149,-35,-21.02,"undercount"
"3823",20133,"Kansas","Neosho County","NHPI_A",12,6,-6,-66.67,"undercount"
"3824",20133,"Kansas","Neosho County","NHPI_AIC",30,14,-16,-72.73,"undercount"
"3825",20135,"Kansas","Ness County","A_A",7,2,-5,-111.11,"undercount"
"3826",20135,"Kansas","Ness County","A_AIC",15,3,-12,-133.33,"undercount"
"3827",20135,"Kansas","Ness County","NHPI_A",0,0,0,0,"equal"
"3828",20135,"Kansas","Ness County","NHPI_AIC",2,3,1,40,"overcount"
"3829",20137,"Kansas","Norton County","A_A",62,35,-27,-55.67,"undercount"
"3830",20137,"Kansas","Norton County","A_AIC",86,54,-32,-45.71,"undercount"
"3831",20137,"Kansas","Norton County","NHPI_A",2,2,0,0,"equal"
"3832",20137,"Kansas","Norton County","NHPI_AIC",5,13,8,88.89,"overcount"
"3833",20139,"Kansas","Osage County","A_A",74,52,-22,-34.92,"undercount"
"3834",20139,"Kansas","Osage County","A_AIC",119,110,-9,-7.86,"undercount"
"3835",20139,"Kansas","Osage County","NHPI_A",8,3,-5,-90.91,"undercount"
"3836",20139,"Kansas","Osage County","NHPI_AIC",24,21,-3,-13.33,"undercount"
"3837",20141,"Kansas","Osborne County","A_A",41,18,-23,-77.97,"undercount"
"3838",20141,"Kansas","Osborne County","A_AIC",50,30,-20,-50,"undercount"
"3839",20141,"Kansas","Osborne County","NHPI_A",0,0,0,0,"equal"
"3840",20141,"Kansas","Osborne County","NHPI_AIC",1,4,3,120,"overcount"
"3841",20143,"Kansas","Ottawa County","A_A",20,10,-10,-66.67,"undercount"
"3842",20143,"Kansas","Ottawa County","A_AIC",39,23,-16,-51.61,"undercount"
"3843",20143,"Kansas","Ottawa County","NHPI_A",0,0,0,0,"equal"
"3844",20143,"Kansas","Ottawa County","NHPI_AIC",3,13,10,125,"overcount"
"3845",20145,"Kansas","Pawnee County","A_A",37,28,-9,-27.69,"undercount"
"3846",20145,"Kansas","Pawnee County","A_AIC",55,44,-11,-22.22,"undercount"
"3847",20145,"Kansas","Pawnee County","NHPI_A",6,0,-6,-200,"undercount"
"3848",20145,"Kansas","Pawnee County","NHPI_AIC",10,9,-1,-10.53,"undercount"
"3849",20147,"Kansas","Phillips County","A_A",61,17,-44,-112.82,"undercount"
"3850",20147,"Kansas","Phillips County","A_AIC",75,26,-49,-97.03,"undercount"
"3851",20147,"Kansas","Phillips County","NHPI_A",0,1,1,200,"overcount"
"3852",20147,"Kansas","Phillips County","NHPI_AIC",2,8,6,120,"overcount"
"3853",20149,"Kansas","Pottawatomie County","A_A",262,194,-68,-29.82,"undercount"
"3854",20149,"Kansas","Pottawatomie County","A_AIC",426,403,-23,-5.55,"undercount"
"3855",20149,"Kansas","Pottawatomie County","NHPI_A",35,27,-8,-25.81,"undercount"
"3856",20149,"Kansas","Pottawatomie County","NHPI_AIC",58,43,-15,-29.7,"undercount"
"3857",20151,"Kansas","Pratt County","A_A",85,45,-40,-61.54,"undercount"
"3858",20151,"Kansas","Pratt County","A_AIC",117,64,-53,-58.56,"undercount"
"3859",20151,"Kansas","Pratt County","NHPI_A",4,10,6,85.71,"overcount"
"3860",20151,"Kansas","Pratt County","NHPI_AIC",9,16,7,56,"overcount"
"3861",20153,"Kansas","Rawlins County","A_A",17,11,-6,-42.86,"undercount"
"3862",20153,"Kansas","Rawlins County","A_AIC",22,28,6,24,"overcount"
"3863",20153,"Kansas","Rawlins County","NHPI_A",2,0,-2,-200,"undercount"
"3864",20153,"Kansas","Rawlins County","NHPI_AIC",3,4,1,28.57,"overcount"
"3865",20155,"Kansas","Reno County","A_A",371,333,-38,-10.8,"undercount"
"3866",20155,"Kansas","Reno County","A_AIC",645,593,-52,-8.4,"undercount"
"3867",20155,"Kansas","Reno County","NHPI_A",69,41,-28,-50.91,"undercount"
"3868",20155,"Kansas","Reno County","NHPI_AIC",114,94,-20,-19.23,"undercount"
"3869",20157,"Kansas","Republic County","A_A",33,11,-22,-100,"undercount"
"3870",20157,"Kansas","Republic County","A_AIC",43,16,-27,-91.53,"undercount"
"3871",20157,"Kansas","Republic County","NHPI_A",1,9,8,160,"overcount"
"3872",20157,"Kansas","Republic County","NHPI_AIC",3,11,8,114.29,"overcount"
"3873",20159,"Kansas","Rice County","A_A",99,30,-69,-106.98,"undercount"
"3874",20159,"Kansas","Rice County","A_AIC",149,62,-87,-82.46,"undercount"
"3875",20159,"Kansas","Rice County","NHPI_A",9,0,-9,-200,"undercount"
"3876",20159,"Kansas","Rice County","NHPI_AIC",18,12,-6,-40,"undercount"
"3877",20161,"Kansas","Riley County","A_A",3564,3376,-188,-5.42,"undercount"
"3878",20161,"Kansas","Riley County","A_AIC",4546,4301,-245,-5.54,"undercount"
"3879",20161,"Kansas","Riley County","NHPI_A",202,228,26,12.09,"overcount"
"3880",20161,"Kansas","Riley County","NHPI_AIC",340,400,60,16.22,"overcount"
"3881",20163,"Kansas","Rooks County","A_A",31,5,-26,-144.44,"undercount"
"3882",20163,"Kansas","Rooks County","A_AIC",42,28,-14,-40,"undercount"
"3883",20163,"Kansas","Rooks County","NHPI_A",6,9,3,40,"overcount"
"3884",20163,"Kansas","Rooks County","NHPI_AIC",8,18,10,76.92,"overcount"
"3885",20165,"Kansas","Rush County","A_A",14,14,0,0,"equal"
"3886",20165,"Kansas","Rush County","A_AIC",21,22,1,4.65,"overcount"
"3887",20165,"Kansas","Rush County","NHPI_A",2,0,-2,-200,"undercount"
"3888",20165,"Kansas","Rush County","NHPI_AIC",2,6,4,100,"overcount"
"3889",20167,"Kansas","Russell County","A_A",45,41,-4,-9.3,"undercount"
"3890",20167,"Kansas","Russell County","A_AIC",63,65,2,3.12,"overcount"
"3891",20167,"Kansas","Russell County","NHPI_A",6,0,-6,-200,"undercount"
"3892",20167,"Kansas","Russell County","NHPI_AIC",9,4,-5,-76.92,"undercount"
"3893",20169,"Kansas","Saline County","A_A",1201,1117,-84,-7.25,"undercount"
"3894",20169,"Kansas","Saline County","A_AIC",1621,1529,-92,-5.84,"undercount"
"3895",20169,"Kansas","Saline County","NHPI_A",49,28,-21,-54.55,"undercount"
"3896",20169,"Kansas","Saline County","NHPI_AIC",134,119,-15,-11.86,"undercount"
"3897",20171,"Kansas","Scott County","A_A",51,15,-36,-109.09,"undercount"
"3898",20171,"Kansas","Scott County","A_AIC",63,41,-22,-42.31,"undercount"
"3899",20171,"Kansas","Scott County","NHPI_A",8,2,-6,-120,"undercount"
"3900",20171,"Kansas","Scott County","NHPI_AIC",9,13,4,36.36,"overcount"
"3901",20173,"Kansas","Sedgwick County","A_A",23830,22376,-1454,-6.29,"undercount"
"3902",20173,"Kansas","Sedgwick County","A_AIC",28855,27514,-1341,-4.76,"undercount"
"3903",20173,"Kansas","Sedgwick County","NHPI_A",501,534,33,6.38,"overcount"
"3904",20173,"Kansas","Sedgwick County","NHPI_AIC",1121,1315,194,15.93,"overcount"
"3905",20175,"Kansas","Seward County","A_A",582,532,-50,-8.98,"undercount"
"3906",20175,"Kansas","Seward County","A_AIC",653,610,-43,-6.81,"undercount"
"3907",20175,"Kansas","Seward County","NHPI_A",55,1,-54,-192.86,"undercount"
"3908",20175,"Kansas","Seward County","NHPI_AIC",68,27,-41,-86.32,"undercount"
"3909",20177,"Kansas","Shawnee County","A_A",2755,2506,-249,-9.47,"undercount"
"3910",20177,"Kansas","Shawnee County","A_AIC",3978,3617,-361,-9.51,"undercount"
"3911",20177,"Kansas","Shawnee County","NHPI_A",223,165,-58,-29.9,"undercount"
"3912",20177,"Kansas","Shawnee County","NHPI_AIC",463,368,-95,-22.86,"undercount"
"3913",20179,"Kansas","Sheridan County","A_A",10,12,2,18.18,"overcount"
"3914",20179,"Kansas","Sheridan County","A_AIC",14,20,6,35.29,"overcount"
"3915",20179,"Kansas","Sheridan County","NHPI_A",1,2,1,66.67,"overcount"
"3916",20179,"Kansas","Sheridan County","NHPI_AIC",1,11,10,166.67,"overcount"
"3917",20181,"Kansas","Sherman County","A_A",29,14,-15,-69.77,"undercount"
"3918",20181,"Kansas","Sherman County","A_AIC",45,37,-8,-19.51,"undercount"
"3919",20181,"Kansas","Sherman County","NHPI_A",9,1,-8,-160,"undercount"
"3920",20181,"Kansas","Sherman County","NHPI_AIC",12,10,-2,-18.18,"undercount"
"3921",20183,"Kansas","Smith County","A_A",18,9,-9,-66.67,"undercount"
"3922",20183,"Kansas","Smith County","A_AIC",30,22,-8,-30.77,"undercount"
"3923",20183,"Kansas","Smith County","NHPI_A",5,0,-5,-200,"undercount"
"3924",20183,"Kansas","Smith County","NHPI_AIC",9,8,-1,-11.76,"undercount"
"3925",20185,"Kansas","Stafford County","A_A",22,13,-9,-51.43,"undercount"
"3926",20185,"Kansas","Stafford County","A_AIC",33,19,-14,-53.85,"undercount"
"3927",20185,"Kansas","Stafford County","NHPI_A",2,0,-2,-200,"undercount"
"3928",20185,"Kansas","Stafford County","NHPI_AIC",4,8,4,66.67,"overcount"
"3929",20187,"Kansas","Stanton County","A_A",7,7,0,0,"equal"
"3930",20187,"Kansas","Stanton County","A_AIC",32,20,-12,-46.15,"undercount"
"3931",20187,"Kansas","Stanton County","NHPI_A",4,0,-4,-200,"undercount"
"3932",20187,"Kansas","Stanton County","NHPI_AIC",5,10,5,66.67,"overcount"
"3933",20189,"Kansas","Stevens County","A_A",33,22,-11,-40,"undercount"
"3934",20189,"Kansas","Stevens County","A_AIC",44,34,-10,-25.64,"undercount"
"3935",20189,"Kansas","Stevens County","NHPI_A",7,0,-7,-200,"undercount"
"3936",20189,"Kansas","Stevens County","NHPI_AIC",13,0,-13,-200,"undercount"
"3937",20191,"Kansas","Sumner County","A_A",118,73,-45,-47.12,"undercount"
"3938",20191,"Kansas","Sumner County","A_AIC",181,130,-51,-32.8,"undercount"
"3939",20191,"Kansas","Sumner County","NHPI_A",7,0,-7,-200,"undercount"
"3940",20191,"Kansas","Sumner County","NHPI_AIC",22,8,-14,-93.33,"undercount"
"3941",20193,"Kansas","Thomas County","A_A",67,51,-16,-27.12,"undercount"
"3942",20193,"Kansas","Thomas County","A_AIC",95,64,-31,-38.99,"undercount"
"3943",20193,"Kansas","Thomas County","NHPI_A",8,0,-8,-200,"undercount"
"3944",20193,"Kansas","Thomas County","NHPI_AIC",12,5,-7,-82.35,"undercount"
"3945",20195,"Kansas","Trego County","A_A",15,12,-3,-22.22,"undercount"
"3946",20195,"Kansas","Trego County","A_AIC",24,24,0,0,"equal"
"3947",20195,"Kansas","Trego County","NHPI_A",1,0,-1,-200,"undercount"
"3948",20195,"Kansas","Trego County","NHPI_AIC",2,7,5,111.11,"overcount"
"3949",20197,"Kansas","Wabaunsee County","A_A",27,12,-15,-76.92,"undercount"
"3950",20197,"Kansas","Wabaunsee County","A_AIC",51,55,4,7.55,"overcount"
"3951",20197,"Kansas","Wabaunsee County","NHPI_A",0,4,4,200,"overcount"
"3952",20197,"Kansas","Wabaunsee County","NHPI_AIC",8,8,0,0,"equal"
"3953",20199,"Kansas","Wallace County","A_A",2,1,-1,-66.67,"undercount"
"3954",20199,"Kansas","Wallace County","A_AIC",6,5,-1,-18.18,"undercount"
"3955",20199,"Kansas","Wallace County","NHPI_A",0,2,2,200,"overcount"
"3956",20199,"Kansas","Wallace County","NHPI_AIC",0,3,3,200,"overcount"
"3957",20201,"Kansas","Washington County","A_A",45,6,-39,-152.94,"undercount"
"3958",20201,"Kansas","Washington County","A_AIC",54,29,-25,-60.24,"undercount"
"3959",20201,"Kansas","Washington County","NHPI_A",3,2,-1,-40,"undercount"
"3960",20201,"Kansas","Washington County","NHPI_AIC",5,10,5,66.67,"overcount"
"3961",20203,"Kansas","Wichita County","A_A",8,0,-8,-200,"undercount"
"3962",20203,"Kansas","Wichita County","A_AIC",10,5,-5,-66.67,"undercount"
"3963",20203,"Kansas","Wichita County","NHPI_A",1,2,1,66.67,"overcount"
"3964",20203,"Kansas","Wichita County","NHPI_AIC",1,5,4,133.33,"overcount"
"3965",20205,"Kansas","Wilson County","A_A",42,35,-7,-18.18,"undercount"
"3966",20205,"Kansas","Wilson County","A_AIC",70,55,-15,-24,"undercount"
"3967",20205,"Kansas","Wilson County","NHPI_A",7,2,-5,-111.11,"undercount"
"3968",20205,"Kansas","Wilson County","NHPI_AIC",14,13,-1,-7.41,"undercount"
"3969",20207,"Kansas","Woodson County","A_A",5,0,-5,-200,"undercount"
"3970",20207,"Kansas","Woodson County","A_AIC",15,25,10,50,"overcount"
"3971",20207,"Kansas","Woodson County","NHPI_A",0,0,0,0,"equal"
"3972",20207,"Kansas","Woodson County","NHPI_AIC",0,8,8,200,"overcount"
"3973",20209,"Kansas","Wyandotte County","A_A",9129,7666,-1463,-17.42,"undercount"
"3974",20209,"Kansas","Wyandotte County","A_AIC",9934,8356,-1578,-17.26,"undercount"
"3975",20209,"Kansas","Wyandotte County","NHPI_A",639,378,-261,-51.33,"undercount"
"3976",20209,"Kansas","Wyandotte County","NHPI_AIC",876,521,-355,-50.82,"undercount"
"3977",21001,"Kentucky","Adair County","A_A",100,72,-28,-32.56,"undercount"
"3978",21001,"Kentucky","Adair County","A_AIC",128,108,-20,-16.95,"undercount"
"3979",21001,"Kentucky","Adair County","NHPI_A",12,8,-4,-40,"undercount"
"3980",21001,"Kentucky","Adair County","NHPI_AIC",17,11,-6,-42.86,"undercount"
"3981",21003,"Kentucky","Allen County","A_A",64,53,-11,-18.8,"undercount"
"3982",21003,"Kentucky","Allen County","A_AIC",92,106,14,14.14,"overcount"
"3983",21003,"Kentucky","Allen County","NHPI_A",3,7,4,80,"overcount"
"3984",21003,"Kentucky","Allen County","NHPI_AIC",6,25,19,122.58,"overcount"
"3985",21005,"Kentucky","Anderson County","A_A",173,104,-69,-49.82,"undercount"
"3986",21005,"Kentucky","Anderson County","A_AIC",243,182,-61,-28.71,"undercount"
"3987",21005,"Kentucky","Anderson County","NHPI_A",11,4,-7,-93.33,"undercount"
"3988",21005,"Kentucky","Anderson County","NHPI_AIC",21,22,1,4.65,"overcount"
"3989",21007,"Kentucky","Ballard County","A_A",36,29,-7,-21.54,"undercount"
"3990",21007,"Kentucky","Ballard County","A_AIC",57,61,4,6.78,"overcount"
"3991",21007,"Kentucky","Ballard County","NHPI_A",4,0,-4,-200,"undercount"
"3992",21007,"Kentucky","Ballard County","NHPI_AIC",8,9,1,11.76,"overcount"
"3993",21009,"Kentucky","Barren County","A_A",374,257,-117,-37.08,"undercount"
"3994",21009,"Kentucky","Barren County","A_AIC",466,328,-138,-34.76,"undercount"
"3995",21009,"Kentucky","Barren County","NHPI_A",92,53,-39,-53.79,"undercount"
"3996",21009,"Kentucky","Barren County","NHPI_AIC",112,61,-51,-58.96,"undercount"
"3997",21011,"Kentucky","Bath County","A_A",62,17,-45,-113.92,"undercount"
"3998",21011,"Kentucky","Bath County","A_AIC",72,34,-38,-71.7,"undercount"
"3999",21011,"Kentucky","Bath County","NHPI_A",15,1,-14,-175,"undercount"
"4000",21011,"Kentucky","Bath County","NHPI_AIC",17,7,-10,-83.33,"undercount"
"4001",21013,"Kentucky","Bell County","A_A",106,122,16,14.04,"overcount"
"4002",21013,"Kentucky","Bell County","A_AIC",148,145,-3,-2.05,"undercount"
"4003",21013,"Kentucky","Bell County","NHPI_A",41,4,-37,-164.44,"undercount"
"4004",21013,"Kentucky","Bell County","NHPI_AIC",48,14,-34,-109.68,"undercount"
"4005",21015,"Kentucky","Boone County","A_A",3436,3097,-339,-10.38,"undercount"
"4006",21015,"Kentucky","Boone County","A_AIC",4395,4050,-345,-8.17,"undercount"
"4007",21015,"Kentucky","Boone County","NHPI_A",242,307,65,23.68,"overcount"
"4008",21015,"Kentucky","Boone County","NHPI_AIC",360,436,76,19.1,"overcount"
"4009",21017,"Kentucky","Bourbon County","A_A",106,78,-28,-30.43,"undercount"
"4010",21017,"Kentucky","Bourbon County","A_AIC",144,141,-3,-2.11,"undercount"
"4011",21017,"Kentucky","Bourbon County","NHPI_A",7,8,1,13.33,"overcount"
"4012",21017,"Kentucky","Bourbon County","NHPI_AIC",19,9,-10,-71.43,"undercount"
"4013",21019,"Kentucky","Boyd County","A_A",293,283,-10,-3.47,"undercount"
"4014",21019,"Kentucky","Boyd County","A_AIC",413,426,13,3.1,"overcount"
"4015",21019,"Kentucky","Boyd County","NHPI_A",18,6,-12,-100,"undercount"
"4016",21019,"Kentucky","Boyd County","NHPI_AIC",47,33,-14,-35,"undercount"
"4017",21021,"Kentucky","Boyle County","A_A",316,362,46,13.57,"overcount"
"4018",21021,"Kentucky","Boyle County","A_AIC",421,474,53,11.84,"overcount"
"4019",21021,"Kentucky","Boyle County","NHPI_A",11,3,-8,-114.29,"undercount"
"4020",21021,"Kentucky","Boyle County","NHPI_AIC",38,12,-26,-104,"undercount"
"4021",21023,"Kentucky","Bracken County","A_A",9,14,5,43.48,"overcount"
"4022",21023,"Kentucky","Bracken County","A_AIC",33,41,8,21.62,"overcount"
"4023",21023,"Kentucky","Bracken County","NHPI_A",3,0,-3,-200,"undercount"
"4024",21023,"Kentucky","Bracken County","NHPI_AIC",5,1,-4,-133.33,"undercount"
"4025",21025,"Kentucky","Breathitt County","A_A",81,38,-43,-72.27,"undercount"
"4026",21025,"Kentucky","Breathitt County","A_AIC",111,67,-44,-49.44,"undercount"
"4027",21025,"Kentucky","Breathitt County","NHPI_A",17,11,-6,-42.86,"undercount"
"4028",21025,"Kentucky","Breathitt County","NHPI_AIC",23,15,-8,-42.11,"undercount"
"4029",21027,"Kentucky","Breckinridge County","A_A",77,38,-39,-67.83,"undercount"
"4030",21027,"Kentucky","Breckinridge County","A_AIC",104,69,-35,-40.46,"undercount"
"4031",21027,"Kentucky","Breckinridge County","NHPI_A",7,3,-4,-80,"undercount"
"4032",21027,"Kentucky","Breckinridge County","NHPI_AIC",9,7,-2,-25,"undercount"
"4033",21029,"Kentucky","Bullitt County","A_A",524,464,-60,-12.15,"undercount"
"4034",21029,"Kentucky","Bullitt County","A_AIC",835,886,51,5.93,"overcount"
"4035",21029,"Kentucky","Bullitt County","NHPI_A",60,24,-36,-85.71,"undercount"
"4036",21029,"Kentucky","Bullitt County","NHPI_AIC",91,70,-21,-26.09,"undercount"
"4037",21031,"Kentucky","Butler County","A_A",43,23,-20,-60.61,"undercount"
"4038",21031,"Kentucky","Butler County","A_AIC",69,44,-25,-44.25,"undercount"
"4039",21031,"Kentucky","Butler County","NHPI_A",0,3,3,200,"overcount"
"4040",21031,"Kentucky","Butler County","NHPI_AIC",5,3,-2,-50,"undercount"
"4041",21033,"Kentucky","Caldwell County","A_A",60,53,-7,-12.39,"undercount"
"4042",21033,"Kentucky","Caldwell County","A_AIC",80,80,0,0,"equal"
"4043",21033,"Kentucky","Caldwell County","NHPI_A",6,2,-4,-100,"undercount"
"4044",21033,"Kentucky","Caldwell County","NHPI_AIC",9,21,12,80,"overcount"
"4045",21035,"Kentucky","Calloway County","A_A",690,440,-250,-44.25,"undercount"
"4046",21035,"Kentucky","Calloway County","A_AIC",828,628,-200,-27.47,"undercount"
"4047",21035,"Kentucky","Calloway County","NHPI_A",22,11,-11,-66.67,"undercount"
"4048",21035,"Kentucky","Calloway County","NHPI_AIC",42,36,-6,-15.38,"undercount"
"4049",21037,"Kentucky","Campbell County","A_A",1038,1028,-10,-0.97,"undercount"
"4050",21037,"Kentucky","Campbell County","A_AIC",1315,1532,217,15.24,"overcount"
"4051",21037,"Kentucky","Campbell County","NHPI_A",44,30,-14,-37.84,"undercount"
"4052",21037,"Kentucky","Campbell County","NHPI_AIC",87,133,46,41.82,"overcount"
"4053",21039,"Kentucky","Carlisle County","A_A",18,12,-6,-40,"undercount"
"4054",21039,"Kentucky","Carlisle County","A_AIC",38,20,-18,-62.07,"undercount"
"4055",21039,"Kentucky","Carlisle County","NHPI_A",0,0,0,0,"equal"
"4056",21039,"Kentucky","Carlisle County","NHPI_AIC",2,16,14,155.56,"overcount"
"4057",21041,"Kentucky","Carroll County","A_A",66,44,-22,-40,"undercount"
"4058",21041,"Kentucky","Carroll County","A_AIC",99,81,-18,-20,"undercount"
"4059",21041,"Kentucky","Carroll County","NHPI_A",6,6,0,0,"equal"
"4060",21041,"Kentucky","Carroll County","NHPI_AIC",12,19,7,45.16,"overcount"
"4061",21043,"Kentucky","Carter County","A_A",74,58,-16,-24.24,"undercount"
"4062",21043,"Kentucky","Carter County","A_AIC",107,84,-23,-24.08,"undercount"
"4063",21043,"Kentucky","Carter County","NHPI_A",6,3,-3,-66.67,"undercount"
"4064",21043,"Kentucky","Carter County","NHPI_AIC",12,14,2,15.38,"overcount"
"4065",21045,"Kentucky","Casey County","A_A",60,52,-8,-14.29,"undercount"
"4066",21045,"Kentucky","Casey County","A_AIC",84,58,-26,-36.62,"undercount"
"4067",21045,"Kentucky","Casey County","NHPI_A",8,1,-7,-155.56,"undercount"
"4068",21045,"Kentucky","Casey County","NHPI_AIC",12,4,-8,-100,"undercount"
"4069",21047,"Kentucky","Christian County","A_A",1122,943,-179,-17.34,"undercount"
"4070",21047,"Kentucky","Christian County","A_AIC",1820,1415,-405,-25.04,"undercount"
"4071",21047,"Kentucky","Christian County","NHPI_A",246,212,-34,-14.85,"undercount"
"4072",21047,"Kentucky","Christian County","NHPI_AIC",450,360,-90,-22.22,"undercount"
"4073",21049,"Kentucky","Clark County","A_A",253,210,-43,-18.57,"undercount"
"4074",21049,"Kentucky","Clark County","A_AIC",369,309,-60,-17.7,"undercount"
"4075",21049,"Kentucky","Clark County","NHPI_A",24,14,-10,-52.63,"undercount"
"4076",21049,"Kentucky","Clark County","NHPI_AIC",44,24,-20,-58.82,"undercount"
"4077",21051,"Kentucky","Clay County","A_A",40,21,-19,-62.3,"undercount"
"4078",21051,"Kentucky","Clay County","A_AIC",75,37,-38,-67.86,"undercount"
"4079",21051,"Kentucky","Clay County","NHPI_A",7,11,4,44.44,"overcount"
"4080",21051,"Kentucky","Clay County","NHPI_AIC",14,17,3,19.35,"overcount"
"4081",21053,"Kentucky","Clinton County","A_A",38,12,-26,-104,"undercount"
"4082",21053,"Kentucky","Clinton County","A_AIC",62,29,-33,-72.53,"undercount"
"4083",21053,"Kentucky","Clinton County","NHPI_A",41,3,-38,-172.73,"undercount"
"4084",21053,"Kentucky","Clinton County","NHPI_AIC",46,13,-33,-111.86,"undercount"
"4085",21055,"Kentucky","Crittenden County","A_A",21,6,-15,-111.11,"undercount"
"4086",21055,"Kentucky","Crittenden County","A_AIC",40,9,-31,-126.53,"undercount"
"4087",21055,"Kentucky","Crittenden County","NHPI_A",6,5,-1,-18.18,"undercount"
"4088",21055,"Kentucky","Crittenden County","NHPI_AIC",9,13,4,36.36,"overcount"
"4089",21057,"Kentucky","Cumberland County","A_A",9,2,-7,-127.27,"undercount"
"4090",21057,"Kentucky","Cumberland County","A_AIC",20,10,-10,-66.67,"undercount"
"4091",21057,"Kentucky","Cumberland County","NHPI_A",0,6,6,200,"overcount"
"4092",21057,"Kentucky","Cumberland County","NHPI_AIC",1,9,8,160,"overcount"
"4093",21059,"Kentucky","Daviess County","A_A",2094,2418,324,14.36,"overcount"
"4094",21059,"Kentucky","Daviess County","A_AIC",2396,2724,328,12.81,"overcount"
"4095",21059,"Kentucky","Daviess County","NHPI_A",137,59,-78,-79.59,"undercount"
"4096",21059,"Kentucky","Daviess County","NHPI_AIC",194,119,-75,-47.92,"undercount"
"4097",21061,"Kentucky","Edmonson County","A_A",52,32,-20,-47.62,"undercount"
"4098",21061,"Kentucky","Edmonson County","A_AIC",84,35,-49,-82.35,"undercount"
"4099",21061,"Kentucky","Edmonson County","NHPI_A",3,7,4,80,"overcount"
"4100",21061,"Kentucky","Edmonson County","NHPI_AIC",11,13,2,16.67,"overcount"
"4101",21063,"Kentucky","Elliott County","A_A",15,17,2,12.5,"overcount"
"4102",21063,"Kentucky","Elliott County","A_AIC",26,25,-1,-3.92,"undercount"
"4103",21063,"Kentucky","Elliott County","NHPI_A",13,0,-13,-200,"undercount"
"4104",21063,"Kentucky","Elliott County","NHPI_AIC",15,4,-11,-115.79,"undercount"
"4105",21065,"Kentucky","Estill County","A_A",17,7,-10,-83.33,"undercount"
"4106",21065,"Kentucky","Estill County","A_AIC",39,27,-12,-36.36,"undercount"
"4107",21065,"Kentucky","Estill County","NHPI_A",2,0,-2,-200,"undercount"
"4108",21065,"Kentucky","Estill County","NHPI_AIC",12,6,-6,-66.67,"undercount"
"4109",21067,"Kentucky","Fayette County","A_A",13832,13514,-318,-2.33,"undercount"
"4110",21067,"Kentucky","Fayette County","A_AIC",16416,16236,-180,-1.1,"undercount"
"4111",21067,"Kentucky","Fayette County","NHPI_A",292,135,-157,-73.54,"undercount"
"4112",21067,"Kentucky","Fayette County","NHPI_AIC",603,395,-208,-41.68,"undercount"
"4113",21069,"Kentucky","Fleming County","A_A",41,17,-24,-82.76,"undercount"
"4114",21069,"Kentucky","Fleming County","A_AIC",65,40,-25,-47.62,"undercount"
"4115",21069,"Kentucky","Fleming County","NHPI_A",1,3,2,100,"overcount"
"4116",21069,"Kentucky","Fleming County","NHPI_AIC",5,6,1,18.18,"overcount"
"4117",21071,"Kentucky","Floyd County","A_A",100,101,1,1,"overcount"
"4118",21071,"Kentucky","Floyd County","A_AIC",134,147,13,9.25,"overcount"
"4119",21071,"Kentucky","Floyd County","NHPI_A",3,2,-1,-40,"undercount"
"4120",21071,"Kentucky","Floyd County","NHPI_AIC",13,8,-5,-47.62,"undercount"
"4121",21073,"Kentucky","Franklin County","A_A",1114,1040,-74,-6.87,"undercount"
"4122",21073,"Kentucky","Franklin County","A_AIC",1247,1233,-14,-1.13,"undercount"
"4123",21073,"Kentucky","Franklin County","NHPI_A",15,14,-1,-6.9,"undercount"
"4124",21073,"Kentucky","Franklin County","NHPI_AIC",55,39,-16,-34.04,"undercount"
"4125",21075,"Kentucky","Fulton County","A_A",44,19,-25,-79.37,"undercount"
"4126",21075,"Kentucky","Fulton County","A_AIC",57,40,-17,-35.05,"undercount"
"4127",21075,"Kentucky","Fulton County","NHPI_A",8,11,3,31.58,"overcount"
"4128",21075,"Kentucky","Fulton County","NHPI_AIC",8,25,17,103.03,"overcount"
"4129",21077,"Kentucky","Gallatin County","A_A",39,13,-26,-100,"undercount"
"4130",21077,"Kentucky","Gallatin County","A_AIC",60,36,-24,-50,"undercount"
"4131",21077,"Kentucky","Gallatin County","NHPI_A",11,7,-4,-44.44,"undercount"
"4132",21077,"Kentucky","Gallatin County","NHPI_AIC",15,14,-1,-6.9,"undercount"
"4133",21079,"Kentucky","Garrard County","A_A",58,51,-7,-12.84,"undercount"
"4134",21079,"Kentucky","Garrard County","A_AIC",80,93,13,15.03,"overcount"
"4135",21079,"Kentucky","Garrard County","NHPI_A",9,8,-1,-11.76,"undercount"
"4136",21079,"Kentucky","Garrard County","NHPI_AIC",17,22,5,25.64,"overcount"
"4137",21081,"Kentucky","Grant County","A_A",109,66,-43,-49.14,"undercount"
"4138",21081,"Kentucky","Grant County","A_AIC",145,161,16,10.46,"overcount"
"4139",21081,"Kentucky","Grant County","NHPI_A",42,33,-9,-24,"undercount"
"4140",21081,"Kentucky","Grant County","NHPI_AIC",52,51,-1,-1.94,"undercount"
"4141",21083,"Kentucky","Graves County","A_A",202,179,-23,-12.07,"undercount"
"4142",21083,"Kentucky","Graves County","A_AIC",276,289,13,4.6,"overcount"
"4143",21083,"Kentucky","Graves County","NHPI_A",39,3,-36,-171.43,"undercount"
"4144",21083,"Kentucky","Graves County","NHPI_AIC",57,20,-37,-96.1,"undercount"
"4145",21085,"Kentucky","Grayson County","A_A",74,104,30,33.71,"overcount"
"4146",21085,"Kentucky","Grayson County","A_AIC",125,162,37,25.78,"overcount"
"4147",21085,"Kentucky","Grayson County","NHPI_A",9,2,-7,-127.27,"undercount"
"4148",21085,"Kentucky","Grayson County","NHPI_AIC",19,9,-10,-71.43,"undercount"
"4149",21087,"Kentucky","Green County","A_A",30,28,-2,-6.9,"undercount"
"4150",21087,"Kentucky","Green County","A_AIC",50,42,-8,-17.39,"undercount"
"4151",21087,"Kentucky","Green County","NHPI_A",2,2,0,0,"equal"
"4152",21087,"Kentucky","Green County","NHPI_AIC",6,7,1,15.38,"overcount"
"4153",21089,"Kentucky","Greenup County","A_A",210,230,20,9.09,"overcount"
"4154",21089,"Kentucky","Greenup County","A_AIC",257,291,34,12.41,"overcount"
"4155",21089,"Kentucky","Greenup County","NHPI_A",6,5,-1,-18.18,"undercount"
"4156",21089,"Kentucky","Greenup County","NHPI_AIC",13,23,10,55.56,"overcount"
"4157",21091,"Kentucky","Hancock County","A_A",35,34,-1,-2.9,"undercount"
"4158",21091,"Kentucky","Hancock County","A_AIC",47,57,10,19.23,"overcount"
"4159",21091,"Kentucky","Hancock County","NHPI_A",1,0,-1,-200,"undercount"
"4160",21091,"Kentucky","Hancock County","NHPI_AIC",4,8,4,66.67,"overcount"
"4161",21093,"Kentucky","Hardin County","A_A",2519,2271,-248,-10.35,"undercount"
"4162",21093,"Kentucky","Hardin County","A_AIC",3914,3694,-220,-5.78,"undercount"
"4163",21093,"Kentucky","Hardin County","NHPI_A",400,400,0,0,"equal"
"4164",21093,"Kentucky","Hardin County","NHPI_AIC",695,651,-44,-6.54,"undercount"
"4165",21095,"Kentucky","Harlan County","A_A",107,88,-19,-19.49,"undercount"
"4166",21095,"Kentucky","Harlan County","A_AIC",133,111,-22,-18.03,"undercount"
"4167",21095,"Kentucky","Harlan County","NHPI_A",24,0,-24,-200,"undercount"
"4168",21095,"Kentucky","Harlan County","NHPI_AIC",32,14,-18,-78.26,"undercount"
"4169",21097,"Kentucky","Harrison County","A_A",67,46,-21,-37.17,"undercount"
"4170",21097,"Kentucky","Harrison County","A_AIC",90,104,14,14.43,"overcount"
"4171",21097,"Kentucky","Harrison County","NHPI_A",14,1,-13,-173.33,"undercount"
"4172",21097,"Kentucky","Harrison County","NHPI_AIC",18,14,-4,-25,"undercount"
"4173",21099,"Kentucky","Hart County","A_A",87,45,-42,-63.64,"undercount"
"4174",21099,"Kentucky","Hart County","A_AIC",122,81,-41,-40.39,"undercount"
"4175",21099,"Kentucky","Hart County","NHPI_A",10,6,-4,-50,"undercount"
"4176",21099,"Kentucky","Hart County","NHPI_AIC",18,11,-7,-48.28,"undercount"
"4177",21101,"Kentucky","Henderson County","A_A",253,239,-14,-5.69,"undercount"
"4178",21101,"Kentucky","Henderson County","A_AIC",360,419,59,15.15,"overcount"
"4179",21101,"Kentucky","Henderson County","NHPI_A",54,49,-5,-9.71,"undercount"
"4180",21101,"Kentucky","Henderson County","NHPI_AIC",80,65,-15,-20.69,"undercount"
"4181",21103,"Kentucky","Henry County","A_A",66,35,-31,-61.39,"undercount"
"4182",21103,"Kentucky","Henry County","A_AIC",97,77,-20,-22.99,"undercount"
"4183",21103,"Kentucky","Henry County","NHPI_A",15,0,-15,-200,"undercount"
"4184",21103,"Kentucky","Henry County","NHPI_AIC",22,0,-22,-200,"undercount"
"4185",21105,"Kentucky","Hickman County","A_A",23,11,-12,-70.59,"undercount"
"4186",21105,"Kentucky","Hickman County","A_AIC",31,16,-15,-63.83,"undercount"
"4187",21105,"Kentucky","Hickman County","NHPI_A",1,0,-1,-200,"undercount"
"4188",21105,"Kentucky","Hickman County","NHPI_AIC",4,6,2,40,"overcount"
"4189",21107,"Kentucky","Hopkins County","A_A",280,233,-47,-18.32,"undercount"
"4190",21107,"Kentucky","Hopkins County","A_AIC",402,362,-40,-10.47,"undercount"
"4191",21107,"Kentucky","Hopkins County","NHPI_A",37,29,-8,-24.24,"undercount"
"4192",21107,"Kentucky","Hopkins County","NHPI_AIC",55,77,22,33.33,"overcount"
"4193",21109,"Kentucky","Jackson County","A_A",20,19,-1,-5.13,"undercount"
"4194",21109,"Kentucky","Jackson County","A_AIC",38,37,-1,-2.67,"undercount"
"4195",21109,"Kentucky","Jackson County","NHPI_A",3,4,1,28.57,"overcount"
"4196",21109,"Kentucky","Jackson County","NHPI_AIC",4,21,17,136,"overcount"
"4197",21111,"Kentucky","Jefferson County","A_A",24417,27130,2713,10.53,"overcount"
"4198",21111,"Kentucky","Jefferson County","A_AIC",29421,32999,3578,11.46,"overcount"
"4199",21111,"Kentucky","Jefferson County","NHPI_A",489,569,80,15.12,"overcount"
"4200",21111,"Kentucky","Jefferson County","NHPI_AIC",1307,1328,21,1.59,"overcount"
"4201",21113,"Kentucky","Jessamine County","A_A",741,658,-83,-11.87,"undercount"
"4202",21113,"Kentucky","Jessamine County","A_AIC",996,931,-65,-6.75,"undercount"
"4203",21113,"Kentucky","Jessamine County","NHPI_A",44,27,-17,-47.89,"undercount"
"4204",21113,"Kentucky","Jessamine County","NHPI_AIC",80,60,-20,-28.57,"undercount"
"4205",21115,"Kentucky","Johnson County","A_A",116,105,-11,-9.95,"undercount"
"4206",21115,"Kentucky","Johnson County","A_AIC",150,143,-7,-4.78,"undercount"
"4207",21115,"Kentucky","Johnson County","NHPI_A",6,4,-2,-40,"undercount"
"4208",21115,"Kentucky","Johnson County","NHPI_AIC",12,11,-1,-8.7,"undercount"
"4209",21117,"Kentucky","Kenton County","A_A",2287,2020,-267,-12.4,"undercount"
"4210",21117,"Kentucky","Kenton County","A_AIC",3040,2995,-45,-1.49,"undercount"
"4211",21117,"Kentucky","Kenton County","NHPI_A",280,241,-39,-14.97,"undercount"
"4212",21117,"Kentucky","Kenton County","NHPI_AIC",416,347,-69,-18.09,"undercount"
"4213",21119,"Kentucky","Knott County","A_A",23,18,-5,-24.39,"undercount"
"4214",21119,"Kentucky","Knott County","A_AIC",42,28,-14,-40,"undercount"
"4215",21119,"Kentucky","Knott County","NHPI_A",4,0,-4,-200,"undercount"
"4216",21119,"Kentucky","Knott County","NHPI_AIC",7,5,-2,-33.33,"undercount"
"4217",21121,"Kentucky","Knox County","A_A",122,85,-37,-35.75,"undercount"
"4218",21121,"Kentucky","Knox County","A_AIC",181,127,-54,-35.06,"undercount"
"4219",21121,"Kentucky","Knox County","NHPI_A",12,2,-10,-142.86,"undercount"
"4220",21121,"Kentucky","Knox County","NHPI_AIC",22,15,-7,-37.84,"undercount"
"4221",21123,"Kentucky","Larue County","A_A",47,29,-18,-47.37,"undercount"
"4222",21123,"Kentucky","Larue County","A_AIC",75,89,14,17.07,"overcount"
"4223",21123,"Kentucky","Larue County","NHPI_A",20,15,-5,-28.57,"undercount"
"4224",21123,"Kentucky","Larue County","NHPI_AIC",35,28,-7,-22.22,"undercount"
"4225",21125,"Kentucky","Laurel County","A_A",364,426,62,15.7,"overcount"
"4226",21125,"Kentucky","Laurel County","A_AIC",454,509,55,11.42,"overcount"
"4227",21125,"Kentucky","Laurel County","NHPI_A",17,4,-13,-123.81,"undercount"
"4228",21125,"Kentucky","Laurel County","NHPI_AIC",41,29,-12,-34.29,"undercount"
"4229",21127,"Kentucky","Lawrence County","A_A",42,35,-7,-18.18,"undercount"
"4230",21127,"Kentucky","Lawrence County","A_AIC",79,62,-17,-24.11,"undercount"
"4231",21127,"Kentucky","Lawrence County","NHPI_A",8,4,-4,-66.67,"undercount"
"4232",21127,"Kentucky","Lawrence County","NHPI_AIC",16,9,-7,-56,"undercount"
"4233",21129,"Kentucky","Lee County","A_A",20,0,-20,-200,"undercount"
"4234",21129,"Kentucky","Lee County","A_AIC",32,1,-31,-187.88,"undercount"
"4235",21129,"Kentucky","Lee County","NHPI_A",0,0,0,0,"equal"
"4236",21129,"Kentucky","Lee County","NHPI_AIC",1,0,-1,-200,"undercount"
"4237",21131,"Kentucky","Leslie County","A_A",30,16,-14,-60.87,"undercount"
"4238",21131,"Kentucky","Leslie County","A_AIC",45,19,-26,-81.25,"undercount"
"4239",21131,"Kentucky","Leslie County","NHPI_A",6,0,-6,-200,"undercount"
"4240",21131,"Kentucky","Leslie County","NHPI_AIC",7,2,-5,-111.11,"undercount"
"4241",21133,"Kentucky","Letcher County","A_A",58,57,-1,-1.74,"undercount"
"4242",21133,"Kentucky","Letcher County","A_AIC",85,72,-13,-16.56,"undercount"
"4243",21133,"Kentucky","Letcher County","NHPI_A",0,0,0,0,"equal"
"4244",21133,"Kentucky","Letcher County","NHPI_AIC",5,13,8,88.89,"overcount"
"4245",21135,"Kentucky","Lewis County","A_A",8,9,1,11.76,"overcount"
"4246",21135,"Kentucky","Lewis County","A_AIC",27,27,0,0,"equal"
"4247",21135,"Kentucky","Lewis County","NHPI_A",0,4,4,200,"overcount"
"4248",21135,"Kentucky","Lewis County","NHPI_AIC",3,6,3,66.67,"overcount"
"4249",21137,"Kentucky","Lincoln County","A_A",74,60,-14,-20.9,"undercount"
"4250",21137,"Kentucky","Lincoln County","A_AIC",113,71,-42,-45.65,"undercount"
"4251",21137,"Kentucky","Lincoln County","NHPI_A",2,2,0,0,"equal"
"4252",21137,"Kentucky","Lincoln County","NHPI_AIC",14,12,-2,-15.38,"undercount"
"4253",21139,"Kentucky","Livingston County","A_A",39,12,-27,-105.88,"undercount"
"4254",21139,"Kentucky","Livingston County","A_AIC",65,37,-28,-54.9,"undercount"
"4255",21139,"Kentucky","Livingston County","NHPI_A",10,6,-4,-50,"undercount"
"4256",21139,"Kentucky","Livingston County","NHPI_AIC",14,18,4,25,"overcount"
"4257",21141,"Kentucky","Logan County","A_A",99,95,-4,-4.12,"undercount"
"4258",21141,"Kentucky","Logan County","A_AIC",156,138,-18,-12.24,"undercount"
"4259",21141,"Kentucky","Logan County","NHPI_A",14,2,-12,-150,"undercount"
"4260",21141,"Kentucky","Logan County","NHPI_AIC",32,13,-19,-84.44,"undercount"
"4261",21143,"Kentucky","Lyon County","A_A",44,34,-10,-25.64,"undercount"
"4262",21143,"Kentucky","Lyon County","A_AIC",62,46,-16,-29.63,"undercount"
"4263",21143,"Kentucky","Lyon County","NHPI_A",1,0,-1,-200,"undercount"
"4264",21143,"Kentucky","Lyon County","NHPI_AIC",6,1,-5,-142.86,"undercount"
"4265",21145,"Kentucky","McCracken County","A_A",624,674,50,7.7,"overcount"
"4266",21145,"Kentucky","McCracken County","A_AIC",880,966,86,9.32,"overcount"
"4267",21145,"Kentucky","McCracken County","NHPI_A",65,18,-47,-113.25,"undercount"
"4268",21145,"Kentucky","McCracken County","NHPI_AIC",139,66,-73,-71.22,"undercount"
"4269",21147,"Kentucky","McCreary County","A_A",96,32,-64,-100,"undercount"
"4270",21147,"Kentucky","McCreary County","A_AIC",134,44,-90,-101.12,"undercount"
"4271",21147,"Kentucky","McCreary County","NHPI_A",10,3,-7,-107.69,"undercount"
"4272",21147,"Kentucky","McCreary County","NHPI_AIC",30,9,-21,-107.69,"undercount"
"4273",21149,"Kentucky","McLean County","A_A",19,13,-6,-37.5,"undercount"
"4274",21149,"Kentucky","McLean County","A_AIC",39,27,-12,-36.36,"undercount"
"4275",21149,"Kentucky","McLean County","NHPI_A",4,2,-2,-66.67,"undercount"
"4276",21149,"Kentucky","McLean County","NHPI_AIC",6,6,0,0,"equal"
"4277",21151,"Kentucky","Madison County","A_A",1048,1013,-35,-3.4,"undercount"
"4278",21151,"Kentucky","Madison County","A_AIC",1457,2198,741,40.55,"overcount"
"4279",21151,"Kentucky","Madison County","NHPI_A",56,58,2,3.51,"overcount"
"4280",21151,"Kentucky","Madison County","NHPI_AIC",124,877,753,150.45,"overcount"
"4281",21153,"Kentucky","Magoffin County","A_A",24,5,-19,-131.03,"undercount"
"4282",21153,"Kentucky","Magoffin County","A_AIC",44,18,-26,-83.87,"undercount"
"4283",21153,"Kentucky","Magoffin County","NHPI_A",0,6,6,200,"overcount"
"4284",21153,"Kentucky","Magoffin County","NHPI_AIC",3,7,4,80,"overcount"
"4285",21155,"Kentucky","Marion County","A_A",166,124,-42,-28.97,"undercount"
"4286",21155,"Kentucky","Marion County","A_AIC",204,186,-18,-9.23,"undercount"
"4287",21155,"Kentucky","Marion County","NHPI_A",7,47,40,148.15,"overcount"
"4288",21155,"Kentucky","Marion County","NHPI_AIC",14,59,45,123.29,"overcount"
"4289",21157,"Kentucky","Marshall County","A_A",147,129,-18,-13.04,"undercount"
"4290",21157,"Kentucky","Marshall County","A_AIC",217,211,-6,-2.8,"undercount"
"4291",21157,"Kentucky","Marshall County","NHPI_A",9,9,0,0,"equal"
"4292",21157,"Kentucky","Marshall County","NHPI_AIC",19,19,0,0,"equal"
"4293",21159,"Kentucky","Martin County","A_A",25,17,-8,-38.1,"undercount"
"4294",21159,"Kentucky","Martin County","A_AIC",39,23,-16,-51.61,"undercount"
"4295",21159,"Kentucky","Martin County","NHPI_A",2,1,-1,-66.67,"undercount"
"4296",21159,"Kentucky","Martin County","NHPI_AIC",5,2,-3,-85.71,"undercount"
"4297",21161,"Kentucky","Mason County","A_A",154,107,-47,-36.02,"undercount"
"4298",21161,"Kentucky","Mason County","A_AIC",203,130,-73,-43.84,"undercount"
"4299",21161,"Kentucky","Mason County","NHPI_A",6,0,-6,-200,"undercount"
"4300",21161,"Kentucky","Mason County","NHPI_AIC",17,8,-9,-72,"undercount"
"4301",21163,"Kentucky","Meade County","A_A",230,221,-9,-3.99,"undercount"
"4302",21163,"Kentucky","Meade County","A_AIC",395,435,40,9.64,"overcount"
"4303",21163,"Kentucky","Meade County","NHPI_A",66,73,7,10.07,"overcount"
"4304",21163,"Kentucky","Meade County","NHPI_AIC",108,136,28,22.95,"overcount"
"4305",21165,"Kentucky","Menifee County","A_A",13,2,-11,-146.67,"undercount"
"4306",21165,"Kentucky","Menifee County","A_AIC",22,12,-10,-58.82,"undercount"
"4307",21165,"Kentucky","Menifee County","NHPI_A",7,2,-5,-111.11,"undercount"
"4308",21165,"Kentucky","Menifee County","NHPI_AIC",8,2,-6,-120,"undercount"
"4309",21167,"Kentucky","Mercer County","A_A",160,80,-80,-66.67,"undercount"
"4310",21167,"Kentucky","Mercer County","A_AIC",203,135,-68,-40.24,"undercount"
"4311",21167,"Kentucky","Mercer County","NHPI_A",23,14,-9,-48.65,"undercount"
"4312",21167,"Kentucky","Mercer County","NHPI_AIC",34,24,-10,-34.48,"undercount"
"4313",21169,"Kentucky","Metcalfe County","A_A",30,9,-21,-107.69,"undercount"
"4314",21169,"Kentucky","Metcalfe County","A_AIC",48,26,-22,-59.46,"undercount"
"4315",21169,"Kentucky","Metcalfe County","NHPI_A",1,0,-1,-200,"undercount"
"4316",21169,"Kentucky","Metcalfe County","NHPI_AIC",1,12,11,169.23,"overcount"
"4317",21171,"Kentucky","Monroe County","A_A",29,10,-19,-97.44,"undercount"
"4318",21171,"Kentucky","Monroe County","A_AIC",47,18,-29,-89.23,"undercount"
"4319",21171,"Kentucky","Monroe County","NHPI_A",5,0,-5,-200,"undercount"
"4320",21171,"Kentucky","Monroe County","NHPI_AIC",7,4,-3,-54.55,"undercount"
"4321",21173,"Kentucky","Montgomery County","A_A",132,145,13,9.39,"overcount"
"4322",21173,"Kentucky","Montgomery County","A_AIC",175,236,61,29.68,"overcount"
"4323",21173,"Kentucky","Montgomery County","NHPI_A",15,1,-14,-175,"undercount"
"4324",21173,"Kentucky","Montgomery County","NHPI_AIC",31,18,-13,-53.06,"undercount"
"4325",21175,"Kentucky","Morgan County","A_A",135,18,-117,-152.94,"undercount"
"4326",21175,"Kentucky","Morgan County","A_AIC",153,36,-117,-123.81,"undercount"
"4327",21175,"Kentucky","Morgan County","NHPI_A",4,4,0,0,"equal"
"4328",21175,"Kentucky","Morgan County","NHPI_AIC",7,10,3,35.29,"overcount"
"4329",21177,"Kentucky","Muhlenberg County","A_A",107,58,-49,-59.39,"undercount"
"4330",21177,"Kentucky","Muhlenberg County","A_AIC",154,98,-56,-44.44,"undercount"
"4331",21177,"Kentucky","Muhlenberg County","NHPI_A",6,3,-3,-66.67,"undercount"
"4332",21177,"Kentucky","Muhlenberg County","NHPI_AIC",22,23,1,4.44,"overcount"
"4333",21179,"Kentucky","Nelson County","A_A",229,267,38,15.32,"overcount"
"4334",21179,"Kentucky","Nelson County","A_AIC",350,453,103,25.65,"overcount"
"4335",21179,"Kentucky","Nelson County","NHPI_A",33,8,-25,-121.95,"undercount"
"4336",21179,"Kentucky","Nelson County","NHPI_AIC",55,37,-18,-39.13,"undercount"
"4337",21181,"Kentucky","Nicholas County","A_A",19,7,-12,-92.31,"undercount"
"4338",21181,"Kentucky","Nicholas County","A_AIC",28,25,-3,-11.32,"undercount"
"4339",21181,"Kentucky","Nicholas County","NHPI_A",0,2,2,200,"overcount"
"4340",21181,"Kentucky","Nicholas County","NHPI_AIC",2,6,4,100,"overcount"
"4341",21183,"Kentucky","Ohio County","A_A",81,59,-22,-31.43,"undercount"
"4342",21183,"Kentucky","Ohio County","A_AIC",112,116,4,3.51,"overcount"
"4343",21183,"Kentucky","Ohio County","NHPI_A",9,2,-7,-127.27,"undercount"
"4344",21183,"Kentucky","Ohio County","NHPI_AIC",14,16,2,13.33,"overcount"
"4345",21185,"Kentucky","Oldham County","A_A",1163,1182,19,1.62,"overcount"
"4346",21185,"Kentucky","Oldham County","A_AIC",1558,1803,245,14.58,"overcount"
"4347",21185,"Kentucky","Oldham County","NHPI_A",56,17,-39,-106.85,"undercount"
"4348",21185,"Kentucky","Oldham County","NHPI_AIC",126,69,-57,-58.46,"undercount"
"4349",21187,"Kentucky","Owen County","A_A",22,18,-4,-20,"undercount"
"4350",21187,"Kentucky","Owen County","A_AIC",43,58,15,29.7,"overcount"
"4351",21187,"Kentucky","Owen County","NHPI_A",1,4,3,120,"overcount"
"4352",21187,"Kentucky","Owen County","NHPI_AIC",4,19,15,130.43,"overcount"
"4353",21189,"Kentucky","Owsley County","A_A",5,1,-4,-133.33,"undercount"
"4354",21189,"Kentucky","Owsley County","A_AIC",14,2,-12,-150,"undercount"
"4355",21189,"Kentucky","Owsley County","NHPI_A",1,5,4,133.33,"overcount"
"4356",21189,"Kentucky","Owsley County","NHPI_AIC",3,6,3,66.67,"overcount"
"4357",21191,"Kentucky","Pendleton County","A_A",38,30,-8,-23.53,"undercount"
"4358",21191,"Kentucky","Pendleton County","A_AIC",83,78,-5,-6.21,"undercount"
"4359",21191,"Kentucky","Pendleton County","NHPI_A",7,3,-4,-80,"undercount"
"4360",21191,"Kentucky","Pendleton County","NHPI_AIC",12,15,3,22.22,"overcount"
"4361",21193,"Kentucky","Perry County","A_A",274,255,-19,-7.18,"undercount"
"4362",21193,"Kentucky","Perry County","A_AIC",312,288,-24,-8,"undercount"
"4363",21193,"Kentucky","Perry County","NHPI_A",14,1,-13,-173.33,"undercount"
"4364",21193,"Kentucky","Perry County","NHPI_AIC",20,14,-6,-35.29,"undercount"
"4365",21195,"Kentucky","Pike County","A_A",322,369,47,13.6,"overcount"
"4366",21195,"Kentucky","Pike County","A_AIC",403,445,42,9.91,"overcount"
"4367",21195,"Kentucky","Pike County","NHPI_A",27,11,-16,-84.21,"undercount"
"4368",21195,"Kentucky","Pike County","NHPI_AIC",44,33,-11,-28.57,"undercount"
"4369",21197,"Kentucky","Powell County","A_A",44,30,-14,-37.84,"undercount"
"4370",21197,"Kentucky","Powell County","A_AIC",70,53,-17,-27.64,"undercount"
"4371",21197,"Kentucky","Powell County","NHPI_A",5,0,-5,-200,"undercount"
"4372",21197,"Kentucky","Powell County","NHPI_AIC",10,7,-3,-35.29,"undercount"
"4373",21199,"Kentucky","Pulaski County","A_A",544,450,-94,-18.91,"undercount"
"4374",21199,"Kentucky","Pulaski County","A_AIC",683,576,-107,-17,"undercount"
"4375",21199,"Kentucky","Pulaski County","NHPI_A",28,11,-17,-87.18,"undercount"
"4376",21199,"Kentucky","Pulaski County","NHPI_AIC",56,30,-26,-60.47,"undercount"
"4377",21201,"Kentucky","Robertson County","A_A",2,7,5,111.11,"overcount"
"4378",21201,"Kentucky","Robertson County","A_AIC",6,11,5,58.82,"overcount"
"4379",21201,"Kentucky","Robertson County","NHPI_A",0,0,0,0,"equal"
"4380",21201,"Kentucky","Robertson County","NHPI_AIC",1,6,5,142.86,"overcount"
"4381",21203,"Kentucky","Rockcastle County","A_A",24,28,4,15.38,"overcount"
"4382",21203,"Kentucky","Rockcastle County","A_AIC",58,52,-6,-10.91,"undercount"
"4383",21203,"Kentucky","Rockcastle County","NHPI_A",4,0,-4,-200,"undercount"
"4384",21203,"Kentucky","Rockcastle County","NHPI_AIC",16,9,-7,-56,"undercount"
"4385",21205,"Kentucky","Rowan County","A_A",210,157,-53,-28.88,"undercount"
"4386",21205,"Kentucky","Rowan County","A_AIC",272,208,-64,-26.67,"undercount"
"4387",21205,"Kentucky","Rowan County","NHPI_A",4,5,1,22.22,"overcount"
"4388",21205,"Kentucky","Rowan County","NHPI_AIC",20,16,-4,-22.22,"undercount"
"4389",21207,"Kentucky","Russell County","A_A",107,107,0,0,"equal"
"4390",21207,"Kentucky","Russell County","A_AIC",141,132,-9,-6.59,"undercount"
"4391",21207,"Kentucky","Russell County","NHPI_A",2,3,1,40,"overcount"
"4392",21207,"Kentucky","Russell County","NHPI_AIC",14,15,1,6.9,"overcount"
"4393",21209,"Kentucky","Scott County","A_A",767,594,-173,-25.42,"undercount"
"4394",21209,"Kentucky","Scott County","A_AIC",1026,957,-69,-6.96,"undercount"
"4395",21209,"Kentucky","Scott County","NHPI_A",25,19,-6,-27.27,"undercount"
"4396",21209,"Kentucky","Scott County","NHPI_AIC",71,69,-2,-2.86,"undercount"
"4397",21211,"Kentucky","Shelby County","A_A",529,366,-163,-36.42,"undercount"
"4398",21211,"Kentucky","Shelby County","A_AIC",753,597,-156,-23.11,"undercount"
"4399",21211,"Kentucky","Shelby County","NHPI_A",122,22,-100,-138.89,"undercount"
"4400",21211,"Kentucky","Shelby County","NHPI_AIC",183,40,-143,-128.25,"undercount"
"4401",21213,"Kentucky","Simpson County","A_A",163,96,-67,-51.74,"undercount"
"4402",21213,"Kentucky","Simpson County","A_AIC",193,153,-40,-23.12,"undercount"
"4403",21213,"Kentucky","Simpson County","NHPI_A",17,5,-12,-109.09,"undercount"
"4404",21213,"Kentucky","Simpson County","NHPI_AIC",27,19,-8,-34.78,"undercount"
"4405",21215,"Kentucky","Spencer County","A_A",73,90,17,20.86,"overcount"
"4406",21215,"Kentucky","Spencer County","A_AIC",115,167,52,36.88,"overcount"
"4407",21215,"Kentucky","Spencer County","NHPI_A",16,13,-3,-20.69,"undercount"
"4408",21215,"Kentucky","Spencer County","NHPI_AIC",26,15,-11,-53.66,"undercount"
"4409",21217,"Kentucky","Taylor County","A_A",215,244,29,12.64,"overcount"
"4410",21217,"Kentucky","Taylor County","A_AIC",263,319,56,19.24,"overcount"
"4411",21217,"Kentucky","Taylor County","NHPI_A",16,10,-6,-46.15,"undercount"
"4412",21217,"Kentucky","Taylor County","NHPI_AIC",24,24,0,0,"equal"
"4413",21219,"Kentucky","Todd County","A_A",39,24,-15,-47.62,"undercount"
"4414",21219,"Kentucky","Todd County","A_AIC",69,74,5,6.99,"overcount"
"4415",21219,"Kentucky","Todd County","NHPI_A",17,6,-11,-95.65,"undercount"
"4416",21219,"Kentucky","Todd County","NHPI_AIC",19,13,-6,-37.5,"undercount"
"4417",21221,"Kentucky","Trigg County","A_A",53,27,-26,-65,"undercount"
"4418",21221,"Kentucky","Trigg County","A_AIC",106,81,-25,-26.74,"undercount"
"4419",21221,"Kentucky","Trigg County","NHPI_A",16,6,-10,-90.91,"undercount"
"4420",21221,"Kentucky","Trigg County","NHPI_AIC",31,24,-7,-25.45,"undercount"
"4421",21223,"Kentucky","Trimble County","A_A",54,29,-25,-60.24,"undercount"
"4422",21223,"Kentucky","Trimble County","A_AIC",78,49,-29,-45.67,"undercount"
"4423",21223,"Kentucky","Trimble County","NHPI_A",11,4,-7,-93.33,"undercount"
"4424",21223,"Kentucky","Trimble County","NHPI_AIC",14,6,-8,-80,"undercount"
"4425",21225,"Kentucky","Union County","A_A",99,32,-67,-102.29,"undercount"
"4426",21225,"Kentucky","Union County","A_AIC",116,70,-46,-49.46,"undercount"
"4427",21225,"Kentucky","Union County","NHPI_A",12,1,-11,-169.23,"undercount"
"4428",21225,"Kentucky","Union County","NHPI_AIC",15,8,-7,-60.87,"undercount"
"4429",21227,"Kentucky","Warren County","A_A",6772,7411,639,9.01,"overcount"
"4430",21227,"Kentucky","Warren County","A_AIC",7451,8206,755,9.64,"overcount"
"4431",21227,"Kentucky","Warren County","NHPI_A",770,661,-109,-15.23,"undercount"
"4432",21227,"Kentucky","Warren County","NHPI_AIC",930,801,-129,-14.9,"undercount"
"4433",21229,"Kentucky","Washington County","A_A",93,38,-55,-83.97,"undercount"
"4434",21229,"Kentucky","Washington County","A_AIC",115,74,-41,-43.39,"undercount"
"4435",21229,"Kentucky","Washington County","NHPI_A",8,5,-3,-46.15,"undercount"
"4436",21229,"Kentucky","Washington County","NHPI_AIC",14,11,-3,-24,"undercount"
"4437",21231,"Kentucky","Wayne County","A_A",97,62,-35,-44.03,"undercount"
"4438",21231,"Kentucky","Wayne County","A_AIC",132,87,-45,-41.1,"undercount"
"4439",21231,"Kentucky","Wayne County","NHPI_A",19,5,-14,-116.67,"undercount"
"4440",21231,"Kentucky","Wayne County","NHPI_AIC",28,11,-17,-87.18,"undercount"
"4441",21233,"Kentucky","Webster County","A_A",74,24,-50,-102.04,"undercount"
"4442",21233,"Kentucky","Webster County","A_AIC",91,61,-30,-39.47,"undercount"
"4443",21233,"Kentucky","Webster County","NHPI_A",48,1,-47,-191.84,"undercount"
"4444",21233,"Kentucky","Webster County","NHPI_AIC",54,9,-45,-142.86,"undercount"
"4445",21235,"Kentucky","Whitley County","A_A",157,204,47,26.04,"overcount"
"4446",21235,"Kentucky","Whitley County","A_AIC",235,281,46,17.83,"overcount"
"4447",21235,"Kentucky","Whitley County","NHPI_A",15,10,-5,-40,"undercount"
"4448",21235,"Kentucky","Whitley County","NHPI_AIC",28,47,19,50.67,"overcount"
"4449",21237,"Kentucky","Wolfe County","A_A",13,5,-8,-88.89,"undercount"
"4450",21237,"Kentucky","Wolfe County","A_AIC",20,18,-2,-10.53,"undercount"
"4451",21237,"Kentucky","Wolfe County","NHPI_A",0,0,0,0,"equal"
"4452",21237,"Kentucky","Wolfe County","NHPI_AIC",1,5,4,133.33,"overcount"
"4453",21239,"Kentucky","Woodford County","A_A",197,157,-40,-22.6,"undercount"
"4454",21239,"Kentucky","Woodford County","A_AIC",262,327,65,22.07,"overcount"
"4455",21239,"Kentucky","Woodford County","NHPI_A",58,15,-43,-117.81,"undercount"
"4456",21239,"Kentucky","Woodford County","NHPI_AIC",71,40,-31,-55.86,"undercount"
"4457",22001,"Louisiana","Acadia Parish","A_A",197,171,-26,-14.13,"undercount"
"4458",22001,"Louisiana","Acadia Parish","A_AIC",303,243,-60,-21.98,"undercount"
"4459",22001,"Louisiana","Acadia Parish","NHPI_A",20,4,-16,-133.33,"undercount"
"4460",22001,"Louisiana","Acadia Parish","NHPI_AIC",45,21,-24,-72.73,"undercount"
"4461",22003,"Louisiana","Allen Parish","A_A",157,183,26,15.29,"overcount"
"4462",22003,"Louisiana","Allen Parish","A_AIC",238,250,12,4.92,"overcount"
"4463",22003,"Louisiana","Allen Parish","NHPI_A",9,7,-2,-25,"undercount"
"4464",22003,"Louisiana","Allen Parish","NHPI_AIC",32,34,2,6.06,"overcount"
"4465",22005,"Louisiana","Ascension Parish","A_A",1829,1708,-121,-6.84,"undercount"
"4466",22005,"Louisiana","Ascension Parish","A_AIC",2322,2340,18,0.77,"overcount"
"4467",22005,"Louisiana","Ascension Parish","NHPI_A",96,33,-63,-97.67,"undercount"
"4468",22005,"Louisiana","Ascension Parish","NHPI_AIC",217,127,-90,-52.33,"undercount"
"4469",22007,"Louisiana","Assumption Parish","A_A",115,56,-59,-69.01,"undercount"
"4470",22007,"Louisiana","Assumption Parish","A_AIC",143,85,-58,-50.88,"undercount"
"4471",22007,"Louisiana","Assumption Parish","NHPI_A",15,1,-14,-175,"undercount"
"4472",22007,"Louisiana","Assumption Parish","NHPI_AIC",23,10,-13,-78.79,"undercount"
"4473",22009,"Louisiana","Avoyelles Parish","A_A",206,351,145,52.06,"overcount"
"4474",22009,"Louisiana","Avoyelles Parish","A_AIC",297,426,129,35.68,"overcount"
"4475",22009,"Louisiana","Avoyelles Parish","NHPI_A",43,6,-37,-151.02,"undercount"
"4476",22009,"Louisiana","Avoyelles Parish","NHPI_AIC",71,30,-41,-81.19,"undercount"
"4477",22011,"Louisiana","Beauregard Parish","A_A",247,231,-16,-6.69,"undercount"
"4478",22011,"Louisiana","Beauregard Parish","A_AIC",449,427,-22,-5.02,"undercount"
"4479",22011,"Louisiana","Beauregard Parish","NHPI_A",47,27,-20,-54.05,"undercount"
"4480",22011,"Louisiana","Beauregard Parish","NHPI_AIC",91,50,-41,-58.16,"undercount"
"4481",22013,"Louisiana","Bienville Parish","A_A",54,21,-33,-88,"undercount"
"4482",22013,"Louisiana","Bienville Parish","A_AIC",89,65,-24,-31.17,"undercount"
"4483",22013,"Louisiana","Bienville Parish","NHPI_A",6,5,-1,-18.18,"undercount"
"4484",22013,"Louisiana","Bienville Parish","NHPI_AIC",12,16,4,28.57,"overcount"
"4485",22015,"Louisiana","Bossier Parish","A_A",2436,2387,-49,-2.03,"undercount"
"4486",22015,"Louisiana","Bossier Parish","A_AIC",3610,3626,16,0.44,"overcount"
"4487",22015,"Louisiana","Bossier Parish","NHPI_A",167,118,-49,-34.39,"undercount"
"4488",22015,"Louisiana","Bossier Parish","NHPI_AIC",341,326,-15,-4.5,"undercount"
"4489",22017,"Louisiana","Caddo Parish","A_A",3311,3205,-106,-3.25,"undercount"
"4490",22017,"Louisiana","Caddo Parish","A_AIC",4288,4252,-36,-0.84,"undercount"
"4491",22017,"Louisiana","Caddo Parish","NHPI_A",151,122,-29,-21.25,"undercount"
"4492",22017,"Louisiana","Caddo Parish","NHPI_AIC",363,285,-78,-24.07,"undercount"
"4493",22019,"Louisiana","Calcasieu Parish","A_A",2969,3829,860,25.3,"overcount"
"4494",22019,"Louisiana","Calcasieu Parish","A_AIC",3803,4752,949,22.19,"overcount"
"4495",22019,"Louisiana","Calcasieu Parish","NHPI_A",131,151,20,14.18,"overcount"
"4496",22019,"Louisiana","Calcasieu Parish","NHPI_AIC",318,315,-3,-0.95,"undercount"
"4497",22021,"Louisiana","Caldwell Parish","A_A",31,42,11,30.14,"overcount"
"4498",22021,"Louisiana","Caldwell Parish","A_AIC",58,55,-3,-5.31,"undercount"
"4499",22021,"Louisiana","Caldwell Parish","NHPI_A",2,3,1,40,"overcount"
"4500",22021,"Louisiana","Caldwell Parish","NHPI_AIC",8,13,5,47.62,"overcount"
"4501",22023,"Louisiana","Cameron Parish","A_A",30,13,-17,-79.07,"undercount"
"4502",22023,"Louisiana","Cameron Parish","A_AIC",50,32,-18,-43.9,"undercount"
"4503",22023,"Louisiana","Cameron Parish","NHPI_A",3,1,-2,-100,"undercount"
"4504",22023,"Louisiana","Cameron Parish","NHPI_AIC",8,6,-2,-28.57,"undercount"
"4505",22025,"Louisiana","Catahoula Parish","A_A",7,26,19,115.15,"overcount"
"4506",22025,"Louisiana","Catahoula Parish","A_AIC",27,46,19,52.05,"overcount"
"4507",22025,"Louisiana","Catahoula Parish","NHPI_A",0,7,7,200,"overcount"
"4508",22025,"Louisiana","Catahoula Parish","NHPI_AIC",5,16,11,104.76,"overcount"
"4509",22027,"Louisiana","Claiborne Parish","A_A",81,42,-39,-63.41,"undercount"
"4510",22027,"Louisiana","Claiborne Parish","A_AIC",119,94,-25,-23.47,"undercount"
"4511",22027,"Louisiana","Claiborne Parish","NHPI_A",4,0,-4,-200,"undercount"
"4512",22027,"Louisiana","Claiborne Parish","NHPI_AIC",15,4,-11,-115.79,"undercount"
"4513",22029,"Louisiana","Concordia Parish","A_A",85,115,30,30,"overcount"
"4514",22029,"Louisiana","Concordia Parish","A_AIC",108,118,10,8.85,"overcount"
"4515",22029,"Louisiana","Concordia Parish","NHPI_A",4,1,-3,-120,"undercount"
"4516",22029,"Louisiana","Concordia Parish","NHPI_AIC",10,10,0,0,"equal"
"4517",22031,"Louisiana","De Soto Parish","A_A",117,101,-16,-14.68,"undercount"
"4518",22031,"Louisiana","De Soto Parish","A_AIC",155,124,-31,-22.22,"undercount"
"4519",22031,"Louisiana","De Soto Parish","NHPI_A",15,1,-14,-175,"undercount"
"4520",22031,"Louisiana","De Soto Parish","NHPI_AIC",29,23,-6,-23.08,"undercount"
"4521",22033,"Louisiana","East Baton Rouge Parish","A_A",15159,14485,-674,-4.55,"undercount"
"4522",22033,"Louisiana","East Baton Rouge Parish","A_AIC",17369,16728,-641,-3.76,"undercount"
"4523",22033,"Louisiana","East Baton Rouge Parish","NHPI_A",207,106,-101,-64.54,"undercount"
"4524",22033,"Louisiana","East Baton Rouge Parish","NHPI_AIC",460,293,-167,-44.36,"undercount"
"4525",22035,"Louisiana","East Carroll Parish","A_A",29,17,-12,-52.17,"undercount"
"4526",22035,"Louisiana","East Carroll Parish","A_AIC",44,30,-14,-37.84,"undercount"
"4527",22035,"Louisiana","East Carroll Parish","NHPI_A",0,0,0,0,"equal"
"4528",22035,"Louisiana","East Carroll Parish","NHPI_AIC",3,6,3,66.67,"overcount"
"4529",22037,"Louisiana","East Feliciana Parish","A_A",53,48,-5,-9.9,"undercount"
"4530",22037,"Louisiana","East Feliciana Parish","A_AIC",84,102,18,19.35,"overcount"
"4531",22037,"Louisiana","East Feliciana Parish","NHPI_A",4,9,5,76.92,"overcount"
"4532",22037,"Louisiana","East Feliciana Parish","NHPI_AIC",17,22,5,25.64,"overcount"
"4533",22039,"Louisiana","Evangeline Parish","A_A",178,183,5,2.77,"overcount"
"4534",22039,"Louisiana","Evangeline Parish","A_AIC",229,254,25,10.35,"overcount"
"4535",22039,"Louisiana","Evangeline Parish","NHPI_A",7,2,-5,-111.11,"undercount"
"4536",22039,"Louisiana","Evangeline Parish","NHPI_AIC",24,27,3,11.76,"overcount"
"4537",22041,"Louisiana","Franklin Parish","A_A",80,38,-42,-71.19,"undercount"
"4538",22041,"Louisiana","Franklin Parish","A_AIC",115,76,-39,-40.84,"undercount"
"4539",22041,"Louisiana","Franklin Parish","NHPI_A",7,0,-7,-200,"undercount"
"4540",22041,"Louisiana","Franklin Parish","NHPI_AIC",17,14,-3,-19.35,"undercount"
"4541",22043,"Louisiana","Grant Parish","A_A",136,68,-68,-66.67,"undercount"
"4542",22043,"Louisiana","Grant Parish","A_AIC",181,129,-52,-33.55,"undercount"
"4543",22043,"Louisiana","Grant Parish","NHPI_A",12,6,-6,-66.67,"undercount"
"4544",22043,"Louisiana","Grant Parish","NHPI_AIC",26,26,0,0,"equal"
"4545",22045,"Louisiana","Iberia Parish","A_A",1888,1942,54,2.82,"overcount"
"4546",22045,"Louisiana","Iberia Parish","A_AIC",2156,2146,-10,-0.46,"undercount"
"4547",22045,"Louisiana","Iberia Parish","NHPI_A",47,3,-44,-176,"undercount"
"4548",22045,"Louisiana","Iberia Parish","NHPI_AIC",117,44,-73,-90.68,"undercount"
"4549",22047,"Louisiana","Iberville Parish","A_A",143,124,-19,-14.23,"undercount"
"4550",22047,"Louisiana","Iberville Parish","A_AIC",185,209,24,12.18,"overcount"
"4551",22047,"Louisiana","Iberville Parish","NHPI_A",8,13,5,47.62,"overcount"
"4552",22047,"Louisiana","Iberville Parish","NHPI_AIC",28,34,6,19.35,"overcount"
"4553",22049,"Louisiana","Jackson Parish","A_A",67,146,79,74.18,"overcount"
"4554",22049,"Louisiana","Jackson Parish","A_AIC",124,183,59,38.44,"overcount"
"4555",22049,"Louisiana","Jackson Parish","NHPI_A",6,5,-1,-18.18,"undercount"
"4556",22049,"Louisiana","Jackson Parish","NHPI_AIC",17,15,-2,-12.5,"undercount"
"4557",22051,"Louisiana","Jefferson Parish","A_A",19410,19686,276,1.41,"overcount"
"4558",22051,"Louisiana","Jefferson Parish","A_AIC",22284,22853,569,2.52,"overcount"
"4559",22051,"Louisiana","Jefferson Parish","NHPI_A",284,110,-174,-88.32,"undercount"
"4560",22051,"Louisiana","Jefferson Parish","NHPI_AIC",617,419,-198,-38.22,"undercount"
"4561",22053,"Louisiana","Jefferson Davis Parish","A_A",174,100,-74,-54.01,"undercount"
"4562",22053,"Louisiana","Jefferson Davis Parish","A_AIC",250,212,-38,-16.45,"undercount"
"4563",22053,"Louisiana","Jefferson Davis Parish","NHPI_A",8,4,-4,-66.67,"undercount"
"4564",22053,"Louisiana","Jefferson Davis Parish","NHPI_AIC",28,39,11,32.84,"overcount"
"4565",22055,"Louisiana","Lafayette Parish","A_A",4943,5235,292,5.74,"overcount"
"4566",22055,"Louisiana","Lafayette Parish","A_AIC",5960,6476,516,8.3,"overcount"
"4567",22055,"Louisiana","Lafayette Parish","NHPI_A",119,70,-49,-51.85,"undercount"
"4568",22055,"Louisiana","Lafayette Parish","NHPI_AIC",275,218,-57,-23.12,"undercount"
"4569",22057,"Louisiana","Lafourche Parish","A_A",883,778,-105,-12.64,"undercount"
"4570",22057,"Louisiana","Lafourche Parish","A_AIC",1116,1027,-89,-8.31,"undercount"
"4571",22057,"Louisiana","Lafourche Parish","NHPI_A",66,31,-35,-72.16,"undercount"
"4572",22057,"Louisiana","Lafourche Parish","NHPI_AIC",126,60,-66,-70.97,"undercount"
"4573",22059,"Louisiana","LaSalle Parish","A_A",50,253,203,133.99,"overcount"
"4574",22059,"Louisiana","LaSalle Parish","A_AIC",74,289,215,118.46,"overcount"
"4575",22059,"Louisiana","LaSalle Parish","NHPI_A",5,10,5,66.67,"overcount"
"4576",22059,"Louisiana","LaSalle Parish","NHPI_AIC",11,19,8,53.33,"overcount"
"4577",22061,"Louisiana","Lincoln Parish","A_A",681,693,12,1.75,"overcount"
"4578",22061,"Louisiana","Lincoln Parish","A_AIC",844,926,82,9.27,"overcount"
"4579",22061,"Louisiana","Lincoln Parish","NHPI_A",43,7,-36,-144,"undercount"
"4580",22061,"Louisiana","Lincoln Parish","NHPI_AIC",75,62,-13,-18.98,"undercount"
"4581",22063,"Louisiana","Livingston Parish","A_A",1092,1146,54,4.83,"overcount"
"4582",22063,"Louisiana","Livingston Parish","A_AIC",1559,1709,150,9.18,"overcount"
"4583",22063,"Louisiana","Livingston Parish","NHPI_A",75,36,-39,-70.27,"undercount"
"4584",22063,"Louisiana","Livingston Parish","NHPI_AIC",113,139,26,20.63,"overcount"
"4585",22065,"Louisiana","Madison Parish","A_A",32,8,-24,-120,"undercount"
"4586",22065,"Louisiana","Madison Parish","A_AIC",50,24,-26,-70.27,"undercount"
"4587",22065,"Louisiana","Madison Parish","NHPI_A",1,5,4,133.33,"overcount"
"4588",22065,"Louisiana","Madison Parish","NHPI_AIC",4,17,13,123.81,"overcount"
"4589",22067,"Louisiana","Morehouse Parish","A_A",115,89,-26,-25.49,"undercount"
"4590",22067,"Louisiana","Morehouse Parish","A_AIC",180,166,-14,-8.09,"undercount"
"4591",22067,"Louisiana","Morehouse Parish","NHPI_A",19,3,-16,-145.45,"undercount"
"4592",22067,"Louisiana","Morehouse Parish","NHPI_AIC",36,19,-17,-61.82,"undercount"
"4593",22069,"Louisiana","Natchitoches Parish","A_A",249,176,-73,-34.35,"undercount"
"4594",22069,"Louisiana","Natchitoches Parish","A_AIC",379,285,-94,-28.31,"undercount"
"4595",22069,"Louisiana","Natchitoches Parish","NHPI_A",21,22,1,4.65,"overcount"
"4596",22069,"Louisiana","Natchitoches Parish","NHPI_AIC",70,56,-14,-22.22,"undercount"
"4597",22071,"Louisiana","Orleans Parish","A_A",11616,10648,-968,-8.7,"undercount"
"4598",22071,"Louisiana","Orleans Parish","A_AIC",13589,13086,-503,-3.77,"undercount"
"4599",22071,"Louisiana","Orleans Parish","NHPI_A",190,131,-59,-36.76,"undercount"
"4600",22071,"Louisiana","Orleans Parish","NHPI_AIC",486,390,-96,-21.92,"undercount"
"4601",22073,"Louisiana","Ouachita Parish","A_A",1629,2283,654,33.44,"overcount"
"4602",22073,"Louisiana","Ouachita Parish","A_AIC",2143,2860,717,28.66,"overcount"
"4603",22073,"Louisiana","Ouachita Parish","NHPI_A",80,31,-49,-88.29,"undercount"
"4604",22073,"Louisiana","Ouachita Parish","NHPI_AIC",200,106,-94,-61.44,"undercount"
"4605",22075,"Louisiana","Plaquemines Parish","A_A",1036,1046,10,0.96,"overcount"
"4606",22075,"Louisiana","Plaquemines Parish","A_AIC",1197,1291,94,7.56,"overcount"
"4607",22075,"Louisiana","Plaquemines Parish","NHPI_A",37,40,3,7.79,"overcount"
"4608",22075,"Louisiana","Plaquemines Parish","NHPI_AIC",75,66,-9,-12.77,"undercount"
"4609",22077,"Louisiana","Pointe Coupee Parish","A_A",85,60,-25,-34.48,"undercount"
"4610",22077,"Louisiana","Pointe Coupee Parish","A_AIC",114,105,-9,-8.22,"undercount"
"4611",22077,"Louisiana","Pointe Coupee Parish","NHPI_A",1,2,1,66.67,"overcount"
"4612",22077,"Louisiana","Pointe Coupee Parish","NHPI_AIC",7,18,11,88,"overcount"
"4613",22079,"Louisiana","Rapides Parish","A_A",1802,1814,12,0.66,"overcount"
"4614",22079,"Louisiana","Rapides Parish","A_AIC",2366,2534,168,6.86,"overcount"
"4615",22079,"Louisiana","Rapides Parish","NHPI_A",77,33,-44,-80,"undercount"
"4616",22079,"Louisiana","Rapides Parish","NHPI_AIC",179,107,-72,-50.35,"undercount"
"4617",22081,"Louisiana","Red River Parish","A_A",20,0,-20,-200,"undercount"
"4618",22081,"Louisiana","Red River Parish","A_AIC",32,13,-19,-84.44,"undercount"
"4619",22081,"Louisiana","Red River Parish","NHPI_A",1,0,-1,-200,"undercount"
"4620",22081,"Louisiana","Red River Parish","NHPI_AIC",3,6,3,66.67,"overcount"
"4621",22083,"Louisiana","Richland Parish","A_A",73,50,-23,-37.4,"undercount"
"4622",22083,"Louisiana","Richland Parish","A_AIC",115,100,-15,-13.95,"undercount"
"4623",22083,"Louisiana","Richland Parish","NHPI_A",5,0,-5,-200,"undercount"
"4624",22083,"Louisiana","Richland Parish","NHPI_AIC",12,11,-1,-8.7,"undercount"
"4625",22085,"Louisiana","Sabine Parish","A_A",92,65,-27,-34.39,"undercount"
"4626",22085,"Louisiana","Sabine Parish","A_AIC",183,111,-72,-48.98,"undercount"
"4627",22085,"Louisiana","Sabine Parish","NHPI_A",12,12,0,0,"equal"
"4628",22085,"Louisiana","Sabine Parish","NHPI_AIC",37,31,-6,-17.65,"undercount"
"4629",22087,"Louisiana","St. Bernard Parish","A_A",1126,993,-133,-12.55,"undercount"
"4630",22087,"Louisiana","St. Bernard Parish","A_AIC",1438,1337,-101,-7.28,"undercount"
"4631",22087,"Louisiana","St. Bernard Parish","NHPI_A",28,7,-21,-120,"undercount"
"4632",22087,"Louisiana","St. Bernard Parish","NHPI_AIC",74,41,-33,-57.39,"undercount"
"4633",22089,"Louisiana","St. Charles Parish","A_A",616,575,-41,-6.88,"undercount"
"4634",22089,"Louisiana","St. Charles Parish","A_AIC",838,827,-11,-1.32,"undercount"
"4635",22089,"Louisiana","St. Charles Parish","NHPI_A",32,23,-9,-32.73,"undercount"
"4636",22089,"Louisiana","St. Charles Parish","NHPI_AIC",71,51,-20,-32.79,"undercount"
"4637",22091,"Louisiana","St. Helena Parish","A_A",24,19,-5,-23.26,"undercount"
"4638",22091,"Louisiana","St. Helena Parish","A_AIC",49,25,-24,-64.86,"undercount"
"4639",22091,"Louisiana","St. Helena Parish","NHPI_A",7,4,-3,-54.55,"undercount"
"4640",22091,"Louisiana","St. Helena Parish","NHPI_AIC",10,10,0,0,"equal"
"4641",22093,"Louisiana","St. James Parish","A_A",81,37,-44,-74.58,"undercount"
"4642",22093,"Louisiana","St. James Parish","A_AIC",112,74,-38,-40.86,"undercount"
"4643",22093,"Louisiana","St. James Parish","NHPI_A",5,2,-3,-85.71,"undercount"
"4644",22093,"Louisiana","St. James Parish","NHPI_AIC",13,12,-1,-8,"undercount"
"4645",22095,"Louisiana","St. John the Baptist Parish","A_A",514,318,-196,-47.12,"undercount"
"4646",22095,"Louisiana","St. John the Baptist Parish","A_AIC",654,418,-236,-44.03,"undercount"
"4647",22095,"Louisiana","St. John the Baptist Parish","NHPI_A",70,18,-52,-118.18,"undercount"
"4648",22095,"Louisiana","St. John the Baptist Parish","NHPI_AIC",104,36,-68,-97.14,"undercount"
"4649",22097,"Louisiana","St. Landry Parish","A_A",387,376,-11,-2.88,"undercount"
"4650",22097,"Louisiana","St. Landry Parish","A_AIC",570,513,-57,-10.53,"undercount"
"4651",22097,"Louisiana","St. Landry Parish","NHPI_A",18,13,-5,-32.26,"undercount"
"4652",22097,"Louisiana","St. Landry Parish","NHPI_AIC",74,45,-29,-48.74,"undercount"
"4653",22099,"Louisiana","St. Martin Parish","A_A",522,442,-80,-16.6,"undercount"
"4654",22099,"Louisiana","St. Martin Parish","A_AIC",674,613,-61,-9.48,"undercount"
"4655",22099,"Louisiana","St. Martin Parish","NHPI_A",17,3,-14,-140,"undercount"
"4656",22099,"Louisiana","St. Martin Parish","NHPI_AIC",56,37,-19,-40.86,"undercount"
"4657",22101,"Louisiana","St. Mary Parish","A_A",791,647,-144,-20.03,"undercount"
"4658",22101,"Louisiana","St. Mary Parish","A_AIC",992,853,-139,-15.07,"undercount"
"4659",22101,"Louisiana","St. Mary Parish","NHPI_A",42,13,-29,-105.45,"undercount"
"4660",22101,"Louisiana","St. Mary Parish","NHPI_AIC",96,58,-38,-49.35,"undercount"
"4661",22103,"Louisiana","St. Tammany Parish","A_A",3949,3862,-87,-2.23,"undercount"
"4662",22103,"Louisiana","St. Tammany Parish","A_AIC",5446,5704,258,4.63,"overcount"
"4663",22103,"Louisiana","St. Tammany Parish","NHPI_A",130,107,-23,-19.41,"undercount"
"4664",22103,"Louisiana","St. Tammany Parish","NHPI_AIC",354,343,-11,-3.16,"undercount"
"4665",22105,"Louisiana","Tangipahoa Parish","A_A",998,942,-56,-5.77,"undercount"
"4666",22105,"Louisiana","Tangipahoa Parish","A_AIC",1470,1392,-78,-5.45,"undercount"
"4667",22105,"Louisiana","Tangipahoa Parish","NHPI_A",84,23,-61,-114.02,"undercount"
"4668",22105,"Louisiana","Tangipahoa Parish","NHPI_AIC",198,127,-71,-43.69,"undercount"
"4669",22107,"Louisiana","Tensas Parish","A_A",10,10,0,0,"equal"
"4670",22107,"Louisiana","Tensas Parish","A_AIC",20,25,5,22.22,"overcount"
"4671",22107,"Louisiana","Tensas Parish","NHPI_A",0,1,1,200,"overcount"
"4672",22107,"Louisiana","Tensas Parish","NHPI_AIC",5,6,1,18.18,"overcount"
"4673",22109,"Louisiana","Terrebonne Parish","A_A",1227,1297,70,5.55,"overcount"
"4674",22109,"Louisiana","Terrebonne Parish","A_AIC",1713,1730,17,0.99,"overcount"
"4675",22109,"Louisiana","Terrebonne Parish","NHPI_A",113,39,-74,-97.37,"undercount"
"4676",22109,"Louisiana","Terrebonne Parish","NHPI_AIC",342,108,-234,-104,"undercount"
"4677",22111,"Louisiana","Union Parish","A_A",71,38,-33,-60.55,"undercount"
"4678",22111,"Louisiana","Union Parish","A_AIC",106,74,-32,-35.56,"undercount"
"4679",22111,"Louisiana","Union Parish","NHPI_A",15,6,-9,-85.71,"undercount"
"4680",22111,"Louisiana","Union Parish","NHPI_AIC",30,20,-10,-40,"undercount"
"4681",22113,"Louisiana","Vermilion Parish","A_A",1301,1262,-39,-3.04,"undercount"
"4682",22113,"Louisiana","Vermilion Parish","A_AIC",1470,1457,-13,-0.89,"undercount"
"4683",22113,"Louisiana","Vermilion Parish","NHPI_A",17,9,-8,-61.54,"undercount"
"4684",22113,"Louisiana","Vermilion Parish","NHPI_AIC",56,47,-9,-17.48,"undercount"
"4685",22115,"Louisiana","Vernon Parish","A_A",969,862,-107,-11.69,"undercount"
"4686",22115,"Louisiana","Vernon Parish","A_AIC",1591,1488,-103,-6.69,"undercount"
"4687",22115,"Louisiana","Vernon Parish","NHPI_A",265,291,26,9.35,"overcount"
"4688",22115,"Louisiana","Vernon Parish","NHPI_AIC",374,468,94,22.33,"overcount"
"4689",22117,"Louisiana","Washington Parish","A_A",159,163,4,2.48,"overcount"
"4690",22117,"Louisiana","Washington Parish","A_AIC",273,234,-39,-15.38,"undercount"
"4691",22117,"Louisiana","Washington Parish","NHPI_A",9,0,-9,-200,"undercount"
"4692",22117,"Louisiana","Washington Parish","NHPI_AIC",43,22,-21,-64.62,"undercount"
"4693",22119,"Louisiana","Webster Parish","A_A",186,138,-48,-29.63,"undercount"
"4694",22119,"Louisiana","Webster Parish","A_AIC",277,216,-61,-24.75,"undercount"
"4695",22119,"Louisiana","Webster Parish","NHPI_A",13,12,-1,-8,"undercount"
"4696",22119,"Louisiana","Webster Parish","NHPI_AIC",37,30,-7,-20.9,"undercount"
"4697",22121,"Louisiana","West Baton Rouge Parish","A_A",196,220,24,11.54,"overcount"
"4698",22121,"Louisiana","West Baton Rouge Parish","A_AIC",268,288,20,7.19,"overcount"
"4699",22121,"Louisiana","West Baton Rouge Parish","NHPI_A",16,8,-8,-66.67,"undercount"
"4700",22121,"Louisiana","West Baton Rouge Parish","NHPI_AIC",39,42,3,7.41,"overcount"
"4701",22123,"Louisiana","West Carroll Parish","A_A",30,13,-17,-79.07,"undercount"
"4702",22123,"Louisiana","West Carroll Parish","A_AIC",53,27,-26,-65,"undercount"
"4703",22123,"Louisiana","West Carroll Parish","NHPI_A",3,0,-3,-200,"undercount"
"4704",22123,"Louisiana","West Carroll Parish","NHPI_AIC",8,4,-4,-66.67,"undercount"
"4705",22125,"Louisiana","West Feliciana Parish","A_A",132,30,-102,-125.93,"undercount"
"4706",22125,"Louisiana","West Feliciana Parish","A_AIC",148,98,-50,-40.65,"undercount"
"4707",22125,"Louisiana","West Feliciana Parish","NHPI_A",7,7,0,0,"equal"
"4708",22125,"Louisiana","West Feliciana Parish","NHPI_AIC",9,25,16,94.12,"overcount"
"4709",22127,"Louisiana","Winn Parish","A_A",36,172,136,130.77,"overcount"
"4710",22127,"Louisiana","Winn Parish","A_AIC",78,212,134,92.41,"overcount"
"4711",22127,"Louisiana","Winn Parish","NHPI_A",5,16,11,104.76,"overcount"
"4712",22127,"Louisiana","Winn Parish","NHPI_AIC",19,38,19,66.67,"overcount"
"4713",23001,"Maine","Androscoggin County","A_A",1065,917,-148,-14.93,"undercount"
"4714",23001,"Maine","Androscoggin County","A_AIC",1716,1524,-192,-11.85,"undercount"
"4715",23001,"Maine","Androscoggin County","NHPI_A",45,50,5,10.53,"overcount"
"4716",23001,"Maine","Androscoggin County","NHPI_AIC",139,128,-11,-8.24,"undercount"
"4717",23003,"Maine","Aroostook County","A_A",370,399,29,7.54,"overcount"
"4718",23003,"Maine","Aroostook County","A_AIC",539,559,20,3.64,"overcount"
"4719",23003,"Maine","Aroostook County","NHPI_A",37,18,-19,-69.09,"undercount"
"4720",23003,"Maine","Aroostook County","NHPI_AIC",68,59,-9,-14.17,"undercount"
"4721",23005,"Maine","Cumberland County","A_A",7469,7279,-190,-2.58,"undercount"
"4722",23005,"Maine","Cumberland County","A_AIC",9844,10113,269,2.7,"overcount"
"4723",23005,"Maine","Cumberland County","NHPI_A",108,98,-10,-9.71,"undercount"
"4724",23005,"Maine","Cumberland County","NHPI_AIC",319,351,32,9.55,"overcount"
"4725",23007,"Maine","Franklin County","A_A",160,384,224,82.35,"overcount"
"4726",23007,"Maine","Franklin County","A_AIC",256,484,228,61.62,"overcount"
"4727",23007,"Maine","Franklin County","NHPI_A",13,23,10,55.56,"overcount"
"4728",23007,"Maine","Franklin County","NHPI_AIC",28,42,14,40,"overcount"
"4729",23009,"Maine","Hancock County","A_A",701,571,-130,-20.44,"undercount"
"4730",23009,"Maine","Hancock County","A_AIC",887,875,-12,-1.36,"undercount"
"4731",23009,"Maine","Hancock County","NHPI_A",16,10,-6,-46.15,"undercount"
"4732",23009,"Maine","Hancock County","NHPI_AIC",42,59,17,33.66,"overcount"
"4733",23011,"Maine","Kennebec County","A_A",1221,1217,-4,-0.33,"undercount"
"4734",23011,"Maine","Kennebec County","A_AIC",1798,1913,115,6.2,"overcount"
"4735",23011,"Maine","Kennebec County","NHPI_A",47,29,-18,-47.37,"undercount"
"4736",23011,"Maine","Kennebec County","NHPI_AIC",136,128,-8,-6.06,"undercount"
"4737",23013,"Maine","Knox County","A_A",252,252,0,0,"equal"
"4738",23013,"Maine","Knox County","A_AIC",375,419,44,11.08,"overcount"
"4739",23013,"Maine","Knox County","NHPI_A",11,18,7,48.28,"overcount"
"4740",23013,"Maine","Knox County","NHPI_AIC",43,50,7,15.05,"overcount"
"4741",23015,"Maine","Lincoln County","A_A",302,231,-71,-26.64,"undercount"
"4742",23015,"Maine","Lincoln County","A_AIC",406,378,-28,-7.14,"undercount"
"4743",23015,"Maine","Lincoln County","NHPI_A",7,9,2,25,"overcount"
"4744",23015,"Maine","Lincoln County","NHPI_AIC",24,41,17,52.31,"overcount"
"4745",23017,"Maine","Oxford County","A_A",458,276,-182,-49.59,"undercount"
"4746",23017,"Maine","Oxford County","A_AIC",672,486,-186,-32.12,"undercount"
"4747",23017,"Maine","Oxford County","NHPI_A",29,16,-13,-57.78,"undercount"
"4748",23017,"Maine","Oxford County","NHPI_AIC",70,48,-22,-37.29,"undercount"
"4749",23019,"Maine","Penobscot County","A_A",1826,1878,52,2.81,"overcount"
"4750",23019,"Maine","Penobscot County","A_AIC",2472,2706,234,9.04,"overcount"
"4751",23019,"Maine","Penobscot County","NHPI_A",57,37,-20,-42.55,"undercount"
"4752",23019,"Maine","Penobscot County","NHPI_AIC",160,151,-9,-5.79,"undercount"
"4753",23021,"Maine","Piscataquis County","A_A",199,131,-68,-41.21,"undercount"
"4754",23021,"Maine","Piscataquis County","A_AIC",252,209,-43,-18.66,"undercount"
"4755",23021,"Maine","Piscataquis County","NHPI_A",6,7,1,15.38,"overcount"
"4756",23021,"Maine","Piscataquis County","NHPI_AIC",22,22,0,0,"equal"
"4757",23023,"Maine","Sagadahoc County","A_A",324,247,-77,-26.97,"undercount"
"4758",23023,"Maine","Sagadahoc County","A_AIC",483,480,-3,-0.62,"undercount"
"4759",23023,"Maine","Sagadahoc County","NHPI_A",13,3,-10,-125,"undercount"
"4760",23023,"Maine","Sagadahoc County","NHPI_AIC",46,36,-10,-24.39,"undercount"
"4761",23025,"Maine","Somerset County","A_A",351,266,-85,-27.55,"undercount"
"4762",23025,"Maine","Somerset County","A_AIC",489,424,-65,-14.24,"undercount"
"4763",23025,"Maine","Somerset County","NHPI_A",22,14,-8,-44.44,"undercount"
"4764",23025,"Maine","Somerset County","NHPI_AIC",48,52,4,8,"overcount"
"4765",23027,"Maine","Waldo County","A_A",248,201,-47,-20.94,"undercount"
"4766",23027,"Maine","Waldo County","A_AIC",352,355,3,0.85,"overcount"
"4767",23027,"Maine","Waldo County","NHPI_A",14,12,-2,-15.38,"undercount"
"4768",23027,"Maine","Waldo County","NHPI_AIC",29,41,12,34.29,"overcount"
"4769",23029,"Maine","Washington County","A_A",152,134,-18,-12.59,"undercount"
"4770",23029,"Maine","Washington County","A_AIC",251,262,11,4.29,"overcount"
"4771",23029,"Maine","Washington County","NHPI_A",11,7,-4,-44.44,"undercount"
"4772",23029,"Maine","Washington County","NHPI_AIC",33,24,-9,-31.58,"undercount"
"4773",23031,"Maine","York County","A_A",2951,2531,-420,-15.32,"undercount"
"4774",23031,"Maine","York County","A_AIC",3961,3842,-119,-3.05,"undercount"
"4775",23031,"Maine","York County","NHPI_A",71,58,-13,-20.16,"undercount"
"4776",23031,"Maine","York County","NHPI_AIC",186,190,4,2.13,"overcount"
"4777",24001,"Maryland","Allegany County","A_A",811,738,-73,-9.43,"undercount"
"4778",24001,"Maryland","Allegany County","A_AIC",1016,960,-56,-5.67,"undercount"
"4779",24001,"Maryland","Allegany County","NHPI_A",52,22,-30,-81.08,"undercount"
"4780",24001,"Maryland","Allegany County","NHPI_AIC",105,59,-46,-56.1,"undercount"
"4781",24003,"Maryland","Anne Arundel County","A_A",25464,25443,-21,-0.08,"undercount"
"4782",24003,"Maryland","Anne Arundel County","A_AIC",33271,34280,1009,2.99,"overcount"
"4783",24003,"Maryland","Anne Arundel County","NHPI_A",736,430,-306,-52.49,"undercount"
"4784",24003,"Maryland","Anne Arundel County","NHPI_AIC",1729,1306,-423,-27.87,"undercount"
"4785",24005,"Maryland","Baltimore County","A_A",53170,55260,2090,3.86,"overcount"
"4786",24005,"Maryland","Baltimore County","A_AIC",60728,63639,2911,4.68,"overcount"
"4787",24005,"Maryland","Baltimore County","NHPI_A",756,290,-466,-89.1,"undercount"
"4788",24005,"Maryland","Baltimore County","NHPI_AIC",1635,1092,-543,-39.82,"undercount"
"4789",24009,"Maryland","Calvert County","A_A",1810,1576,-234,-13.82,"undercount"
"4790",24009,"Maryland","Calvert County","A_AIC",2903,2815,-88,-3.08,"undercount"
"4791",24009,"Maryland","Calvert County","NHPI_A",120,76,-44,-44.9,"undercount"
"4792",24009,"Maryland","Calvert County","NHPI_AIC",275,265,-10,-3.7,"undercount"
"4793",24011,"Maryland","Caroline County","A_A",402,356,-46,-12.14,"undercount"
"4794",24011,"Maryland","Caroline County","A_AIC",538,533,-5,-0.93,"undercount"
"4795",24011,"Maryland","Caroline County","NHPI_A",111,13,-98,-158.06,"undercount"
"4796",24011,"Maryland","Caroline County","NHPI_AIC",152,34,-118,-126.88,"undercount"
"4797",24013,"Maryland","Carroll County","A_A",3797,3816,19,0.5,"overcount"
"4798",24013,"Maryland","Carroll County","A_AIC",5141,5652,511,9.47,"overcount"
"4799",24013,"Maryland","Carroll County","NHPI_A",108,36,-72,-100,"undercount"
"4800",24013,"Maryland","Carroll County","NHPI_AIC",248,185,-63,-29.1,"undercount"
"4801",24015,"Maryland","Cecil County","A_A",1520,1256,-264,-19.02,"undercount"
"4802",24015,"Maryland","Cecil County","A_AIC",2156,2020,-136,-6.51,"undercount"
"4803",24015,"Maryland","Cecil County","NHPI_A",78,37,-41,-71.3,"undercount"
"4804",24015,"Maryland","Cecil County","NHPI_AIC",199,127,-72,-44.17,"undercount"
"4805",24017,"Maryland","Charles County","A_A",5633,5683,50,0.88,"overcount"
"4806",24017,"Maryland","Charles County","A_AIC",7656,7824,168,2.17,"overcount"
"4807",24017,"Maryland","Charles County","NHPI_A",233,155,-78,-40.21,"undercount"
"4808",24017,"Maryland","Charles County","NHPI_AIC",526,445,-81,-16.68,"undercount"
"4809",24019,"Maryland","Dorchester County","A_A",363,358,-5,-1.39,"undercount"
"4810",24019,"Maryland","Dorchester County","A_AIC",476,488,12,2.49,"overcount"
"4811",24019,"Maryland","Dorchester County","NHPI_A",22,10,-12,-75,"undercount"
"4812",24019,"Maryland","Dorchester County","NHPI_AIC",67,30,-37,-76.29,"undercount"
"4813",24021,"Maryland","Frederick County","A_A",13952,13685,-267,-1.93,"undercount"
"4814",24021,"Maryland","Frederick County","A_AIC",17036,17184,148,0.86,"overcount"
"4815",24021,"Maryland","Frederick County","NHPI_A",250,158,-92,-45.1,"undercount"
"4816",24021,"Maryland","Frederick County","NHPI_AIC",551,465,-86,-16.93,"undercount"
"4817",24023,"Maryland","Garrett County","A_A",131,83,-48,-44.86,"undercount"
"4818",24023,"Maryland","Garrett County","A_AIC",201,164,-37,-20.27,"undercount"
"4819",24023,"Maryland","Garrett County","NHPI_A",1,2,1,66.67,"overcount"
"4820",24023,"Maryland","Garrett County","NHPI_AIC",15,39,24,88.89,"overcount"
"4821",24025,"Maryland","Harford County","A_A",7976,8192,216,2.67,"overcount"
"4822",24025,"Maryland","Harford County","A_AIC",10538,11062,524,4.85,"overcount"
"4823",24025,"Maryland","Harford County","NHPI_A",245,180,-65,-30.59,"undercount"
"4824",24025,"Maryland","Harford County","NHPI_AIC",585,477,-108,-20.34,"undercount"
"4825",24027,"Maryland","Howard County","A_A",65079,66587,1508,2.29,"overcount"
"4826",24027,"Maryland","Howard County","A_AIC",71034,73130,2096,2.91,"overcount"
"4827",24027,"Maryland","Howard County","NHPI_A",281,114,-167,-84.56,"undercount"
"4828",24027,"Maryland","Howard County","NHPI_AIC",759,489,-270,-43.27,"undercount"
"4829",24029,"Maryland","Kent County","A_A",265,254,-11,-4.24,"undercount"
"4830",24029,"Maryland","Kent County","A_AIC",337,359,22,6.32,"overcount"
"4831",24029,"Maryland","Kent County","NHPI_A",10,0,-10,-200,"undercount"
"4832",24029,"Maryland","Kent County","NHPI_AIC",32,31,-1,-3.17,"undercount"
"4833",24031,"Maryland","Montgomery County","A_A",167231,164419,-2812,-1.7,"undercount"
"4834",24031,"Maryland","Montgomery County","A_AIC",185802,183930,-1872,-1.01,"undercount"
"4835",24031,"Maryland","Montgomery County","NHPI_A",1149,483,-666,-81.62,"undercount"
"4836",24031,"Maryland","Montgomery County","NHPI_AIC",2860,1694,-1166,-51.21,"undercount"
"4837",24033,"Maryland","Prince George's County","A_A",39845,42195,2350,5.73,"overcount"
"4838",24033,"Maryland","Prince George's County","A_AIC",46793,49529,2736,5.68,"overcount"
"4839",24033,"Maryland","Prince George's County","NHPI_A",2056,406,-1650,-134.04,"undercount"
"4840",24033,"Maryland","Prince George's County","NHPI_AIC",3186,1299,-1887,-84.15,"undercount"
"4841",24035,"Maryland","Queen Anne's County","A_A",651,610,-41,-6.5,"undercount"
"4842",24035,"Maryland","Queen Anne's County","A_AIC",987,972,-15,-1.53,"undercount"
"4843",24035,"Maryland","Queen Anne's County","NHPI_A",61,11,-50,-138.89,"undercount"
"4844",24035,"Maryland","Queen Anne's County","NHPI_AIC",101,62,-39,-47.85,"undercount"
"4845",24037,"Maryland","St. Mary's County","A_A",3366,3321,-45,-1.35,"undercount"
"4846",24037,"Maryland","St. Mary's County","A_AIC",4833,5171,338,6.76,"overcount"
"4847",24037,"Maryland","St. Mary's County","NHPI_A",150,86,-64,-54.24,"undercount"
"4848",24037,"Maryland","St. Mary's County","NHPI_AIC",335,303,-32,-10.03,"undercount"
"4849",24039,"Maryland","Somerset County","A_A",242,251,9,3.65,"overcount"
"4850",24039,"Maryland","Somerset County","A_AIC",367,333,-34,-9.71,"undercount"
"4851",24039,"Maryland","Somerset County","NHPI_A",24,1,-23,-184,"undercount"
"4852",24039,"Maryland","Somerset County","NHPI_AIC",60,21,-39,-96.3,"undercount"
"4853",24041,"Maryland","Talbot County","A_A",556,538,-18,-3.29,"undercount"
"4854",24041,"Maryland","Talbot County","A_AIC",723,719,-4,-0.55,"undercount"
"4855",24041,"Maryland","Talbot County","NHPI_A",84,11,-73,-153.68,"undercount"
"4856",24041,"Maryland","Talbot County","NHPI_AIC",137,60,-77,-78.17,"undercount"
"4857",24043,"Maryland","Washington County","A_A",2967,3138,171,5.6,"overcount"
"4858",24043,"Maryland","Washington County","A_AIC",3875,4202,327,8.1,"overcount"
"4859",24043,"Maryland","Washington County","NHPI_A",135,70,-65,-63.41,"undercount"
"4860",24043,"Maryland","Washington County","NHPI_AIC",293,224,-69,-26.69,"undercount"
"4861",24045,"Maryland","Wicomico County","A_A",3301,3167,-134,-4.14,"undercount"
"4862",24045,"Maryland","Wicomico County","A_AIC",4003,3808,-195,-4.99,"undercount"
"4863",24045,"Maryland","Wicomico County","NHPI_A",152,40,-112,-116.67,"undercount"
"4864",24045,"Maryland","Wicomico County","NHPI_AIC",292,175,-117,-50.11,"undercount"
"4865",24047,"Maryland","Worcester County","A_A",839,739,-100,-12.67,"undercount"
"4866",24047,"Maryland","Worcester County","A_AIC",1056,1004,-52,-5.05,"undercount"
"4867",24047,"Maryland","Worcester County","NHPI_A",24,7,-17,-109.68,"undercount"
"4868",24047,"Maryland","Worcester County","NHPI_AIC",86,24,-62,-112.73,"undercount"
"4869",24510,"Maryland","Baltimore city","A_A",16145,21273,5128,27.41,"overcount"
"4870",24510,"Maryland","Baltimore city","A_AIC",20028,25982,5954,25.88,"overcount"
"4871",24510,"Maryland","Baltimore city","NHPI_A",608,167,-441,-113.81,"undercount"
"4872",24510,"Maryland","Baltimore city","NHPI_AIC",1208,643,-565,-61.05,"undercount"
"4873",25001,"Massachusetts","Barnstable County","A_A",3494,3308,-186,-5.47,"undercount"
"4874",25001,"Massachusetts","Barnstable County","A_AIC",4636,4559,-77,-1.67,"undercount"
"4875",25001,"Massachusetts","Barnstable County","NHPI_A",142,77,-65,-59.36,"undercount"
"4876",25001,"Massachusetts","Barnstable County","NHPI_AIC",367,238,-129,-42.64,"undercount"
"4877",25003,"Massachusetts","Berkshire County","A_A",2122,2033,-89,-4.28,"undercount"
"4878",25003,"Massachusetts","Berkshire County","A_AIC",2855,2838,-17,-0.6,"undercount"
"4879",25003,"Massachusetts","Berkshire County","NHPI_A",79,19,-60,-122.45,"undercount"
"4880",25003,"Massachusetts","Berkshire County","NHPI_AIC",213,96,-117,-75.73,"undercount"
"4881",25005,"Massachusetts","Bristol County","A_A",14295,13892,-403,-2.86,"undercount"
"4882",25005,"Massachusetts","Bristol County","A_AIC",17546,17096,-450,-2.6,"undercount"
"4883",25005,"Massachusetts","Bristol County","NHPI_A",746,219,-527,-109.22,"undercount"
"4884",25005,"Massachusetts","Bristol County","NHPI_AIC",1592,646,-946,-84.54,"undercount"
"4885",25007,"Massachusetts","Dukes County","A_A",236,190,-46,-21.6,"undercount"
"4886",25007,"Massachusetts","Dukes County","A_AIC",335,360,25,7.19,"overcount"
"4887",25007,"Massachusetts","Dukes County","NHPI_A",12,9,-3,-28.57,"undercount"
"4888",25007,"Massachusetts","Dukes County","NHPI_AIC",70,56,-14,-22.22,"undercount"
"4889",25009,"Massachusetts","Essex County","A_A",31413,29771,-1642,-5.37,"undercount"
"4890",25009,"Massachusetts","Essex County","A_AIC",35814,35215,-599,-1.69,"undercount"
"4891",25009,"Massachusetts","Essex County","NHPI_A",1370,191,-1179,-151.06,"undercount"
"4892",25009,"Massachusetts","Essex County","NHPI_AIC",2359,617,-1742,-117.07,"undercount"
"4893",25011,"Massachusetts","Franklin County","A_A",1201,1235,34,2.79,"overcount"
"4894",25011,"Massachusetts","Franklin County","A_AIC",1670,1804,134,7.71,"overcount"
"4895",25011,"Massachusetts","Franklin County","NHPI_A",144,14,-130,-164.56,"undercount"
"4896",25011,"Massachusetts","Franklin County","NHPI_AIC",249,73,-176,-109.32,"undercount"
"4897",25013,"Massachusetts","Hampden County","A_A",12655,12268,-387,-3.11,"undercount"
"4898",25013,"Massachusetts","Hampden County","A_AIC",14779,15104,325,2.18,"overcount"
"4899",25013,"Massachusetts","Hampden County","NHPI_A",856,186,-670,-128.6,"undercount"
"4900",25013,"Massachusetts","Hampden County","NHPI_AIC",1437,545,-892,-90.01,"undercount"
"4901",25015,"Massachusetts","Hampshire County","A_A",9036,10852,1816,18.26,"overcount"
"4902",25015,"Massachusetts","Hampshire County","A_AIC",10831,12952,2121,17.84,"overcount"
"4903",25015,"Massachusetts","Hampshire County","NHPI_A",131,64,-67,-68.72,"undercount"
"4904",25015,"Massachusetts","Hampshire County","NHPI_AIC",371,221,-150,-50.68,"undercount"
"4905",25017,"Massachusetts","Middlesex County","A_A",219126,213092,-6034,-2.79,"undercount"
"4906",25017,"Massachusetts","Middlesex County","A_AIC",239761,236606,-3155,-1.32,"undercount"
"4907",25017,"Massachusetts","Middlesex County","NHPI_A",1062,438,-624,-83.2,"undercount"
"4908",25017,"Massachusetts","Middlesex County","NHPI_AIC",2870,1669,-1201,-52.92,"undercount"
"4909",25019,"Massachusetts","Nantucket County","A_A",214,271,57,23.51,"overcount"
"4910",25019,"Massachusetts","Nantucket County","A_AIC",262,381,119,37.01,"overcount"
"4911",25019,"Massachusetts","Nantucket County","NHPI_A",16,3,-13,-136.84,"undercount"
"4912",25019,"Massachusetts","Nantucket County","NHPI_AIC",31,40,9,25.35,"overcount"
"4913",25021,"Massachusetts","Norfolk County","A_A",88375,89156,781,0.88,"overcount"
"4914",25021,"Massachusetts","Norfolk County","A_AIC",96239,97983,1744,1.8,"overcount"
"4915",25021,"Massachusetts","Norfolk County","NHPI_A",381,216,-165,-55.28,"undercount"
"4916",25021,"Massachusetts","Norfolk County","NHPI_AIC",1089,791,-298,-31.7,"undercount"
"4917",25023,"Massachusetts","Plymouth County","A_A",8850,8089,-761,-8.99,"undercount"
"4918",25023,"Massachusetts","Plymouth County","A_AIC",11741,11171,-570,-4.98,"undercount"
"4919",25023,"Massachusetts","Plymouth County","NHPI_A",705,336,-369,-70.89,"undercount"
"4920",25023,"Massachusetts","Plymouth County","NHPI_AIC",1306,784,-522,-49.95,"undercount"
"4921",25025,"Massachusetts","Suffolk County","A_A",76183,81651,5468,6.93,"overcount"
"4922",25025,"Massachusetts","Suffolk County","A_AIC",84317,90187,5870,6.73,"overcount"
"4923",25025,"Massachusetts","Suffolk County","NHPI_A",1256,429,-827,-98.16,"undercount"
"4924",25025,"Massachusetts","Suffolk County","NHPI_AIC",3143,1034,-2109,-100.98,"undercount"
"4925",25027,"Massachusetts","Worcester County","A_A",45309,46873,1564,3.39,"overcount"
"4926",25027,"Massachusetts","Worcester County","A_AIC",51131,53492,2361,4.51,"overcount"
"4927",25027,"Massachusetts","Worcester County","NHPI_A",684,243,-441,-95.15,"undercount"
"4928",25027,"Massachusetts","Worcester County","NHPI_AIC",1396,790,-606,-55.44,"undercount"
"4929",26001,"Michigan","Alcona County","A_A",44,14,-30,-103.45,"undercount"
"4930",26001,"Michigan","Alcona County","A_AIC",59,44,-15,-29.13,"undercount"
"4931",26001,"Michigan","Alcona County","NHPI_A",9,1,-8,-160,"undercount"
"4932",26001,"Michigan","Alcona County","NHPI_AIC",10,8,-2,-22.22,"undercount"
"4933",26003,"Michigan","Alger County","A_A",42,24,-18,-54.55,"undercount"
"4934",26003,"Michigan","Alger County","A_AIC",67,43,-24,-43.64,"undercount"
"4935",26003,"Michigan","Alger County","NHPI_A",1,1,0,0,"equal"
"4936",26003,"Michigan","Alger County","NHPI_AIC",3,17,14,140,"overcount"
"4937",26005,"Michigan","Allegan County","A_A",1062,840,-222,-23.34,"undercount"
"4938",26005,"Michigan","Allegan County","A_AIC",1470,1439,-31,-2.13,"undercount"
"4939",26005,"Michigan","Allegan County","NHPI_A",51,21,-30,-83.33,"undercount"
"4940",26005,"Michigan","Allegan County","NHPI_AIC",117,87,-30,-29.41,"undercount"
"4941",26007,"Michigan","Alpena County","A_A",157,112,-45,-33.46,"undercount"
"4942",26007,"Michigan","Alpena County","A_AIC",224,221,-3,-1.35,"undercount"
"4943",26007,"Michigan","Alpena County","NHPI_A",12,12,0,0,"equal"
"4944",26007,"Michigan","Alpena County","NHPI_AIC",23,46,23,66.67,"overcount"
"4945",26009,"Michigan","Antrim County","A_A",87,70,-17,-21.66,"undercount"
"4946",26009,"Michigan","Antrim County","A_AIC",132,129,-3,-2.3,"undercount"
"4947",26009,"Michigan","Antrim County","NHPI_A",15,18,3,18.18,"overcount"
"4948",26009,"Michigan","Antrim County","NHPI_AIC",26,30,4,14.29,"overcount"
"4949",26011,"Michigan","Arenac County","A_A",50,38,-12,-27.27,"undercount"
"4950",26011,"Michigan","Arenac County","A_AIC",102,74,-28,-31.82,"undercount"
"4951",26011,"Michigan","Arenac County","NHPI_A",9,4,-5,-76.92,"undercount"
"4952",26011,"Michigan","Arenac County","NHPI_AIC",22,17,-5,-25.64,"undercount"
"4953",26013,"Michigan","Baraga County","A_A",31,18,-13,-53.06,"undercount"
"4954",26013,"Michigan","Baraga County","A_AIC",69,54,-15,-24.39,"undercount"
"4955",26013,"Michigan","Baraga County","NHPI_A",2,3,1,40,"overcount"
"4956",26013,"Michigan","Baraga County","NHPI_AIC",15,14,-1,-6.9,"undercount"
"4957",26015,"Michigan","Barry County","A_A",319,246,-73,-25.84,"undercount"
"4958",26015,"Michigan","Barry County","A_AIC",522,505,-17,-3.31,"undercount"
"4959",26015,"Michigan","Barry County","NHPI_A",16,15,-1,-6.45,"undercount"
"4960",26015,"Michigan","Barry County","NHPI_AIC",37,60,23,47.42,"overcount"
"4961",26017,"Michigan","Bay County","A_A",607,584,-23,-3.86,"undercount"
"4962",26017,"Michigan","Bay County","A_AIC",901,946,45,4.87,"overcount"
"4963",26017,"Michigan","Bay County","NHPI_A",16,0,-16,-200,"undercount"
"4964",26017,"Michigan","Bay County","NHPI_AIC",60,51,-9,-16.22,"undercount"
"4965",26019,"Michigan","Benzie County","A_A",95,76,-19,-22.22,"undercount"
"4966",26019,"Michigan","Benzie County","A_AIC",139,115,-24,-18.9,"undercount"
"4967",26019,"Michigan","Benzie County","NHPI_A",7,0,-7,-200,"undercount"
"4968",26019,"Michigan","Benzie County","NHPI_AIC",19,9,-10,-71.43,"undercount"
"4969",26021,"Michigan","Berrien County","A_A",3272,3217,-55,-1.7,"undercount"
"4970",26021,"Michigan","Berrien County","A_AIC",4247,4154,-93,-2.21,"undercount"
"4971",26021,"Michigan","Berrien County","NHPI_A",158,109,-49,-36.7,"undercount"
"4972",26021,"Michigan","Berrien County","NHPI_AIC",327,195,-132,-50.57,"undercount"
"4973",26023,"Michigan","Branch County","A_A",323,266,-57,-19.35,"undercount"
"4974",26023,"Michigan","Branch County","A_AIC",587,476,-111,-20.88,"undercount"
"4975",26023,"Michigan","Branch County","NHPI_A",13,10,-3,-26.09,"undercount"
"4976",26023,"Michigan","Branch County","NHPI_AIC",32,32,0,0,"equal"
"4977",26025,"Michigan","Calhoun County","A_A",3806,3754,-52,-1.38,"undercount"
"4978",26025,"Michigan","Calhoun County","A_AIC",4555,4377,-178,-3.99,"undercount"
"4979",26025,"Michigan","Calhoun County","NHPI_A",67,41,-26,-48.15,"undercount"
"4980",26025,"Michigan","Calhoun County","NHPI_AIC",234,140,-94,-50.27,"undercount"
"4981",26027,"Michigan","Cass County","A_A",396,346,-50,-13.48,"undercount"
"4982",26027,"Michigan","Cass County","A_AIC",593,567,-26,-4.48,"undercount"
"4983",26027,"Michigan","Cass County","NHPI_A",26,11,-15,-81.08,"undercount"
"4984",26027,"Michigan","Cass County","NHPI_AIC",74,46,-28,-46.67,"undercount"
"4985",26029,"Michigan","Charlevoix County","A_A",158,122,-36,-25.71,"undercount"
"4986",26029,"Michigan","Charlevoix County","A_AIC",232,212,-20,-9.01,"undercount"
"4987",26029,"Michigan","Charlevoix County","NHPI_A",21,10,-11,-70.97,"undercount"
"4988",26029,"Michigan","Charlevoix County","NHPI_AIC",33,53,20,46.51,"overcount"
"4989",26031,"Michigan","Cheboygan County","A_A",111,85,-26,-26.53,"undercount"
"4990",26031,"Michigan","Cheboygan County","A_AIC",174,164,-10,-5.92,"undercount"
"4991",26031,"Michigan","Cheboygan County","NHPI_A",14,1,-13,-173.33,"undercount"
"4992",26031,"Michigan","Cheboygan County","NHPI_AIC",30,7,-23,-124.32,"undercount"
"4993",26033,"Michigan","Chippewa County","A_A",272,193,-79,-33.98,"undercount"
"4994",26033,"Michigan","Chippewa County","A_AIC",504,292,-212,-53.27,"undercount"
"4995",26033,"Michigan","Chippewa County","NHPI_A",25,13,-12,-63.16,"undercount"
"4996",26033,"Michigan","Chippewa County","NHPI_AIC",79,42,-37,-61.16,"undercount"
"4997",26035,"Michigan","Clare County","A_A",83,72,-11,-14.19,"undercount"
"4998",26035,"Michigan","Clare County","A_AIC",141,134,-7,-5.09,"undercount"
"4999",26035,"Michigan","Clare County","NHPI_A",11,0,-11,-200,"undercount"
"5000",26035,"Michigan","Clare County","NHPI_AIC",24,18,-6,-28.57,"undercount"
"5001",26037,"Michigan","Clinton County","A_A",1294,1885,591,37.18,"overcount"
"5002",26037,"Michigan","Clinton County","A_AIC",1715,2341,626,30.87,"overcount"
"5003",26037,"Michigan","Clinton County","NHPI_A",49,23,-26,-72.22,"undercount"
"5004",26037,"Michigan","Clinton County","NHPI_AIC",106,82,-24,-25.53,"undercount"
"5005",26039,"Michigan","Crawford County","A_A",102,58,-44,-55,"undercount"
"5006",26039,"Michigan","Crawford County","A_AIC",131,92,-39,-34.98,"undercount"
"5007",26039,"Michigan","Crawford County","NHPI_A",8,4,-4,-66.67,"undercount"
"5008",26039,"Michigan","Crawford County","NHPI_AIC",15,9,-6,-50,"undercount"
"5009",26041,"Michigan","Delta County","A_A",182,154,-28,-16.67,"undercount"
"5010",26041,"Michigan","Delta County","A_AIC",330,310,-20,-6.25,"undercount"
"5011",26041,"Michigan","Delta County","NHPI_A",12,10,-2,-18.18,"undercount"
"5012",26041,"Michigan","Delta County","NHPI_AIC",44,36,-8,-20,"undercount"
"5013",26043,"Michigan","Dickinson County","A_A",183,150,-33,-19.82,"undercount"
"5014",26043,"Michigan","Dickinson County","A_AIC",259,243,-16,-6.37,"undercount"
"5015",26043,"Michigan","Dickinson County","NHPI_A",24,4,-20,-142.86,"undercount"
"5016",26043,"Michigan","Dickinson County","NHPI_AIC",40,8,-32,-133.33,"undercount"
"5017",26045,"Michigan","Eaton County","A_A",2719,2459,-260,-10.04,"undercount"
"5018",26045,"Michigan","Eaton County","A_AIC",3301,3014,-287,-9.09,"undercount"
"5019",26045,"Michigan","Eaton County","NHPI_A",56,13,-43,-124.64,"undercount"
"5020",26045,"Michigan","Eaton County","NHPI_AIC",170,117,-53,-36.93,"undercount"
"5021",26047,"Michigan","Emmet County","A_A",214,174,-40,-20.62,"undercount"
"5022",26047,"Michigan","Emmet County","A_AIC",317,301,-16,-5.18,"undercount"
"5023",26047,"Michigan","Emmet County","NHPI_A",43,22,-21,-64.62,"undercount"
"5024",26047,"Michigan","Emmet County","NHPI_AIC",66,54,-12,-20,"undercount"
"5025",26049,"Michigan","Genesee County","A_A",4263,4119,-144,-3.44,"undercount"
"5026",26049,"Michigan","Genesee County","A_AIC",6321,6066,-255,-4.12,"undercount"
"5027",26049,"Michigan","Genesee County","NHPI_A",120,131,11,8.76,"overcount"
"5028",26049,"Michigan","Genesee County","NHPI_AIC",443,372,-71,-17.42,"undercount"
"5029",26051,"Michigan","Gladwin County","A_A",112,72,-40,-43.48,"undercount"
"5030",26051,"Michigan","Gladwin County","A_AIC",159,107,-52,-39.1,"undercount"
"5031",26051,"Michigan","Gladwin County","NHPI_A",8,0,-8,-200,"undercount"
"5032",26051,"Michigan","Gladwin County","NHPI_AIC",16,10,-6,-46.15,"undercount"
"5033",26053,"Michigan","Gogebic County","A_A",57,41,-16,-32.65,"undercount"
"5034",26053,"Michigan","Gogebic County","A_AIC",98,92,-6,-6.32,"undercount"
"5035",26053,"Michigan","Gogebic County","NHPI_A",9,3,-6,-100,"undercount"
"5036",26053,"Michigan","Gogebic County","NHPI_AIC",20,21,1,4.88,"overcount"
"5037",26055,"Michigan","Grand Traverse County","A_A",742,843,101,12.74,"overcount"
"5038",26055,"Michigan","Grand Traverse County","A_AIC",1177,1420,243,18.71,"overcount"
"5039",26055,"Michigan","Grand Traverse County","NHPI_A",83,41,-42,-67.74,"undercount"
"5040",26055,"Michigan","Grand Traverse County","NHPI_AIC",153,157,4,2.58,"overcount"
"5041",26057,"Michigan","Gratiot County","A_A",203,166,-37,-20.05,"undercount"
"5042",26057,"Michigan","Gratiot County","A_AIC",305,290,-15,-5.04,"undercount"
"5043",26057,"Michigan","Gratiot County","NHPI_A",24,28,4,15.38,"overcount"
"5044",26057,"Michigan","Gratiot County","NHPI_AIC",49,51,2,4,"overcount"
"5045",26059,"Michigan","Hillsdale County","A_A",218,200,-18,-8.61,"undercount"
"5046",26059,"Michigan","Hillsdale County","A_AIC",333,380,47,13.18,"overcount"
"5047",26059,"Michigan","Hillsdale County","NHPI_A",15,6,-9,-85.71,"undercount"
"5048",26059,"Michigan","Hillsdale County","NHPI_AIC",34,38,4,11.11,"overcount"
"5049",26061,"Michigan","Houghton County","A_A",941,855,-86,-9.58,"undercount"
"5050",26061,"Michigan","Houghton County","A_AIC",1093,1062,-31,-2.88,"undercount"
"5051",26061,"Michigan","Houghton County","NHPI_A",15,21,6,33.33,"overcount"
"5052",26061,"Michigan","Houghton County","NHPI_AIC",41,52,11,23.66,"overcount"
"5053",26063,"Michigan","Huron County","A_A",200,150,-50,-28.57,"undercount"
"5054",26063,"Michigan","Huron County","A_AIC",245,233,-12,-5.02,"undercount"
"5055",26063,"Michigan","Huron County","NHPI_A",4,5,1,22.22,"overcount"
"5056",26063,"Michigan","Huron County","NHPI_AIC",14,15,1,6.9,"overcount"
"5057",26065,"Michigan","Ingham County","A_A",19524,16680,-2844,-15.71,"undercount"
"5058",26065,"Michigan","Ingham County","A_AIC",22398,19339,-3059,-14.66,"undercount"
"5059",26065,"Michigan","Ingham County","NHPI_A",226,111,-115,-68.25,"undercount"
"5060",26065,"Michigan","Ingham County","NHPI_AIC",570,351,-219,-47.56,"undercount"
"5061",26067,"Michigan","Ionia County","A_A",316,229,-87,-31.93,"undercount"
"5062",26067,"Michigan","Ionia County","A_AIC",543,462,-81,-16.12,"undercount"
"5063",26067,"Michigan","Ionia County","NHPI_A",21,6,-15,-111.11,"undercount"
"5064",26067,"Michigan","Ionia County","NHPI_AIC",56,40,-16,-33.33,"undercount"
"5065",26069,"Michigan","Iosco County","A_A",201,158,-43,-23.96,"undercount"
"5066",26069,"Michigan","Iosco County","A_AIC",286,257,-29,-10.68,"undercount"
"5067",26069,"Michigan","Iosco County","NHPI_A",14,3,-11,-129.41,"undercount"
"5068",26069,"Michigan","Iosco County","NHPI_AIC",29,14,-15,-69.77,"undercount"
"5069",26071,"Michigan","Iron County","A_A",50,41,-9,-19.78,"undercount"
"5070",26071,"Michigan","Iron County","A_AIC",84,75,-9,-11.32,"undercount"
"5071",26071,"Michigan","Iron County","NHPI_A",2,0,-2,-200,"undercount"
"5072",26071,"Michigan","Iron County","NHPI_AIC",7,13,6,60,"overcount"
"5073",26073,"Michigan","Isabella County","A_A",1193,1134,-59,-5.07,"undercount"
"5074",26073,"Michigan","Isabella County","A_AIC",1611,1492,-119,-7.67,"undercount"
"5075",26073,"Michigan","Isabella County","NHPI_A",33,17,-16,-64,"undercount"
"5076",26073,"Michigan","Isabella County","NHPI_AIC",116,52,-64,-76.19,"undercount"
"5077",26075,"Michigan","Jackson County","A_A",1403,1483,80,5.54,"overcount"
"5078",26075,"Michigan","Jackson County","A_AIC",1993,2178,185,8.87,"overcount"
"5079",26075,"Michigan","Jackson County","NHPI_A",88,30,-58,-98.31,"undercount"
"5080",26075,"Michigan","Jackson County","NHPI_AIC",202,103,-99,-64.92,"undercount"
"5081",26077,"Michigan","Kalamazoo County","A_A",7541,7087,-454,-6.21,"undercount"
"5082",26077,"Michigan","Kalamazoo County","A_AIC",9577,9250,-327,-3.47,"undercount"
"5083",26077,"Michigan","Kalamazoo County","NHPI_A",168,64,-104,-89.66,"undercount"
"5084",26077,"Michigan","Kalamazoo County","NHPI_AIC",451,277,-174,-47.8,"undercount"
"5085",26079,"Michigan","Kalkaska County","A_A",113,60,-53,-61.27,"undercount"
"5086",26079,"Michigan","Kalkaska County","A_AIC",165,113,-52,-37.41,"undercount"
"5087",26079,"Michigan","Kalkaska County","NHPI_A",11,0,-11,-200,"undercount"
"5088",26079,"Michigan","Kalkaska County","NHPI_AIC",24,14,-10,-52.63,"undercount"
"5089",26081,"Michigan","Kent County","A_A",22300,22010,-290,-1.31,"undercount"
"5090",26081,"Michigan","Kent County","A_AIC",26706,27403,697,2.58,"overcount"
"5091",26081,"Michigan","Kent County","NHPI_A",557,181,-376,-101.9,"undercount"
"5092",26081,"Michigan","Kent County","NHPI_AIC",1159,726,-433,-45.94,"undercount"
"5093",26083,"Michigan","Keweenaw County","A_A",2,0,-2,-200,"undercount"
"5094",26083,"Michigan","Keweenaw County","A_AIC",9,9,0,0,"equal"
"5095",26083,"Michigan","Keweenaw County","NHPI_A",0,0,0,0,"equal"
"5096",26083,"Michigan","Keweenaw County","NHPI_AIC",0,5,5,200,"overcount"
"5097",26085,"Michigan","Lake County","A_A",40,45,5,11.76,"overcount"
"5098",26085,"Michigan","Lake County","A_AIC",87,66,-21,-27.45,"undercount"
"5099",26085,"Michigan","Lake County","NHPI_A",2,8,6,120,"overcount"
"5100",26085,"Michigan","Lake County","NHPI_AIC",24,30,6,22.22,"overcount"
"5101",26087,"Michigan","Lapeer County","A_A",584,421,-163,-32.44,"undercount"
"5102",26087,"Michigan","Lapeer County","A_AIC",865,752,-113,-13.98,"undercount"
"5103",26087,"Michigan","Lapeer County","NHPI_A",12,14,2,15.38,"overcount"
"5104",26087,"Michigan","Lapeer County","NHPI_AIC",42,61,19,36.89,"overcount"
"5105",26089,"Michigan","Leelanau County","A_A",130,106,-24,-20.34,"undercount"
"5106",26089,"Michigan","Leelanau County","A_AIC",202,193,-9,-4.56,"undercount"
"5107",26089,"Michigan","Leelanau County","NHPI_A",15,4,-11,-115.79,"undercount"
"5108",26089,"Michigan","Leelanau County","NHPI_AIC",27,33,6,20,"overcount"
"5109",26091,"Michigan","Lenawee County","A_A",508,478,-30,-6.09,"undercount"
"5110",26091,"Michigan","Lenawee County","A_AIC",857,928,71,7.96,"overcount"
"5111",26091,"Michigan","Lenawee County","NHPI_A",46,8,-38,-140.74,"undercount"
"5112",26091,"Michigan","Lenawee County","NHPI_AIC",114,41,-73,-94.19,"undercount"
"5113",26093,"Michigan","Livingston County","A_A",1875,1657,-218,-12.34,"undercount"
"5114",26093,"Michigan","Livingston County","A_AIC",2876,2915,39,1.35,"overcount"
"5115",26093,"Michigan","Livingston County","NHPI_A",102,113,11,10.23,"overcount"
"5116",26093,"Michigan","Livingston County","NHPI_AIC",198,243,45,20.41,"overcount"
"5117",26095,"Michigan","Luce County","A_A",15,3,-12,-133.33,"undercount"
"5118",26095,"Michigan","Luce County","A_AIC",40,19,-21,-71.19,"undercount"
"5119",26095,"Michigan","Luce County","NHPI_A",4,0,-4,-200,"undercount"
"5120",26095,"Michigan","Luce County","NHPI_AIC",8,11,3,31.58,"overcount"
"5121",26097,"Michigan","Mackinac County","A_A",109,28,-81,-118.25,"undercount"
"5122",26097,"Michigan","Mackinac County","A_AIC",149,50,-99,-99.5,"undercount"
"5123",26097,"Michigan","Mackinac County","NHPI_A",2,1,-1,-66.67,"undercount"
"5124",26097,"Michigan","Mackinac County","NHPI_AIC",11,3,-8,-114.29,"undercount"
"5125",26099,"Michigan","Macomb County","A_A",38636,38507,-129,-0.33,"undercount"
"5126",26099,"Michigan","Macomb County","A_AIC",46362,45868,-494,-1.07,"undercount"
"5127",26099,"Michigan","Macomb County","NHPI_A",286,193,-93,-38.83,"undercount"
"5128",26099,"Michigan","Macomb County","NHPI_AIC",1345,779,-566,-53.3,"undercount"
"5129",26101,"Michigan","Manistee County","A_A",101,79,-22,-24.44,"undercount"
"5130",26101,"Michigan","Manistee County","A_AIC",169,157,-12,-7.36,"undercount"
"5131",26101,"Michigan","Manistee County","NHPI_A",15,2,-13,-152.94,"undercount"
"5132",26101,"Michigan","Manistee County","NHPI_AIC",33,13,-20,-86.96,"undercount"
"5133",26103,"Michigan","Marquette County","A_A",509,400,-109,-23.98,"undercount"
"5134",26103,"Michigan","Marquette County","A_AIC",775,710,-65,-8.75,"undercount"
"5135",26103,"Michigan","Marquette County","NHPI_A",26,17,-9,-41.86,"undercount"
"5136",26103,"Michigan","Marquette County","NHPI_AIC",76,43,-33,-55.46,"undercount"
"5137",26105,"Michigan","Mason County","A_A",246,154,-92,-46,"undercount"
"5138",26105,"Michigan","Mason County","A_AIC",337,262,-75,-25.04,"undercount"
"5139",26105,"Michigan","Mason County","NHPI_A",5,8,3,46.15,"overcount"
"5140",26105,"Michigan","Mason County","NHPI_AIC",21,41,20,64.52,"overcount"
"5141",26107,"Michigan","Mecosta County","A_A",381,324,-57,-16.17,"undercount"
"5142",26107,"Michigan","Mecosta County","A_AIC",546,476,-70,-13.7,"undercount"
"5143",26107,"Michigan","Mecosta County","NHPI_A",18,14,-4,-25,"undercount"
"5144",26107,"Michigan","Mecosta County","NHPI_AIC",65,20,-45,-105.88,"undercount"
"5145",26109,"Michigan","Menominee County","A_A",102,94,-8,-8.16,"undercount"
"5146",26109,"Michigan","Menominee County","A_AIC",171,179,8,4.57,"overcount"
"5147",26109,"Michigan","Menominee County","NHPI_A",10,5,-5,-66.67,"undercount"
"5148",26109,"Michigan","Menominee County","NHPI_AIC",21,18,-3,-15.38,"undercount"
"5149",26111,"Michigan","Midland County","A_A",1924,1768,-156,-8.45,"undercount"
"5150",26111,"Michigan","Midland County","A_AIC",2338,2271,-67,-2.91,"undercount"
"5151",26111,"Michigan","Midland County","NHPI_A",71,83,12,15.58,"overcount"
"5152",26111,"Michigan","Midland County","NHPI_AIC",120,127,7,5.67,"overcount"
"5153",26113,"Michigan","Missaukee County","A_A",99,51,-48,-64,"undercount"
"5154",26113,"Michigan","Missaukee County","A_AIC",135,99,-36,-30.77,"undercount"
"5155",26113,"Michigan","Missaukee County","NHPI_A",2,1,-1,-66.67,"undercount"
"5156",26113,"Michigan","Missaukee County","NHPI_AIC",14,8,-6,-54.55,"undercount"
"5157",26115,"Michigan","Monroe County","A_A",1066,974,-92,-9.02,"undercount"
"5158",26115,"Michigan","Monroe County","A_AIC",1562,1595,33,2.09,"overcount"
"5159",26115,"Michigan","Monroe County","NHPI_A",52,26,-26,-66.67,"undercount"
"5160",26115,"Michigan","Monroe County","NHPI_AIC",131,91,-40,-36.04,"undercount"
"5161",26117,"Michigan","Montcalm County","A_A",269,238,-31,-12.23,"undercount"
"5162",26117,"Michigan","Montcalm County","A_AIC",460,465,5,1.08,"overcount"
"5163",26117,"Michigan","Montcalm County","NHPI_A",29,23,-6,-23.08,"undercount"
"5164",26117,"Michigan","Montcalm County","NHPI_AIC",69,65,-4,-5.97,"undercount"
"5165",26119,"Michigan","Montmorency County","A_A",26,26,0,0,"equal"
"5166",26119,"Michigan","Montmorency County","A_AIC",57,51,-6,-11.11,"undercount"
"5167",26119,"Michigan","Montmorency County","NHPI_A",1,0,-1,-200,"undercount"
"5168",26119,"Michigan","Montmorency County","NHPI_AIC",4,5,1,22.22,"overcount"
"5169",26121,"Michigan","Muskegon County","A_A",1246,1082,-164,-14.09,"undercount"
"5170",26121,"Michigan","Muskegon County","A_AIC",2070,1932,-138,-6.9,"undercount"
"5171",26121,"Michigan","Muskegon County","NHPI_A",72,37,-35,-64.22,"undercount"
"5172",26121,"Michigan","Muskegon County","NHPI_AIC",209,187,-22,-11.11,"undercount"
"5173",26123,"Michigan","Newaygo County","A_A",255,189,-66,-29.73,"undercount"
"5174",26123,"Michigan","Newaygo County","A_AIC",376,346,-30,-8.31,"undercount"
"5175",26123,"Michigan","Newaygo County","NHPI_A",16,14,-2,-13.33,"undercount"
"5176",26123,"Michigan","Newaygo County","NHPI_AIC",42,71,29,51.33,"overcount"
"5177",26125,"Michigan","Oakland County","A_A",104102,106228,2126,2.02,"overcount"
"5178",26125,"Michigan","Oakland County","A_AIC",115456,119332,3876,3.3,"overcount"
"5179",26125,"Michigan","Oakland County","NHPI_A",405,315,-90,-25,"undercount"
"5180",26125,"Michigan","Oakland County","NHPI_AIC",1540,963,-577,-46.1,"undercount"
"5181",26127,"Michigan","Oceana County","A_A",87,69,-18,-23.08,"undercount"
"5182",26127,"Michigan","Oceana County","A_AIC",149,153,4,2.65,"overcount"
"5183",26127,"Michigan","Oceana County","NHPI_A",12,4,-8,-100,"undercount"
"5184",26127,"Michigan","Oceana County","NHPI_AIC",25,21,-4,-17.39,"undercount"
"5185",26129,"Michigan","Ogemaw County","A_A",141,58,-83,-83.42,"undercount"
"5186",26129,"Michigan","Ogemaw County","A_AIC",185,101,-84,-58.74,"undercount"
"5187",26129,"Michigan","Ogemaw County","NHPI_A",8,8,0,0,"equal"
"5188",26129,"Michigan","Ogemaw County","NHPI_AIC",17,19,2,11.11,"overcount"
"5189",26131,"Michigan","Ontonagon County","A_A",34,23,-11,-38.6,"undercount"
"5190",26131,"Michigan","Ontonagon County","A_AIC",54,48,-6,-11.76,"undercount"
"5191",26131,"Michigan","Ontonagon County","NHPI_A",1,2,1,66.67,"overcount"
"5192",26131,"Michigan","Ontonagon County","NHPI_AIC",4,10,6,85.71,"overcount"
"5193",26133,"Michigan","Osceola County","A_A",75,42,-33,-56.41,"undercount"
"5194",26133,"Michigan","Osceola County","A_AIC",150,100,-50,-40,"undercount"
"5195",26133,"Michigan","Osceola County","NHPI_A",13,7,-6,-60,"undercount"
"5196",26133,"Michigan","Osceola County","NHPI_AIC",27,13,-14,-70,"undercount"
"5197",26135,"Michigan","Oscoda County","A_A",20,10,-10,-66.67,"undercount"
"5198",26135,"Michigan","Oscoda County","A_AIC",44,47,3,6.59,"overcount"
"5199",26135,"Michigan","Oscoda County","NHPI_A",4,0,-4,-200,"undercount"
"5200",26135,"Michigan","Oscoda County","NHPI_AIC",6,14,8,80,"overcount"
"5201",26137,"Michigan","Otsego County","A_A",170,91,-79,-60.54,"undercount"
"5202",26137,"Michigan","Otsego County","A_AIC",248,195,-53,-23.93,"undercount"
"5203",26137,"Michigan","Otsego County","NHPI_A",13,1,-12,-171.43,"undercount"
"5204",26137,"Michigan","Otsego County","NHPI_AIC",33,24,-9,-31.58,"undercount"
"5205",26139,"Michigan","Ottawa County","A_A",8580,8004,-576,-6.95,"undercount"
"5206",26139,"Michigan","Ottawa County","A_AIC",10589,10266,-323,-3.1,"undercount"
"5207",26139,"Michigan","Ottawa County","NHPI_A",159,100,-59,-45.56,"undercount"
"5208",26139,"Michigan","Ottawa County","NHPI_AIC",358,342,-16,-4.57,"undercount"
"5209",26141,"Michigan","Presque Isle County","A_A",85,56,-29,-41.13,"undercount"
"5210",26141,"Michigan","Presque Isle County","A_AIC",107,77,-30,-32.61,"undercount"
"5211",26141,"Michigan","Presque Isle County","NHPI_A",6,0,-6,-200,"undercount"
"5212",26141,"Michigan","Presque Isle County","NHPI_AIC",11,16,5,37.04,"overcount"
"5213",26143,"Michigan","Roscommon County","A_A",167,78,-89,-72.65,"undercount"
"5214",26143,"Michigan","Roscommon County","A_AIC",222,134,-88,-49.44,"undercount"
"5215",26143,"Michigan","Roscommon County","NHPI_A",6,10,4,50,"overcount"
"5216",26143,"Michigan","Roscommon County","NHPI_AIC",16,36,20,76.92,"overcount"
"5217",26145,"Michigan","Saginaw County","A_A",2620,2430,-190,-7.52,"undercount"
"5218",26145,"Michigan","Saginaw County","A_AIC",3323,3123,-200,-6.21,"undercount"
"5219",26145,"Michigan","Saginaw County","NHPI_A",112,85,-27,-27.41,"undercount"
"5220",26145,"Michigan","Saginaw County","NHPI_AIC",267,171,-96,-43.84,"undercount"
"5221",26147,"Michigan","St. Clair County","A_A",949,814,-135,-15.31,"undercount"
"5222",26147,"Michigan","St. Clair County","A_AIC",1520,1403,-117,-8.01,"undercount"
"5223",26147,"Michigan","St. Clair County","NHPI_A",54,13,-41,-122.39,"undercount"
"5224",26147,"Michigan","St. Clair County","NHPI_AIC",146,87,-59,-50.64,"undercount"
"5225",26149,"Michigan","St. Joseph County","A_A",413,421,8,1.92,"overcount"
"5226",26149,"Michigan","St. Joseph County","A_AIC",675,671,-4,-0.59,"undercount"
"5227",26149,"Michigan","St. Joseph County","NHPI_A",12,9,-3,-28.57,"undercount"
"5228",26149,"Michigan","St. Joseph County","NHPI_AIC",51,45,-6,-12.5,"undercount"
"5229",26151,"Michigan","Sanilac County","A_A",160,86,-74,-60.16,"undercount"
"5230",26151,"Michigan","Sanilac County","A_AIC",250,187,-63,-28.83,"undercount"
"5231",26151,"Michigan","Sanilac County","NHPI_A",13,2,-11,-146.67,"undercount"
"5232",26151,"Michigan","Sanilac County","NHPI_AIC",27,30,3,10.53,"overcount"
"5233",26153,"Michigan","Schoolcraft County","A_A",21,15,-6,-33.33,"undercount"
"5234",26153,"Michigan","Schoolcraft County","A_AIC",43,42,-1,-2.35,"undercount"
"5235",26153,"Michigan","Schoolcraft County","NHPI_A",0,1,1,200,"overcount"
"5236",26153,"Michigan","Schoolcraft County","NHPI_AIC",4,11,7,93.33,"overcount"
"5237",26155,"Michigan","Shiawassee County","A_A",372,292,-80,-24.1,"undercount"
"5238",26155,"Michigan","Shiawassee County","A_AIC",580,515,-65,-11.87,"undercount"
"5239",26155,"Michigan","Shiawassee County","NHPI_A",48,20,-28,-82.35,"undercount"
"5240",26155,"Michigan","Shiawassee County","NHPI_AIC",73,72,-1,-1.38,"undercount"
"5241",26157,"Michigan","Tuscola County","A_A",197,162,-35,-19.5,"undercount"
"5242",26157,"Michigan","Tuscola County","A_AIC",300,249,-51,-18.58,"undercount"
"5243",26157,"Michigan","Tuscola County","NHPI_A",25,12,-13,-70.27,"undercount"
"5244",26157,"Michigan","Tuscola County","NHPI_AIC",51,26,-25,-64.94,"undercount"
"5245",26159,"Michigan","Van Buren County","A_A",540,395,-145,-31.02,"undercount"
"5246",26159,"Michigan","Van Buren County","A_AIC",883,714,-169,-21.16,"undercount"
"5247",26159,"Michigan","Van Buren County","NHPI_A",44,27,-17,-47.89,"undercount"
"5248",26159,"Michigan","Van Buren County","NHPI_AIC",124,86,-38,-36.19,"undercount"
"5249",26161,"Michigan","Washtenaw County","A_A",34192,33788,-404,-1.19,"undercount"
"5250",26161,"Michigan","Washtenaw County","A_AIC",39522,40433,911,2.28,"overcount"
"5251",26161,"Michigan","Washtenaw County","NHPI_A",215,188,-27,-13.4,"undercount"
"5252",26161,"Michigan","Washtenaw County","NHPI_AIC",621,569,-52,-8.74,"undercount"
"5253",26163,"Michigan","Wayne County","A_A",61912,65176,3264,5.14,"overcount"
"5254",26163,"Michigan","Wayne County","A_AIC",76925,78875,1950,2.5,"overcount"
"5255",26163,"Michigan","Wayne County","NHPI_A",365,346,-19,-5.34,"undercount"
"5256",26163,"Michigan","Wayne County","NHPI_AIC",2015,1649,-366,-19.98,"undercount"
"5257",26165,"Michigan","Wexford County","A_A",239,186,-53,-24.94,"undercount"
"5258",26165,"Michigan","Wexford County","A_AIC",356,342,-14,-4.01,"undercount"
"5259",26165,"Michigan","Wexford County","NHPI_A",24,1,-23,-184,"undercount"
"5260",26165,"Michigan","Wexford County","NHPI_AIC",35,18,-17,-64.15,"undercount"
"5261",27001,"Minnesota","Aitkin County","A_A",45,38,-7,-16.87,"undercount"
"5262",27001,"Minnesota","Aitkin County","A_AIC",106,83,-23,-24.34,"undercount"
"5263",27001,"Minnesota","Aitkin County","NHPI_A",5,3,-2,-50,"undercount"
"5264",27001,"Minnesota","Aitkin County","NHPI_AIC",12,12,0,0,"equal"
"5265",27003,"Minnesota","Anoka County","A_A",19369,19341,-28,-0.14,"undercount"
"5266",27003,"Minnesota","Anoka County","A_AIC",22824,23338,514,2.23,"overcount"
"5267",27003,"Minnesota","Anoka County","NHPI_A",242,112,-130,-73.45,"undercount"
"5268",27003,"Minnesota","Anoka County","NHPI_AIC",552,465,-87,-17.11,"undercount"
"5269",27005,"Minnesota","Becker County","A_A",185,168,-17,-9.63,"undercount"
"5270",27005,"Minnesota","Becker County","A_AIC",332,300,-32,-10.13,"undercount"
"5271",27005,"Minnesota","Becker County","NHPI_A",21,9,-12,-80,"undercount"
"5272",27005,"Minnesota","Becker County","NHPI_AIC",39,38,-1,-2.6,"undercount"
"5273",27007,"Minnesota","Beltrami County","A_A",359,276,-83,-26.14,"undercount"
"5274",27007,"Minnesota","Beltrami County","A_AIC",609,542,-67,-11.64,"undercount"
"5275",27007,"Minnesota","Beltrami County","NHPI_A",30,15,-15,-66.67,"undercount"
"5276",27007,"Minnesota","Beltrami County","NHPI_AIC",68,52,-16,-26.67,"undercount"
"5277",27009,"Minnesota","Benton County","A_A",464,463,-1,-0.22,"undercount"
"5278",27009,"Minnesota","Benton County","A_AIC",721,748,27,3.68,"overcount"
"5279",27009,"Minnesota","Benton County","NHPI_A",26,9,-17,-97.14,"undercount"
"5280",27009,"Minnesota","Benton County","NHPI_AIC",58,30,-28,-63.64,"undercount"
"5281",27011,"Minnesota","Big Stone County","A_A",19,12,-7,-45.16,"undercount"
"5282",27011,"Minnesota","Big Stone County","A_AIC",32,23,-9,-32.73,"undercount"
"5283",27011,"Minnesota","Big Stone County","NHPI_A",0,4,4,200,"overcount"
"5284",27011,"Minnesota","Big Stone County","NHPI_AIC",4,13,9,105.88,"overcount"
"5285",27013,"Minnesota","Blue Earth County","A_A",1716,1851,135,7.57,"overcount"
"5286",27013,"Minnesota","Blue Earth County","A_AIC",2237,2445,208,8.89,"overcount"
"5287",27013,"Minnesota","Blue Earth County","NHPI_A",50,26,-24,-63.16,"undercount"
"5288",27013,"Minnesota","Blue Earth County","NHPI_AIC",103,97,-6,-6,"undercount"
"5289",27015,"Minnesota","Brown County","A_A",197,128,-69,-42.46,"undercount"
"5290",27015,"Minnesota","Brown County","A_AIC",265,192,-73,-31.95,"undercount"
"5291",27015,"Minnesota","Brown County","NHPI_A",9,6,-3,-40,"undercount"
"5292",27015,"Minnesota","Brown County","NHPI_AIC",20,11,-9,-58.06,"undercount"
"5293",27017,"Minnesota","Carlton County","A_A",212,153,-59,-32.33,"undercount"
"5294",27017,"Minnesota","Carlton County","A_AIC",369,346,-23,-6.43,"undercount"
"5295",27017,"Minnesota","Carlton County","NHPI_A",7,12,5,52.63,"overcount"
"5296",27017,"Minnesota","Carlton County","NHPI_AIC",31,69,38,76,"overcount"
"5297",27019,"Minnesota","Carver County","A_A",3769,3645,-124,-3.35,"undercount"
"5298",27019,"Minnesota","Carver County","A_AIC",4668,4824,156,3.29,"overcount"
"5299",27019,"Minnesota","Carver County","NHPI_A",53,15,-38,-111.76,"undercount"
"5300",27019,"Minnesota","Carver County","NHPI_AIC",121,100,-21,-19,"undercount"
"5301",27021,"Minnesota","Cass County","A_A",133,111,-22,-18.03,"undercount"
"5302",27021,"Minnesota","Cass County","A_AIC",290,206,-84,-33.87,"undercount"
"5303",27021,"Minnesota","Cass County","NHPI_A",6,0,-6,-200,"undercount"
"5304",27021,"Minnesota","Cass County","NHPI_AIC",31,15,-16,-69.57,"undercount"
"5305",27023,"Minnesota","Chippewa County","A_A",144,44,-100,-106.38,"undercount"
"5306",27023,"Minnesota","Chippewa County","A_AIC",202,85,-117,-81.53,"undercount"
"5307",27023,"Minnesota","Chippewa County","NHPI_A",180,296,116,48.74,"overcount"
"5308",27023,"Minnesota","Chippewa County","NHPI_AIC",189,297,108,44.44,"overcount"
"5309",27025,"Minnesota","Chisago County","A_A",820,787,-33,-4.11,"undercount"
"5310",27025,"Minnesota","Chisago County","A_AIC",1095,1142,47,4.2,"overcount"
"5311",27025,"Minnesota","Chisago County","NHPI_A",22,3,-19,-152,"undercount"
"5312",27025,"Minnesota","Chisago County","NHPI_AIC",60,75,15,22.22,"overcount"
"5313",27027,"Minnesota","Clay County","A_A",929,764,-165,-19.49,"undercount"
"5314",27027,"Minnesota","Clay County","A_AIC",1422,1214,-208,-15.78,"undercount"
"5315",27027,"Minnesota","Clay County","NHPI_A",47,18,-29,-89.23,"undercount"
"5316",27027,"Minnesota","Clay County","NHPI_AIC",96,91,-5,-5.35,"undercount"
"5317",27029,"Minnesota","Clearwater County","A_A",28,24,-4,-15.38,"undercount"
"5318",27029,"Minnesota","Clearwater County","A_AIC",90,50,-40,-57.14,"undercount"
"5319",27029,"Minnesota","Clearwater County","NHPI_A",2,2,0,0,"equal"
"5320",27029,"Minnesota","Clearwater County","NHPI_AIC",8,15,7,60.87,"overcount"
"5321",27031,"Minnesota","Cook County","A_A",60,48,-12,-22.22,"undercount"
"5322",27031,"Minnesota","Cook County","A_AIC",90,71,-19,-23.6,"undercount"
"5323",27031,"Minnesota","Cook County","NHPI_A",2,1,-1,-66.67,"undercount"
"5324",27031,"Minnesota","Cook County","NHPI_AIC",6,10,4,50,"overcount"
"5325",27033,"Minnesota","Cottonwood County","A_A",480,361,-119,-28.3,"undercount"
"5326",27033,"Minnesota","Cottonwood County","A_AIC",553,472,-81,-15.8,"undercount"
"5327",27033,"Minnesota","Cottonwood County","NHPI_A",43,80,37,60.16,"overcount"
"5328",27033,"Minnesota","Cottonwood County","NHPI_AIC",51,103,52,67.53,"overcount"
"5329",27035,"Minnesota","Crow Wing County","A_A",329,336,7,2.11,"overcount"
"5330",27035,"Minnesota","Crow Wing County","A_AIC",582,634,52,8.55,"overcount"
"5331",27035,"Minnesota","Crow Wing County","NHPI_A",21,19,-2,-10,"undercount"
"5332",27035,"Minnesota","Crow Wing County","NHPI_AIC",55,65,10,16.67,"overcount"
"5333",27037,"Minnesota","Dakota County","A_A",23530,24301,771,3.22,"overcount"
"5334",27037,"Minnesota","Dakota County","A_AIC",27811,29578,1767,6.16,"overcount"
"5335",27037,"Minnesota","Dakota County","NHPI_A",432,209,-223,-69.58,"undercount"
"5336",27037,"Minnesota","Dakota County","NHPI_AIC",960,680,-280,-34.15,"undercount"
"5337",27039,"Minnesota","Dodge County","A_A",172,104,-68,-49.28,"undercount"
"5338",27039,"Minnesota","Dodge County","A_AIC",304,253,-51,-18.31,"undercount"
"5339",27039,"Minnesota","Dodge County","NHPI_A",6,1,-5,-142.86,"undercount"
"5340",27039,"Minnesota","Dodge County","NHPI_AIC",32,18,-14,-56,"undercount"
"5341",27041,"Minnesota","Douglas County","A_A",244,227,-17,-7.22,"undercount"
"5342",27041,"Minnesota","Douglas County","A_AIC",363,379,16,4.31,"overcount"
"5343",27041,"Minnesota","Douglas County","NHPI_A",10,11,1,9.52,"overcount"
"5344",27041,"Minnesota","Douglas County","NHPI_AIC",30,36,6,18.18,"overcount"
"5345",27043,"Minnesota","Faribault County","A_A",55,49,-6,-11.54,"undercount"
"5346",27043,"Minnesota","Faribault County","A_AIC",105,93,-12,-12.12,"undercount"
"5347",27043,"Minnesota","Faribault County","NHPI_A",3,0,-3,-200,"undercount"
"5348",27043,"Minnesota","Faribault County","NHPI_AIC",17,5,-12,-109.09,"undercount"
"5349",27045,"Minnesota","Fillmore County","A_A",141,71,-70,-66.04,"undercount"
"5350",27045,"Minnesota","Fillmore County","A_AIC",201,148,-53,-30.37,"undercount"
"5351",27045,"Minnesota","Fillmore County","NHPI_A",4,2,-2,-66.67,"undercount"
"5352",27045,"Minnesota","Fillmore County","NHPI_AIC",14,10,-4,-33.33,"undercount"
"5353",27047,"Minnesota","Freeborn County","A_A",1020,1135,115,10.67,"overcount"
"5354",27047,"Minnesota","Freeborn County","A_AIC",1174,1273,99,8.09,"overcount"
"5355",27047,"Minnesota","Freeborn County","NHPI_A",71,5,-66,-173.68,"undercount"
"5356",27047,"Minnesota","Freeborn County","NHPI_AIC",90,16,-74,-139.62,"undercount"
"5357",27049,"Minnesota","Goodhue County","A_A",355,352,-3,-0.85,"undercount"
"5358",27049,"Minnesota","Goodhue County","A_AIC",566,555,-11,-1.96,"undercount"
"5359",27049,"Minnesota","Goodhue County","NHPI_A",38,56,18,38.3,"overcount"
"5360",27049,"Minnesota","Goodhue County","NHPI_AIC",77,85,8,9.88,"overcount"
"5361",27051,"Minnesota","Grant County","A_A",22,14,-8,-44.44,"undercount"
"5362",27051,"Minnesota","Grant County","A_AIC",40,44,4,9.52,"overcount"
"5363",27051,"Minnesota","Grant County","NHPI_A",8,9,1,11.76,"overcount"
"5364",27051,"Minnesota","Grant County","NHPI_AIC",12,21,9,54.55,"overcount"
"5365",27053,"Minnesota","Hennepin County","A_A",96754,98206,1452,1.49,"overcount"
"5366",27053,"Minnesota","Hennepin County","A_AIC",109558,115276,5718,5.09,"overcount"
"5367",27053,"Minnesota","Hennepin County","NHPI_A",779,508,-271,-42.11,"undercount"
"5368",27053,"Minnesota","Hennepin County","NHPI_AIC",2340,1825,-515,-24.73,"undercount"
"5369",27055,"Minnesota","Houston County","A_A",172,101,-71,-52.01,"undercount"
"5370",27055,"Minnesota","Houston County","A_AIC",240,180,-60,-28.57,"undercount"
"5371",27055,"Minnesota","Houston County","NHPI_A",4,4,0,0,"equal"
"5372",27055,"Minnesota","Houston County","NHPI_AIC",19,15,-4,-23.53,"undercount"
"5373",27057,"Minnesota","Hubbard County","A_A",120,70,-50,-52.63,"undercount"
"5374",27057,"Minnesota","Hubbard County","A_AIC",180,177,-3,-1.68,"undercount"
"5375",27057,"Minnesota","Hubbard County","NHPI_A",20,31,11,43.14,"overcount"
"5376",27057,"Minnesota","Hubbard County","NHPI_AIC",38,57,19,40,"overcount"
"5377",27059,"Minnesota","Isanti County","A_A",577,488,-89,-16.71,"undercount"
"5378",27059,"Minnesota","Isanti County","A_AIC",831,721,-110,-14.18,"undercount"
"5379",27059,"Minnesota","Isanti County","NHPI_A",25,13,-12,-63.16,"undercount"
"5380",27059,"Minnesota","Isanti County","NHPI_AIC",56,40,-16,-33.33,"undercount"
"5381",27061,"Minnesota","Itasca County","A_A",163,148,-15,-9.65,"undercount"
"5382",27061,"Minnesota","Itasca County","A_AIC",338,344,6,1.76,"overcount"
"5383",27061,"Minnesota","Itasca County","NHPI_A",77,2,-75,-189.87,"undercount"
"5384",27061,"Minnesota","Itasca County","NHPI_AIC",115,38,-77,-100.65,"undercount"
"5385",27063,"Minnesota","Jackson County","A_A",166,125,-41,-28.18,"undercount"
"5386",27063,"Minnesota","Jackson County","A_AIC",215,208,-7,-3.31,"undercount"
"5387",27063,"Minnesota","Jackson County","NHPI_A",10,0,-10,-200,"undercount"
"5388",27063,"Minnesota","Jackson County","NHPI_AIC",18,2,-16,-160,"undercount"
"5389",27065,"Minnesota","Kanabec County","A_A",113,80,-33,-34.2,"undercount"
"5390",27065,"Minnesota","Kanabec County","A_AIC",179,148,-31,-18.96,"undercount"
"5391",27065,"Minnesota","Kanabec County","NHPI_A",6,0,-6,-200,"undercount"
"5392",27065,"Minnesota","Kanabec County","NHPI_AIC",17,7,-10,-83.33,"undercount"
"5393",27067,"Minnesota","Kandiyohi County","A_A",532,586,54,9.66,"overcount"
"5394",27067,"Minnesota","Kandiyohi County","A_AIC",696,723,27,3.81,"overcount"
"5395",27067,"Minnesota","Kandiyohi County","NHPI_A",71,37,-34,-62.96,"undercount"
"5396",27067,"Minnesota","Kandiyohi County","NHPI_AIC",93,68,-25,-31.06,"undercount"
"5397",27069,"Minnesota","Kittson County","A_A",29,18,-11,-46.81,"undercount"
"5398",27069,"Minnesota","Kittson County","A_AIC",45,39,-6,-14.29,"undercount"
"5399",27069,"Minnesota","Kittson County","NHPI_A",0,6,6,200,"overcount"
"5400",27069,"Minnesota","Kittson County","NHPI_AIC",2,14,12,150,"overcount"
"5401",27071,"Minnesota","Koochiching County","A_A",78,34,-44,-78.57,"undercount"
"5402",27071,"Minnesota","Koochiching County","A_AIC",119,69,-50,-53.19,"undercount"
"5403",27071,"Minnesota","Koochiching County","NHPI_A",3,12,9,120,"overcount"
"5404",27071,"Minnesota","Koochiching County","NHPI_AIC",15,17,2,12.5,"overcount"
"5405",27073,"Minnesota","Lac qui Parle County","A_A",58,40,-18,-36.73,"undercount"
"5406",27073,"Minnesota","Lac qui Parle County","A_AIC",75,65,-10,-14.29,"undercount"
"5407",27073,"Minnesota","Lac qui Parle County","NHPI_A",13,1,-12,-171.43,"undercount"
"5408",27073,"Minnesota","Lac qui Parle County","NHPI_AIC",16,7,-9,-78.26,"undercount"
"5409",27075,"Minnesota","Lake County","A_A",59,55,-4,-7.02,"undercount"
"5410",27075,"Minnesota","Lake County","A_AIC",93,88,-5,-5.52,"undercount"
"5411",27075,"Minnesota","Lake County","NHPI_A",3,0,-3,-200,"undercount"
"5412",27075,"Minnesota","Lake County","NHPI_AIC",14,11,-3,-24,"undercount"
"5413",27077,"Minnesota","Lake of the Woods County","A_A",63,17,-46,-115,"undercount"
"5414",27077,"Minnesota","Lake of the Woods County","A_AIC",84,57,-27,-38.3,"undercount"
"5415",27077,"Minnesota","Lake of the Woods County","NHPI_A",0,0,0,0,"equal"
"5416",27077,"Minnesota","Lake of the Woods County","NHPI_AIC",3,8,5,90.91,"overcount"
"5417",27079,"Minnesota","Le Sueur County","A_A",189,148,-41,-24.33,"undercount"
"5418",27079,"Minnesota","Le Sueur County","A_AIC",324,290,-34,-11.07,"undercount"
"5419",27079,"Minnesota","Le Sueur County","NHPI_A",10,20,10,66.67,"overcount"
"5420",27079,"Minnesota","Le Sueur County","NHPI_AIC",24,34,10,34.48,"overcount"
"5421",27081,"Minnesota","Lincoln County","A_A",35,22,-13,-45.61,"undercount"
"5422",27081,"Minnesota","Lincoln County","A_AIC",50,52,2,3.92,"overcount"
"5423",27081,"Minnesota","Lincoln County","NHPI_A",3,0,-3,-200,"undercount"
"5424",27081,"Minnesota","Lincoln County","NHPI_AIC",7,4,-3,-54.55,"undercount"
"5425",27083,"Minnesota","Lyon County","A_A",1304,1263,-41,-3.19,"undercount"
"5426",27083,"Minnesota","Lyon County","A_AIC",1401,1371,-30,-2.16,"undercount"
"5427",27083,"Minnesota","Lyon County","NHPI_A",17,3,-14,-140,"undercount"
"5428",27083,"Minnesota","Lyon County","NHPI_AIC",33,21,-12,-44.44,"undercount"
"5429",27085,"Minnesota","McLeod County","A_A",291,232,-59,-22.56,"undercount"
"5430",27085,"Minnesota","McLeod County","A_AIC",422,400,-22,-5.35,"undercount"
"5431",27085,"Minnesota","McLeod County","NHPI_A",33,27,-6,-20,"undercount"
"5432",27085,"Minnesota","McLeod County","NHPI_AIC",54,46,-8,-16,"undercount"
"5433",27087,"Minnesota","Mahnomen County","A_A",6,8,2,28.57,"overcount"
"5434",27087,"Minnesota","Mahnomen County","A_AIC",39,14,-25,-94.34,"undercount"
"5435",27087,"Minnesota","Mahnomen County","NHPI_A",3,0,-3,-200,"undercount"
"5436",27087,"Minnesota","Mahnomen County","NHPI_AIC",16,2,-14,-155.56,"undercount"
"5437",27089,"Minnesota","Marshall County","A_A",36,19,-17,-61.82,"undercount"
"5438",27089,"Minnesota","Marshall County","A_AIC",56,44,-12,-24,"undercount"
"5439",27089,"Minnesota","Marshall County","NHPI_A",7,0,-7,-200,"undercount"
"5440",27089,"Minnesota","Marshall County","NHPI_AIC",15,10,-5,-40,"undercount"
"5441",27091,"Minnesota","Martin County","A_A",146,92,-54,-45.38,"undercount"
"5442",27091,"Minnesota","Martin County","A_AIC",203,184,-19,-9.82,"undercount"
"5443",27091,"Minnesota","Martin County","NHPI_A",32,6,-26,-136.84,"undercount"
"5444",27091,"Minnesota","Martin County","NHPI_AIC",46,19,-27,-83.08,"undercount"
"5445",27093,"Minnesota","Meeker County","A_A",98,64,-34,-41.98,"undercount"
"5446",27093,"Minnesota","Meeker County","A_AIC",156,107,-49,-37.26,"undercount"
"5447",27093,"Minnesota","Meeker County","NHPI_A",18,2,-16,-160,"undercount"
"5448",27093,"Minnesota","Meeker County","NHPI_AIC",26,24,-2,-8,"undercount"
"5449",27095,"Minnesota","Mille Lacs County","A_A",192,128,-64,-40,"undercount"
"5450",27095,"Minnesota","Mille Lacs County","A_AIC",293,263,-30,-10.79,"undercount"
"5451",27095,"Minnesota","Mille Lacs County","NHPI_A",11,6,-5,-58.82,"undercount"
"5452",27095,"Minnesota","Mille Lacs County","NHPI_AIC",27,21,-6,-25,"undercount"
"5453",27097,"Minnesota","Morrison County","A_A",121,102,-19,-17.04,"undercount"
"5454",27097,"Minnesota","Morrison County","A_AIC",222,185,-37,-18.18,"undercount"
"5455",27097,"Minnesota","Morrison County","NHPI_A",13,5,-8,-88.89,"undercount"
"5456",27097,"Minnesota","Morrison County","NHPI_AIC",38,12,-26,-104,"undercount"
"5457",27099,"Minnesota","Mower County","A_A",2234,2071,-163,-7.57,"undercount"
"5458",27099,"Minnesota","Mower County","A_AIC",2473,2244,-229,-9.71,"undercount"
"5459",27099,"Minnesota","Mower County","NHPI_A",213,261,48,20.25,"overcount"
"5460",27099,"Minnesota","Mower County","NHPI_AIC",249,289,40,14.87,"overcount"
"5461",27101,"Minnesota","Murray County","A_A",148,108,-40,-31.25,"undercount"
"5462",27101,"Minnesota","Murray County","A_AIC",171,124,-47,-31.86,"undercount"
"5463",27101,"Minnesota","Murray County","NHPI_A",20,4,-16,-133.33,"undercount"
"5464",27101,"Minnesota","Murray County","NHPI_AIC",24,7,-17,-109.68,"undercount"
"5465",27103,"Minnesota","Nicollet County","A_A",556,560,4,0.72,"overcount"
"5466",27103,"Minnesota","Nicollet County","A_AIC",780,719,-61,-8.14,"undercount"
"5467",27103,"Minnesota","Nicollet County","NHPI_A",7,11,4,44.44,"overcount"
"5468",27103,"Minnesota","Nicollet County","NHPI_AIC",35,29,-6,-18.75,"undercount"
"5469",27105,"Minnesota","Nobles County","A_A",1598,1329,-269,-18.38,"undercount"
"5470",27105,"Minnesota","Nobles County","A_AIC",1724,1481,-243,-15.16,"undercount"
"5471",27105,"Minnesota","Nobles County","NHPI_A",71,41,-30,-53.57,"undercount"
"5472",27105,"Minnesota","Nobles County","NHPI_AIC",87,56,-31,-43.36,"undercount"
"5473",27107,"Minnesota","Norman County","A_A",41,18,-23,-77.97,"undercount"
"5474",27107,"Minnesota","Norman County","A_AIC",78,45,-33,-53.66,"undercount"
"5475",27107,"Minnesota","Norman County","NHPI_A",1,0,-1,-200,"undercount"
"5476",27107,"Minnesota","Norman County","NHPI_AIC",3,12,9,120,"overcount"
"5477",27109,"Minnesota","Olmsted County","A_A",10532,10276,-256,-2.46,"undercount"
"5478",27109,"Minnesota","Olmsted County","A_AIC",12339,12384,45,0.36,"overcount"
"5479",27109,"Minnesota","Olmsted County","NHPI_A",129,70,-59,-59.3,"undercount"
"5480",27109,"Minnesota","Olmsted County","NHPI_AIC",277,201,-76,-31.8,"undercount"
"5481",27111,"Minnesota","Otter Tail County","A_A",360,349,-11,-3.1,"undercount"
"5482",27111,"Minnesota","Otter Tail County","A_AIC",600,608,8,1.32,"overcount"
"5483",27111,"Minnesota","Otter Tail County","NHPI_A",49,17,-32,-96.97,"undercount"
"5484",27111,"Minnesota","Otter Tail County","NHPI_AIC",88,54,-34,-47.89,"undercount"
"5485",27113,"Minnesota","Pennington County","A_A",141,121,-20,-15.27,"undercount"
"5486",27113,"Minnesota","Pennington County","A_AIC",208,194,-14,-6.97,"undercount"
"5487",27113,"Minnesota","Pennington County","NHPI_A",2,6,4,100,"overcount"
"5488",27113,"Minnesota","Pennington County","NHPI_AIC",13,25,12,63.16,"overcount"
"5489",27115,"Minnesota","Pine County","A_A",250,264,14,5.45,"overcount"
"5490",27115,"Minnesota","Pine County","A_AIC",374,383,9,2.38,"overcount"
"5491",27115,"Minnesota","Pine County","NHPI_A",9,2,-7,-127.27,"undercount"
"5492",27115,"Minnesota","Pine County","NHPI_AIC",42,36,-6,-15.38,"undercount"
"5493",27117,"Minnesota","Pipestone County","A_A",96,67,-29,-35.58,"undercount"
"5494",27117,"Minnesota","Pipestone County","A_AIC",138,93,-45,-38.96,"undercount"
"5495",27117,"Minnesota","Pipestone County","NHPI_A",0,0,0,0,"equal"
"5496",27117,"Minnesota","Pipestone County","NHPI_AIC",6,7,1,15.38,"overcount"
"5497",27119,"Minnesota","Polk County","A_A",297,161,-136,-59.39,"undercount"
"5498",27119,"Minnesota","Polk County","A_AIC",438,328,-110,-28.72,"undercount"
"5499",27119,"Minnesota","Polk County","NHPI_A",18,4,-14,-127.27,"undercount"
"5500",27119,"Minnesota","Polk County","NHPI_AIC",48,43,-5,-10.99,"undercount"
"5501",27121,"Minnesota","Pope County","A_A",79,53,-26,-39.39,"undercount"
"5502",27121,"Minnesota","Pope County","A_AIC",105,83,-22,-23.4,"undercount"
"5503",27121,"Minnesota","Pope County","NHPI_A",2,0,-2,-200,"undercount"
"5504",27121,"Minnesota","Pope County","NHPI_AIC",11,4,-7,-93.33,"undercount"
"5505",27123,"Minnesota","Ramsey County","A_A",85529,86147,618,0.72,"overcount"
"5506",27123,"Minnesota","Ramsey County","A_AIC",91139,92826,1687,1.83,"overcount"
"5507",27123,"Minnesota","Ramsey County","NHPI_A",496,216,-280,-78.65,"undercount"
"5508",27123,"Minnesota","Ramsey County","NHPI_AIC",1283,923,-360,-32.64,"undercount"
"5509",27125,"Minnesota","Red Lake County","A_A",15,6,-9,-85.71,"undercount"
"5510",27125,"Minnesota","Red Lake County","A_AIC",27,27,0,0,"equal"
"5511",27125,"Minnesota","Red Lake County","NHPI_A",4,3,-1,-28.57,"undercount"
"5512",27125,"Minnesota","Red Lake County","NHPI_AIC",4,7,3,54.55,"overcount"
"5513",27127,"Minnesota","Redwood County","A_A",414,420,6,1.44,"overcount"
"5514",27127,"Minnesota","Redwood County","A_AIC",495,510,15,2.99,"overcount"
"5515",27127,"Minnesota","Redwood County","NHPI_A",9,1,-8,-160,"undercount"
"5516",27127,"Minnesota","Redwood County","NHPI_AIC",23,27,4,16,"overcount"
"5517",27129,"Minnesota","Renville County","A_A",122,61,-61,-66.67,"undercount"
"5518",27129,"Minnesota","Renville County","A_AIC",165,133,-32,-21.48,"undercount"
"5519",27129,"Minnesota","Renville County","NHPI_A",5,5,0,0,"equal"
"5520",27129,"Minnesota","Renville County","NHPI_AIC",17,15,-2,-12.5,"undercount"
"5521",27131,"Minnesota","Rice County","A_A",1470,1611,141,9.15,"overcount"
"5522",27131,"Minnesota","Rice County","A_AIC",2001,2074,73,3.58,"overcount"
"5523",27131,"Minnesota","Rice County","NHPI_A",83,12,-71,-149.47,"undercount"
"5524",27131,"Minnesota","Rice County","NHPI_AIC",137,118,-19,-14.9,"undercount"
"5525",27133,"Minnesota","Rock County","A_A",74,63,-11,-16.06,"undercount"
"5526",27133,"Minnesota","Rock County","A_AIC",123,109,-14,-12.07,"undercount"
"5527",27133,"Minnesota","Rock County","NHPI_A",1,10,9,163.64,"overcount"
"5528",27133,"Minnesota","Rock County","NHPI_AIC",8,23,15,96.77,"overcount"
"5529",27135,"Minnesota","Roseau County","A_A",438,403,-35,-8.32,"undercount"
"5530",27135,"Minnesota","Roseau County","A_AIC",529,494,-35,-6.84,"undercount"
"5531",27135,"Minnesota","Roseau County","NHPI_A",4,10,6,85.71,"overcount"
"5532",27135,"Minnesota","Roseau County","NHPI_AIC",15,24,9,46.15,"overcount"
"5533",27137,"Minnesota","St. Louis County","A_A",2243,1917,-326,-15.67,"undercount"
"5534",27137,"Minnesota","St. Louis County","A_AIC",3285,3123,-162,-5.06,"undercount"
"5535",27137,"Minnesota","St. Louis County","NHPI_A",103,60,-43,-52.76,"undercount"
"5536",27137,"Minnesota","St. Louis County","NHPI_AIC",248,270,22,8.49,"overcount"
"5537",27139,"Minnesota","Scott County","A_A",10019,10068,49,0.49,"overcount"
"5538",27139,"Minnesota","Scott County","A_AIC",11581,11837,256,2.19,"overcount"
"5539",27139,"Minnesota","Scott County","NHPI_A",153,69,-84,-75.68,"undercount"
"5540",27139,"Minnesota","Scott County","NHPI_AIC",308,233,-75,-27.73,"undercount"
"5541",27141,"Minnesota","Sherburne County","A_A",1416,1295,-121,-8.93,"undercount"
"5542",27141,"Minnesota","Sherburne County","A_AIC",2079,2051,-28,-1.36,"undercount"
"5543",27141,"Minnesota","Sherburne County","NHPI_A",47,25,-22,-61.11,"undercount"
"5544",27141,"Minnesota","Sherburne County","NHPI_AIC",120,139,19,14.67,"overcount"
"5545",27143,"Minnesota","Sibley County","A_A",118,76,-42,-43.3,"undercount"
"5546",27143,"Minnesota","Sibley County","A_AIC",170,127,-43,-28.96,"undercount"
"5547",27143,"Minnesota","Sibley County","NHPI_A",7,10,3,35.29,"overcount"
"5548",27143,"Minnesota","Sibley County","NHPI_AIC",14,13,-1,-7.41,"undercount"
"5549",27145,"Minnesota","Stearns County","A_A",3804,3178,-626,-17.93,"undercount"
"5550",27145,"Minnesota","Stearns County","A_AIC",4831,4088,-743,-16.66,"undercount"
"5551",27145,"Minnesota","Stearns County","NHPI_A",205,67,-138,-101.47,"undercount"
"5552",27145,"Minnesota","Stearns County","NHPI_AIC",321,198,-123,-47.4,"undercount"
"5553",27147,"Minnesota","Steele County","A_A",393,340,-53,-14.46,"undercount"
"5554",27147,"Minnesota","Steele County","A_AIC",541,531,-10,-1.87,"undercount"
"5555",27147,"Minnesota","Steele County","NHPI_A",21,18,-3,-15.38,"undercount"
"5556",27147,"Minnesota","Steele County","NHPI_AIC",32,50,18,43.9,"overcount"
"5557",27149,"Minnesota","Stevens County","A_A",200,68,-132,-98.51,"undercount"
"5558",27149,"Minnesota","Stevens County","A_AIC",254,122,-132,-70.21,"undercount"
"5559",27149,"Minnesota","Stevens County","NHPI_A",5,1,-4,-133.33,"undercount"
"5560",27149,"Minnesota","Stevens County","NHPI_AIC",8,4,-4,-66.67,"undercount"
"5561",27151,"Minnesota","Swift County","A_A",69,78,9,12.24,"overcount"
"5562",27151,"Minnesota","Swift County","A_AIC",98,114,16,15.09,"overcount"
"5563",27151,"Minnesota","Swift County","NHPI_A",103,133,30,25.42,"overcount"
"5564",27151,"Minnesota","Swift County","NHPI_AIC",108,137,29,23.67,"overcount"
"5565",27153,"Minnesota","Todd County","A_A",129,97,-32,-28.32,"undercount"
"5566",27153,"Minnesota","Todd County","A_AIC",223,168,-55,-28.13,"undercount"
"5567",27153,"Minnesota","Todd County","NHPI_A",67,83,16,21.33,"overcount"
"5568",27153,"Minnesota","Todd County","NHPI_AIC",87,95,8,8.79,"overcount"
"5569",27155,"Minnesota","Traverse County","A_A",18,0,-18,-200,"undercount"
"5570",27155,"Minnesota","Traverse County","A_AIC",36,27,-9,-28.57,"undercount"
"5571",27155,"Minnesota","Traverse County","NHPI_A",2,0,-2,-200,"undercount"
"5572",27155,"Minnesota","Traverse County","NHPI_AIC",4,5,1,22.22,"overcount"
"5573",27157,"Minnesota","Wabasha County","A_A",152,97,-55,-44.18,"undercount"
"5574",27157,"Minnesota","Wabasha County","A_AIC",222,176,-46,-23.12,"undercount"
"5575",27157,"Minnesota","Wabasha County","NHPI_A",11,6,-5,-58.82,"undercount"
"5576",27157,"Minnesota","Wabasha County","NHPI_AIC",21,22,1,4.65,"overcount"
"5577",27159,"Minnesota","Wadena County","A_A",73,54,-19,-29.92,"undercount"
"5578",27159,"Minnesota","Wadena County","A_AIC",121,67,-54,-57.45,"undercount"
"5579",27159,"Minnesota","Wadena County","NHPI_A",1,9,8,160,"overcount"
"5580",27159,"Minnesota","Wadena County","NHPI_AIC",10,11,1,9.52,"overcount"
"5581",27161,"Minnesota","Waseca County","A_A",161,116,-45,-32.49,"undercount"
"5582",27161,"Minnesota","Waseca County","A_AIC",220,183,-37,-18.36,"undercount"
"5583",27161,"Minnesota","Waseca County","NHPI_A",15,12,-3,-22.22,"undercount"
"5584",27161,"Minnesota","Waseca County","NHPI_AIC",30,29,-1,-3.39,"undercount"
"5585",27163,"Minnesota","Washington County","A_A",18158,18678,520,2.82,"overcount"
"5586",27163,"Minnesota","Washington County","A_AIC",20731,21788,1057,4.97,"overcount"
"5587",27163,"Minnesota","Washington County","NHPI_A",195,75,-120,-88.89,"undercount"
"5588",27163,"Minnesota","Washington County","NHPI_AIC",466,394,-72,-16.74,"undercount"
"5589",27165,"Minnesota","Watonwan County","A_A",135,86,-49,-44.34,"undercount"
"5590",27165,"Minnesota","Watonwan County","A_AIC",159,124,-35,-24.73,"undercount"
"5591",27165,"Minnesota","Watonwan County","NHPI_A",8,0,-8,-200,"undercount"
"5592",27165,"Minnesota","Watonwan County","NHPI_AIC",12,9,-3,-28.57,"undercount"
"5593",27167,"Minnesota","Wilkin County","A_A",39,10,-29,-118.37,"undercount"
"5594",27167,"Minnesota","Wilkin County","A_AIC",55,37,-18,-39.13,"undercount"
"5595",27167,"Minnesota","Wilkin County","NHPI_A",0,1,1,200,"overcount"
"5596",27167,"Minnesota","Wilkin County","NHPI_AIC",2,3,1,40,"overcount"
"5597",27169,"Minnesota","Winona County","A_A",1341,938,-403,-35.37,"undercount"
"5598",27169,"Minnesota","Winona County","A_AIC",1523,1238,-285,-20.64,"undercount"
"5599",27169,"Minnesota","Winona County","NHPI_A",10,4,-6,-85.71,"undercount"
"5600",27169,"Minnesota","Winona County","NHPI_AIC",24,51,27,72,"overcount"
"5601",27171,"Minnesota","Wright County","A_A",2040,1917,-123,-6.22,"undercount"
"5602",27171,"Minnesota","Wright County","A_AIC",2940,3064,124,4.13,"overcount"
"5603",27171,"Minnesota","Wright County","NHPI_A",67,35,-32,-62.75,"undercount"
"5604",27171,"Minnesota","Wright County","NHPI_AIC",146,125,-21,-15.5,"undercount"
"5605",27173,"Minnesota","Yellow Medicine County","A_A",57,29,-28,-65.12,"undercount"
"5606",27173,"Minnesota","Yellow Medicine County","A_AIC",85,67,-18,-23.68,"undercount"
"5607",27173,"Minnesota","Yellow Medicine County","NHPI_A",11,1,-10,-166.67,"undercount"
"5608",27173,"Minnesota","Yellow Medicine County","NHPI_AIC",13,9,-4,-36.36,"undercount"
"5609",28001,"Mississippi","Adams County","A_A",180,168,-12,-6.9,"undercount"
"5610",28001,"Mississippi","Adams County","A_AIC",241,207,-34,-15.18,"undercount"
"5611",28001,"Mississippi","Adams County","NHPI_A",7,7,0,0,"equal"
"5612",28001,"Mississippi","Adams County","NHPI_AIC",21,24,3,13.33,"overcount"
"5613",28003,"Mississippi","Alcorn County","A_A",172,192,20,10.99,"overcount"
"5614",28003,"Mississippi","Alcorn County","A_AIC",234,276,42,16.47,"overcount"
"5615",28003,"Mississippi","Alcorn County","NHPI_A",14,19,5,30.3,"overcount"
"5616",28003,"Mississippi","Alcorn County","NHPI_AIC",31,25,-6,-21.43,"undercount"
"5617",28005,"Mississippi","Amite County","A_A",25,31,6,21.43,"overcount"
"5618",28005,"Mississippi","Amite County","A_AIC",51,56,5,9.35,"overcount"
"5619",28005,"Mississippi","Amite County","NHPI_A",3,0,-3,-200,"undercount"
"5620",28005,"Mississippi","Amite County","NHPI_AIC",5,9,4,57.14,"overcount"
"5621",28007,"Mississippi","Attala County","A_A",83,97,14,15.56,"overcount"
"5622",28007,"Mississippi","Attala County","A_AIC",118,138,20,15.62,"overcount"
"5623",28007,"Mississippi","Attala County","NHPI_A",4,4,0,0,"equal"
"5624",28007,"Mississippi","Attala County","NHPI_AIC",7,15,8,72.73,"overcount"
"5625",28009,"Mississippi","Benton County","A_A",17,1,-16,-177.78,"undercount"
"5626",28009,"Mississippi","Benton County","A_AIC",41,13,-28,-103.7,"undercount"
"5627",28009,"Mississippi","Benton County","NHPI_A",3,0,-3,-200,"undercount"
"5628",28009,"Mississippi","Benton County","NHPI_AIC",6,1,-5,-142.86,"undercount"
"5629",28011,"Mississippi","Bolivar County","A_A",318,272,-46,-15.59,"undercount"
"5630",28011,"Mississippi","Bolivar County","A_AIC",357,332,-25,-7.26,"undercount"
"5631",28011,"Mississippi","Bolivar County","NHPI_A",16,0,-16,-200,"undercount"
"5632",28011,"Mississippi","Bolivar County","NHPI_AIC",23,10,-13,-78.79,"undercount"
"5633",28013,"Mississippi","Calhoun County","A_A",27,17,-10,-45.45,"undercount"
"5634",28013,"Mississippi","Calhoun County","A_AIC",48,32,-16,-40,"undercount"
"5635",28013,"Mississippi","Calhoun County","NHPI_A",5,0,-5,-200,"undercount"
"5636",28013,"Mississippi","Calhoun County","NHPI_AIC",10,2,-8,-133.33,"undercount"
"5637",28015,"Mississippi","Carroll County","A_A",24,29,5,18.87,"overcount"
"5638",28015,"Mississippi","Carroll County","A_AIC",38,62,24,48,"overcount"
"5639",28015,"Mississippi","Carroll County","NHPI_A",2,0,-2,-200,"undercount"
"5640",28015,"Mississippi","Carroll County","NHPI_AIC",5,14,9,94.74,"overcount"
"5641",28017,"Mississippi","Chickasaw County","A_A",84,44,-40,-62.5,"undercount"
"5642",28017,"Mississippi","Chickasaw County","A_AIC",118,80,-38,-38.38,"undercount"
"5643",28017,"Mississippi","Chickasaw County","NHPI_A",9,0,-9,-200,"undercount"
"5644",28017,"Mississippi","Chickasaw County","NHPI_AIC",23,7,-16,-106.67,"undercount"
"5645",28019,"Mississippi","Choctaw County","A_A",34,6,-28,-140,"undercount"
"5646",28019,"Mississippi","Choctaw County","A_AIC",58,30,-28,-63.64,"undercount"
"5647",28019,"Mississippi","Choctaw County","NHPI_A",3,0,-3,-200,"undercount"
"5648",28019,"Mississippi","Choctaw County","NHPI_AIC",8,7,-1,-13.33,"undercount"
"5649",28021,"Mississippi","Claiborne County","A_A",67,0,-67,-200,"undercount"
"5650",28021,"Mississippi","Claiborne County","A_AIC",80,12,-68,-147.83,"undercount"
"5651",28021,"Mississippi","Claiborne County","NHPI_A",4,0,-4,-200,"undercount"
"5652",28021,"Mississippi","Claiborne County","NHPI_AIC",10,9,-1,-10.53,"undercount"
"5653",28023,"Mississippi","Clarke County","A_A",32,8,-24,-120,"undercount"
"5654",28023,"Mississippi","Clarke County","A_AIC",44,36,-8,-20,"undercount"
"5655",28023,"Mississippi","Clarke County","NHPI_A",1,6,5,142.86,"overcount"
"5656",28023,"Mississippi","Clarke County","NHPI_AIC",3,18,15,142.86,"overcount"
"5657",28025,"Mississippi","Clay County","A_A",82,57,-25,-35.97,"undercount"
"5658",28025,"Mississippi","Clay County","A_AIC",116,77,-39,-40.41,"undercount"
"5659",28025,"Mississippi","Clay County","NHPI_A",3,1,-2,-100,"undercount"
"5660",28025,"Mississippi","Clay County","NHPI_AIC",10,8,-2,-22.22,"undercount"
"5661",28027,"Mississippi","Coahoma County","A_A",95,112,17,16.43,"overcount"
"5662",28027,"Mississippi","Coahoma County","A_AIC",128,156,28,19.72,"overcount"
"5663",28027,"Mississippi","Coahoma County","NHPI_A",11,0,-11,-200,"undercount"
"5664",28027,"Mississippi","Coahoma County","NHPI_AIC",14,10,-4,-33.33,"undercount"
"5665",28029,"Mississippi","Copiah County","A_A",117,121,4,3.36,"overcount"
"5666",28029,"Mississippi","Copiah County","A_AIC",181,143,-38,-23.46,"undercount"
"5667",28029,"Mississippi","Copiah County","NHPI_A",9,24,15,90.91,"overcount"
"5668",28029,"Mississippi","Copiah County","NHPI_AIC",27,34,7,22.95,"overcount"
"5669",28031,"Mississippi","Covington County","A_A",90,85,-5,-5.71,"undercount"
"5670",28031,"Mississippi","Covington County","A_AIC",138,115,-23,-18.18,"undercount"
"5671",28031,"Mississippi","Covington County","NHPI_A",11,4,-7,-93.33,"undercount"
"5672",28031,"Mississippi","Covington County","NHPI_AIC",17,15,-2,-12.5,"undercount"
"5673",28033,"Mississippi","DeSoto County","A_A",3082,3051,-31,-1.01,"undercount"
"5674",28033,"Mississippi","DeSoto County","A_AIC",3923,4212,289,7.11,"overcount"
"5675",28033,"Mississippi","DeSoto County","NHPI_A",177,143,-34,-21.25,"undercount"
"5676",28033,"Mississippi","DeSoto County","NHPI_AIC",306,269,-37,-12.87,"undercount"
"5677",28035,"Mississippi","Forrest County","A_A",830,790,-40,-4.94,"undercount"
"5678",28035,"Mississippi","Forrest County","A_AIC",1072,1070,-2,-0.19,"undercount"
"5679",28035,"Mississippi","Forrest County","NHPI_A",50,29,-21,-53.16,"undercount"
"5680",28035,"Mississippi","Forrest County","NHPI_AIC",116,79,-37,-37.95,"undercount"
"5681",28037,"Mississippi","Franklin County","A_A",11,8,-3,-31.58,"undercount"
"5682",28037,"Mississippi","Franklin County","A_AIC",24,20,-4,-18.18,"undercount"
"5683",28037,"Mississippi","Franklin County","NHPI_A",2,0,-2,-200,"undercount"
"5684",28037,"Mississippi","Franklin County","NHPI_AIC",6,5,-1,-18.18,"undercount"
"5685",28039,"Mississippi","George County","A_A",162,77,-85,-71.13,"undercount"
"5686",28039,"Mississippi","George County","A_AIC",212,113,-99,-60.92,"undercount"
"5687",28039,"Mississippi","George County","NHPI_A",1,1,0,0,"equal"
"5688",28039,"Mississippi","George County","NHPI_AIC",10,11,1,9.52,"overcount"
"5689",28041,"Mississippi","Greene County","A_A",25,21,-4,-17.39,"undercount"
"5690",28041,"Mississippi","Greene County","A_AIC",40,42,2,4.88,"overcount"
"5691",28041,"Mississippi","Greene County","NHPI_A",1,3,2,100,"overcount"
"5692",28041,"Mississippi","Greene County","NHPI_AIC",5,9,4,57.14,"overcount"
"5693",28043,"Mississippi","Grenada County","A_A",104,84,-20,-21.28,"undercount"
"5694",28043,"Mississippi","Grenada County","A_AIC",135,130,-5,-3.77,"undercount"
"5695",28043,"Mississippi","Grenada County","NHPI_A",6,2,-4,-100,"undercount"
"5696",28043,"Mississippi","Grenada County","NHPI_AIC",17,9,-8,-61.54,"undercount"
"5697",28045,"Mississippi","Hancock County","A_A",455,435,-20,-4.49,"undercount"
"5698",28045,"Mississippi","Hancock County","A_AIC",679,686,7,1.03,"overcount"
"5699",28045,"Mississippi","Hancock County","NHPI_A",28,9,-19,-102.7,"undercount"
"5700",28045,"Mississippi","Hancock County","NHPI_AIC",60,54,-6,-10.53,"undercount"
"5701",28047,"Mississippi","Harrison County","A_A",5988,5999,11,0.18,"overcount"
"5702",28047,"Mississippi","Harrison County","A_AIC",8001,8263,262,3.22,"overcount"
"5703",28047,"Mississippi","Harrison County","NHPI_A",299,259,-40,-14.34,"undercount"
"5704",28047,"Mississippi","Harrison County","NHPI_AIC",652,576,-76,-12.38,"undercount"
"5705",28049,"Mississippi","Hinds County","A_A",1659,2196,537,27.86,"overcount"
"5706",28049,"Mississippi","Hinds County","A_AIC",2136,2706,570,23.54,"overcount"
"5707",28049,"Mississippi","Hinds County","NHPI_A",61,46,-15,-28.04,"undercount"
"5708",28049,"Mississippi","Hinds County","NHPI_AIC",183,117,-66,-44,"undercount"
"5709",28051,"Mississippi","Holmes County","A_A",40,20,-20,-66.67,"undercount"
"5710",28051,"Mississippi","Holmes County","A_AIC",59,32,-27,-59.34,"undercount"
"5711",28051,"Mississippi","Holmes County","NHPI_A",1,0,-1,-200,"undercount"
"5712",28051,"Mississippi","Holmes County","NHPI_AIC",7,4,-3,-54.55,"undercount"
"5713",28053,"Mississippi","Humphreys County","A_A",39,10,-29,-118.37,"undercount"
"5714",28053,"Mississippi","Humphreys County","A_AIC",54,22,-32,-84.21,"undercount"
"5715",28053,"Mississippi","Humphreys County","NHPI_A",5,0,-5,-200,"undercount"
"5716",28053,"Mississippi","Humphreys County","NHPI_AIC",12,8,-4,-40,"undercount"
"5717",28055,"Mississippi","Issaquena County","A_A",6,5,-1,-18.18,"undercount"
"5718",28055,"Mississippi","Issaquena County","A_AIC",8,8,0,0,"equal"
"5719",28055,"Mississippi","Issaquena County","NHPI_A",1,0,-1,-200,"undercount"
"5720",28055,"Mississippi","Issaquena County","NHPI_AIC",1,2,1,66.67,"overcount"
"5721",28057,"Mississippi","Itawamba County","A_A",120,50,-70,-82.35,"undercount"
"5722",28057,"Mississippi","Itawamba County","A_AIC",140,79,-61,-55.71,"undercount"
"5723",28057,"Mississippi","Itawamba County","NHPI_A",4,0,-4,-200,"undercount"
"5724",28057,"Mississippi","Itawamba County","NHPI_AIC",10,9,-1,-10.53,"undercount"
"5725",28059,"Mississippi","Jackson County","A_A",3339,3206,-133,-4.06,"undercount"
"5726",28059,"Mississippi","Jackson County","A_AIC",4350,4367,17,0.39,"overcount"
"5727",28059,"Mississippi","Jackson County","NHPI_A",150,91,-59,-48.96,"undercount"
"5728",28059,"Mississippi","Jackson County","NHPI_AIC",289,232,-57,-21.88,"undercount"
"5729",28061,"Mississippi","Jasper County","A_A",24,8,-16,-100,"undercount"
"5730",28061,"Mississippi","Jasper County","A_AIC",43,35,-8,-20.51,"undercount"
"5731",28061,"Mississippi","Jasper County","NHPI_A",11,1,-10,-166.67,"undercount"
"5732",28061,"Mississippi","Jasper County","NHPI_AIC",12,6,-6,-66.67,"undercount"
"5733",28063,"Mississippi","Jefferson County","A_A",12,14,2,15.38,"overcount"
"5734",28063,"Mississippi","Jefferson County","A_AIC",25,27,2,7.69,"overcount"
"5735",28063,"Mississippi","Jefferson County","NHPI_A",2,5,3,85.71,"overcount"
"5736",28063,"Mississippi","Jefferson County","NHPI_AIC",4,11,7,93.33,"overcount"
"5737",28065,"Mississippi","Jefferson Davis County","A_A",33,21,-12,-44.44,"undercount"
"5738",28065,"Mississippi","Jefferson Davis County","A_AIC",45,32,-13,-33.77,"undercount"
"5739",28065,"Mississippi","Jefferson Davis County","NHPI_A",7,0,-7,-200,"undercount"
"5740",28065,"Mississippi","Jefferson Davis County","NHPI_AIC",12,6,-6,-66.67,"undercount"
"5741",28067,"Mississippi","Jones County","A_A",325,280,-45,-14.88,"undercount"
"5742",28067,"Mississippi","Jones County","A_AIC",456,437,-19,-4.26,"undercount"
"5743",28067,"Mississippi","Jones County","NHPI_A",32,25,-7,-24.56,"undercount"
"5744",28067,"Mississippi","Jones County","NHPI_AIC",66,39,-27,-51.43,"undercount"
"5745",28069,"Mississippi","Kemper County","A_A",19,6,-13,-104,"undercount"
"5746",28069,"Mississippi","Kemper County","A_AIC",30,9,-21,-107.69,"undercount"
"5747",28069,"Mississippi","Kemper County","NHPI_A",0,1,1,200,"overcount"
"5748",28069,"Mississippi","Kemper County","NHPI_AIC",2,5,3,85.71,"overcount"
"5749",28071,"Mississippi","Lafayette County","A_A",1283,1700,417,27.96,"overcount"
"5750",28071,"Mississippi","Lafayette County","A_AIC",1545,2090,545,29.99,"overcount"
"5751",28071,"Mississippi","Lafayette County","NHPI_A",45,24,-21,-60.87,"undercount"
"5752",28071,"Mississippi","Lafayette County","NHPI_AIC",74,54,-20,-31.25,"undercount"
"5753",28073,"Mississippi","Lamar County","A_A",936,1103,167,16.38,"overcount"
"5754",28073,"Mississippi","Lamar County","A_AIC",1123,1468,345,26.63,"overcount"
"5755",28073,"Mississippi","Lamar County","NHPI_A",54,50,-4,-7.69,"undercount"
"5756",28073,"Mississippi","Lamar County","NHPI_AIC",79,101,22,24.44,"overcount"
"5757",28075,"Mississippi","Lauderdale County","A_A",597,610,13,2.15,"overcount"
"5758",28075,"Mississippi","Lauderdale County","A_AIC",795,832,37,4.55,"overcount"
"5759",28075,"Mississippi","Lauderdale County","NHPI_A",42,28,-14,-40,"undercount"
"5760",28075,"Mississippi","Lauderdale County","NHPI_AIC",90,72,-18,-22.22,"undercount"
"5761",28077,"Mississippi","Lawrence County","A_A",59,33,-26,-56.52,"undercount"
"5762",28077,"Mississippi","Lawrence County","A_AIC",78,57,-21,-31.11,"undercount"
"5763",28077,"Mississippi","Lawrence County","NHPI_A",2,5,3,85.71,"overcount"
"5764",28077,"Mississippi","Lawrence County","NHPI_AIC",4,7,3,54.55,"overcount"
"5765",28079,"Mississippi","Leake County","A_A",115,78,-37,-38.34,"undercount"
"5766",28079,"Mississippi","Leake County","A_AIC",167,89,-78,-60.94,"undercount"
"5767",28079,"Mississippi","Leake County","NHPI_A",8,5,-3,-46.15,"undercount"
"5768",28079,"Mississippi","Leake County","NHPI_AIC",21,24,3,13.33,"overcount"
"5769",28081,"Mississippi","Lee County","A_A",821,931,110,12.56,"overcount"
"5770",28081,"Mississippi","Lee County","A_AIC",1021,1169,148,13.52,"overcount"
"5771",28081,"Mississippi","Lee County","NHPI_A",27,25,-2,-7.69,"undercount"
"5772",28081,"Mississippi","Lee County","NHPI_AIC",74,48,-26,-42.62,"undercount"
"5773",28083,"Mississippi","Leflore County","A_A",160,205,45,24.66,"overcount"
"5774",28083,"Mississippi","Leflore County","A_AIC",185,245,60,27.91,"overcount"
"5775",28083,"Mississippi","Leflore County","NHPI_A",3,0,-3,-200,"undercount"
"5776",28083,"Mississippi","Leflore County","NHPI_AIC",11,10,-1,-9.52,"undercount"
"5777",28085,"Mississippi","Lincoln County","A_A",161,163,2,1.23,"overcount"
"5778",28085,"Mississippi","Lincoln County","A_AIC",219,241,22,9.57,"overcount"
"5779",28085,"Mississippi","Lincoln County","NHPI_A",18,8,-10,-76.92,"undercount"
"5780",28085,"Mississippi","Lincoln County","NHPI_AIC",39,29,-10,-29.41,"undercount"
"5781",28087,"Mississippi","Lowndes County","A_A",580,517,-63,-11.49,"undercount"
"5782",28087,"Mississippi","Lowndes County","A_AIC",767,798,31,3.96,"overcount"
"5783",28087,"Mississippi","Lowndes County","NHPI_A",34,17,-17,-66.67,"undercount"
"5784",28087,"Mississippi","Lowndes County","NHPI_AIC",90,55,-35,-48.28,"undercount"
"5785",28089,"Mississippi","Madison County","A_A",3062,3199,137,4.38,"overcount"
"5786",28089,"Mississippi","Madison County","A_AIC",3427,3729,302,8.44,"overcount"
"5787",28089,"Mississippi","Madison County","NHPI_A",93,14,-79,-147.66,"undercount"
"5788",28089,"Mississippi","Madison County","NHPI_AIC",183,44,-139,-122.47,"undercount"
"5789",28091,"Mississippi","Marion County","A_A",100,69,-31,-36.69,"undercount"
"5790",28091,"Mississippi","Marion County","A_AIC",170,134,-36,-23.68,"undercount"
"5791",28091,"Mississippi","Marion County","NHPI_A",10,0,-10,-200,"undercount"
"5792",28091,"Mississippi","Marion County","NHPI_AIC",30,14,-16,-72.73,"undercount"
"5793",28093,"Mississippi","Marshall County","A_A",101,74,-27,-30.86,"undercount"
"5794",28093,"Mississippi","Marshall County","A_AIC",179,137,-42,-26.58,"undercount"
"5795",28093,"Mississippi","Marshall County","NHPI_A",21,20,-1,-4.88,"undercount"
"5796",28093,"Mississippi","Marshall County","NHPI_AIC",48,56,8,15.38,"overcount"
"5797",28095,"Mississippi","Monroe County","A_A",113,67,-46,-51.11,"undercount"
"5798",28095,"Mississippi","Monroe County","A_AIC",170,119,-51,-35.29,"undercount"
"5799",28095,"Mississippi","Monroe County","NHPI_A",7,3,-4,-80,"undercount"
"5800",28095,"Mississippi","Monroe County","NHPI_AIC",24,11,-13,-74.29,"undercount"
"5801",28097,"Mississippi","Montgomery County","A_A",63,24,-39,-89.66,"undercount"
"5802",28097,"Mississippi","Montgomery County","A_AIC",80,53,-27,-40.6,"undercount"
"5803",28097,"Mississippi","Montgomery County","NHPI_A",2,0,-2,-200,"undercount"
"5804",28097,"Mississippi","Montgomery County","NHPI_AIC",5,12,7,82.35,"overcount"
"5805",28099,"Mississippi","Neshoba County","A_A",141,122,-19,-14.45,"undercount"
"5806",28099,"Mississippi","Neshoba County","A_AIC",234,161,-73,-36.96,"undercount"
"5807",28099,"Mississippi","Neshoba County","NHPI_A",14,0,-14,-200,"undercount"
"5808",28099,"Mississippi","Neshoba County","NHPI_AIC",42,10,-32,-123.08,"undercount"
"5809",28101,"Mississippi","Newton County","A_A",106,85,-21,-21.99,"undercount"
"5810",28101,"Mississippi","Newton County","A_AIC",154,112,-42,-31.58,"undercount"
"5811",28101,"Mississippi","Newton County","NHPI_A",8,3,-5,-90.91,"undercount"
"5812",28101,"Mississippi","Newton County","NHPI_AIC",17,7,-10,-83.33,"undercount"
"5813",28103,"Mississippi","Noxubee County","A_A",25,14,-11,-56.41,"undercount"
"5814",28103,"Mississippi","Noxubee County","A_AIC",42,23,-19,-58.46,"undercount"
"5815",28103,"Mississippi","Noxubee County","NHPI_A",3,5,2,50,"overcount"
"5816",28103,"Mississippi","Noxubee County","NHPI_AIC",4,10,6,85.71,"overcount"
"5817",28105,"Mississippi","Oktibbeha County","A_A",1548,1544,-4,-0.26,"undercount"
"5818",28105,"Mississippi","Oktibbeha County","A_AIC",1765,1787,22,1.24,"overcount"
"5819",28105,"Mississippi","Oktibbeha County","NHPI_A",43,25,-18,-52.94,"undercount"
"5820",28105,"Mississippi","Oktibbeha County","NHPI_AIC",84,44,-40,-62.5,"undercount"
"5821",28107,"Mississippi","Panola County","A_A",73,62,-11,-16.3,"undercount"
"5822",28107,"Mississippi","Panola County","A_AIC",171,111,-60,-42.55,"undercount"
"5823",28107,"Mississippi","Panola County","NHPI_A",3,4,1,28.57,"overcount"
"5824",28107,"Mississippi","Panola County","NHPI_AIC",28,19,-9,-38.3,"undercount"
"5825",28109,"Mississippi","Pearl River County","A_A",249,278,29,11.01,"overcount"
"5826",28109,"Mississippi","Pearl River County","A_AIC",481,493,12,2.46,"overcount"
"5827",28109,"Mississippi","Pearl River County","NHPI_A",51,0,-51,-200,"undercount"
"5828",28109,"Mississippi","Pearl River County","NHPI_AIC",102,30,-72,-109.09,"undercount"
"5829",28111,"Mississippi","Perry County","A_A",22,29,7,27.45,"overcount"
"5830",28111,"Mississippi","Perry County","A_AIC",45,65,20,36.36,"overcount"
"5831",28111,"Mississippi","Perry County","NHPI_A",10,3,-7,-107.69,"undercount"
"5832",28111,"Mississippi","Perry County","NHPI_AIC",14,19,5,30.3,"overcount"
"5833",28113,"Mississippi","Pike County","A_A",275,268,-7,-2.58,"undercount"
"5834",28113,"Mississippi","Pike County","A_AIC",339,332,-7,-2.09,"undercount"
"5835",28113,"Mississippi","Pike County","NHPI_A",17,7,-10,-83.33,"undercount"
"5836",28113,"Mississippi","Pike County","NHPI_AIC",40,27,-13,-38.81,"undercount"
"5837",28115,"Mississippi","Pontotoc County","A_A",133,55,-78,-82.98,"undercount"
"5838",28115,"Mississippi","Pontotoc County","A_AIC",200,110,-90,-58.06,"undercount"
"5839",28115,"Mississippi","Pontotoc County","NHPI_A",18,5,-13,-113.04,"undercount"
"5840",28115,"Mississippi","Pontotoc County","NHPI_AIC",39,17,-22,-78.57,"undercount"
"5841",28117,"Mississippi","Prentiss County","A_A",78,86,8,9.76,"overcount"
"5842",28117,"Mississippi","Prentiss County","A_AIC",123,113,-10,-8.47,"undercount"
"5843",28117,"Mississippi","Prentiss County","NHPI_A",7,9,2,25,"overcount"
"5844",28117,"Mississippi","Prentiss County","NHPI_AIC",21,12,-9,-54.55,"undercount"
"5845",28119,"Mississippi","Quitman County","A_A",14,12,-2,-15.38,"undercount"
"5846",28119,"Mississippi","Quitman County","A_AIC",33,20,-13,-49.06,"undercount"
"5847",28119,"Mississippi","Quitman County","NHPI_A",3,3,0,0,"equal"
"5848",28119,"Mississippi","Quitman County","NHPI_AIC",6,4,-2,-40,"undercount"
"5849",28121,"Mississippi","Rankin County","A_A",2146,2274,128,5.79,"overcount"
"5850",28121,"Mississippi","Rankin County","A_AIC",2643,2917,274,9.86,"overcount"
"5851",28121,"Mississippi","Rankin County","NHPI_A",134,94,-40,-35.09,"undercount"
"5852",28121,"Mississippi","Rankin County","NHPI_AIC",241,143,-98,-51.04,"undercount"
"5853",28123,"Mississippi","Scott County","A_A",152,103,-49,-38.43,"undercount"
"5854",28123,"Mississippi","Scott County","A_AIC",215,150,-65,-35.62,"undercount"
"5855",28123,"Mississippi","Scott County","NHPI_A",108,0,-108,-200,"undercount"
"5856",28123,"Mississippi","Scott County","NHPI_AIC",128,12,-116,-165.71,"undercount"
"5857",28125,"Mississippi","Sharkey County","A_A",34,14,-20,-83.33,"undercount"
"5858",28125,"Mississippi","Sharkey County","A_AIC",40,21,-19,-62.3,"undercount"
"5859",28125,"Mississippi","Sharkey County","NHPI_A",0,3,3,200,"overcount"
"5860",28125,"Mississippi","Sharkey County","NHPI_AIC",0,5,5,200,"overcount"
"5861",28127,"Mississippi","Simpson County","A_A",154,92,-62,-50.41,"undercount"
"5862",28127,"Mississippi","Simpson County","A_AIC",213,148,-65,-36.01,"undercount"
"5863",28127,"Mississippi","Simpson County","NHPI_A",40,2,-38,-180.95,"undercount"
"5864",28127,"Mississippi","Simpson County","NHPI_AIC",59,16,-43,-114.67,"undercount"
"5865",28129,"Mississippi","Smith County","A_A",28,21,-7,-28.57,"undercount"
"5866",28129,"Mississippi","Smith County","A_AIC",45,38,-7,-16.87,"undercount"
"5867",28129,"Mississippi","Smith County","NHPI_A",3,0,-3,-200,"undercount"
"5868",28129,"Mississippi","Smith County","NHPI_AIC",9,4,-5,-76.92,"undercount"
"5869",28131,"Mississippi","Stone County","A_A",80,89,9,10.65,"overcount"
"5870",28131,"Mississippi","Stone County","A_AIC",161,161,0,0,"equal"
"5871",28131,"Mississippi","Stone County","NHPI_A",13,10,-3,-26.09,"undercount"
"5872",28131,"Mississippi","Stone County","NHPI_AIC",26,19,-7,-31.11,"undercount"
"5873",28133,"Mississippi","Sunflower County","A_A",112,92,-20,-19.61,"undercount"
"5874",28133,"Mississippi","Sunflower County","A_AIC",131,118,-13,-10.44,"undercount"
"5875",28133,"Mississippi","Sunflower County","NHPI_A",10,0,-10,-200,"undercount"
"5876",28133,"Mississippi","Sunflower County","NHPI_AIC",21,22,1,4.65,"overcount"
"5877",28135,"Mississippi","Tallahatchie County","A_A",149,10,-139,-174.84,"undercount"
"5878",28135,"Mississippi","Tallahatchie County","A_AIC",188,14,-174,-172.28,"undercount"
"5879",28135,"Mississippi","Tallahatchie County","NHPI_A",14,3,-11,-129.41,"undercount"
"5880",28135,"Mississippi","Tallahatchie County","NHPI_AIC",26,14,-12,-60,"undercount"
"5881",28137,"Mississippi","Tate County","A_A",93,63,-30,-38.46,"undercount"
"5882",28137,"Mississippi","Tate County","A_AIC",179,107,-72,-50.35,"undercount"
"5883",28137,"Mississippi","Tate County","NHPI_A",12,1,-11,-169.23,"undercount"
"5884",28137,"Mississippi","Tate County","NHPI_AIC",43,32,-11,-29.33,"undercount"
"5885",28139,"Mississippi","Tippah County","A_A",66,24,-42,-93.33,"undercount"
"5886",28139,"Mississippi","Tippah County","A_AIC",96,51,-45,-61.22,"undercount"
"5887",28139,"Mississippi","Tippah County","NHPI_A",6,0,-6,-200,"undercount"
"5888",28139,"Mississippi","Tippah County","NHPI_AIC",12,5,-7,-82.35,"undercount"
"5889",28141,"Mississippi","Tishomingo County","A_A",47,42,-5,-11.24,"undercount"
"5890",28141,"Mississippi","Tishomingo County","A_AIC",67,73,6,8.57,"overcount"
"5891",28141,"Mississippi","Tishomingo County","NHPI_A",5,0,-5,-200,"undercount"
"5892",28141,"Mississippi","Tishomingo County","NHPI_AIC",16,11,-5,-37.04,"undercount"
"5893",28143,"Mississippi","Tunica County","A_A",77,27,-50,-96.15,"undercount"
"5894",28143,"Mississippi","Tunica County","A_AIC",100,45,-55,-75.86,"undercount"
"5895",28143,"Mississippi","Tunica County","NHPI_A",12,0,-12,-200,"undercount"
"5896",28143,"Mississippi","Tunica County","NHPI_AIC",19,3,-16,-145.45,"undercount"
"5897",28145,"Mississippi","Union County","A_A",301,109,-192,-93.66,"undercount"
"5898",28145,"Mississippi","Union County","A_AIC",401,157,-244,-87.46,"undercount"
"5899",28145,"Mississippi","Union County","NHPI_A",17,0,-17,-200,"undercount"
"5900",28145,"Mississippi","Union County","NHPI_AIC",49,7,-42,-150,"undercount"
"5901",28147,"Mississippi","Walthall County","A_A",73,48,-25,-41.32,"undercount"
"5902",28147,"Mississippi","Walthall County","A_AIC",113,55,-58,-69.05,"undercount"
"5903",28147,"Mississippi","Walthall County","NHPI_A",15,8,-7,-60.87,"undercount"
"5904",28147,"Mississippi","Walthall County","NHPI_AIC",32,19,-13,-50.98,"undercount"
"5905",28149,"Mississippi","Warren County","A_A",366,379,13,3.49,"overcount"
"5906",28149,"Mississippi","Warren County","A_AIC",474,561,87,16.81,"overcount"
"5907",28149,"Mississippi","Warren County","NHPI_A",13,0,-13,-200,"undercount"
"5908",28149,"Mississippi","Warren County","NHPI_AIC",46,4,-42,-168,"undercount"
"5909",28151,"Mississippi","Washington County","A_A",337,302,-35,-10.95,"undercount"
"5910",28151,"Mississippi","Washington County","A_AIC",406,355,-51,-13.4,"undercount"
"5911",28151,"Mississippi","Washington County","NHPI_A",23,5,-18,-128.57,"undercount"
"5912",28151,"Mississippi","Washington County","NHPI_AIC",44,26,-18,-51.43,"undercount"
"5913",28153,"Mississippi","Wayne County","A_A",50,35,-15,-35.29,"undercount"
"5914",28153,"Mississippi","Wayne County","A_AIC",90,53,-37,-51.75,"undercount"
"5915",28153,"Mississippi","Wayne County","NHPI_A",7,4,-3,-54.55,"undercount"
"5916",28153,"Mississippi","Wayne County","NHPI_AIC",17,8,-9,-72,"undercount"
"5917",28155,"Mississippi","Webster County","A_A",17,13,-4,-26.67,"undercount"
"5918",28155,"Mississippi","Webster County","A_AIC",33,31,-2,-6.25,"undercount"
"5919",28155,"Mississippi","Webster County","NHPI_A",1,1,0,0,"equal"
"5920",28155,"Mississippi","Webster County","NHPI_AIC",2,3,1,40,"overcount"
"5921",28157,"Mississippi","Wilkinson County","A_A",10,8,-2,-22.22,"undercount"
"5922",28157,"Mississippi","Wilkinson County","A_AIC",23,31,8,29.63,"overcount"
"5923",28157,"Mississippi","Wilkinson County","NHPI_A",2,0,-2,-200,"undercount"
"5924",28157,"Mississippi","Wilkinson County","NHPI_AIC",5,0,-5,-200,"undercount"
"5925",28159,"Mississippi","Winston County","A_A",61,39,-22,-44,"undercount"
"5926",28159,"Mississippi","Winston County","A_AIC",79,64,-15,-20.98,"undercount"
"5927",28159,"Mississippi","Winston County","NHPI_A",9,1,-8,-160,"undercount"
"5928",28159,"Mississippi","Winston County","NHPI_AIC",14,6,-8,-80,"undercount"
"5929",28161,"Mississippi","Yalobusha County","A_A",29,21,-8,-32,"undercount"
"5930",28161,"Mississippi","Yalobusha County","A_AIC",50,55,5,9.52,"overcount"
"5931",28161,"Mississippi","Yalobusha County","NHPI_A",1,2,1,66.67,"overcount"
"5932",28161,"Mississippi","Yalobusha County","NHPI_AIC",8,13,5,47.62,"overcount"
"5933",28163,"Mississippi","Yazoo County","A_A",154,116,-38,-28.15,"undercount"
"5934",28163,"Mississippi","Yazoo County","A_AIC",213,165,-48,-25.4,"undercount"
"5935",28163,"Mississippi","Yazoo County","NHPI_A",15,6,-9,-85.71,"undercount"
"5936",28163,"Mississippi","Yazoo County","NHPI_AIC",39,20,-19,-64.41,"undercount"
"5937",29001,"Missouri","Adair County","A_A",699,685,-14,-2.02,"undercount"
"5938",29001,"Missouri","Adair County","A_AIC",851,881,30,3.46,"overcount"
"5939",29001,"Missouri","Adair County","NHPI_A",18,13,-5,-32.26,"undercount"
"5940",29001,"Missouri","Adair County","NHPI_AIC",39,33,-6,-16.67,"undercount"
"5941",29003,"Missouri","Andrew County","A_A",123,89,-34,-32.08,"undercount"
"5942",29003,"Missouri","Andrew County","A_AIC",162,135,-27,-18.18,"undercount"
"5943",29003,"Missouri","Andrew County","NHPI_A",10,0,-10,-200,"undercount"
"5944",29003,"Missouri","Andrew County","NHPI_AIC",18,11,-7,-48.28,"undercount"
"5945",29005,"Missouri","Atchison County","A_A",18,12,-6,-40,"undercount"
"5946",29005,"Missouri","Atchison County","A_AIC",26,38,12,37.5,"overcount"
"5947",29005,"Missouri","Atchison County","NHPI_A",3,0,-3,-200,"undercount"
"5948",29005,"Missouri","Atchison County","NHPI_AIC",6,4,-2,-40,"undercount"
"5949",29007,"Missouri","Audrain County","A_A",144,114,-30,-23.26,"undercount"
"5950",29007,"Missouri","Audrain County","A_AIC",231,208,-23,-10.48,"undercount"
"5951",29007,"Missouri","Audrain County","NHPI_A",30,2,-28,-175,"undercount"
"5952",29007,"Missouri","Audrain County","NHPI_AIC",46,31,-15,-38.96,"undercount"
"5953",29009,"Missouri","Barry County","A_A",877,808,-69,-8.19,"undercount"
"5954",29009,"Missouri","Barry County","A_AIC",958,926,-32,-3.4,"undercount"
"5955",29009,"Missouri","Barry County","NHPI_A",67,71,4,5.8,"overcount"
"5956",29009,"Missouri","Barry County","NHPI_AIC",91,94,3,3.24,"overcount"
"5957",29011,"Missouri","Barton County","A_A",74,42,-32,-55.17,"undercount"
"5958",29011,"Missouri","Barton County","A_AIC",111,80,-31,-32.46,"undercount"
"5959",29011,"Missouri","Barton County","NHPI_A",7,2,-5,-111.11,"undercount"
"5960",29011,"Missouri","Barton County","NHPI_AIC",13,4,-9,-105.88,"undercount"
"5961",29013,"Missouri","Bates County","A_A",52,50,-2,-3.92,"undercount"
"5962",29013,"Missouri","Bates County","A_AIC",95,88,-7,-7.65,"undercount"
"5963",29013,"Missouri","Bates County","NHPI_A",10,9,-1,-10.53,"undercount"
"5964",29013,"Missouri","Bates County","NHPI_AIC",18,25,7,32.56,"overcount"
"5965",29015,"Missouri","Benton County","A_A",95,51,-44,-60.27,"undercount"
"5966",29015,"Missouri","Benton County","A_AIC",155,111,-44,-33.08,"undercount"
"5967",29015,"Missouri","Benton County","NHPI_A",16,0,-16,-200,"undercount"
"5968",29015,"Missouri","Benton County","NHPI_AIC",24,10,-14,-82.35,"undercount"
"5969",29017,"Missouri","Bollinger County","A_A",28,20,-8,-33.33,"undercount"
"5970",29017,"Missouri","Bollinger County","A_AIC",63,26,-37,-83.15,"undercount"
"5971",29017,"Missouri","Bollinger County","NHPI_A",3,3,0,0,"equal"
"5972",29017,"Missouri","Bollinger County","NHPI_AIC",9,5,-4,-57.14,"undercount"
"5973",29019,"Missouri","Boone County","A_A",9176,7838,-1338,-15.73,"undercount"
"5974",29019,"Missouri","Boone County","A_AIC",10824,9744,-1080,-10.5,"undercount"
"5975",29019,"Missouri","Boone County","NHPI_A",176,122,-54,-36.24,"undercount"
"5976",29019,"Missouri","Boone County","NHPI_AIC",376,345,-31,-8.6,"undercount"
"5977",29021,"Missouri","Buchanan County","A_A",1444,1051,-393,-31.5,"undercount"
"5978",29021,"Missouri","Buchanan County","A_AIC",1790,1477,-313,-19.16,"undercount"
"5979",29021,"Missouri","Buchanan County","NHPI_A",445,428,-17,-3.89,"undercount"
"5980",29021,"Missouri","Buchanan County","NHPI_AIC",540,572,32,5.76,"overcount"
"5981",29023,"Missouri","Butler County","A_A",415,310,-105,-28.97,"undercount"
"5982",29023,"Missouri","Butler County","A_AIC",554,465,-89,-17.47,"undercount"
"5983",29023,"Missouri","Butler County","NHPI_A",17,14,-3,-19.35,"undercount"
"5984",29023,"Missouri","Butler County","NHPI_AIC",45,31,-14,-36.84,"undercount"
"5985",29025,"Missouri","Caldwell County","A_A",33,28,-5,-16.39,"undercount"
"5986",29025,"Missouri","Caldwell County","A_AIC",74,78,4,5.26,"overcount"
"5987",29025,"Missouri","Caldwell County","NHPI_A",10,7,-3,-35.29,"undercount"
"5988",29025,"Missouri","Caldwell County","NHPI_AIC",16,23,7,35.9,"overcount"
"5989",29027,"Missouri","Callaway County","A_A",368,222,-146,-49.49,"undercount"
"5990",29027,"Missouri","Callaway County","A_AIC",507,442,-65,-13.7,"undercount"
"5991",29027,"Missouri","Callaway County","NHPI_A",29,30,1,3.39,"overcount"
"5992",29027,"Missouri","Callaway County","NHPI_AIC",70,70,0,0,"equal"
"5993",29029,"Missouri","Camden County","A_A",309,222,-87,-32.77,"undercount"
"5994",29029,"Missouri","Camden County","A_AIC",470,390,-80,-18.6,"undercount"
"5995",29029,"Missouri","Camden County","NHPI_A",26,40,14,42.42,"overcount"
"5996",29029,"Missouri","Camden County","NHPI_AIC",45,75,30,50,"overcount"
"5997",29031,"Missouri","Cape Girardeau County","A_A",1548,1313,-235,-16.43,"undercount"
"5998",29031,"Missouri","Cape Girardeau County","A_AIC",1898,1731,-167,-9.2,"undercount"
"5999",29031,"Missouri","Cape Girardeau County","NHPI_A",36,14,-22,-88,"undercount"
"6000",29031,"Missouri","Cape Girardeau County","NHPI_AIC",96,51,-45,-61.22,"undercount"
"6001",29033,"Missouri","Carroll County","A_A",17,15,-2,-12.5,"undercount"
"6002",29033,"Missouri","Carroll County","A_AIC",36,36,0,0,"equal"
"6003",29033,"Missouri","Carroll County","NHPI_A",10,0,-10,-200,"undercount"
"6004",29033,"Missouri","Carroll County","NHPI_AIC",12,1,-11,-169.23,"undercount"
"6005",29035,"Missouri","Carter County","A_A",9,18,9,66.67,"overcount"
"6006",29035,"Missouri","Carter County","A_AIC",26,28,2,7.41,"overcount"
"6007",29035,"Missouri","Carter County","NHPI_A",1,1,0,0,"equal"
"6008",29035,"Missouri","Carter County","NHPI_AIC",3,3,0,0,"equal"
"6009",29037,"Missouri","Cass County","A_A",902,868,-34,-3.84,"undercount"
"6010",29037,"Missouri","Cass County","A_AIC",1614,1587,-27,-1.69,"undercount"
"6011",29037,"Missouri","Cass County","NHPI_A",129,78,-51,-49.28,"undercount"
"6012",29037,"Missouri","Cass County","NHPI_AIC",229,214,-15,-6.77,"undercount"
"6013",29039,"Missouri","Cedar County","A_A",64,44,-20,-37.04,"undercount"
"6014",29039,"Missouri","Cedar County","A_AIC",103,109,6,5.66,"overcount"
"6015",29039,"Missouri","Cedar County","NHPI_A",9,7,-2,-25,"undercount"
"6016",29039,"Missouri","Cedar County","NHPI_AIC",15,20,5,28.57,"overcount"
"6017",29041,"Missouri","Chariton County","A_A",18,3,-15,-142.86,"undercount"
"6018",29041,"Missouri","Chariton County","A_AIC",33,24,-9,-31.58,"undercount"
"6019",29041,"Missouri","Chariton County","NHPI_A",0,3,3,200,"overcount"
"6020",29041,"Missouri","Chariton County","NHPI_AIC",0,15,15,200,"overcount"
"6021",29043,"Missouri","Christian County","A_A",627,635,8,1.27,"overcount"
"6022",29043,"Missouri","Christian County","A_AIC",1101,1212,111,9.6,"overcount"
"6023",29043,"Missouri","Christian County","NHPI_A",46,71,25,42.74,"overcount"
"6024",29043,"Missouri","Christian County","NHPI_AIC",124,176,52,34.67,"overcount"
"6025",29045,"Missouri","Clark County","A_A",28,12,-16,-80,"undercount"
"6026",29045,"Missouri","Clark County","A_AIC",45,29,-16,-43.24,"undercount"
"6027",29045,"Missouri","Clark County","NHPI_A",1,0,-1,-200,"undercount"
"6028",29045,"Missouri","Clark County","NHPI_AIC",1,9,8,160,"overcount"
"6029",29047,"Missouri","Clay County","A_A",6446,6140,-306,-4.86,"undercount"
"6030",29047,"Missouri","Clay County","A_AIC",8564,8451,-113,-1.33,"undercount"
"6031",29047,"Missouri","Clay County","NHPI_A",971,1004,33,3.34,"overcount"
"6032",29047,"Missouri","Clay County","NHPI_AIC",1378,1407,29,2.08,"overcount"
"6033",29049,"Missouri","Clinton County","A_A",101,85,-16,-17.2,"undercount"
"6034",29049,"Missouri","Clinton County","A_AIC",171,173,2,1.16,"overcount"
"6035",29049,"Missouri","Clinton County","NHPI_A",15,5,-10,-100,"undercount"
"6036",29049,"Missouri","Clinton County","NHPI_AIC",36,6,-30,-142.86,"undercount"
"6037",29051,"Missouri","Cole County","A_A",1075,971,-104,-10.17,"undercount"
"6038",29051,"Missouri","Cole County","A_AIC",1408,1422,14,0.99,"overcount"
"6039",29051,"Missouri","Cole County","NHPI_A",65,56,-9,-14.88,"undercount"
"6040",29051,"Missouri","Cole County","NHPI_AIC",167,139,-28,-18.3,"undercount"
"6041",29053,"Missouri","Cooper County","A_A",115,68,-47,-51.37,"undercount"
"6042",29053,"Missouri","Cooper County","A_AIC",173,150,-23,-14.24,"undercount"
"6043",29053,"Missouri","Cooper County","NHPI_A",14,10,-4,-33.33,"undercount"
"6044",29053,"Missouri","Cooper County","NHPI_AIC",32,32,0,0,"equal"
"6045",29055,"Missouri","Crawford County","A_A",70,81,11,14.57,"overcount"
"6046",29055,"Missouri","Crawford County","A_AIC",126,161,35,24.39,"overcount"
"6047",29055,"Missouri","Crawford County","NHPI_A",23,14,-9,-48.65,"undercount"
"6048",29055,"Missouri","Crawford County","NHPI_AIC",38,34,-4,-11.11,"undercount"
"6049",29057,"Missouri","Dade County","A_A",40,24,-16,-50,"undercount"
"6050",29057,"Missouri","Dade County","A_AIC",64,48,-16,-28.57,"undercount"
"6051",29057,"Missouri","Dade County","NHPI_A",3,0,-3,-200,"undercount"
"6052",29057,"Missouri","Dade County","NHPI_AIC",6,1,-5,-142.86,"undercount"
"6053",29059,"Missouri","Dallas County","A_A",77,29,-48,-90.57,"undercount"
"6054",29059,"Missouri","Dallas County","A_AIC",122,62,-60,-65.22,"undercount"
"6055",29059,"Missouri","Dallas County","NHPI_A",18,22,4,20,"overcount"
"6056",29059,"Missouri","Dallas County","NHPI_AIC",28,32,4,13.33,"overcount"
"6057",29061,"Missouri","Daviess County","A_A",15,21,6,33.33,"overcount"
"6058",29061,"Missouri","Daviess County","A_AIC",43,40,-3,-7.23,"undercount"
"6059",29061,"Missouri","Daviess County","NHPI_A",3,10,7,107.69,"overcount"
"6060",29061,"Missouri","Daviess County","NHPI_AIC",13,19,6,37.5,"overcount"
"6061",29063,"Missouri","DeKalb County","A_A",53,45,-8,-16.33,"undercount"
"6062",29063,"Missouri","DeKalb County","A_AIC",77,76,-1,-1.31,"undercount"
"6063",29063,"Missouri","DeKalb County","NHPI_A",9,2,-7,-127.27,"undercount"
"6064",29063,"Missouri","DeKalb County","NHPI_AIC",19,19,0,0,"equal"
"6065",29065,"Missouri","Dent County","A_A",128,54,-74,-81.32,"undercount"
"6066",29065,"Missouri","Dent County","A_AIC",172,92,-80,-60.61,"undercount"
"6067",29065,"Missouri","Dent County","NHPI_A",9,7,-2,-25,"undercount"
"6068",29065,"Missouri","Dent County","NHPI_AIC",26,20,-6,-26.09,"undercount"
"6069",29067,"Missouri","Douglas County","A_A",55,24,-31,-78.48,"undercount"
"6070",29067,"Missouri","Douglas County","A_AIC",94,37,-57,-87.02,"undercount"
"6071",29067,"Missouri","Douglas County","NHPI_A",3,0,-3,-200,"undercount"
"6072",29067,"Missouri","Douglas County","NHPI_AIC",15,11,-4,-30.77,"undercount"
"6073",29069,"Missouri","Dunklin County","A_A",262,78,-184,-108.24,"undercount"
"6074",29069,"Missouri","Dunklin County","A_AIC",319,108,-211,-98.83,"undercount"
"6075",29069,"Missouri","Dunklin County","NHPI_A",9,4,-5,-76.92,"undercount"
"6076",29069,"Missouri","Dunklin County","NHPI_AIC",35,37,2,5.56,"overcount"
"6077",29071,"Missouri","Franklin County","A_A",585,534,-51,-9.12,"undercount"
"6078",29071,"Missouri","Franklin County","A_AIC",896,950,54,5.85,"overcount"
"6079",29071,"Missouri","Franklin County","NHPI_A",71,32,-39,-75.73,"undercount"
"6080",29071,"Missouri","Franklin County","NHPI_AIC",129,100,-29,-25.33,"undercount"
"6081",29073,"Missouri","Gasconade County","A_A",62,52,-10,-17.54,"undercount"
"6082",29073,"Missouri","Gasconade County","A_AIC",99,90,-9,-9.52,"undercount"
"6083",29073,"Missouri","Gasconade County","NHPI_A",4,9,5,76.92,"overcount"
"6084",29073,"Missouri","Gasconade County","NHPI_AIC",17,36,19,71.7,"overcount"
"6085",29075,"Missouri","Gentry County","A_A",30,9,-21,-107.69,"undercount"
"6086",29075,"Missouri","Gentry County","A_AIC",44,31,-13,-34.67,"undercount"
"6087",29075,"Missouri","Gentry County","NHPI_A",1,1,0,0,"equal"
"6088",29075,"Missouri","Gentry County","NHPI_AIC",3,4,1,28.57,"overcount"
"6089",29077,"Missouri","Greene County","A_A",6896,6259,-637,-9.68,"undercount"
"6090",29077,"Missouri","Greene County","A_AIC",8882,8716,-166,-1.89,"undercount"
"6091",29077,"Missouri","Greene County","NHPI_A",383,382,-1,-0.26,"undercount"
"6092",29077,"Missouri","Greene County","NHPI_AIC",750,833,83,10.49,"overcount"
"6093",29079,"Missouri","Grundy County","A_A",112,54,-58,-69.88,"undercount"
"6094",29079,"Missouri","Grundy County","A_AIC",133,97,-36,-31.3,"undercount"
"6095",29079,"Missouri","Grundy County","NHPI_A",4,8,4,66.67,"overcount"
"6096",29079,"Missouri","Grundy County","NHPI_AIC",18,14,-4,-25,"undercount"
"6097",29081,"Missouri","Harrison County","A_A",39,24,-15,-47.62,"undercount"
"6098",29081,"Missouri","Harrison County","A_AIC",55,41,-14,-29.17,"undercount"
"6099",29081,"Missouri","Harrison County","NHPI_A",11,3,-8,-114.29,"undercount"
"6100",29081,"Missouri","Harrison County","NHPI_AIC",15,13,-2,-14.29,"undercount"
"6101",29083,"Missouri","Henry County","A_A",88,93,5,5.52,"overcount"
"6102",29083,"Missouri","Henry County","A_AIC",146,144,-2,-1.38,"undercount"
"6103",29083,"Missouri","Henry County","NHPI_A",19,6,-13,-104,"undercount"
"6104",29083,"Missouri","Henry County","NHPI_AIC",38,15,-23,-86.79,"undercount"
"6105",29085,"Missouri","Hickory County","A_A",23,15,-8,-42.11,"undercount"
"6106",29085,"Missouri","Hickory County","A_AIC",40,22,-18,-58.06,"undercount"
"6107",29085,"Missouri","Hickory County","NHPI_A",10,0,-10,-200,"undercount"
"6108",29085,"Missouri","Hickory County","NHPI_AIC",16,8,-8,-66.67,"undercount"
"6109",29087,"Missouri","Holt County","A_A",16,2,-14,-155.56,"undercount"
"6110",29087,"Missouri","Holt County","A_AIC",24,26,2,8,"overcount"
"6111",29087,"Missouri","Holt County","NHPI_A",1,0,-1,-200,"undercount"
"6112",29087,"Missouri","Holt County","NHPI_AIC",5,2,-3,-85.71,"undercount"
"6113",29089,"Missouri","Howard County","A_A",34,27,-7,-22.95,"undercount"
"6114",29089,"Missouri","Howard County","A_AIC",63,75,12,17.39,"overcount"
"6115",29089,"Missouri","Howard County","NHPI_A",8,3,-5,-90.91,"undercount"
"6116",29089,"Missouri","Howard County","NHPI_AIC",22,13,-9,-51.43,"undercount"
"6117",29091,"Missouri","Howell County","A_A",295,217,-78,-30.47,"undercount"
"6118",29091,"Missouri","Howell County","A_AIC",435,352,-83,-21.09,"undercount"
"6119",29091,"Missouri","Howell County","NHPI_A",26,17,-9,-41.86,"undercount"
"6120",29091,"Missouri","Howell County","NHPI_AIC",53,44,-9,-18.56,"undercount"
"6121",29093,"Missouri","Iron County","A_A",14,34,20,83.33,"overcount"
"6122",29093,"Missouri","Iron County","A_AIC",37,69,32,60.38,"overcount"
"6123",29093,"Missouri","Iron County","NHPI_A",0,2,2,200,"overcount"
"6124",29093,"Missouri","Iron County","NHPI_AIC",9,11,2,20,"overcount"
"6125",29095,"Missouri","Jackson County","A_A",14284,15166,882,5.99,"overcount"
"6126",29095,"Missouri","Jackson County","A_AIC",19249,20961,1712,8.52,"overcount"
"6127",29095,"Missouri","Jackson County","NHPI_A",2245,1742,-503,-25.23,"undercount"
"6128",29095,"Missouri","Jackson County","NHPI_AIC",3747,3214,-533,-15.31,"undercount"
"6129",29097,"Missouri","Jasper County","A_A",1543,1515,-28,-1.83,"undercount"
"6130",29097,"Missouri","Jasper County","A_AIC",2143,2191,48,2.22,"overcount"
"6131",29097,"Missouri","Jasper County","NHPI_A",683,440,-243,-43.28,"undercount"
"6132",29097,"Missouri","Jasper County","NHPI_AIC",834,626,-208,-28.49,"undercount"
"6133",29099,"Missouri","Jefferson County","A_A",1885,1844,-41,-2.2,"undercount"
"6134",29099,"Missouri","Jefferson County","A_AIC",2891,3068,177,5.94,"overcount"
"6135",29099,"Missouri","Jefferson County","NHPI_A",88,71,-17,-21.38,"undercount"
"6136",29099,"Missouri","Jefferson County","NHPI_AIC",210,226,16,7.34,"overcount"
"6137",29101,"Missouri","Johnson County","A_A",983,831,-152,-16.76,"undercount"
"6138",29101,"Missouri","Johnson County","A_AIC",1491,1367,-124,-8.68,"undercount"
"6139",29101,"Missouri","Johnson County","NHPI_A",172,212,40,20.83,"overcount"
"6140",29101,"Missouri","Johnson County","NHPI_AIC",264,320,56,19.18,"overcount"
"6141",29103,"Missouri","Knox County","A_A",17,21,4,21.05,"overcount"
"6142",29103,"Missouri","Knox County","A_AIC",26,26,0,0,"equal"
"6143",29103,"Missouri","Knox County","NHPI_A",0,0,0,0,"equal"
"6144",29103,"Missouri","Knox County","NHPI_AIC",3,3,0,0,"equal"
"6145",29105,"Missouri","Laclede County","A_A",229,195,-34,-16.04,"undercount"
"6146",29105,"Missouri","Laclede County","A_AIC",421,332,-89,-23.64,"undercount"
"6147",29105,"Missouri","Laclede County","NHPI_A",31,17,-14,-58.33,"undercount"
"6148",29105,"Missouri","Laclede County","NHPI_AIC",75,59,-16,-23.88,"undercount"
"6149",29107,"Missouri","Lafayette County","A_A",186,122,-64,-41.56,"undercount"
"6150",29107,"Missouri","Lafayette County","A_AIC",304,241,-63,-23.12,"undercount"
"6151",29107,"Missouri","Lafayette County","NHPI_A",60,12,-48,-133.33,"undercount"
"6152",29107,"Missouri","Lafayette County","NHPI_AIC",98,60,-38,-48.1,"undercount"
"6153",29109,"Missouri","Lawrence County","A_A",243,171,-72,-34.78,"undercount"
"6154",29109,"Missouri","Lawrence County","A_AIC",360,275,-85,-26.77,"undercount"
"6155",29109,"Missouri","Lawrence County","NHPI_A",43,40,-3,-7.23,"undercount"
"6156",29109,"Missouri","Lawrence County","NHPI_AIC",70,45,-25,-43.48,"undercount"
"6157",29111,"Missouri","Lewis County","A_A",45,22,-23,-68.66,"undercount"
"6158",29111,"Missouri","Lewis County","A_AIC",65,45,-20,-36.36,"undercount"
"6159",29111,"Missouri","Lewis County","NHPI_A",7,0,-7,-200,"undercount"
"6160",29111,"Missouri","Lewis County","NHPI_AIC",10,4,-6,-85.71,"undercount"
"6161",29113,"Missouri","Lincoln County","A_A",300,238,-62,-23.05,"undercount"
"6162",29113,"Missouri","Lincoln County","A_AIC",514,498,-16,-3.16,"undercount"
"6163",29113,"Missouri","Lincoln County","NHPI_A",37,31,-6,-17.65,"undercount"
"6164",29113,"Missouri","Lincoln County","NHPI_AIC",88,65,-23,-30.07,"undercount"
"6165",29115,"Missouri","Linn County","A_A",30,22,-8,-30.77,"undercount"
"6166",29115,"Missouri","Linn County","A_AIC",50,51,1,1.98,"overcount"
"6167",29115,"Missouri","Linn County","NHPI_A",6,6,0,0,"equal"
"6168",29115,"Missouri","Linn County","NHPI_AIC",12,15,3,22.22,"overcount"
"6169",29117,"Missouri","Livingston County","A_A",115,87,-28,-27.72,"undercount"
"6170",29117,"Missouri","Livingston County","A_AIC",161,141,-20,-13.25,"undercount"
"6171",29117,"Missouri","Livingston County","NHPI_A",6,5,-1,-18.18,"undercount"
"6172",29117,"Missouri","Livingston County","NHPI_AIC",15,13,-2,-14.29,"undercount"
"6173",29119,"Missouri","McDonald County","A_A",396,376,-20,-5.18,"undercount"
"6174",29119,"Missouri","McDonald County","A_AIC",499,479,-20,-4.09,"undercount"
"6175",29119,"Missouri","McDonald County","NHPI_A",732,868,136,17,"overcount"
"6176",29119,"Missouri","McDonald County","NHPI_AIC",767,914,147,17.49,"overcount"
"6177",29121,"Missouri","Macon County","A_A",124,88,-36,-33.96,"undercount"
"6178",29121,"Missouri","Macon County","A_AIC",156,147,-9,-5.94,"undercount"
"6179",29121,"Missouri","Macon County","NHPI_A",9,4,-5,-76.92,"undercount"
"6180",29121,"Missouri","Macon County","NHPI_AIC",22,8,-14,-93.33,"undercount"
"6181",29123,"Missouri","Madison County","A_A",130,41,-89,-104.09,"undercount"
"6182",29123,"Missouri","Madison County","A_AIC",164,78,-86,-71.07,"undercount"
"6183",29123,"Missouri","Madison County","NHPI_A",6,0,-6,-200,"undercount"
"6184",29123,"Missouri","Madison County","NHPI_AIC",13,16,3,20.69,"overcount"
"6185",29125,"Missouri","Maries County","A_A",31,7,-24,-126.32,"undercount"
"6186",29125,"Missouri","Maries County","A_AIC",55,53,-2,-3.7,"undercount"
"6187",29125,"Missouri","Maries County","NHPI_A",3,0,-3,-200,"undercount"
"6188",29125,"Missouri","Maries County","NHPI_AIC",12,6,-6,-66.67,"undercount"
"6189",29127,"Missouri","Marion County","A_A",196,175,-21,-11.32,"undercount"
"6190",29127,"Missouri","Marion County","A_AIC",292,304,12,4.03,"overcount"
"6191",29127,"Missouri","Marion County","NHPI_A",26,16,-10,-47.62,"undercount"
"6192",29127,"Missouri","Marion County","NHPI_AIC",59,62,3,4.96,"overcount"
"6193",29129,"Missouri","Mercer County","A_A",27,0,-27,-200,"undercount"
"6194",29129,"Missouri","Mercer County","A_AIC",34,11,-23,-102.22,"undercount"
"6195",29129,"Missouri","Mercer County","NHPI_A",1,0,-1,-200,"undercount"
"6196",29129,"Missouri","Mercer County","NHPI_AIC",4,4,0,0,"equal"
"6197",29131,"Missouri","Miller County","A_A",115,66,-49,-54.14,"undercount"
"6198",29131,"Missouri","Miller County","A_AIC",176,119,-57,-38.64,"undercount"
"6199",29131,"Missouri","Miller County","NHPI_A",54,31,-23,-54.12,"undercount"
"6200",29131,"Missouri","Miller County","NHPI_AIC",74,57,-17,-25.95,"undercount"
"6201",29133,"Missouri","Mississippi County","A_A",41,21,-20,-64.52,"undercount"
"6202",29133,"Missouri","Mississippi County","A_AIC",70,37,-33,-61.68,"undercount"
"6203",29133,"Missouri","Mississippi County","NHPI_A",2,0,-2,-200,"undercount"
"6204",29133,"Missouri","Mississippi County","NHPI_AIC",13,10,-3,-26.09,"undercount"
"6205",29135,"Missouri","Moniteau County","A_A",72,42,-30,-52.63,"undercount"
"6206",29135,"Missouri","Moniteau County","A_AIC",125,71,-54,-55.1,"undercount"
"6207",29135,"Missouri","Moniteau County","NHPI_A",15,16,1,6.45,"overcount"
"6208",29135,"Missouri","Moniteau County","NHPI_AIC",31,34,3,9.23,"overcount"
"6209",29137,"Missouri","Monroe County","A_A",36,32,-4,-11.76,"undercount"
"6210",29137,"Missouri","Monroe County","A_AIC",63,51,-12,-21.05,"undercount"
"6211",29137,"Missouri","Monroe County","NHPI_A",3,1,-2,-100,"undercount"
"6212",29137,"Missouri","Monroe County","NHPI_AIC",7,3,-4,-80,"undercount"
"6213",29139,"Missouri","Montgomery County","A_A",57,50,-7,-13.08,"undercount"
"6214",29139,"Missouri","Montgomery County","A_AIC",88,80,-8,-9.52,"undercount"
"6215",29139,"Missouri","Montgomery County","NHPI_A",6,5,-1,-18.18,"undercount"
"6216",29139,"Missouri","Montgomery County","NHPI_AIC",15,15,0,0,"equal"
"6217",29141,"Missouri","Morgan County","A_A",99,65,-34,-41.46,"undercount"
"6218",29141,"Missouri","Morgan County","A_AIC",164,119,-45,-31.8,"undercount"
"6219",29141,"Missouri","Morgan County","NHPI_A",9,12,3,28.57,"overcount"
"6220",29141,"Missouri","Morgan County","NHPI_AIC",24,29,5,18.87,"overcount"
"6221",29143,"Missouri","New Madrid County","A_A",73,62,-11,-16.3,"undercount"
"6222",29143,"Missouri","New Madrid County","A_AIC",115,96,-19,-18.01,"undercount"
"6223",29143,"Missouri","New Madrid County","NHPI_A",9,4,-5,-76.92,"undercount"
"6224",29143,"Missouri","New Madrid County","NHPI_AIC",16,16,0,0,"equal"
"6225",29145,"Missouri","Newton County","A_A",876,805,-71,-8.45,"undercount"
"6226",29145,"Missouri","Newton County","A_AIC",1147,1067,-80,-7.23,"undercount"
"6227",29145,"Missouri","Newton County","NHPI_A",732,790,58,7.62,"overcount"
"6228",29145,"Missouri","Newton County","NHPI_AIC",822,889,67,7.83,"overcount"
"6229",29147,"Missouri","Nodaway County","A_A",331,392,61,16.87,"overcount"
"6230",29147,"Missouri","Nodaway County","A_AIC",412,469,57,12.94,"overcount"
"6231",29147,"Missouri","Nodaway County","NHPI_A",4,4,0,0,"equal"
"6232",29147,"Missouri","Nodaway County","NHPI_AIC",23,20,-3,-13.95,"undercount"
"6233",29149,"Missouri","Oregon County","A_A",39,8,-31,-131.91,"undercount"
"6234",29149,"Missouri","Oregon County","A_AIC",63,40,-23,-44.66,"undercount"
"6235",29149,"Missouri","Oregon County","NHPI_A",9,0,-9,-200,"undercount"
"6236",29149,"Missouri","Oregon County","NHPI_AIC",13,3,-10,-125,"undercount"
"6237",29151,"Missouri","Osage County","A_A",23,3,-20,-153.85,"undercount"
"6238",29151,"Missouri","Osage County","A_AIC",35,16,-19,-74.51,"undercount"
"6239",29151,"Missouri","Osage County","NHPI_A",12,10,-2,-18.18,"undercount"
"6240",29151,"Missouri","Osage County","NHPI_AIC",14,13,-1,-7.41,"undercount"
"6241",29153,"Missouri","Ozark County","A_A",21,14,-7,-40,"undercount"
"6242",29153,"Missouri","Ozark County","A_AIC",49,46,-3,-6.32,"undercount"
"6243",29153,"Missouri","Ozark County","NHPI_A",0,5,5,200,"overcount"
"6244",29153,"Missouri","Ozark County","NHPI_AIC",6,6,0,0,"equal"
"6245",29155,"Missouri","Pemiscot County","A_A",81,36,-45,-76.92,"undercount"
"6246",29155,"Missouri","Pemiscot County","A_AIC",115,52,-63,-75.45,"undercount"
"6247",29155,"Missouri","Pemiscot County","NHPI_A",14,4,-10,-111.11,"undercount"
"6248",29155,"Missouri","Pemiscot County","NHPI_AIC",20,16,-4,-22.22,"undercount"
"6249",29157,"Missouri","Perry County","A_A",208,129,-79,-46.88,"undercount"
"6250",29157,"Missouri","Perry County","A_AIC",250,181,-69,-32.02,"undercount"
"6251",29157,"Missouri","Perry County","NHPI_A",23,0,-23,-200,"undercount"
"6252",29157,"Missouri","Perry County","NHPI_AIC",34,18,-16,-61.54,"undercount"
"6253",29159,"Missouri","Pettis County","A_A",364,294,-70,-21.28,"undercount"
"6254",29159,"Missouri","Pettis County","A_AIC",554,480,-74,-14.31,"undercount"
"6255",29159,"Missouri","Pettis County","NHPI_A",161,120,-41,-29.18,"undercount"
"6256",29159,"Missouri","Pettis County","NHPI_AIC",201,156,-45,-25.21,"undercount"
"6257",29161,"Missouri","Phelps County","A_A",1567,1541,-26,-1.67,"undercount"
"6258",29161,"Missouri","Phelps County","A_AIC",1838,1959,121,6.37,"overcount"
"6259",29161,"Missouri","Phelps County","NHPI_A",44,20,-24,-75,"undercount"
"6260",29161,"Missouri","Phelps County","NHPI_AIC",92,49,-43,-60.99,"undercount"
"6261",29163,"Missouri","Pike County","A_A",68,30,-38,-77.55,"undercount"
"6262",29163,"Missouri","Pike County","A_AIC",111,78,-33,-34.92,"undercount"
"6263",29163,"Missouri","Pike County","NHPI_A",5,7,2,33.33,"overcount"
"6264",29163,"Missouri","Pike County","NHPI_AIC",24,16,-8,-40,"undercount"
"6265",29165,"Missouri","Platte County","A_A",3140,2752,-388,-13.17,"undercount"
"6266",29165,"Missouri","Platte County","A_AIC",4122,3854,-268,-6.72,"undercount"
"6267",29165,"Missouri","Platte County","NHPI_A",600,721,121,18.32,"overcount"
"6268",29165,"Missouri","Platte County","NHPI_AIC",786,941,155,17.95,"overcount"
"6269",29167,"Missouri","Polk County","A_A",292,131,-161,-76.12,"undercount"
"6270",29167,"Missouri","Polk County","A_AIC",403,250,-153,-46.86,"undercount"
"6271",29167,"Missouri","Polk County","NHPI_A",13,4,-9,-105.88,"undercount"
"6272",29167,"Missouri","Polk County","NHPI_AIC",37,26,-11,-34.92,"undercount"
"6273",29169,"Missouri","Pulaski County","A_A",1695,1790,95,5.45,"overcount"
"6274",29169,"Missouri","Pulaski County","A_AIC",2483,2637,154,6.02,"overcount"
"6275",29169,"Missouri","Pulaski County","NHPI_A",376,419,43,10.82,"overcount"
"6276",29169,"Missouri","Pulaski County","NHPI_AIC",602,655,53,8.43,"overcount"
"6277",29171,"Missouri","Putnam County","A_A",24,0,-24,-200,"undercount"
"6278",29171,"Missouri","Putnam County","A_AIC",38,8,-30,-130.43,"undercount"
"6279",29171,"Missouri","Putnam County","NHPI_A",1,0,-1,-200,"undercount"
"6280",29171,"Missouri","Putnam County","NHPI_AIC",6,9,3,40,"overcount"
"6281",29173,"Missouri","Ralls County","A_A",37,17,-20,-74.07,"undercount"
"6282",29173,"Missouri","Ralls County","A_AIC",69,21,-48,-106.67,"undercount"
"6283",29173,"Missouri","Ralls County","NHPI_A",16,4,-12,-120,"undercount"
"6284",29173,"Missouri","Ralls County","NHPI_AIC",22,13,-9,-51.43,"undercount"
"6285",29175,"Missouri","Randolph County","A_A",169,95,-74,-56.06,"undercount"
"6286",29175,"Missouri","Randolph County","A_AIC",254,196,-58,-25.78,"undercount"
"6287",29175,"Missouri","Randolph County","NHPI_A",9,10,1,10.53,"overcount"
"6288",29175,"Missouri","Randolph County","NHPI_AIC",32,31,-1,-3.17,"undercount"
"6289",29177,"Missouri","Ray County","A_A",89,76,-13,-15.76,"undercount"
"6290",29177,"Missouri","Ray County","A_AIC",158,136,-22,-14.97,"undercount"
"6291",29177,"Missouri","Ray County","NHPI_A",30,8,-22,-115.79,"undercount"
"6292",29177,"Missouri","Ray County","NHPI_AIC",50,45,-5,-10.53,"undercount"
"6293",29179,"Missouri","Reynolds County","A_A",12,18,6,40,"overcount"
"6294",29179,"Missouri","Reynolds County","A_AIC",38,35,-3,-8.22,"undercount"
"6295",29179,"Missouri","Reynolds County","NHPI_A",1,2,1,66.67,"overcount"
"6296",29179,"Missouri","Reynolds County","NHPI_AIC",5,8,3,46.15,"overcount"
"6297",29181,"Missouri","Ripley County","A_A",40,28,-12,-35.29,"undercount"
"6298",29181,"Missouri","Ripley County","A_AIC",76,52,-24,-37.5,"undercount"
"6299",29181,"Missouri","Ripley County","NHPI_A",4,1,-3,-120,"undercount"
"6300",29181,"Missouri","Ripley County","NHPI_AIC",15,5,-10,-100,"undercount"
"6301",29183,"Missouri","St. Charles County","A_A",11555,11153,-402,-3.54,"undercount"
"6302",29183,"Missouri","St. Charles County","A_AIC",14244,14714,470,3.25,"overcount"
"6303",29183,"Missouri","St. Charles County","NHPI_A",238,202,-36,-16.36,"undercount"
"6304",29183,"Missouri","St. Charles County","NHPI_AIC",547,569,22,3.94,"overcount"
"6305",29185,"Missouri","St. Clair County","A_A",32,19,-13,-50.98,"undercount"
"6306",29185,"Missouri","St. Clair County","A_AIC",55,48,-7,-13.59,"undercount"
"6307",29185,"Missouri","St. Clair County","NHPI_A",2,7,5,111.11,"overcount"
"6308",29185,"Missouri","St. Clair County","NHPI_AIC",11,13,2,16.67,"overcount"
"6309",29186,"Missouri","Ste. Genevieve County","A_A",53,29,-24,-58.54,"undercount"
"6310",29186,"Missouri","Ste. Genevieve County","A_AIC",86,84,-2,-2.35,"undercount"
"6311",29186,"Missouri","Ste. Genevieve County","NHPI_A",118,2,-116,-193.33,"undercount"
"6312",29186,"Missouri","Ste. Genevieve County","NHPI_AIC",127,17,-110,-152.78,"undercount"
"6313",29187,"Missouri","St. Francois County","A_A",294,403,109,31.28,"overcount"
"6314",29187,"Missouri","St. Francois County","A_AIC",460,633,173,31.66,"overcount"
"6315",29187,"Missouri","St. Francois County","NHPI_A",39,21,-18,-60,"undercount"
"6316",29187,"Missouri","St. Francois County","NHPI_AIC",75,67,-8,-11.27,"undercount"
"6317",29189,"Missouri","St. Louis County","A_A",48151,48993,842,1.73,"overcount"
"6318",29189,"Missouri","St. Louis County","A_AIC",56453,58577,2124,3.69,"overcount"
"6319",29189,"Missouri","St. Louis County","NHPI_A",204,274,70,29.29,"overcount"
"6320",29189,"Missouri","St. Louis County","NHPI_AIC",1077,972,-105,-10.25,"undercount"
"6321",29195,"Missouri","Saline County","A_A",260,197,-63,-27.57,"undercount"
"6322",29195,"Missouri","Saline County","A_AIC",344,266,-78,-25.57,"undercount"
"6323",29195,"Missouri","Saline County","NHPI_A",337,397,60,16.35,"overcount"
"6324",29195,"Missouri","Saline County","NHPI_AIC",364,431,67,16.86,"overcount"
"6325",29197,"Missouri","Schuyler County","A_A",15,27,12,57.14,"overcount"
"6326",29197,"Missouri","Schuyler County","A_AIC",22,44,22,66.67,"overcount"
"6327",29197,"Missouri","Schuyler County","NHPI_A",0,1,1,200,"overcount"
"6328",29197,"Missouri","Schuyler County","NHPI_AIC",5,3,-2,-50,"undercount"
"6329",29199,"Missouri","Scotland County","A_A",11,5,-6,-75,"undercount"
"6330",29199,"Missouri","Scotland County","A_AIC",18,20,2,10.53,"overcount"
"6331",29199,"Missouri","Scotland County","NHPI_A",0,1,1,200,"overcount"
"6332",29199,"Missouri","Scotland County","NHPI_AIC",2,7,5,111.11,"overcount"
"6333",29201,"Missouri","Scott County","A_A",180,153,-27,-16.22,"undercount"
"6334",29201,"Missouri","Scott County","A_AIC",270,225,-45,-18.18,"undercount"
"6335",29201,"Missouri","Scott County","NHPI_A",18,2,-16,-160,"undercount"
"6336",29201,"Missouri","Scott County","NHPI_AIC",47,21,-26,-76.47,"undercount"
"6337",29203,"Missouri","Shannon County","A_A",22,13,-9,-51.43,"undercount"
"6338",29203,"Missouri","Shannon County","A_AIC",44,45,1,2.25,"overcount"
"6339",29203,"Missouri","Shannon County","NHPI_A",1,1,0,0,"equal"
"6340",29203,"Missouri","Shannon County","NHPI_AIC",8,20,12,85.71,"overcount"
"6341",29205,"Missouri","Shelby County","A_A",14,2,-12,-150,"undercount"
"6342",29205,"Missouri","Shelby County","A_AIC",25,22,-3,-12.77,"undercount"
"6343",29205,"Missouri","Shelby County","NHPI_A",0,0,0,0,"equal"
"6344",29205,"Missouri","Shelby County","NHPI_AIC",1,11,10,166.67,"overcount"
"6345",29207,"Missouri","Stoddard County","A_A",114,90,-24,-23.53,"undercount"
"6346",29207,"Missouri","Stoddard County","A_AIC",178,158,-20,-11.9,"undercount"
"6347",29207,"Missouri","Stoddard County","NHPI_A",10,2,-8,-133.33,"undercount"
"6348",29207,"Missouri","Stoddard County","NHPI_AIC",20,15,-5,-28.57,"undercount"
"6349",29209,"Missouri","Stone County","A_A",145,136,-9,-6.41,"undercount"
"6350",29209,"Missouri","Stone County","A_AIC",203,213,10,4.81,"overcount"
"6351",29209,"Missouri","Stone County","NHPI_A",41,21,-20,-64.52,"undercount"
"6352",29209,"Missouri","Stone County","NHPI_AIC",62,45,-17,-31.78,"undercount"
"6353",29211,"Missouri","Sullivan County","A_A",42,32,-10,-27.03,"undercount"
"6354",29211,"Missouri","Sullivan County","A_AIC",48,51,3,6.06,"overcount"
"6355",29211,"Missouri","Sullivan County","NHPI_A",26,1,-25,-185.19,"undercount"
"6356",29211,"Missouri","Sullivan County","NHPI_AIC",27,7,-20,-117.65,"undercount"
"6357",29213,"Missouri","Taney County","A_A",651,621,-30,-4.72,"undercount"
"6358",29213,"Missouri","Taney County","A_AIC",919,993,74,7.74,"overcount"
"6359",29213,"Missouri","Taney County","NHPI_A",76,187,111,84.41,"overcount"
"6360",29213,"Missouri","Taney County","NHPI_AIC",134,292,158,74.18,"overcount"
"6361",29215,"Missouri","Texas County","A_A",87,67,-20,-25.97,"undercount"
"6362",29215,"Missouri","Texas County","A_AIC",145,130,-15,-10.91,"undercount"
"6363",29215,"Missouri","Texas County","NHPI_A",16,6,-10,-90.91,"undercount"
"6364",29215,"Missouri","Texas County","NHPI_AIC",34,29,-5,-15.87,"undercount"
"6365",29217,"Missouri","Vernon County","A_A",144,105,-39,-31.33,"undercount"
"6366",29217,"Missouri","Vernon County","A_AIC",188,167,-21,-11.83,"undercount"
"6367",29217,"Missouri","Vernon County","NHPI_A",11,18,7,48.28,"overcount"
"6368",29217,"Missouri","Vernon County","NHPI_AIC",27,40,13,38.81,"overcount"
"6369",29219,"Missouri","Warren County","A_A",169,145,-24,-15.29,"undercount"
"6370",29219,"Missouri","Warren County","A_AIC",288,296,8,2.74,"overcount"
"6371",29219,"Missouri","Warren County","NHPI_A",18,1,-17,-178.95,"undercount"
"6372",29219,"Missouri","Warren County","NHPI_AIC",39,33,-6,-16.67,"undercount"
"6373",29221,"Missouri","Washington County","A_A",79,42,-37,-61.16,"undercount"
"6374",29221,"Missouri","Washington County","A_AIC",119,89,-30,-28.85,"undercount"
"6375",29221,"Missouri","Washington County","NHPI_A",9,1,-8,-160,"undercount"
"6376",29221,"Missouri","Washington County","NHPI_AIC",22,19,-3,-14.63,"undercount"
"6377",29223,"Missouri","Wayne County","A_A",36,24,-12,-40,"undercount"
"6378",29223,"Missouri","Wayne County","A_AIC",54,45,-9,-18.18,"undercount"
"6379",29223,"Missouri","Wayne County","NHPI_A",5,5,0,0,"equal"
"6380",29223,"Missouri","Wayne County","NHPI_AIC",9,14,5,43.48,"overcount"
"6381",29225,"Missouri","Webster County","A_A",156,142,-14,-9.4,"undercount"
"6382",29225,"Missouri","Webster County","A_AIC",271,262,-9,-3.38,"undercount"
"6383",29225,"Missouri","Webster County","NHPI_A",13,9,-4,-36.36,"undercount"
"6384",29225,"Missouri","Webster County","NHPI_AIC",37,32,-5,-14.49,"undercount"
"6385",29227,"Missouri","Worth County","A_A",5,7,2,33.33,"overcount"
"6386",29227,"Missouri","Worth County","A_AIC",9,7,-2,-25,"undercount"
"6387",29227,"Missouri","Worth County","NHPI_A",0,5,5,200,"overcount"
"6388",29227,"Missouri","Worth County","NHPI_AIC",0,6,6,200,"overcount"
"6389",29229,"Missouri","Wright County","A_A",84,54,-30,-43.48,"undercount"
"6390",29229,"Missouri","Wright County","A_AIC",113,112,-1,-0.89,"undercount"
"6391",29229,"Missouri","Wright County","NHPI_A",15,5,-10,-100,"undercount"
"6392",29229,"Missouri","Wright County","NHPI_AIC",21,23,2,9.09,"overcount"
"6393",29510,"Missouri","St. Louis city","A_A",10589,12338,1749,15.26,"overcount"
"6394",29510,"Missouri","St. Louis city","A_AIC",12919,15135,2216,15.8,"overcount"
"6395",29510,"Missouri","St. Louis city","NHPI_A",140,88,-52,-45.61,"undercount"
"6396",29510,"Missouri","St. Louis city","NHPI_AIC",499,328,-171,-41.35,"undercount"
"6397",30001,"Montana","Beaverhead County","A_A",55,37,-18,-39.13,"undercount"
"6398",30001,"Montana","Beaverhead County","A_AIC",99,62,-37,-45.96,"undercount"
"6399",30001,"Montana","Beaverhead County","NHPI_A",56,3,-53,-179.66,"undercount"
"6400",30001,"Montana","Beaverhead County","NHPI_AIC",72,9,-63,-155.56,"undercount"
"6401",30003,"Montana","Big Horn County","A_A",94,44,-50,-72.46,"undercount"
"6402",30003,"Montana","Big Horn County","A_AIC",141,96,-45,-37.97,"undercount"
"6403",30003,"Montana","Big Horn County","NHPI_A",3,9,6,100,"overcount"
"6404",30003,"Montana","Big Horn County","NHPI_AIC",14,21,7,40,"overcount"
"6405",30005,"Montana","Blaine County","A_A",15,13,-2,-14.29,"undercount"
"6406",30005,"Montana","Blaine County","A_AIC",33,51,18,42.86,"overcount"
"6407",30005,"Montana","Blaine County","NHPI_A",1,0,-1,-200,"undercount"
"6408",30005,"Montana","Blaine County","NHPI_AIC",2,20,18,163.64,"overcount"
"6409",30007,"Montana","Broadwater County","A_A",21,6,-15,-111.11,"undercount"
"6410",30007,"Montana","Broadwater County","A_AIC",37,32,-5,-14.49,"undercount"
"6411",30007,"Montana","Broadwater County","NHPI_A",9,0,-9,-200,"undercount"
"6412",30007,"Montana","Broadwater County","NHPI_AIC",11,10,-1,-9.52,"undercount"
"6413",30009,"Montana","Carbon County","A_A",42,21,-21,-66.67,"undercount"
"6414",30009,"Montana","Carbon County","A_AIC",68,74,6,8.45,"overcount"
"6415",30009,"Montana","Carbon County","NHPI_A",12,0,-12,-200,"undercount"
"6416",30009,"Montana","Carbon County","NHPI_AIC",18,30,12,50,"overcount"
"6417",30011,"Montana","Carter County","A_A",1,1,0,0,"equal"
"6418",30011,"Montana","Carter County","A_AIC",2,15,13,152.94,"overcount"
"6419",30011,"Montana","Carter County","NHPI_A",0,0,0,0,"equal"
"6420",30011,"Montana","Carter County","NHPI_AIC",3,10,7,107.69,"overcount"
"6421",30013,"Montana","Cascade County","A_A",886,941,55,6.02,"overcount"
"6422",30013,"Montana","Cascade County","A_AIC",1719,1787,68,3.88,"overcount"
"6423",30013,"Montana","Cascade County","NHPI_A",92,115,23,22.22,"overcount"
"6424",30013,"Montana","Cascade County","NHPI_AIC",279,318,39,13.07,"overcount"
"6425",30015,"Montana","Chouteau County","A_A",27,18,-9,-40,"undercount"
"6426",30015,"Montana","Chouteau County","A_AIC",46,52,6,12.24,"overcount"
"6427",30015,"Montana","Chouteau County","NHPI_A",4,0,-4,-200,"undercount"
"6428",30015,"Montana","Chouteau County","NHPI_AIC",10,4,-6,-85.71,"undercount"
"6429",30017,"Montana","Custer County","A_A",97,53,-44,-58.67,"undercount"
"6430",30017,"Montana","Custer County","A_AIC",152,120,-32,-23.53,"undercount"
"6431",30017,"Montana","Custer County","NHPI_A",8,7,-1,-13.33,"undercount"
"6432",30017,"Montana","Custer County","NHPI_AIC",17,26,9,41.86,"overcount"
"6433",30019,"Montana","Daniels County","A_A",3,14,11,129.41,"overcount"
"6434",30019,"Montana","Daniels County","A_AIC",10,39,29,118.37,"overcount"
"6435",30019,"Montana","Daniels County","NHPI_A",0,0,0,0,"equal"
"6436",30019,"Montana","Daniels County","NHPI_AIC",0,4,4,200,"overcount"
"6437",30021,"Montana","Dawson County","A_A",51,62,11,19.47,"overcount"
"6438",30021,"Montana","Dawson County","A_AIC",68,100,32,38.1,"overcount"
"6439",30021,"Montana","Dawson County","NHPI_A",3,1,-2,-100,"undercount"
"6440",30021,"Montana","Dawson County","NHPI_AIC",6,9,3,40,"overcount"
"6441",30023,"Montana","Deer Lodge County","A_A",46,34,-12,-30,"undercount"
"6442",30023,"Montana","Deer Lodge County","A_AIC",80,76,-4,-5.13,"undercount"
"6443",30023,"Montana","Deer Lodge County","NHPI_A",8,2,-6,-120,"undercount"
"6444",30023,"Montana","Deer Lodge County","NHPI_AIC",17,14,-3,-19.35,"undercount"
"6445",30025,"Montana","Fallon County","A_A",23,5,-18,-128.57,"undercount"
"6446",30025,"Montana","Fallon County","A_AIC",30,16,-14,-60.87,"undercount"
"6447",30025,"Montana","Fallon County","NHPI_A",5,2,-3,-85.71,"undercount"
"6448",30025,"Montana","Fallon County","NHPI_AIC",7,13,6,60,"overcount"
"6449",30027,"Montana","Fergus County","A_A",83,39,-44,-72.13,"undercount"
"6450",30027,"Montana","Fergus County","A_AIC",116,85,-31,-30.85,"undercount"
"6451",30027,"Montana","Fergus County","NHPI_A",0,0,0,0,"equal"
"6452",30027,"Montana","Fergus County","NHPI_AIC",9,4,-5,-76.92,"undercount"
"6453",30029,"Montana","Flathead County","A_A",909,705,-204,-25.28,"undercount"
"6454",30029,"Montana","Flathead County","A_AIC",1551,1524,-27,-1.76,"undercount"
"6455",30029,"Montana","Flathead County","NHPI_A",87,86,-1,-1.16,"undercount"
"6456",30029,"Montana","Flathead County","NHPI_AIC",208,260,52,22.22,"overcount"
"6457",30031,"Montana","Gallatin County","A_A",1973,1437,-536,-31.44,"undercount"
"6458",30031,"Montana","Gallatin County","A_AIC",2918,2695,-223,-7.95,"undercount"
"6459",30031,"Montana","Gallatin County","NHPI_A",104,91,-13,-13.33,"undercount"
"6460",30031,"Montana","Gallatin County","NHPI_AIC",258,245,-13,-5.17,"undercount"
"6461",30033,"Montana","Garfield County","A_A",1,2,1,66.67,"overcount"
"6462",30033,"Montana","Garfield County","A_AIC",2,5,3,85.71,"overcount"
"6463",30033,"Montana","Garfield County","NHPI_A",0,1,1,200,"overcount"
"6464",30033,"Montana","Garfield County","NHPI_AIC",0,3,3,200,"overcount"
"6465",30035,"Montana","Glacier County","A_A",49,39,-10,-22.73,"undercount"
"6466",30035,"Montana","Glacier County","A_AIC",91,81,-10,-11.63,"undercount"
"6467",30035,"Montana","Glacier County","NHPI_A",3,16,13,136.84,"overcount"
"6468",30035,"Montana","Glacier County","NHPI_AIC",15,42,27,94.74,"overcount"
"6469",30037,"Montana","Golden Valley County","A_A",5,0,-5,-200,"undercount"
"6470",30037,"Montana","Golden Valley County","A_AIC",11,0,-11,-200,"undercount"
"6471",30037,"Montana","Golden Valley County","NHPI_A",2,1,-1,-66.67,"undercount"
"6472",30037,"Montana","Golden Valley County","NHPI_AIC",2,2,0,0,"equal"
"6473",30039,"Montana","Granite County","A_A",16,3,-13,-136.84,"undercount"
"6474",30039,"Montana","Granite County","A_AIC",31,12,-19,-88.37,"undercount"
"6475",30039,"Montana","Granite County","NHPI_A",1,0,-1,-200,"undercount"
"6476",30039,"Montana","Granite County","NHPI_AIC",3,7,4,80,"overcount"
"6477",30041,"Montana","Hill County","A_A",106,79,-27,-29.19,"undercount"
"6478",30041,"Montana","Hill County","A_AIC",215,201,-14,-6.73,"undercount"
"6479",30041,"Montana","Hill County","NHPI_A",9,8,-1,-11.76,"undercount"
"6480",30041,"Montana","Hill County","NHPI_AIC",46,34,-12,-30,"undercount"
"6481",30043,"Montana","Jefferson County","A_A",71,49,-22,-36.67,"undercount"
"6482",30043,"Montana","Jefferson County","A_AIC",125,107,-18,-15.52,"undercount"
"6483",30043,"Montana","Jefferson County","NHPI_A",12,0,-12,-200,"undercount"
"6484",30043,"Montana","Jefferson County","NHPI_AIC",27,18,-9,-40,"undercount"
"6485",30045,"Montana","Judith Basin County","A_A",13,6,-7,-73.68,"undercount"
"6486",30045,"Montana","Judith Basin County","A_AIC",15,12,-3,-22.22,"undercount"
"6487",30045,"Montana","Judith Basin County","NHPI_A",0,2,2,200,"overcount"
"6488",30045,"Montana","Judith Basin County","NHPI_AIC",0,10,10,200,"overcount"
"6489",30047,"Montana","Lake County","A_A",226,138,-88,-48.35,"undercount"
"6490",30047,"Montana","Lake County","A_AIC",370,275,-95,-29.46,"undercount"
"6491",30047,"Montana","Lake County","NHPI_A",39,21,-18,-60,"undercount"
"6492",30047,"Montana","Lake County","NHPI_AIC",97,71,-26,-30.95,"undercount"
"6493",30049,"Montana","Lewis and Clark County","A_A",567,554,-13,-2.32,"undercount"
"6494",30049,"Montana","Lewis and Clark County","A_AIC",961,1097,136,13.22,"overcount"
"6495",30049,"Montana","Lewis and Clark County","NHPI_A",56,44,-12,-24,"undercount"
"6496",30049,"Montana","Lewis and Clark County","NHPI_AIC",153,165,12,7.55,"overcount"
"6497",30051,"Montana","Liberty County","A_A",4,6,2,40,"overcount"
"6498",30051,"Montana","Liberty County","A_AIC",16,15,-1,-6.45,"undercount"
"6499",30051,"Montana","Liberty County","NHPI_A",1,0,-1,-200,"undercount"
"6500",30051,"Montana","Liberty County","NHPI_AIC",4,11,7,93.33,"overcount"
"6501",30053,"Montana","Lincoln County","A_A",88,100,12,12.77,"overcount"
"6502",30053,"Montana","Lincoln County","A_AIC",207,203,-4,-1.95,"undercount"
"6503",30053,"Montana","Lincoln County","NHPI_A",23,13,-10,-55.56,"undercount"
"6504",30053,"Montana","Lincoln County","NHPI_AIC",50,55,5,9.52,"overcount"
"6505",30055,"Montana","McCone County","A_A",6,8,2,28.57,"overcount"
"6506",30055,"Montana","McCone County","A_AIC",16,24,8,40,"overcount"
"6507",30055,"Montana","McCone County","NHPI_A",0,2,2,200,"overcount"
"6508",30055,"Montana","McCone County","NHPI_AIC",2,8,6,120,"overcount"
"6509",30057,"Montana","Madison County","A_A",48,30,-18,-46.15,"undercount"
"6510",30057,"Montana","Madison County","A_AIC",71,71,0,0,"equal"
"6511",30057,"Montana","Madison County","NHPI_A",4,6,2,40,"overcount"
"6512",30057,"Montana","Madison County","NHPI_AIC",10,27,17,91.89,"overcount"
"6513",30059,"Montana","Meagher County","A_A",8,2,-6,-120,"undercount"
"6514",30059,"Montana","Meagher County","A_AIC",9,22,13,83.87,"overcount"
"6515",30059,"Montana","Meagher County","NHPI_A",0,0,0,0,"equal"
"6516",30059,"Montana","Meagher County","NHPI_AIC",2,8,6,120,"overcount"
"6517",30061,"Montana","Mineral County","A_A",31,21,-10,-38.46,"undercount"
"6518",30061,"Montana","Mineral County","A_AIC",54,56,2,3.64,"overcount"
"6519",30061,"Montana","Mineral County","NHPI_A",1,5,4,133.33,"overcount"
"6520",30061,"Montana","Mineral County","NHPI_AIC",3,20,17,147.83,"overcount"
"6521",30063,"Montana","Missoula County","A_A",2408,1457,-951,-49.21,"undercount"
"6522",30063,"Montana","Missoula County","A_AIC",3603,2615,-988,-31.78,"undercount"
"6523",30063,"Montana","Missoula County","NHPI_A",123,125,2,1.61,"overcount"
"6524",30063,"Montana","Missoula County","NHPI_AIC",347,349,2,0.57,"overcount"
"6525",30065,"Montana","Musselshell County","A_A",66,23,-43,-96.63,"undercount"
"6526",30065,"Montana","Musselshell County","A_AIC",83,33,-50,-86.21,"undercount"
"6527",30065,"Montana","Musselshell County","NHPI_A",2,5,3,85.71,"overcount"
"6528",30065,"Montana","Musselshell County","NHPI_AIC",8,8,0,0,"equal"
"6529",30067,"Montana","Park County","A_A",83,75,-8,-10.13,"undercount"
"6530",30067,"Montana","Park County","A_AIC",176,165,-11,-6.45,"undercount"
"6531",30067,"Montana","Park County","NHPI_A",9,0,-9,-200,"undercount"
"6532",30067,"Montana","Park County","NHPI_AIC",39,15,-24,-88.89,"undercount"
"6533",30069,"Montana","Petroleum County","A_A",0,0,0,0,"equal"
"6534",30069,"Montana","Petroleum County","A_AIC",2,4,2,66.67,"overcount"
"6535",30069,"Montana","Petroleum County","NHPI_A",0,1,1,200,"overcount"
"6536",30069,"Montana","Petroleum County","NHPI_AIC",2,8,6,120,"overcount"
"6537",30071,"Montana","Phillips County","A_A",13,16,3,20.69,"overcount"
"6538",30071,"Montana","Phillips County","A_AIC",37,36,-1,-2.74,"undercount"
"6539",30071,"Montana","Phillips County","NHPI_A",1,0,-1,-200,"undercount"
"6540",30071,"Montana","Phillips County","NHPI_AIC",7,7,0,0,"equal"
"6541",30073,"Montana","Pondera County","A_A",31,25,-6,-21.43,"undercount"
"6542",30073,"Montana","Pondera County","A_AIC",57,31,-26,-59.09,"undercount"
"6543",30073,"Montana","Pondera County","NHPI_A",5,11,6,75,"overcount"
"6544",30073,"Montana","Pondera County","NHPI_AIC",14,20,6,35.29,"overcount"
"6545",30075,"Montana","Powder River County","A_A",2,0,-2,-200,"undercount"
"6546",30075,"Montana","Powder River County","A_AIC",10,2,-8,-133.33,"undercount"
"6547",30075,"Montana","Powder River County","NHPI_A",0,0,0,0,"equal"
"6548",30075,"Montana","Powder River County","NHPI_AIC",3,3,0,0,"equal"
"6549",30077,"Montana","Powell County","A_A",31,23,-8,-29.63,"undercount"
"6550",30077,"Montana","Powell County","A_AIC",63,42,-21,-40,"undercount"
"6551",30077,"Montana","Powell County","NHPI_A",4,3,-1,-28.57,"undercount"
"6552",30077,"Montana","Powell County","NHPI_AIC",12,7,-5,-52.63,"undercount"
"6553",30079,"Montana","Prairie County","A_A",9,10,1,10.53,"overcount"
"6554",30079,"Montana","Prairie County","A_AIC",13,16,3,20.69,"overcount"
"6555",30079,"Montana","Prairie County","NHPI_A",0,0,0,0,"equal"
"6556",30079,"Montana","Prairie County","NHPI_AIC",1,2,1,66.67,"overcount"
"6557",30081,"Montana","Ravalli County","A_A",320,263,-57,-19.55,"undercount"
"6558",30081,"Montana","Ravalli County","A_AIC",491,503,12,2.41,"overcount"
"6559",30081,"Montana","Ravalli County","NHPI_A",45,51,6,12.5,"overcount"
"6560",30081,"Montana","Ravalli County","NHPI_AIC",92,98,6,6.32,"overcount"
"6561",30083,"Montana","Richland County","A_A",67,125,58,60.42,"overcount"
"6562",30083,"Montana","Richland County","A_AIC",115,173,58,40.28,"overcount"
"6563",30083,"Montana","Richland County","NHPI_A",5,5,0,0,"equal"
"6564",30083,"Montana","Richland County","NHPI_AIC",20,14,-6,-35.29,"undercount"
"6565",30085,"Montana","Roosevelt County","A_A",64,48,-16,-28.57,"undercount"
"6566",30085,"Montana","Roosevelt County","A_AIC",107,102,-5,-4.78,"undercount"
"6567",30085,"Montana","Roosevelt County","NHPI_A",6,0,-6,-200,"undercount"
"6568",30085,"Montana","Roosevelt County","NHPI_AIC",18,3,-15,-142.86,"undercount"
"6569",30087,"Montana","Rosebud County","A_A",143,33,-110,-125,"undercount"
"6570",30087,"Montana","Rosebud County","A_AIC",182,64,-118,-95.93,"undercount"
"6571",30087,"Montana","Rosebud County","NHPI_A",4,2,-2,-66.67,"undercount"
"6572",30087,"Montana","Rosebud County","NHPI_AIC",21,15,-6,-33.33,"undercount"
"6573",30089,"Montana","Sanders County","A_A",58,56,-2,-3.51,"undercount"
"6574",30089,"Montana","Sanders County","A_AIC",110,117,7,6.17,"overcount"
"6575",30089,"Montana","Sanders County","NHPI_A",3,3,0,0,"equal"
"6576",30089,"Montana","Sanders County","NHPI_AIC",20,27,7,29.79,"overcount"
"6577",30091,"Montana","Sheridan County","A_A",22,13,-9,-51.43,"undercount"
"6578",30091,"Montana","Sheridan County","A_AIC",37,26,-11,-34.92,"undercount"
"6579",30091,"Montana","Sheridan County","NHPI_A",0,0,0,0,"equal"
"6580",30091,"Montana","Sheridan County","NHPI_AIC",8,8,0,0,"equal"
"6581",30093,"Montana","Silver Bow County","A_A",290,216,-74,-29.25,"undercount"
"6582",30093,"Montana","Silver Bow County","A_AIC",490,361,-129,-30.32,"undercount"
"6583",30093,"Montana","Silver Bow County","NHPI_A",38,20,-18,-62.07,"undercount"
"6584",30093,"Montana","Silver Bow County","NHPI_AIC",86,67,-19,-24.84,"undercount"
"6585",30095,"Montana","Stillwater County","A_A",54,23,-31,-80.52,"undercount"
"6586",30095,"Montana","Stillwater County","A_AIC",100,60,-40,-50,"undercount"
"6587",30095,"Montana","Stillwater County","NHPI_A",6,0,-6,-200,"undercount"
"6588",30095,"Montana","Stillwater County","NHPI_AIC",19,20,1,5.13,"overcount"
"6589",30097,"Montana","Sweet Grass County","A_A",30,15,-15,-66.67,"undercount"
"6590",30097,"Montana","Sweet Grass County","A_AIC",50,38,-12,-27.27,"undercount"
"6591",30097,"Montana","Sweet Grass County","NHPI_A",1,3,2,100,"overcount"
"6592",30097,"Montana","Sweet Grass County","NHPI_AIC",4,14,10,111.11,"overcount"
"6593",30099,"Montana","Teton County","A_A",78,15,-63,-135.48,"undercount"
"6594",30099,"Montana","Teton County","A_AIC",102,36,-66,-95.65,"undercount"
"6595",30099,"Montana","Teton County","NHPI_A",1,6,5,142.86,"overcount"
"6596",30099,"Montana","Teton County","NHPI_AIC",9,19,10,71.43,"overcount"
"6597",30101,"Montana","Toole County","A_A",36,36,0,0,"equal"
"6598",30101,"Montana","Toole County","A_AIC",58,59,1,1.71,"overcount"
"6599",30101,"Montana","Toole County","NHPI_A",2,0,-2,-200,"undercount"
"6600",30101,"Montana","Toole County","NHPI_AIC",5,7,2,33.33,"overcount"
"6601",30103,"Montana","Treasure County","A_A",6,4,-2,-40,"undercount"
"6602",30103,"Montana","Treasure County","A_AIC",11,8,-3,-31.58,"undercount"
"6603",30103,"Montana","Treasure County","NHPI_A",0,1,1,200,"overcount"
"6604",30103,"Montana","Treasure County","NHPI_AIC",0,4,4,200,"overcount"
"6605",30105,"Montana","Valley County","A_A",77,19,-58,-120.83,"undercount"
"6606",30105,"Montana","Valley County","A_AIC",107,47,-60,-77.92,"undercount"
"6607",30105,"Montana","Valley County","NHPI_A",4,0,-4,-200,"undercount"
"6608",30105,"Montana","Valley County","NHPI_AIC",12,17,5,34.48,"overcount"
"6609",30107,"Montana","Wheatland County","A_A",12,3,-9,-120,"undercount"
"6610",30107,"Montana","Wheatland County","A_AIC",20,9,-11,-75.86,"undercount"
"6611",30107,"Montana","Wheatland County","NHPI_A",0,0,0,0,"equal"
"6612",30107,"Montana","Wheatland County","NHPI_AIC",1,10,9,163.64,"overcount"
"6613",30109,"Montana","Wibaux County","A_A",8,5,-3,-46.15,"undercount"
"6614",30109,"Montana","Wibaux County","A_AIC",12,13,1,8,"overcount"
"6615",30109,"Montana","Wibaux County","NHPI_A",2,2,0,0,"equal"
"6616",30109,"Montana","Wibaux County","NHPI_AIC",2,2,0,0,"equal"
"6617",30111,"Montana","Yellowstone County","A_A",1325,1281,-44,-3.38,"undercount"
"6618",30111,"Montana","Yellowstone County","A_AIC",2488,2521,33,1.32,"overcount"
"6619",30111,"Montana","Yellowstone County","NHPI_A",140,213,73,41.36,"overcount"
"6620",30111,"Montana","Yellowstone County","NHPI_AIC",466,554,88,17.25,"overcount"
"6621",31001,"Nebraska","Adams County","A_A",415,419,4,0.96,"overcount"
"6622",31001,"Nebraska","Adams County","A_AIC",497,546,49,9.4,"overcount"
"6623",31001,"Nebraska","Adams County","NHPI_A",32,9,-23,-112.2,"undercount"
"6624",31001,"Nebraska","Adams County","NHPI_AIC",50,38,-12,-27.27,"undercount"
"6625",31003,"Nebraska","Antelope County","A_A",31,22,-9,-33.96,"undercount"
"6626",31003,"Nebraska","Antelope County","A_AIC",41,35,-6,-15.79,"undercount"
"6627",31003,"Nebraska","Antelope County","NHPI_A",1,0,-1,-200,"undercount"
"6628",31003,"Nebraska","Antelope County","NHPI_AIC",2,0,-2,-200,"undercount"
"6629",31005,"Nebraska","Arthur County","A_A",1,0,-1,-200,"undercount"
"6630",31005,"Nebraska","Arthur County","A_AIC",3,3,0,0,"equal"
"6631",31005,"Nebraska","Arthur County","NHPI_A",0,0,0,0,"equal"
"6632",31005,"Nebraska","Arthur County","NHPI_AIC",0,0,0,0,"equal"
"6633",31007,"Nebraska","Banner County","A_A",2,2,0,0,"equal"
"6634",31007,"Nebraska","Banner County","A_AIC",2,6,4,100,"overcount"
"6635",31007,"Nebraska","Banner County","NHPI_A",0,0,0,0,"equal"
"6636",31007,"Nebraska","Banner County","NHPI_AIC",0,2,2,200,"overcount"
"6637",31009,"Nebraska","Blaine County","A_A",0,1,1,200,"overcount"
"6638",31009,"Nebraska","Blaine County","A_AIC",0,4,4,200,"overcount"
"6639",31009,"Nebraska","Blaine County","NHPI_A",0,0,0,0,"equal"
"6640",31009,"Nebraska","Blaine County","NHPI_AIC",0,1,1,200,"overcount"
"6641",31011,"Nebraska","Boone County","A_A",14,7,-7,-66.67,"undercount"
"6642",31011,"Nebraska","Boone County","A_AIC",19,14,-5,-30.3,"undercount"
"6643",31011,"Nebraska","Boone County","NHPI_A",0,0,0,0,"equal"
"6644",31011,"Nebraska","Boone County","NHPI_AIC",1,6,5,142.86,"overcount"
"6645",31013,"Nebraska","Box Butte County","A_A",82,71,-11,-14.38,"undercount"
"6646",31013,"Nebraska","Box Butte County","A_AIC",124,109,-15,-12.88,"undercount"
"6647",31013,"Nebraska","Box Butte County","NHPI_A",3,0,-3,-200,"undercount"
"6648",31013,"Nebraska","Box Butte County","NHPI_AIC",12,6,-6,-66.67,"undercount"
"6649",31015,"Nebraska","Boyd County","A_A",26,0,-26,-200,"undercount"
"6650",31015,"Nebraska","Boyd County","A_AIC",28,5,-23,-139.39,"undercount"
"6651",31015,"Nebraska","Boyd County","NHPI_A",2,0,-2,-200,"undercount"
"6652",31015,"Nebraska","Boyd County","NHPI_AIC",2,1,-1,-66.67,"undercount"
"6653",31017,"Nebraska","Brown County","A_A",6,6,0,0,"equal"
"6654",31017,"Nebraska","Brown County","A_AIC",12,17,5,34.48,"overcount"
"6655",31017,"Nebraska","Brown County","NHPI_A",3,0,-3,-200,"undercount"
"6656",31017,"Nebraska","Brown County","NHPI_AIC",3,7,4,80,"overcount"
"6657",31019,"Nebraska","Buffalo County","A_A",748,663,-85,-12.05,"undercount"
"6658",31019,"Nebraska","Buffalo County","A_AIC",930,867,-63,-7.01,"undercount"
"6659",31019,"Nebraska","Buffalo County","NHPI_A",76,35,-41,-73.87,"undercount"
"6660",31019,"Nebraska","Buffalo County","NHPI_AIC",99,62,-37,-45.96,"undercount"
"6661",31021,"Nebraska","Burt County","A_A",27,35,8,25.81,"overcount"
"6662",31021,"Nebraska","Burt County","A_AIC",59,49,-10,-18.52,"undercount"
"6663",31021,"Nebraska","Burt County","NHPI_A",7,17,10,83.33,"overcount"
"6664",31021,"Nebraska","Burt County","NHPI_AIC",13,23,10,55.56,"overcount"
"6665",31023,"Nebraska","Butler County","A_A",33,9,-24,-114.29,"undercount"
"6666",31023,"Nebraska","Butler County","A_AIC",51,28,-23,-58.23,"undercount"
"6667",31023,"Nebraska","Butler County","NHPI_A",4,1,-3,-120,"undercount"
"6668",31023,"Nebraska","Butler County","NHPI_AIC",9,2,-7,-127.27,"undercount"
"6669",31025,"Nebraska","Cass County","A_A",144,104,-40,-32.26,"undercount"
"6670",31025,"Nebraska","Cass County","A_AIC",252,230,-22,-9.13,"undercount"
"6671",31025,"Nebraska","Cass County","NHPI_A",16,8,-8,-66.67,"undercount"
"6672",31025,"Nebraska","Cass County","NHPI_AIC",43,32,-11,-29.33,"undercount"
"6673",31027,"Nebraska","Cedar County","A_A",22,9,-13,-83.87,"undercount"
"6674",31027,"Nebraska","Cedar County","A_AIC",50,33,-17,-40.96,"undercount"
"6675",31027,"Nebraska","Cedar County","NHPI_A",0,2,2,200,"overcount"
"6676",31027,"Nebraska","Cedar County","NHPI_AIC",4,3,-1,-28.57,"undercount"
"6677",31029,"Nebraska","Chase County","A_A",9,11,2,20,"overcount"
"6678",31029,"Nebraska","Chase County","A_AIC",18,15,-3,-18.18,"undercount"
"6679",31029,"Nebraska","Chase County","NHPI_A",0,0,0,0,"equal"
"6680",31029,"Nebraska","Chase County","NHPI_AIC",2,2,0,0,"equal"
"6681",31031,"Nebraska","Cherry County","A_A",34,7,-27,-131.71,"undercount"
"6682",31031,"Nebraska","Cherry County","A_AIC",70,34,-36,-69.23,"undercount"
"6683",31031,"Nebraska","Cherry County","NHPI_A",3,0,-3,-200,"undercount"
"6684",31031,"Nebraska","Cherry County","NHPI_AIC",7,4,-3,-54.55,"undercount"
"6685",31033,"Nebraska","Cheyenne County","A_A",98,77,-21,-24,"undercount"
"6686",31033,"Nebraska","Cheyenne County","A_AIC",135,103,-32,-26.89,"undercount"
"6687",31033,"Nebraska","Cheyenne County","NHPI_A",7,0,-7,-200,"undercount"
"6688",31033,"Nebraska","Cheyenne County","NHPI_AIC",17,12,-5,-34.48,"undercount"
"6689",31035,"Nebraska","Clay County","A_A",17,10,-7,-51.85,"undercount"
"6690",31035,"Nebraska","Clay County","A_AIC",30,16,-14,-60.87,"undercount"
"6691",31035,"Nebraska","Clay County","NHPI_A",18,0,-18,-200,"undercount"
"6692",31035,"Nebraska","Clay County","NHPI_AIC",18,8,-10,-76.92,"undercount"
"6693",31037,"Nebraska","Colfax County","A_A",125,50,-75,-85.71,"undercount"
"6694",31037,"Nebraska","Colfax County","A_AIC",146,76,-70,-63.06,"undercount"
"6695",31037,"Nebraska","Colfax County","NHPI_A",71,2,-69,-189.04,"undercount"
"6696",31037,"Nebraska","Colfax County","NHPI_AIC",73,7,-66,-165,"undercount"
"6697",31039,"Nebraska","Cuming County","A_A",46,19,-27,-83.08,"undercount"
"6698",31039,"Nebraska","Cuming County","A_AIC",65,44,-21,-38.53,"undercount"
"6699",31039,"Nebraska","Cuming County","NHPI_A",3,9,6,100,"overcount"
"6700",31039,"Nebraska","Cuming County","NHPI_AIC",6,20,14,107.69,"overcount"
"6701",31041,"Nebraska","Custer County","A_A",24,19,-5,-23.26,"undercount"
"6702",31041,"Nebraska","Custer County","A_AIC",46,26,-20,-55.56,"undercount"
"6703",31041,"Nebraska","Custer County","NHPI_A",2,2,0,0,"equal"
"6704",31041,"Nebraska","Custer County","NHPI_AIC",6,2,-4,-100,"undercount"
"6705",31043,"Nebraska","Dakota County","A_A",781,602,-179,-25.89,"undercount"
"6706",31043,"Nebraska","Dakota County","A_AIC",895,674,-221,-28.17,"undercount"
"6707",31043,"Nebraska","Dakota County","NHPI_A",119,154,35,25.64,"overcount"
"6708",31043,"Nebraska","Dakota County","NHPI_AIC",143,168,25,16.08,"overcount"
"6709",31045,"Nebraska","Dawes County","A_A",142,53,-89,-91.28,"undercount"
"6710",31045,"Nebraska","Dawes County","A_AIC",188,104,-84,-57.53,"undercount"
"6711",31045,"Nebraska","Dawes County","NHPI_A",29,6,-23,-131.43,"undercount"
"6712",31045,"Nebraska","Dawes County","NHPI_AIC",44,19,-25,-79.37,"undercount"
"6713",31047,"Nebraska","Dawson County","A_A",324,192,-132,-51.16,"undercount"
"6714",31047,"Nebraska","Dawson County","A_AIC",365,231,-134,-44.97,"undercount"
"6715",31047,"Nebraska","Dawson County","NHPI_A",106,42,-64,-86.49,"undercount"
"6716",31047,"Nebraska","Dawson County","NHPI_AIC",118,65,-53,-57.92,"undercount"
"6717",31049,"Nebraska","Deuel County","A_A",7,6,-1,-15.38,"undercount"
"6718",31049,"Nebraska","Deuel County","A_AIC",10,10,0,0,"equal"
"6719",31049,"Nebraska","Deuel County","NHPI_A",0,0,0,0,"equal"
"6720",31049,"Nebraska","Deuel County","NHPI_AIC",0,3,3,200,"overcount"
"6721",31051,"Nebraska","Dixon County","A_A",22,19,-3,-14.63,"undercount"
"6722",31051,"Nebraska","Dixon County","A_AIC",32,26,-6,-20.69,"undercount"
"6723",31051,"Nebraska","Dixon County","NHPI_A",12,0,-12,-200,"undercount"
"6724",31051,"Nebraska","Dixon County","NHPI_AIC",13,14,1,7.41,"overcount"
"6725",31053,"Nebraska","Dodge County","A_A",251,184,-67,-30.8,"undercount"
"6726",31053,"Nebraska","Dodge County","A_AIC",380,290,-90,-26.87,"undercount"
"6727",31053,"Nebraska","Dodge County","NHPI_A",144,12,-132,-169.23,"undercount"
"6728",31053,"Nebraska","Dodge County","NHPI_AIC",170,28,-142,-143.43,"undercount"
"6729",31055,"Nebraska","Douglas County","A_A",25130,27761,2631,9.95,"overcount"
"6730",31055,"Nebraska","Douglas County","A_AIC",29630,33451,3821,12.11,"overcount"
"6731",31055,"Nebraska","Douglas County","NHPI_A",527,412,-115,-24.49,"undercount"
"6732",31055,"Nebraska","Douglas County","NHPI_AIC",1323,1168,-155,-12.44,"undercount"
"6733",31057,"Nebraska","Dundy County","A_A",3,1,-2,-100,"undercount"
"6734",31057,"Nebraska","Dundy County","A_AIC",9,9,0,0,"equal"
"6735",31057,"Nebraska","Dundy County","NHPI_A",4,3,-1,-28.57,"undercount"
"6736",31057,"Nebraska","Dundy County","NHPI_AIC",5,3,-2,-50,"undercount"
"6737",31059,"Nebraska","Fillmore County","A_A",40,13,-27,-101.89,"undercount"
"6738",31059,"Nebraska","Fillmore County","A_AIC",55,24,-31,-78.48,"undercount"
"6739",31059,"Nebraska","Fillmore County","NHPI_A",0,1,1,200,"overcount"
"6740",31059,"Nebraska","Fillmore County","NHPI_AIC",4,3,-1,-28.57,"undercount"
"6741",31061,"Nebraska","Franklin County","A_A",5,14,9,94.74,"overcount"
"6742",31061,"Nebraska","Franklin County","A_AIC",16,22,6,31.58,"overcount"
"6743",31061,"Nebraska","Franklin County","NHPI_A",0,0,0,0,"equal"
"6744",31061,"Nebraska","Franklin County","NHPI_AIC",2,3,1,40,"overcount"
"6745",31063,"Nebraska","Frontier County","A_A",5,0,-5,-200,"undercount"
"6746",31063,"Nebraska","Frontier County","A_AIC",14,7,-7,-66.67,"undercount"
"6747",31063,"Nebraska","Frontier County","NHPI_A",0,3,3,200,"overcount"
"6748",31063,"Nebraska","Frontier County","NHPI_AIC",1,13,12,171.43,"overcount"
"6749",31065,"Nebraska","Furnas County","A_A",19,6,-13,-104,"undercount"
"6750",31065,"Nebraska","Furnas County","A_AIC",33,33,0,0,"equal"
"6751",31065,"Nebraska","Furnas County","NHPI_A",2,0,-2,-200,"undercount"
"6752",31065,"Nebraska","Furnas County","NHPI_AIC",5,2,-3,-85.71,"undercount"
"6753",31067,"Nebraska","Gage County","A_A",154,99,-55,-43.48,"undercount"
"6754",31067,"Nebraska","Gage County","A_AIC",213,150,-63,-34.71,"undercount"
"6755",31067,"Nebraska","Gage County","NHPI_A",3,1,-2,-100,"undercount"
"6756",31067,"Nebraska","Gage County","NHPI_AIC",24,13,-11,-59.46,"undercount"
"6757",31069,"Nebraska","Garden County","A_A",0,2,2,200,"overcount"
"6758",31069,"Nebraska","Garden County","A_AIC",7,4,-3,-54.55,"undercount"
"6759",31069,"Nebraska","Garden County","NHPI_A",3,2,-1,-40,"undercount"
"6760",31069,"Nebraska","Garden County","NHPI_AIC",3,5,2,50,"overcount"
"6761",31071,"Nebraska","Garfield County","A_A",2,0,-2,-200,"undercount"
"6762",31071,"Nebraska","Garfield County","A_AIC",3,0,-3,-200,"undercount"
"6763",31071,"Nebraska","Garfield County","NHPI_A",1,0,-1,-200,"undercount"
"6764",31071,"Nebraska","Garfield County","NHPI_AIC",2,2,0,0,"equal"
"6765",31073,"Nebraska","Gosper County","A_A",11,13,2,16.67,"overcount"
"6766",31073,"Nebraska","Gosper County","A_AIC",16,19,3,17.14,"overcount"
"6767",31073,"Nebraska","Gosper County","NHPI_A",0,0,0,0,"equal"
"6768",31073,"Nebraska","Gosper County","NHPI_AIC",1,7,6,150,"overcount"
"6769",31075,"Nebraska","Grant County","A_A",1,1,0,0,"equal"
"6770",31075,"Nebraska","Grant County","A_AIC",4,1,-3,-120,"undercount"
"6771",31075,"Nebraska","Grant County","NHPI_A",0,0,0,0,"equal"
"6772",31075,"Nebraska","Grant County","NHPI_AIC",0,0,0,0,"equal"
"6773",31077,"Nebraska","Greeley County","A_A",7,6,-1,-15.38,"undercount"
"6774",31077,"Nebraska","Greeley County","A_AIC",8,11,3,31.58,"overcount"
"6775",31077,"Nebraska","Greeley County","NHPI_A",0,1,1,200,"overcount"
"6776",31077,"Nebraska","Greeley County","NHPI_AIC",0,6,6,200,"overcount"
"6777",31079,"Nebraska","Hall County","A_A",858,696,-162,-20.85,"undercount"
"6778",31079,"Nebraska","Hall County","A_AIC",1142,911,-231,-22.5,"undercount"
"6779",31079,"Nebraska","Hall County","NHPI_A",328,29,-299,-167.51,"undercount"
"6780",31079,"Nebraska","Hall County","NHPI_AIC",406,39,-367,-164.94,"undercount"
"6781",31081,"Nebraska","Hamilton County","A_A",36,17,-19,-71.7,"undercount"
"6782",31081,"Nebraska","Hamilton County","A_AIC",59,38,-21,-43.3,"undercount"
"6783",31081,"Nebraska","Hamilton County","NHPI_A",1,0,-1,-200,"undercount"
"6784",31081,"Nebraska","Hamilton County","NHPI_AIC",5,0,-5,-200,"undercount"
"6785",31083,"Nebraska","Harlan County","A_A",8,11,3,31.58,"overcount"
"6786",31083,"Nebraska","Harlan County","A_AIC",23,14,-9,-48.65,"undercount"
"6787",31083,"Nebraska","Harlan County","NHPI_A",0,0,0,0,"equal"
"6788",31083,"Nebraska","Harlan County","NHPI_AIC",3,3,0,0,"equal"
"6789",31085,"Nebraska","Hayes County","A_A",5,2,-3,-85.71,"undercount"
"6790",31085,"Nebraska","Hayes County","A_AIC",9,15,6,50,"overcount"
"6791",31085,"Nebraska","Hayes County","NHPI_A",1,0,-1,-200,"undercount"
"6792",31085,"Nebraska","Hayes County","NHPI_AIC",1,5,4,133.33,"overcount"
"6793",31087,"Nebraska","Hitchcock County","A_A",4,2,-2,-66.67,"undercount"
"6794",31087,"Nebraska","Hitchcock County","A_AIC",11,4,-7,-93.33,"undercount"
"6795",31087,"Nebraska","Hitchcock County","NHPI_A",0,4,4,200,"overcount"
"6796",31087,"Nebraska","Hitchcock County","NHPI_AIC",0,6,6,200,"overcount"
"6797",31089,"Nebraska","Holt County","A_A",54,50,-4,-7.69,"undercount"
"6798",31089,"Nebraska","Holt County","A_AIC",74,59,-15,-22.56,"undercount"
"6799",31089,"Nebraska","Holt County","NHPI_A",11,1,-10,-166.67,"undercount"
"6800",31089,"Nebraska","Holt County","NHPI_AIC",16,1,-15,-176.47,"undercount"
"6801",31091,"Nebraska","Hooker County","A_A",2,1,-1,-66.67,"undercount"
"6802",31091,"Nebraska","Hooker County","A_AIC",3,2,-1,-40,"undercount"
"6803",31091,"Nebraska","Hooker County","NHPI_A",0,0,0,0,"equal"
"6804",31091,"Nebraska","Hooker County","NHPI_AIC",1,2,1,66.67,"overcount"
"6805",31093,"Nebraska","Howard County","A_A",39,12,-27,-105.88,"undercount"
"6806",31093,"Nebraska","Howard County","A_AIC",47,30,-17,-44.16,"undercount"
"6807",31093,"Nebraska","Howard County","NHPI_A",6,1,-5,-142.86,"undercount"
"6808",31093,"Nebraska","Howard County","NHPI_AIC",7,8,1,13.33,"overcount"
"6809",31095,"Nebraska","Jefferson County","A_A",28,18,-10,-43.48,"undercount"
"6810",31095,"Nebraska","Jefferson County","A_AIC",47,42,-5,-11.24,"undercount"
"6811",31095,"Nebraska","Jefferson County","NHPI_A",2,0,-2,-200,"undercount"
"6812",31095,"Nebraska","Jefferson County","NHPI_AIC",7,9,2,25,"overcount"
"6813",31097,"Nebraska","Johnson County","A_A",66,76,10,14.08,"overcount"
"6814",31097,"Nebraska","Johnson County","A_AIC",75,93,18,21.43,"overcount"
"6815",31097,"Nebraska","Johnson County","NHPI_A",0,0,0,0,"equal"
"6816",31097,"Nebraska","Johnson County","NHPI_AIC",3,0,-3,-200,"undercount"
"6817",31099,"Nebraska","Kearney County","A_A",23,13,-10,-55.56,"undercount"
"6818",31099,"Nebraska","Kearney County","A_AIC",49,19,-30,-88.24,"undercount"
"6819",31099,"Nebraska","Kearney County","NHPI_A",10,2,-8,-133.33,"undercount"
"6820",31099,"Nebraska","Kearney County","NHPI_AIC",16,16,0,0,"equal"
"6821",31101,"Nebraska","Keith County","A_A",58,39,-19,-39.18,"undercount"
"6822",31101,"Nebraska","Keith County","A_AIC",99,66,-33,-40,"undercount"
"6823",31101,"Nebraska","Keith County","NHPI_A",0,7,7,200,"overcount"
"6824",31101,"Nebraska","Keith County","NHPI_AIC",9,19,10,71.43,"overcount"
"6825",31103,"Nebraska","Keya Paha County","A_A",5,0,-5,-200,"undercount"
"6826",31103,"Nebraska","Keya Paha County","A_AIC",5,0,-5,-200,"undercount"
"6827",31103,"Nebraska","Keya Paha County","NHPI_A",0,1,1,200,"overcount"
"6828",31103,"Nebraska","Keya Paha County","NHPI_AIC",0,2,2,200,"overcount"
"6829",31105,"Nebraska","Kimball County","A_A",33,15,-18,-75,"undercount"
"6830",31105,"Nebraska","Kimball County","A_AIC",54,16,-38,-108.57,"undercount"
"6831",31105,"Nebraska","Kimball County","NHPI_A",6,0,-6,-200,"undercount"
"6832",31105,"Nebraska","Kimball County","NHPI_AIC",14,2,-12,-150,"undercount"
"6833",31107,"Nebraska","Knox County","A_A",37,28,-9,-27.69,"undercount"
"6834",31107,"Nebraska","Knox County","A_AIC",57,52,-5,-9.17,"undercount"
"6835",31107,"Nebraska","Knox County","NHPI_A",5,3,-2,-50,"undercount"
"6836",31107,"Nebraska","Knox County","NHPI_AIC",16,7,-9,-78.26,"undercount"
"6837",31109,"Nebraska","Lancaster County","A_A",15033,14076,-957,-6.58,"undercount"
"6838",31109,"Nebraska","Lancaster County","A_AIC",17759,17303,-456,-2.6,"undercount"
"6839",31109,"Nebraska","Lancaster County","NHPI_A",341,177,-164,-63.32,"undercount"
"6840",31109,"Nebraska","Lancaster County","NHPI_AIC",702,494,-208,-34.78,"undercount"
"6841",31111,"Nebraska","Lincoln County","A_A",304,337,33,10.3,"overcount"
"6842",31111,"Nebraska","Lincoln County","A_AIC",431,429,-2,-0.47,"undercount"
"6843",31111,"Nebraska","Lincoln County","NHPI_A",27,6,-21,-127.27,"undercount"
"6844",31111,"Nebraska","Lincoln County","NHPI_AIC",55,23,-32,-82.05,"undercount"
"6845",31113,"Nebraska","Logan County","A_A",3,4,1,28.57,"overcount"
"6846",31113,"Nebraska","Logan County","A_AIC",4,6,2,40,"overcount"
"6847",31113,"Nebraska","Logan County","NHPI_A",0,0,0,0,"equal"
"6848",31113,"Nebraska","Logan County","NHPI_AIC",0,0,0,0,"equal"
"6849",31115,"Nebraska","Loup County","A_A",1,1,0,0,"equal"
"6850",31115,"Nebraska","Loup County","A_AIC",1,10,9,163.64,"overcount"
"6851",31115,"Nebraska","Loup County","NHPI_A",0,0,0,0,"equal"
"6852",31115,"Nebraska","Loup County","NHPI_AIC",0,0,0,0,"equal"
"6853",31117,"Nebraska","McPherson County","A_A",1,2,1,66.67,"overcount"
"6854",31117,"Nebraska","McPherson County","A_AIC",1,7,6,150,"overcount"
"6855",31117,"Nebraska","McPherson County","NHPI_A",0,0,0,0,"equal"
"6856",31117,"Nebraska","McPherson County","NHPI_AIC",0,0,0,0,"equal"
"6857",31119,"Nebraska","Madison County","A_A",650,445,-205,-37.44,"undercount"
"6858",31119,"Nebraska","Madison County","A_AIC",789,595,-194,-28.03,"undercount"
"6859",31119,"Nebraska","Madison County","NHPI_A",27,7,-20,-117.65,"undercount"
"6860",31119,"Nebraska","Madison County","NHPI_AIC",64,53,-11,-18.8,"undercount"
"6861",31121,"Nebraska","Merrick County","A_A",87,29,-58,-100,"undercount"
"6862",31121,"Nebraska","Merrick County","A_AIC",111,54,-57,-69.09,"undercount"
"6863",31121,"Nebraska","Merrick County","NHPI_A",9,3,-6,-100,"undercount"
"6864",31121,"Nebraska","Merrick County","NHPI_AIC",9,10,1,10.53,"overcount"
"6865",31123,"Nebraska","Morrill County","A_A",29,20,-9,-36.73,"undercount"
"6866",31123,"Nebraska","Morrill County","A_AIC",42,29,-13,-36.62,"undercount"
"6867",31123,"Nebraska","Morrill County","NHPI_A",0,0,0,0,"equal"
"6868",31123,"Nebraska","Morrill County","NHPI_AIC",1,9,8,160,"overcount"
"6869",31125,"Nebraska","Nance County","A_A",5,5,0,0,"equal"
"6870",31125,"Nebraska","Nance County","A_AIC",14,30,16,72.73,"overcount"
"6871",31125,"Nebraska","Nance County","NHPI_A",1,0,-1,-200,"undercount"
"6872",31125,"Nebraska","Nance County","NHPI_AIC",1,7,6,150,"overcount"
"6873",31127,"Nebraska","Nemaha County","A_A",39,31,-8,-22.86,"undercount"
"6874",31127,"Nebraska","Nemaha County","A_AIC",54,42,-12,-25,"undercount"
"6875",31127,"Nebraska","Nemaha County","NHPI_A",8,0,-8,-200,"undercount"
"6876",31127,"Nebraska","Nemaha County","NHPI_AIC",13,4,-9,-105.88,"undercount"
"6877",31129,"Nebraska","Nuckolls County","A_A",61,4,-57,-175.38,"undercount"
"6878",31129,"Nebraska","Nuckolls County","A_AIC",68,8,-60,-157.89,"undercount"
"6879",31129,"Nebraska","Nuckolls County","NHPI_A",0,0,0,0,"equal"
"6880",31129,"Nebraska","Nuckolls County","NHPI_AIC",3,1,-2,-100,"undercount"
"6881",31131,"Nebraska","Otoe County","A_A",126,86,-40,-37.74,"undercount"
"6882",31131,"Nebraska","Otoe County","A_AIC",181,182,1,0.55,"overcount"
"6883",31131,"Nebraska","Otoe County","NHPI_A",24,0,-24,-200,"undercount"
"6884",31131,"Nebraska","Otoe County","NHPI_AIC",34,7,-27,-131.71,"undercount"
"6885",31133,"Nebraska","Pawnee County","A_A",8,0,-8,-200,"undercount"
"6886",31133,"Nebraska","Pawnee County","A_AIC",23,11,-12,-70.59,"undercount"
"6887",31133,"Nebraska","Pawnee County","NHPI_A",0,1,1,200,"overcount"
"6888",31133,"Nebraska","Pawnee County","NHPI_AIC",1,2,1,66.67,"overcount"
"6889",31135,"Nebraska","Perkins County","A_A",6,5,-1,-18.18,"undercount"
"6890",31135,"Nebraska","Perkins County","A_AIC",12,19,7,45.16,"overcount"
"6891",31135,"Nebraska","Perkins County","NHPI_A",3,3,0,0,"equal"
"6892",31135,"Nebraska","Perkins County","NHPI_AIC",5,6,1,18.18,"overcount"
"6893",31137,"Nebraska","Phelps County","A_A",45,29,-16,-43.24,"undercount"
"6894",31137,"Nebraska","Phelps County","A_AIC",65,45,-20,-36.36,"undercount"
"6895",31137,"Nebraska","Phelps County","NHPI_A",3,1,-2,-100,"undercount"
"6896",31137,"Nebraska","Phelps County","NHPI_AIC",6,7,1,15.38,"overcount"
"6897",31139,"Nebraska","Pierce County","A_A",29,12,-17,-82.93,"undercount"
"6898",31139,"Nebraska","Pierce County","A_AIC",43,39,-4,-9.76,"undercount"
"6899",31139,"Nebraska","Pierce County","NHPI_A",0,2,2,200,"overcount"
"6900",31139,"Nebraska","Pierce County","NHPI_AIC",1,3,2,100,"overcount"
"6901",31141,"Nebraska","Platte County","A_A",404,198,-206,-68.44,"undercount"
"6902",31141,"Nebraska","Platte County","A_AIC",489,298,-191,-48.54,"undercount"
"6903",31141,"Nebraska","Platte County","NHPI_A",61,17,-44,-112.82,"undercount"
"6904",31141,"Nebraska","Platte County","NHPI_AIC",80,32,-48,-85.71,"undercount"
"6905",31143,"Nebraska","Polk County","A_A",12,2,-10,-142.86,"undercount"
"6906",31143,"Nebraska","Polk County","A_AIC",24,4,-20,-142.86,"undercount"
"6907",31143,"Nebraska","Polk County","NHPI_A",3,1,-2,-100,"undercount"
"6908",31143,"Nebraska","Polk County","NHPI_AIC",5,2,-3,-85.71,"undercount"
"6909",31145,"Nebraska","Red Willow County","A_A",39,39,0,0,"equal"
"6910",31145,"Nebraska","Red Willow County","A_AIC",67,57,-10,-16.13,"undercount"
"6911",31145,"Nebraska","Red Willow County","NHPI_A",2,12,10,142.86,"overcount"
"6912",31145,"Nebraska","Red Willow County","NHPI_AIC",7,15,8,72.73,"overcount"
"6913",31147,"Nebraska","Richardson County","A_A",41,35,-6,-15.79,"undercount"
"6914",31147,"Nebraska","Richardson County","A_AIC",79,56,-23,-34.07,"undercount"
"6915",31147,"Nebraska","Richardson County","NHPI_A",1,0,-1,-200,"undercount"
"6916",31147,"Nebraska","Richardson County","NHPI_AIC",6,0,-6,-200,"undercount"
"6917",31149,"Nebraska","Rock County","A_A",5,1,-4,-133.33,"undercount"
"6918",31149,"Nebraska","Rock County","A_AIC",6,5,-1,-18.18,"undercount"
"6919",31149,"Nebraska","Rock County","NHPI_A",0,0,0,0,"equal"
"6920",31149,"Nebraska","Rock County","NHPI_AIC",0,3,3,200,"overcount"
"6921",31151,"Nebraska","Saline County","A_A",428,281,-147,-41.47,"undercount"
"6922",31151,"Nebraska","Saline County","A_AIC",488,327,-161,-39.51,"undercount"
"6923",31151,"Nebraska","Saline County","NHPI_A",93,46,-47,-67.63,"undercount"
"6924",31151,"Nebraska","Saline County","NHPI_AIC",103,52,-51,-65.81,"undercount"
"6925",31153,"Nebraska","Sarpy County","A_A",5158,4819,-339,-6.8,"undercount"
"6926",31153,"Nebraska","Sarpy County","A_AIC",7649,7478,-171,-2.26,"undercount"
"6927",31153,"Nebraska","Sarpy County","NHPI_A",242,227,-15,-6.4,"undercount"
"6928",31153,"Nebraska","Sarpy County","NHPI_AIC",617,598,-19,-3.13,"undercount"
"6929",31155,"Nebraska","Saunders County","A_A",107,86,-21,-21.76,"undercount"
"6930",31155,"Nebraska","Saunders County","A_AIC",226,178,-48,-23.76,"undercount"
"6931",31155,"Nebraska","Saunders County","NHPI_A",2,5,3,85.71,"overcount"
"6932",31155,"Nebraska","Saunders County","NHPI_AIC",14,10,-4,-33.33,"undercount"
"6933",31157,"Nebraska","Scotts Bluff County","A_A",323,285,-38,-12.5,"undercount"
"6934",31157,"Nebraska","Scotts Bluff County","A_AIC",465,414,-51,-11.6,"undercount"
"6935",31157,"Nebraska","Scotts Bluff County","NHPI_A",44,36,-8,-20,"undercount"
"6936",31157,"Nebraska","Scotts Bluff County","NHPI_AIC",76,74,-2,-2.67,"undercount"
"6937",31159,"Nebraska","Seward County","A_A",86,57,-29,-40.56,"undercount"
"6938",31159,"Nebraska","Seward County","A_AIC",159,126,-33,-23.16,"undercount"
"6939",31159,"Nebraska","Seward County","NHPI_A",3,6,3,66.67,"overcount"
"6940",31159,"Nebraska","Seward County","NHPI_AIC",15,19,4,23.53,"overcount"
"6941",31161,"Nebraska","Sheridan County","A_A",37,29,-8,-24.24,"undercount"
"6942",31161,"Nebraska","Sheridan County","A_AIC",73,46,-27,-45.38,"undercount"
"6943",31161,"Nebraska","Sheridan County","NHPI_A",13,2,-11,-146.67,"undercount"
"6944",31161,"Nebraska","Sheridan County","NHPI_AIC",18,9,-9,-66.67,"undercount"
"6945",31163,"Nebraska","Sherman County","A_A",13,5,-8,-88.89,"undercount"
"6946",31163,"Nebraska","Sherman County","A_AIC",18,12,-6,-40,"undercount"
"6947",31163,"Nebraska","Sherman County","NHPI_A",0,2,2,200,"overcount"
"6948",31163,"Nebraska","Sherman County","NHPI_AIC",1,14,13,173.33,"overcount"
"6949",31165,"Nebraska","Sioux County","A_A",3,4,1,28.57,"overcount"
"6950",31165,"Nebraska","Sioux County","A_AIC",6,8,2,28.57,"overcount"
"6951",31165,"Nebraska","Sioux County","NHPI_A",0,2,2,200,"overcount"
"6952",31165,"Nebraska","Sioux County","NHPI_AIC",1,4,3,120,"overcount"
"6953",31167,"Nebraska","Stanton County","A_A",17,18,1,5.71,"overcount"
"6954",31167,"Nebraska","Stanton County","A_AIC",36,48,12,28.57,"overcount"
"6955",31167,"Nebraska","Stanton County","NHPI_A",1,7,6,150,"overcount"
"6956",31167,"Nebraska","Stanton County","NHPI_AIC",2,7,5,111.11,"overcount"
"6957",31169,"Nebraska","Thayer County","A_A",17,10,-7,-51.85,"undercount"
"6958",31169,"Nebraska","Thayer County","A_AIC",25,20,-5,-22.22,"undercount"
"6959",31169,"Nebraska","Thayer County","NHPI_A",1,5,4,133.33,"overcount"
"6960",31169,"Nebraska","Thayer County","NHPI_AIC",4,21,17,136,"overcount"
"6961",31171,"Nebraska","Thomas County","A_A",2,0,-2,-200,"undercount"
"6962",31171,"Nebraska","Thomas County","A_AIC",4,3,-1,-28.57,"undercount"
"6963",31171,"Nebraska","Thomas County","NHPI_A",0,0,0,0,"equal"
"6964",31171,"Nebraska","Thomas County","NHPI_AIC",0,0,0,0,"equal"
"6965",31173,"Nebraska","Thurston County","A_A",47,10,-37,-129.82,"undercount"
"6966",31173,"Nebraska","Thurston County","A_AIC",82,17,-65,-131.31,"undercount"
"6967",31173,"Nebraska","Thurston County","NHPI_A",2,4,2,66.67,"overcount"
"6968",31173,"Nebraska","Thurston County","NHPI_AIC",7,5,-2,-33.33,"undercount"
"6969",31175,"Nebraska","Valley County","A_A",17,5,-12,-109.09,"undercount"
"6970",31175,"Nebraska","Valley County","A_AIC",31,12,-19,-88.37,"undercount"
"6971",31175,"Nebraska","Valley County","NHPI_A",2,5,3,85.71,"overcount"
"6972",31175,"Nebraska","Valley County","NHPI_AIC",2,7,5,111.11,"overcount"
"6973",31177,"Nebraska","Washington County","A_A",89,100,11,11.64,"overcount"
"6974",31177,"Nebraska","Washington County","A_AIC",170,184,14,7.91,"overcount"
"6975",31177,"Nebraska","Washington County","NHPI_A",26,1,-25,-185.19,"undercount"
"6976",31177,"Nebraska","Washington County","NHPI_AIC",51,16,-35,-104.48,"undercount"
"6977",31179,"Nebraska","Wayne County","A_A",61,122,61,66.67,"overcount"
"6978",31179,"Nebraska","Wayne County","A_AIC",102,203,101,66.23,"overcount"
"6979",31179,"Nebraska","Wayne County","NHPI_A",13,8,-5,-47.62,"undercount"
"6980",31179,"Nebraska","Wayne County","NHPI_AIC",22,70,48,104.35,"overcount"
"6981",31181,"Nebraska","Webster County","A_A",13,11,-2,-16.67,"undercount"
"6982",31181,"Nebraska","Webster County","A_AIC",25,21,-4,-17.39,"undercount"
"6983",31181,"Nebraska","Webster County","NHPI_A",14,0,-14,-200,"undercount"
"6984",31181,"Nebraska","Webster County","NHPI_AIC",17,1,-16,-177.78,"undercount"
"6985",31183,"Nebraska","Wheeler County","A_A",3,0,-3,-200,"undercount"
"6986",31183,"Nebraska","Wheeler County","A_AIC",4,5,1,22.22,"overcount"
"6987",31183,"Nebraska","Wheeler County","NHPI_A",0,0,0,0,"equal"
"6988",31183,"Nebraska","Wheeler County","NHPI_AIC",0,1,1,200,"overcount"
"6989",31185,"Nebraska","York County","A_A",101,90,-11,-11.52,"undercount"
"6990",31185,"Nebraska","York County","A_AIC",157,124,-33,-23.49,"undercount"
"6991",31185,"Nebraska","York County","NHPI_A",9,2,-7,-127.27,"undercount"
"6992",31185,"Nebraska","York County","NHPI_AIC",21,13,-8,-47.06,"undercount"
"6993",32001,"Nevada","Churchill County","A_A",774,659,-115,-16.05,"undercount"
"6994",32001,"Nevada","Churchill County","A_AIC",1247,1088,-159,-13.62,"undercount"
"6995",32001,"Nevada","Churchill County","NHPI_A",99,87,-12,-12.9,"undercount"
"6996",32001,"Nevada","Churchill County","NHPI_AIC",207,174,-33,-17.32,"undercount"
"6997",32003,"Nevada","Clark County","A_A",247040,234212,-12828,-5.33,"undercount"
"6998",32003,"Nevada","Clark County","A_AIC",308515,287932,-20583,-6.9,"undercount"
"6999",32003,"Nevada","Clark County","NHPI_A",21654,19091,-2563,-12.58,"undercount"
"7000",32003,"Nevada","Clark County","NHPI_AIC",42452,37722,-4730,-11.8,"undercount"
"7001",32005,"Nevada","Douglas County","A_A",973,902,-71,-7.57,"undercount"
"7002",32005,"Nevada","Douglas County","A_AIC",1570,1483,-87,-5.7,"undercount"
"7003",32005,"Nevada","Douglas County","NHPI_A",139,81,-58,-52.73,"undercount"
"7004",32005,"Nevada","Douglas County","NHPI_AIC",325,259,-66,-22.6,"undercount"
"7005",32007,"Nevada","Elko County","A_A",718,560,-158,-24.73,"undercount"
"7006",32007,"Nevada","Elko County","A_AIC",1188,958,-230,-21.44,"undercount"
"7007",32007,"Nevada","Elko County","NHPI_A",128,85,-43,-40.38,"undercount"
"7008",32007,"Nevada","Elko County","NHPI_AIC",305,226,-79,-29.76,"undercount"
"7009",32009,"Nevada","Esmeralda County","A_A",8,6,-2,-28.57,"undercount"
"7010",32009,"Nevada","Esmeralda County","A_AIC",16,11,-5,-37.04,"undercount"
"7011",32009,"Nevada","Esmeralda County","NHPI_A",1,0,-1,-200,"undercount"
"7012",32009,"Nevada","Esmeralda County","NHPI_AIC",7,7,0,0,"equal"
"7013",32011,"Nevada","Eureka County","A_A",26,8,-18,-105.88,"undercount"
"7014",32011,"Nevada","Eureka County","A_AIC",45,21,-24,-72.73,"undercount"
"7015",32011,"Nevada","Eureka County","NHPI_A",4,3,-1,-28.57,"undercount"
"7016",32011,"Nevada","Eureka County","NHPI_AIC",11,13,2,16.67,"overcount"
"7017",32013,"Nevada","Humboldt County","A_A",186,158,-28,-16.28,"undercount"
"7018",32013,"Nevada","Humboldt County","A_AIC",318,269,-49,-16.7,"undercount"
"7019",32013,"Nevada","Humboldt County","NHPI_A",53,26,-27,-68.35,"undercount"
"7020",32013,"Nevada","Humboldt County","NHPI_AIC",101,61,-40,-49.38,"undercount"
"7021",32015,"Nevada","Lander County","A_A",66,35,-31,-61.39,"undercount"
"7022",32015,"Nevada","Lander County","A_AIC",95,78,-17,-19.65,"undercount"
"7023",32015,"Nevada","Lander County","NHPI_A",1,10,9,163.64,"overcount"
"7024",32015,"Nevada","Lander County","NHPI_AIC",15,42,27,94.74,"overcount"
"7025",32017,"Nevada","Lincoln County","A_A",40,22,-18,-58.06,"undercount"
"7026",32017,"Nevada","Lincoln County","A_AIC",71,42,-29,-51.33,"undercount"
"7027",32017,"Nevada","Lincoln County","NHPI_A",19,13,-6,-37.5,"undercount"
"7028",32017,"Nevada","Lincoln County","NHPI_AIC",36,33,-3,-8.7,"undercount"
"7029",32019,"Nevada","Lyon County","A_A",981,927,-54,-5.66,"undercount"
"7030",32019,"Nevada","Lyon County","A_AIC",1587,1586,-1,-0.06,"undercount"
"7031",32019,"Nevada","Lyon County","NHPI_A",212,174,-38,-19.69,"undercount"
"7032",32019,"Nevada","Lyon County","NHPI_AIC",418,414,-4,-0.96,"undercount"
"7033",32021,"Nevada","Mineral County","A_A",164,66,-98,-85.22,"undercount"
"7034",32021,"Nevada","Mineral County","A_AIC",201,123,-78,-48.15,"undercount"
"7035",32021,"Nevada","Mineral County","NHPI_A",10,8,-2,-22.22,"undercount"
"7036",32021,"Nevada","Mineral County","NHPI_AIC",27,27,0,0,"equal"
"7037",32023,"Nevada","Nye County","A_A",972,1041,69,6.86,"overcount"
"7038",32023,"Nevada","Nye County","A_AIC",1507,1587,80,5.17,"overcount"
"7039",32023,"Nevada","Nye County","NHPI_A",312,220,-92,-34.59,"undercount"
"7040",32023,"Nevada","Nye County","NHPI_AIC",480,486,6,1.24,"overcount"
"7041",32027,"Nevada","Pershing County","A_A",85,109,24,24.74,"overcount"
"7042",32027,"Nevada","Pershing County","A_AIC",132,152,20,14.08,"overcount"
"7043",32027,"Nevada","Pershing County","NHPI_A",27,24,-3,-11.76,"undercount"
"7044",32027,"Nevada","Pershing County","NHPI_AIC",52,41,-11,-23.66,"undercount"
"7045",32029,"Nevada","Storey County","A_A",97,67,-30,-36.59,"undercount"
"7046",32029,"Nevada","Storey County","A_AIC",121,131,10,7.94,"overcount"
"7047",32029,"Nevada","Storey County","NHPI_A",20,8,-12,-85.71,"undercount"
"7048",32029,"Nevada","Storey County","NHPI_AIC",31,33,2,6.25,"overcount"
"7049",32031,"Nevada","Washoe County","A_A",28277,28460,183,0.65,"overcount"
"7050",32031,"Nevada","Washoe County","A_AIC",37383,37472,89,0.24,"overcount"
"7051",32031,"Nevada","Washoe County","NHPI_A",3701,3288,-413,-11.82,"undercount"
"7052",32031,"Nevada","Washoe County","NHPI_AIC",6037,5561,-476,-8.21,"undercount"
"7053",32033,"Nevada","White Pine County","A_A",102,105,3,2.9,"overcount"
"7054",32033,"Nevada","White Pine County","A_AIC",151,154,3,1.97,"overcount"
"7055",32033,"Nevada","White Pine County","NHPI_A",15,22,7,37.84,"overcount"
"7056",32033,"Nevada","White Pine County","NHPI_AIC",39,41,2,5,"overcount"
"7057",32510,"Nevada","Carson City","A_A",1497,1371,-126,-8.79,"undercount"
"7058",32510,"Nevada","Carson City","A_AIC",2153,2100,-53,-2.49,"undercount"
"7059",32510,"Nevada","Carson City","NHPI_A",200,111,-89,-57.23,"undercount"
"7060",32510,"Nevada","Carson City","NHPI_AIC",384,343,-41,-11.28,"undercount"
"7061",33001,"New Hampshire","Belknap County","A_A",698,582,-116,-18.12,"undercount"
"7062",33001,"New Hampshire","Belknap County","A_AIC",977,916,-61,-6.44,"undercount"
"7063",33001,"New Hampshire","Belknap County","NHPI_A",43,11,-32,-118.52,"undercount"
"7064",33001,"New Hampshire","Belknap County","NHPI_AIC",86,62,-24,-32.43,"undercount"
"7065",33003,"New Hampshire","Carroll County","A_A",381,362,-19,-5.11,"undercount"
"7066",33003,"New Hampshire","Carroll County","A_AIC",495,576,81,15.13,"overcount"
"7067",33003,"New Hampshire","Carroll County","NHPI_A",14,6,-8,-80,"undercount"
"7068",33003,"New Hampshire","Carroll County","NHPI_AIC",43,50,7,15.05,"overcount"
"7069",33005,"New Hampshire","Cheshire County","A_A",1272,1087,-185,-15.68,"undercount"
"7070",33005,"New Hampshire","Cheshire County","A_AIC",1630,1565,-65,-4.07,"undercount"
"7071",33005,"New Hampshire","Cheshire County","NHPI_A",40,46,6,13.95,"overcount"
"7072",33005,"New Hampshire","Cheshire County","NHPI_AIC",90,136,46,40.71,"overcount"
"7073",33007,"New Hampshire","Coos County","A_A",216,193,-23,-11.25,"undercount"
"7074",33007,"New Hampshire","Coos County","A_AIC",303,322,19,6.08,"overcount"
"7075",33007,"New Hampshire","Coos County","NHPI_A",5,3,-2,-50,"undercount"
"7076",33007,"New Hampshire","Coos County","NHPI_AIC",19,18,-1,-5.41,"undercount"
"7077",33009,"New Hampshire","Grafton County","A_A",3561,2885,-676,-20.97,"undercount"
"7078",33009,"New Hampshire","Grafton County","A_AIC",4176,3758,-418,-10.54,"undercount"
"7079",33009,"New Hampshire","Grafton County","NHPI_A",32,25,-7,-24.56,"undercount"
"7080",33009,"New Hampshire","Grafton County","NHPI_AIC",92,87,-5,-5.59,"undercount"
"7081",33011,"New Hampshire","Hillsborough County","A_A",19184,16623,-2561,-14.3,"undercount"
"7082",33011,"New Hampshire","Hillsborough County","A_AIC",22130,20224,-1906,-9,"undercount"
"7083",33011,"New Hampshire","Hillsborough County","NHPI_A",299,116,-183,-88.19,"undercount"
"7084",33011,"New Hampshire","Hillsborough County","NHPI_AIC",632,445,-187,-34.73,"undercount"
"7085",33013,"New Hampshire","Merrimack County","A_A",3563,3072,-491,-14.8,"undercount"
"7086",33013,"New Hampshire","Merrimack County","A_AIC",4314,4020,-294,-7.06,"undercount"
"7087",33013,"New Hampshire","Merrimack County","NHPI_A",62,59,-3,-4.96,"undercount"
"7088",33013,"New Hampshire","Merrimack County","NHPI_AIC",142,191,49,29.43,"overcount"
"7089",33015,"New Hampshire","Rockingham County","A_A",7239,6300,-939,-13.87,"undercount"
"7090",33015,"New Hampshire","Rockingham County","A_AIC",9097,8569,-528,-5.98,"undercount"
"7091",33015,"New Hampshire","Rockingham County","NHPI_A",162,90,-72,-57.14,"undercount"
"7092",33015,"New Hampshire","Rockingham County","NHPI_AIC",336,307,-29,-9.02,"undercount"
"7093",33017,"New Hampshire","Strafford County","A_A",5149,4478,-671,-13.94,"undercount"
"7094",33017,"New Hampshire","Strafford County","A_AIC",6107,5691,-416,-7.05,"undercount"
"7095",33017,"New Hampshire","Strafford County","NHPI_A",65,42,-23,-42.99,"undercount"
"7096",33017,"New Hampshire","Strafford County","NHPI_AIC",188,203,15,7.67,"overcount"
"7097",33019,"New Hampshire","Sullivan County","A_A",471,435,-36,-7.95,"undercount"
"7098",33019,"New Hampshire","Sullivan County","A_AIC",628,639,11,1.74,"overcount"
"7099",33019,"New Hampshire","Sullivan County","NHPI_A",11,6,-5,-58.82,"undercount"
"7100",33019,"New Hampshire","Sullivan County","NHPI_AIC",52,53,1,1.9,"overcount"
"7101",34001,"New Jersey","Atlantic County","A_A",21177,21855,678,3.15,"overcount"
"7102",34001,"New Jersey","Atlantic County","A_AIC",23753,24132,379,1.58,"overcount"
"7103",34001,"New Jersey","Atlantic County","NHPI_A",255,85,-170,-100,"undercount"
"7104",34001,"New Jersey","Atlantic County","NHPI_AIC",634,362,-272,-54.62,"undercount"
"7105",34003,"New Jersey","Bergen County","A_A",160283,159022,-1261,-0.79,"undercount"
"7106",34003,"New Jersey","Bergen County","A_AIC",170641,169409,-1232,-0.72,"undercount"
"7107",34003,"New Jersey","Bergen County","NHPI_A",1000,178,-822,-139.56,"undercount"
"7108",34003,"New Jersey","Bergen County","NHPI_AIC",2276,935,-1341,-83.53,"undercount"
"7109",34005,"New Jersey","Burlington County","A_A",25105,26329,1224,4.76,"overcount"
"7110",34005,"New Jersey","Burlington County","A_AIC",29887,31726,1839,5.97,"overcount"
"7111",34005,"New Jersey","Burlington County","NHPI_A",424,271,-153,-44.03,"undercount"
"7112",34005,"New Jersey","Burlington County","NHPI_AIC",905,691,-214,-26.82,"undercount"
"7113",34007,"New Jersey","Camden County","A_A",30920,32767,1847,5.8,"overcount"
"7114",34007,"New Jersey","Camden County","A_AIC",34938,37039,2101,5.84,"overcount"
"7115",34007,"New Jersey","Camden County","NHPI_A",600,120,-480,-133.33,"undercount"
"7116",34007,"New Jersey","Camden County","NHPI_AIC",1093,539,-554,-67.89,"undercount"
"7117",34009,"New Jersey","Cape May County","A_A",923,942,19,2.04,"overcount"
"7118",34009,"New Jersey","Cape May County","A_AIC",1350,1347,-3,-0.22,"undercount"
"7119",34009,"New Jersey","Cape May County","NHPI_A",78,24,-54,-105.88,"undercount"
"7120",34009,"New Jersey","Cape May County","NHPI_AIC",190,105,-85,-57.63,"undercount"
"7121",34011,"New Jersey","Cumberland County","A_A",2142,2115,-27,-1.27,"undercount"
"7122",34011,"New Jersey","Cumberland County","A_AIC",2900,2587,-313,-11.41,"undercount"
"7123",34011,"New Jersey","Cumberland County","NHPI_A",276,12,-264,-183.33,"undercount"
"7124",34011,"New Jersey","Cumberland County","NHPI_AIC",503,119,-384,-123.47,"undercount"
"7125",34013,"New Jersey","Essex County","A_A",48640,47991,-649,-1.34,"undercount"
"7126",34013,"New Jersey","Essex County","A_AIC",54414,54710,296,0.54,"overcount"
"7127",34013,"New Jersey","Essex County","NHPI_A",1281,341,-940,-115.91,"undercount"
"7128",34013,"New Jersey","Essex County","NHPI_AIC",2456,967,-1489,-87,"undercount"
"7129",34015,"New Jersey","Gloucester County","A_A",9312,9541,229,2.43,"overcount"
"7130",34015,"New Jersey","Gloucester County","A_AIC",11431,11988,557,4.76,"overcount"
"7131",34015,"New Jersey","Gloucester County","NHPI_A",235,93,-142,-86.59,"undercount"
"7132",34015,"New Jersey","Gloucester County","NHPI_AIC",490,339,-151,-36.43,"undercount"
"7133",34017,"New Jersey","Hudson County","A_A",113475,126163,12688,10.59,"overcount"
"7134",34017,"New Jersey","Hudson County","A_AIC",119170,132906,13736,10.9,"overcount"
"7135",34017,"New Jersey","Hudson County","NHPI_A",1345,406,-939,-107.25,"undercount"
"7136",34017,"New Jersey","Hudson County","NHPI_AIC",2379,1109,-1270,-72.82,"undercount"
"7137",34019,"New Jersey","Hunterdon County","A_A",5707,5746,39,0.68,"overcount"
"7138",34019,"New Jersey","Hunterdon County","A_AIC",6725,6941,216,3.16,"overcount"
"7139",34019,"New Jersey","Hunterdon County","NHPI_A",206,11,-195,-179.72,"undercount"
"7140",34019,"New Jersey","Hunterdon County","NHPI_AIC",324,83,-241,-118.43,"undercount"
"7141",34021,"New Jersey","Mercer County","A_A",45331,48653,3322,7.07,"overcount"
"7142",34021,"New Jersey","Mercer County","A_AIC",49208,52321,3113,6.13,"overcount"
"7143",34021,"New Jersey","Mercer County","NHPI_A",843,127,-716,-147.63,"undercount"
"7144",34021,"New Jersey","Mercer County","NHPI_AIC",1520,463,-1057,-106.61,"undercount"
"7145",34023,"New Jersey","Middlesex County","A_A",209475,230341,20866,9.49,"overcount"
"7146",34023,"New Jersey","Middlesex County","A_AIC",217480,237490,20010,8.8,"overcount"
"7147",34023,"New Jersey","Middlesex County","NHPI_A",1061,261,-800,-121.03,"undercount"
"7148",34023,"New Jersey","Middlesex County","NHPI_AIC",1821,782,-1039,-79.83,"undercount"
"7149",34025,"New Jersey","Monmouth County","A_A",34975,36447,1472,4.12,"overcount"
"7150",34025,"New Jersey","Monmouth County","A_AIC",39775,42094,2319,5.67,"overcount"
"7151",34025,"New Jersey","Monmouth County","NHPI_A",391,122,-269,-104.87,"undercount"
"7152",34025,"New Jersey","Monmouth County","NHPI_AIC",866,574,-292,-40.56,"undercount"
"7153",34027,"New Jersey","Morris County","A_A",55071,58161,3090,5.46,"overcount"
"7154",34027,"New Jersey","Morris County","A_AIC",60366,64148,3782,6.07,"overcount"
"7155",34027,"New Jersey","Morris County","NHPI_A",267,120,-147,-75.97,"undercount"
"7156",34027,"New Jersey","Morris County","NHPI_AIC",619,414,-205,-39.69,"undercount"
"7157",34029,"New Jersey","Ocean County","A_A",12378,11543,-835,-6.98,"undercount"
"7158",34029,"New Jersey","Ocean County","A_AIC",15487,14731,-756,-5,"undercount"
"7159",34029,"New Jersey","Ocean County","NHPI_A",288,122,-166,-80.98,"undercount"
"7160",34029,"New Jersey","Ocean County","NHPI_AIC",624,427,-197,-37.49,"undercount"
"7161",34031,"New Jersey","Passaic County","A_A",29310,30676,1366,4.55,"overcount"
"7162",34031,"New Jersey","Passaic County","A_AIC",32622,33855,1233,3.71,"overcount"
"7163",34031,"New Jersey","Passaic County","NHPI_A",1164,74,-1090,-176.09,"undercount"
"7164",34031,"New Jersey","Passaic County","NHPI_AIC",1662,298,-1364,-139.18,"undercount"
"7165",34033,"New Jersey","Salem County","A_A",697,649,-48,-7.13,"undercount"
"7166",34033,"New Jersey","Salem County","A_AIC",1017,944,-73,-7.45,"undercount"
"7167",34033,"New Jersey","Salem County","NHPI_A",38,19,-19,-66.67,"undercount"
"7168",34033,"New Jersey","Salem County","NHPI_AIC",127,72,-55,-55.28,"undercount"
"7169",34035,"New Jersey","Somerset County","A_A",64456,67571,3115,4.72,"overcount"
"7170",34035,"New Jersey","Somerset County","A_AIC",68101,71636,3535,5.06,"overcount"
"7171",34035,"New Jersey","Somerset County","NHPI_A",301,74,-227,-121.07,"undercount"
"7172",34035,"New Jersey","Somerset County","NHPI_AIC",591,292,-299,-67.72,"undercount"
"7173",34037,"New Jersey","Sussex County","A_A",2989,2958,-31,-1.04,"undercount"
"7174",34037,"New Jersey","Sussex County","A_AIC",3996,3978,-18,-0.45,"undercount"
"7175",34037,"New Jersey","Sussex County","NHPI_A",61,18,-43,-108.86,"undercount"
"7176",34037,"New Jersey","Sussex County","NHPI_AIC",183,64,-119,-96.36,"undercount"
"7177",34039,"New Jersey","Union County","A_A",32798,32652,-146,-0.45,"undercount"
"7178",34039,"New Jersey","Union County","A_AIC",36805,37089,284,0.77,"overcount"
"7179",34039,"New Jersey","Union County","NHPI_A",747,111,-636,-148.25,"undercount"
"7180",34039,"New Jersey","Union County","NHPI_AIC",1481,527,-954,-95.02,"undercount"
"7181",34041,"New Jersey","Warren County","A_A",3122,2928,-194,-6.41,"undercount"
"7182",34041,"New Jersey","Warren County","A_AIC",3730,3670,-60,-1.62,"undercount"
"7183",34041,"New Jersey","Warren County","NHPI_A",97,35,-62,-93.94,"undercount"
"7184",34041,"New Jersey","Warren County","NHPI_AIC",192,116,-76,-49.35,"undercount"
"7185",35001,"New Mexico","Bernalillo County","A_A",20595,19439,-1156,-5.78,"undercount"
"7186",35001,"New Mexico","Bernalillo County","A_AIC",28536,25490,-3046,-11.28,"undercount"
"7187",35001,"New Mexico","Bernalillo County","NHPI_A",1003,581,-422,-53.28,"undercount"
"7188",35001,"New Mexico","Bernalillo County","NHPI_AIC",2568,1528,-1040,-50.78,"undercount"
"7189",35003,"New Mexico","Catron County","A_A",12,8,-4,-40,"undercount"
"7190",35003,"New Mexico","Catron County","A_AIC",28,26,-2,-7.41,"undercount"
"7191",35003,"New Mexico","Catron County","NHPI_A",1,0,-1,-200,"undercount"
"7192",35003,"New Mexico","Catron County","NHPI_AIC",4,4,0,0,"equal"
"7193",35005,"New Mexico","Chaves County","A_A",765,630,-135,-19.35,"undercount"
"7194",35005,"New Mexico","Chaves County","A_AIC",1042,823,-219,-23.49,"undercount"
"7195",35005,"New Mexico","Chaves County","NHPI_A",179,30,-149,-142.58,"undercount"
"7196",35005,"New Mexico","Chaves County","NHPI_AIC",231,57,-174,-120.83,"undercount"
"7197",35006,"New Mexico","Cibola County","A_A",170,202,32,17.2,"overcount"
"7198",35006,"New Mexico","Cibola County","A_AIC",274,284,10,3.58,"overcount"
"7199",35006,"New Mexico","Cibola County","NHPI_A",30,7,-23,-124.32,"undercount"
"7200",35006,"New Mexico","Cibola County","NHPI_AIC",54,44,-10,-20.41,"undercount"
"7201",35007,"New Mexico","Colfax County","A_A",102,60,-42,-51.85,"undercount"
"7202",35007,"New Mexico","Colfax County","A_AIC",132,92,-40,-35.71,"undercount"
"7203",35007,"New Mexico","Colfax County","NHPI_A",32,11,-21,-97.67,"undercount"
"7204",35007,"New Mexico","Colfax County","NHPI_AIC",40,14,-26,-96.3,"undercount"
"7205",35009,"New Mexico","Curry County","A_A",928,743,-185,-22.14,"undercount"
"7206",35009,"New Mexico","Curry County","A_AIC",1435,1108,-327,-25.72,"undercount"
"7207",35009,"New Mexico","Curry County","NHPI_A",125,35,-90,-112.5,"undercount"
"7208",35009,"New Mexico","Curry County","NHPI_AIC",220,112,-108,-65.06,"undercount"
"7209",35011,"New Mexico","De Baca County","A_A",4,4,0,0,"equal"
"7210",35011,"New Mexico","De Baca County","A_AIC",22,14,-8,-44.44,"undercount"
"7211",35011,"New Mexico","De Baca County","NHPI_A",0,4,4,200,"overcount"
"7212",35011,"New Mexico","De Baca County","NHPI_AIC",2,10,8,133.33,"overcount"
"7213",35013,"New Mexico","Dona Ana County","A_A",3045,2483,-562,-20.33,"undercount"
"7214",35013,"New Mexico","Dona Ana County","A_AIC",4272,3444,-828,-21.46,"undercount"
"7215",35013,"New Mexico","Dona Ana County","NHPI_A",418,123,-295,-109.06,"undercount"
"7216",35013,"New Mexico","Dona Ana County","NHPI_AIC",690,326,-364,-71.65,"undercount"
"7217",35015,"New Mexico","Eddy County","A_A",558,597,39,6.75,"overcount"
"7218",35015,"New Mexico","Eddy County","A_AIC",745,784,39,5.1,"overcount"
"7219",35015,"New Mexico","Eddy County","NHPI_A",99,43,-56,-78.87,"undercount"
"7220",35015,"New Mexico","Eddy County","NHPI_AIC",178,100,-78,-56.12,"undercount"
"7221",35017,"New Mexico","Grant County","A_A",252,193,-59,-26.52,"undercount"
"7222",35017,"New Mexico","Grant County","A_AIC",356,281,-75,-23.55,"undercount"
"7223",35017,"New Mexico","Grant County","NHPI_A",48,22,-26,-74.29,"undercount"
"7224",35017,"New Mexico","Grant County","NHPI_AIC",87,54,-33,-46.81,"undercount"
"7225",35019,"New Mexico","Guadalupe County","A_A",60,49,-11,-20.18,"undercount"
"7226",35019,"New Mexico","Guadalupe County","A_AIC",84,73,-11,-14.01,"undercount"
"7227",35019,"New Mexico","Guadalupe County","NHPI_A",0,0,0,0,"equal"
"7228",35019,"New Mexico","Guadalupe County","NHPI_AIC",6,1,-5,-142.86,"undercount"
"7229",35021,"New Mexico","Harding County","A_A",2,0,-2,-200,"undercount"
"7230",35021,"New Mexico","Harding County","A_AIC",5,5,0,0,"equal"
"7231",35021,"New Mexico","Harding County","NHPI_A",0,0,0,0,"equal"
"7232",35021,"New Mexico","Harding County","NHPI_AIC",0,0,0,0,"equal"
"7233",35023,"New Mexico","Hidalgo County","A_A",24,11,-13,-74.29,"undercount"
"7234",35023,"New Mexico","Hidalgo County","A_AIC",34,21,-13,-47.27,"undercount"
"7235",35023,"New Mexico","Hidalgo County","NHPI_A",8,5,-3,-46.15,"undercount"
"7236",35023,"New Mexico","Hidalgo County","NHPI_AIC",8,18,10,76.92,"overcount"
"7237",35025,"New Mexico","Lea County","A_A",505,639,134,23.43,"overcount"
"7238",35025,"New Mexico","Lea County","A_AIC",617,800,183,25.83,"overcount"
"7239",35025,"New Mexico","Lea County","NHPI_A",90,22,-68,-121.43,"undercount"
"7240",35025,"New Mexico","Lea County","NHPI_AIC",135,71,-64,-62.14,"undercount"
"7241",35027,"New Mexico","Lincoln County","A_A",143,138,-5,-3.56,"undercount"
"7242",35027,"New Mexico","Lincoln County","A_AIC",203,178,-25,-13.12,"undercount"
"7243",35027,"New Mexico","Lincoln County","NHPI_A",30,8,-22,-115.79,"undercount"
"7244",35027,"New Mexico","Lincoln County","NHPI_AIC",45,19,-26,-81.25,"undercount"
"7245",35028,"New Mexico","Los Alamos County","A_A",1354,1232,-122,-9.44,"undercount"
"7246",35028,"New Mexico","Los Alamos County","A_AIC",1579,1528,-51,-3.28,"undercount"
"7247",35028,"New Mexico","Los Alamos County","NHPI_A",15,15,0,0,"equal"
"7248",35028,"New Mexico","Los Alamos County","NHPI_AIC",42,35,-7,-18.18,"undercount"
"7249",35029,"New Mexico","Luna County","A_A",309,160,-149,-63.54,"undercount"
"7250",35029,"New Mexico","Luna County","A_AIC",392,259,-133,-40.86,"undercount"
"7251",35029,"New Mexico","Luna County","NHPI_A",48,12,-36,-120,"undercount"
"7252",35029,"New Mexico","Luna County","NHPI_AIC",81,33,-48,-84.21,"undercount"
"7253",35031,"New Mexico","McKinley County","A_A",808,940,132,15.1,"overcount"
"7254",35031,"New Mexico","McKinley County","A_AIC",1033,1132,99,9.15,"overcount"
"7255",35031,"New Mexico","McKinley County","NHPI_A",41,34,-7,-18.67,"undercount"
"7256",35031,"New Mexico","McKinley County","NHPI_AIC",130,93,-37,-33.18,"undercount"
"7257",35033,"New Mexico","Mora County","A_A",27,14,-13,-63.41,"undercount"
"7258",35033,"New Mexico","Mora County","A_AIC",40,29,-11,-31.88,"undercount"
"7259",35033,"New Mexico","Mora County","NHPI_A",1,0,-1,-200,"undercount"
"7260",35033,"New Mexico","Mora County","NHPI_AIC",3,11,8,114.29,"overcount"
"7261",35035,"New Mexico","Otero County","A_A",1169,1015,-154,-14.1,"undercount"
"7262",35035,"New Mexico","Otero County","A_AIC",1814,1649,-165,-9.53,"undercount"
"7263",35035,"New Mexico","Otero County","NHPI_A",186,160,-26,-15.03,"undercount"
"7264",35035,"New Mexico","Otero County","NHPI_AIC",319,296,-23,-7.48,"undercount"
"7265",35037,"New Mexico","Quay County","A_A",96,48,-48,-66.67,"undercount"
"7266",35037,"New Mexico","Quay County","A_AIC",139,88,-51,-44.93,"undercount"
"7267",35037,"New Mexico","Quay County","NHPI_A",18,6,-12,-100,"undercount"
"7268",35037,"New Mexico","Quay County","NHPI_AIC",28,14,-14,-66.67,"undercount"
"7269",35039,"New Mexico","Rio Arriba County","A_A",326,233,-93,-33.27,"undercount"
"7270",35039,"New Mexico","Rio Arriba County","A_AIC",409,311,-98,-27.22,"undercount"
"7271",35039,"New Mexico","Rio Arriba County","NHPI_A",93,10,-83,-161.17,"undercount"
"7272",35039,"New Mexico","Rio Arriba County","NHPI_AIC",114,37,-77,-101.99,"undercount"
"7273",35041,"New Mexico","Roosevelt County","A_A",283,173,-110,-48.25,"undercount"
"7274",35041,"New Mexico","Roosevelt County","A_AIC",380,270,-110,-33.85,"undercount"
"7275",35041,"New Mexico","Roosevelt County","NHPI_A",33,18,-15,-58.82,"undercount"
"7276",35041,"New Mexico","Roosevelt County","NHPI_AIC",52,54,2,3.77,"overcount"
"7277",35043,"New Mexico","Sandoval County","A_A",2791,2353,-438,-17.03,"undercount"
"7278",35043,"New Mexico","Sandoval County","A_AIC",4324,3584,-740,-18.72,"undercount"
"7279",35043,"New Mexico","Sandoval County","NHPI_A",290,173,-117,-50.54,"undercount"
"7280",35043,"New Mexico","Sandoval County","NHPI_AIC",587,448,-139,-26.86,"undercount"
"7281",35045,"New Mexico","San Juan County","A_A",741,897,156,19.05,"overcount"
"7282",35045,"New Mexico","San Juan County","A_AIC",1309,1305,-4,-0.31,"undercount"
"7283",35045,"New Mexico","San Juan County","NHPI_A",101,69,-32,-37.65,"undercount"
"7284",35045,"New Mexico","San Juan County","NHPI_AIC",215,187,-28,-13.93,"undercount"
"7285",35047,"New Mexico","San Miguel County","A_A",402,140,-262,-96.68,"undercount"
"7286",35047,"New Mexico","San Miguel County","A_AIC",484,198,-286,-83.87,"undercount"
"7287",35047,"New Mexico","San Miguel County","NHPI_A",55,2,-53,-185.96,"undercount"
"7288",35047,"New Mexico","San Miguel County","NHPI_AIC",71,34,-37,-70.48,"undercount"
"7289",35049,"New Mexico","Santa Fe County","A_A",2459,2274,-185,-7.82,"undercount"
"7290",35049,"New Mexico","Santa Fe County","A_AIC",3355,3235,-120,-3.64,"undercount"
"7291",35049,"New Mexico","Santa Fe County","NHPI_A",309,72,-237,-124.41,"undercount"
"7292",35049,"New Mexico","Santa Fe County","NHPI_AIC",477,254,-223,-61.01,"undercount"
"7293",35051,"New Mexico","Sierra County","A_A",97,123,26,23.64,"overcount"
"7294",35051,"New Mexico","Sierra County","A_AIC",141,145,4,2.8,"overcount"
"7295",35051,"New Mexico","Sierra County","NHPI_A",6,3,-3,-66.67,"undercount"
"7296",35051,"New Mexico","Sierra County","NHPI_AIC",20,13,-7,-42.42,"undercount"
"7297",35053,"New Mexico","Socorro County","A_A",396,303,-93,-26.61,"undercount"
"7298",35053,"New Mexico","Socorro County","A_AIC",506,367,-139,-31.84,"undercount"
"7299",35053,"New Mexico","Socorro County","NHPI_A",19,8,-11,-81.48,"undercount"
"7300",35053,"New Mexico","Socorro County","NHPI_AIC",41,29,-12,-34.29,"undercount"
"7301",35055,"New Mexico","Taos County","A_A",342,204,-138,-50.55,"undercount"
"7302",35055,"New Mexico","Taos County","A_AIC",459,356,-103,-25.28,"undercount"
"7303",35055,"New Mexico","Taos County","NHPI_A",44,7,-37,-145.1,"undercount"
"7304",35055,"New Mexico","Taos County","NHPI_AIC",82,60,-22,-30.99,"undercount"
"7305",35057,"New Mexico","Torrance County","A_A",103,51,-52,-67.53,"undercount"
"7306",35057,"New Mexico","Torrance County","A_AIC",185,108,-77,-52.56,"undercount"
"7307",35057,"New Mexico","Torrance County","NHPI_A",42,2,-40,-181.82,"undercount"
"7308",35057,"New Mexico","Torrance County","NHPI_AIC",71,28,-43,-86.87,"undercount"
"7309",35059,"New Mexico","Union County","A_A",32,6,-26,-136.84,"undercount"
"7310",35059,"New Mexico","Union County","A_AIC",48,24,-24,-66.67,"undercount"
"7311",35059,"New Mexico","Union County","NHPI_A",1,4,3,120,"overcount"
"7312",35059,"New Mexico","Union County","NHPI_AIC",5,12,7,82.35,"overcount"
"7313",35061,"New Mexico","Valencia County","A_A",653,372,-281,-54.83,"undercount"
"7314",35061,"New Mexico","Valencia County","A_AIC",1077,659,-418,-48.16,"undercount"
"7315",35061,"New Mexico","Valencia County","NHPI_A",128,33,-95,-118.01,"undercount"
"7316",35061,"New Mexico","Valencia County","NHPI_AIC",226,106,-120,-72.29,"undercount"
"7317",36001,"New York","Albany County","A_A",21165,24620,3455,15.09,"overcount"
"7318",36001,"New York","Albany County","A_AIC",24480,27580,3100,11.91,"overcount"
"7319",36001,"New York","Albany County","NHPI_A",244,179,-65,-30.73,"undercount"
"7320",36001,"New York","Albany County","NHPI_AIC",627,431,-196,-37.05,"undercount"
"7321",36003,"New York","Allegany County","A_A",570,403,-167,-34.33,"undercount"
"7322",36003,"New York","Allegany County","A_AIC",772,615,-157,-22.64,"undercount"
"7323",36003,"New York","Allegany County","NHPI_A",22,8,-14,-93.33,"undercount"
"7324",36003,"New York","Allegany County","NHPI_AIC",55,69,14,22.58,"overcount"
"7325",36005,"New York","Bronx County","A_A",65520,72154,6634,9.64,"overcount"
"7326",36005,"New York","Bronx County","A_AIC",72126,79090,6964,9.21,"overcount"
"7327",36005,"New York","Bronx County","NHPI_A",6045,857,-5188,-150.33,"undercount"
"7328",36005,"New York","Bronx County","NHPI_AIC",9166,1978,-7188,-129,"undercount"
"7329",36007,"New York","Broome County","A_A",8504,9479,975,10.84,"overcount"
"7330",36007,"New York","Broome County","A_AIC",10254,10905,651,6.15,"overcount"
"7331",36007,"New York","Broome County","NHPI_A",131,65,-66,-67.35,"undercount"
"7332",36007,"New York","Broome County","NHPI_AIC",363,257,-106,-34.19,"undercount"
"7333",36009,"New York","Cattaraugus County","A_A",617,566,-51,-8.62,"undercount"
"7334",36009,"New York","Cattaraugus County","A_AIC",912,798,-114,-13.33,"undercount"
"7335",36009,"New York","Cattaraugus County","NHPI_A",28,12,-16,-80,"undercount"
"7336",36009,"New York","Cattaraugus County","NHPI_AIC",96,61,-35,-44.59,"undercount"
"7337",36011,"New York","Cayuga County","A_A",523,379,-144,-31.93,"undercount"
"7338",36011,"New York","Cayuga County","A_AIC",800,632,-168,-23.46,"undercount"
"7339",36011,"New York","Cayuga County","NHPI_A",57,54,-3,-5.41,"undercount"
"7340",36011,"New York","Cayuga County","NHPI_AIC",118,116,-2,-1.71,"undercount"
"7341",36013,"New York","Chautauqua County","A_A",834,823,-11,-1.33,"undercount"
"7342",36013,"New York","Chautauqua County","A_AIC",1252,1208,-44,-3.58,"undercount"
"7343",36013,"New York","Chautauqua County","NHPI_A",67,50,-17,-29.06,"undercount"
"7344",36013,"New York","Chautauqua County","NHPI_AIC",143,116,-27,-20.85,"undercount"
"7345",36015,"New York","Chemung County","A_A",1194,1436,242,18.4,"overcount"
"7346",36015,"New York","Chemung County","A_AIC",1651,1829,178,10.23,"overcount"
"7347",36015,"New York","Chemung County","NHPI_A",35,17,-18,-69.23,"undercount"
"7348",36015,"New York","Chemung County","NHPI_AIC",114,63,-51,-57.63,"undercount"
"7349",36017,"New York","Chenango County","A_A",270,253,-17,-6.5,"undercount"
"7350",36017,"New York","Chenango County","A_AIC",431,393,-38,-9.22,"undercount"
"7351",36017,"New York","Chenango County","NHPI_A",8,15,7,60.87,"overcount"
"7352",36017,"New York","Chenango County","NHPI_AIC",30,43,13,35.62,"overcount"
"7353",36019,"New York","Clinton County","A_A",1134,982,-152,-14.37,"undercount"
"7354",36019,"New York","Clinton County","A_AIC",1488,1353,-135,-9.5,"undercount"
"7355",36019,"New York","Clinton County","NHPI_A",33,24,-9,-31.58,"undercount"
"7356",36019,"New York","Clinton County","NHPI_AIC",96,95,-1,-1.05,"undercount"
"7357",36021,"New York","Columbia County","A_A",1277,1430,153,11.3,"overcount"
"7358",36021,"New York","Columbia County","A_AIC",1560,1793,233,13.9,"overcount"
"7359",36021,"New York","Columbia County","NHPI_A",34,18,-16,-61.54,"undercount"
"7360",36021,"New York","Columbia County","NHPI_AIC",80,77,-3,-3.82,"undercount"
"7361",36023,"New York","Cortland County","A_A",541,1033,492,62.52,"overcount"
"7362",36023,"New York","Cortland County","A_AIC",775,1223,448,44.84,"overcount"
"7363",36023,"New York","Cortland County","NHPI_A",18,6,-12,-100,"undercount"
"7364",36023,"New York","Cortland County","NHPI_AIC",51,41,-10,-21.74,"undercount"
"7365",36025,"New York","Delaware County","A_A",515,483,-32,-6.41,"undercount"
"7366",36025,"New York","Delaware County","A_AIC",691,697,6,0.86,"overcount"
"7367",36025,"New York","Delaware County","NHPI_A",26,7,-19,-115.15,"undercount"
"7368",36025,"New York","Delaware County","NHPI_AIC",71,29,-42,-84,"undercount"
"7369",36027,"New York","Dutchess County","A_A",10865,10815,-50,-0.46,"undercount"
"7370",36027,"New York","Dutchess County","A_AIC",13299,13116,-183,-1.39,"undercount"
"7371",36027,"New York","Dutchess County","NHPI_A",257,83,-174,-102.35,"undercount"
"7372",36027,"New York","Dutchess County","NHPI_AIC",574,327,-247,-54.83,"undercount"
"7373",36029,"New York","Erie County","A_A",37048,46490,9442,22.61,"overcount"
"7374",36029,"New York","Erie County","A_AIC",43193,53003,9810,20.4,"overcount"
"7375",36029,"New York","Erie County","NHPI_A",482,208,-274,-79.42,"undercount"
"7376",36029,"New York","Erie County","NHPI_AIC",1108,765,-343,-36.63,"undercount"
"7377",36031,"New York","Essex County","A_A",275,237,-38,-14.84,"undercount"
"7378",36031,"New York","Essex County","A_AIC",378,382,4,1.05,"overcount"
"7379",36031,"New York","Essex County","NHPI_A",22,7,-15,-103.45,"undercount"
"7380",36031,"New York","Essex County","NHPI_AIC",52,37,-15,-33.71,"undercount"
"7381",36033,"New York","Franklin County","A_A",254,199,-55,-24.28,"undercount"
"7382",36033,"New York","Franklin County","A_AIC",399,340,-59,-15.97,"undercount"
"7383",36033,"New York","Franklin County","NHPI_A",14,0,-14,-200,"undercount"
"7384",36033,"New York","Franklin County","NHPI_AIC",45,31,-14,-36.84,"undercount"
"7385",36035,"New York","Fulton County","A_A",381,368,-13,-3.47,"undercount"
"7386",36035,"New York","Fulton County","A_AIC",562,578,16,2.81,"overcount"
"7387",36035,"New York","Fulton County","NHPI_A",18,5,-13,-113.04,"undercount"
"7388",36035,"New York","Fulton County","NHPI_AIC",64,22,-42,-97.67,"undercount"
"7389",36037,"New York","Genesee County","A_A",380,412,32,8.08,"overcount"
"7390",36037,"New York","Genesee County","A_AIC",583,646,63,10.25,"overcount"
"7391",36037,"New York","Genesee County","NHPI_A",7,16,9,78.26,"overcount"
"7392",36037,"New York","Genesee County","NHPI_AIC",64,32,-32,-66.67,"undercount"
"7393",36039,"New York","Greene County","A_A",554,502,-52,-9.85,"undercount"
"7394",36039,"New York","Greene County","A_AIC",778,748,-30,-3.93,"undercount"
"7395",36039,"New York","Greene County","NHPI_A",21,3,-18,-150,"undercount"
"7396",36039,"New York","Greene County","NHPI_AIC",87,47,-40,-59.7,"undercount"
"7397",36041,"New York","Hamilton County","A_A",34,14,-20,-83.33,"undercount"
"7398",36041,"New York","Hamilton County","A_AIC",44,37,-7,-17.28,"undercount"
"7399",36041,"New York","Hamilton County","NHPI_A",4,1,-3,-120,"undercount"
"7400",36041,"New York","Hamilton County","NHPI_AIC",8,9,1,11.76,"overcount"
"7401",36043,"New York","Herkimer County","A_A",377,363,-14,-3.78,"undercount"
"7402",36043,"New York","Herkimer County","A_AIC",575,591,16,2.74,"overcount"
"7403",36043,"New York","Herkimer County","NHPI_A",21,32,11,41.51,"overcount"
"7404",36043,"New York","Herkimer County","NHPI_AIC",62,72,10,14.93,"overcount"
"7405",36045,"New York","Jefferson County","A_A",1897,2224,327,15.87,"overcount"
"7406",36045,"New York","Jefferson County","A_AIC",2953,3003,50,1.68,"overcount"
"7407",36045,"New York","Jefferson County","NHPI_A",348,300,-48,-14.81,"undercount"
"7408",36045,"New York","Jefferson County","NHPI_AIC",525,457,-68,-13.85,"undercount"
"7409",36047,"New York","Kings County","A_A",327999,378683,50684,14.34,"overcount"
"7410",36047,"New York","Kings County","A_AIC",356746,419208,62462,16.1,"overcount"
"7411",36047,"New York","Kings County","NHPI_A",2902,1101,-1801,-89.98,"undercount"
"7412",36047,"New York","Kings County","NHPI_AIC",7687,3852,-3835,-66.47,"undercount"
"7413",36049,"New York","Lewis County","A_A",116,66,-50,-54.95,"undercount"
"7414",36049,"New York","Lewis County","A_AIC",174,134,-40,-25.97,"undercount"
"7415",36049,"New York","Lewis County","NHPI_A",32,13,-19,-84.44,"undercount"
"7416",36049,"New York","Lewis County","NHPI_AIC",51,41,-10,-21.74,"undercount"
"7417",36051,"New York","Livingston County","A_A",864,657,-207,-27.22,"undercount"
"7418",36051,"New York","Livingston County","A_AIC",1223,983,-240,-21.76,"undercount"
"7419",36051,"New York","Livingston County","NHPI_A",32,6,-26,-136.84,"undercount"
"7420",36051,"New York","Livingston County","NHPI_AIC",83,52,-31,-45.93,"undercount"
"7421",36053,"New York","Madison County","A_A",677,671,-6,-0.89,"undercount"
"7422",36053,"New York","Madison County","A_AIC",1036,998,-38,-3.74,"undercount"
"7423",36053,"New York","Madison County","NHPI_A",26,11,-15,-81.08,"undercount"
"7424",36053,"New York","Madison County","NHPI_AIC",76,51,-25,-39.37,"undercount"
"7425",36055,"New York","Monroe County","A_A",27782,32639,4857,16.08,"overcount"
"7426",36055,"New York","Monroe County","A_AIC",34000,39208,5208,14.23,"overcount"
"7427",36055,"New York","Monroe County","NHPI_A",582,206,-376,-95.43,"undercount"
"7428",36055,"New York","Monroe County","NHPI_AIC",1207,733,-474,-48.87,"undercount"
"7429",36057,"New York","Montgomery County","A_A",497,494,-3,-0.61,"undercount"
"7430",36057,"New York","Montgomery County","A_AIC",647,695,48,7.15,"overcount"
"7431",36057,"New York","Montgomery County","NHPI_A",79,16,-63,-132.63,"undercount"
"7432",36057,"New York","Montgomery County","NHPI_AIC",126,44,-82,-96.47,"undercount"
"7433",36059,"New York","Nassau County","A_A",156607,166919,10312,6.37,"overcount"
"7434",36059,"New York","Nassau County","A_AIC",169819,180006,10187,5.82,"overcount"
"7435",36059,"New York","Nassau County","NHPI_A",1518,437,-1081,-110.59,"undercount"
"7436",36059,"New York","Nassau County","NHPI_AIC",2754,1291,-1463,-72.34,"undercount"
"7437",36061,"New York","New York County","A_A",209878,222265,12387,5.73,"overcount"
"7438",36061,"New York","New York County","A_AIC",231234,250582,19348,8.03,"overcount"
"7439",36061,"New York","New York County","NHPI_A",2954,929,-2025,-104.3,"undercount"
"7440",36061,"New York","New York County","NHPI_AIC",5407,3426,-1981,-44.85,"undercount"
"7441",36063,"New York","Niagara County","A_A",2475,2514,39,1.56,"overcount"
"7442",36063,"New York","Niagara County","A_AIC",3481,3473,-8,-0.23,"undercount"
"7443",36063,"New York","Niagara County","NHPI_A",127,45,-82,-95.35,"undercount"
"7444",36063,"New York","Niagara County","NHPI_AIC",315,154,-161,-68.66,"undercount"
"7445",36065,"New York","Oneida County","A_A",9558,10598,1040,10.32,"overcount"
"7446",36065,"New York","Oneida County","A_AIC",10853,11943,1090,9.56,"overcount"
"7447",36065,"New York","Oneida County","NHPI_A",270,76,-194,-112.14,"undercount"
"7448",36065,"New York","Oneida County","NHPI_AIC",492,222,-270,-75.63,"undercount"
"7449",36067,"New York","Onondaga County","A_A",17707,20287,2580,13.58,"overcount"
"7450",36067,"New York","Onondaga County","A_AIC",21563,23838,2275,10.02,"overcount"
"7451",36067,"New York","Onondaga County","NHPI_A",242,117,-125,-69.64,"undercount"
"7452",36067,"New York","Onondaga County","NHPI_AIC",644,573,-71,-11.67,"undercount"
"7453",36069,"New York","Ontario County","A_A",1581,1392,-189,-12.71,"undercount"
"7454",36069,"New York","Ontario County","A_AIC",2162,2039,-123,-5.86,"undercount"
"7455",36069,"New York","Ontario County","NHPI_A",55,23,-32,-82.05,"undercount"
"7456",36069,"New York","Ontario County","NHPI_AIC",139,111,-28,-22.4,"undercount"
"7457",36071,"New York","Orange County","A_A",11876,12856,980,7.92,"overcount"
"7458",36071,"New York","Orange County","A_AIC",14938,15767,829,5.4,"overcount"
"7459",36071,"New York","Orange County","NHPI_A",492,158,-334,-102.77,"undercount"
"7460",36071,"New York","Orange County","NHPI_AIC",844,434,-410,-64.16,"undercount"
"7461",36073,"New York","Orleans County","A_A",245,168,-77,-37.29,"undercount"
"7462",36073,"New York","Orleans County","A_AIC",377,312,-65,-18.87,"undercount"
"7463",36073,"New York","Orleans County","NHPI_A",26,12,-14,-73.68,"undercount"
"7464",36073,"New York","Orleans County","NHPI_AIC",60,46,-14,-26.42,"undercount"
"7465",36075,"New York","Oswego County","A_A",838,885,47,5.46,"overcount"
"7466",36075,"New York","Oswego County","A_AIC",1356,1344,-12,-0.89,"undercount"
"7467",36075,"New York","Oswego County","NHPI_A",43,19,-24,-77.42,"undercount"
"7468",36075,"New York","Oswego County","NHPI_AIC",111,129,18,15,"overcount"
"7469",36077,"New York","Otsego County","A_A",847,848,1,0.12,"overcount"
"7470",36077,"New York","Otsego County","A_AIC",1128,1213,85,7.26,"overcount"
"7471",36077,"New York","Otsego County","NHPI_A",39,10,-29,-118.37,"undercount"
"7472",36077,"New York","Otsego County","NHPI_AIC",91,59,-32,-42.67,"undercount"
"7473",36079,"New York","Putnam County","A_A",2354,2213,-141,-6.17,"undercount"
"7474",36079,"New York","Putnam County","A_AIC",3069,2934,-135,-4.5,"undercount"
"7475",36079,"New York","Putnam County","NHPI_A",80,22,-58,-113.73,"undercount"
"7476",36079,"New York","Putnam County","NHPI_AIC",181,111,-70,-47.95,"undercount"
"7477",36081,"New York","Queens County","A_A",610301,687936,77635,11.96,"overcount"
"7478",36081,"New York","Queens County","A_AIC",645503,719333,73830,10.82,"overcount"
"7479",36081,"New York","Queens County","NHPI_A",5308,2801,-2507,-61.83,"undercount"
"7480",36081,"New York","Queens County","NHPI_AIC",10449,6412,-4037,-47.89,"undercount"
"7481",36083,"New York","Rensselaer County","A_A",4578,5757,1179,22.82,"overcount"
"7482",36083,"New York","Rensselaer County","A_AIC",5684,6963,1279,20.23,"overcount"
"7483",36083,"New York","Rensselaer County","NHPI_A",92,17,-75,-137.61,"undercount"
"7484",36083,"New York","Rensselaer County","NHPI_AIC",223,109,-114,-68.67,"undercount"
"7485",36085,"New York","Richmond County","A_A",55975,59280,3305,5.74,"overcount"
"7486",36085,"New York","Richmond County","A_AIC",60160,63309,3149,5.1,"overcount"
"7487",36085,"New York","Richmond County","NHPI_A",586,151,-435,-118.05,"undercount"
"7488",36085,"New York","Richmond County","NHPI_AIC",1024,523,-501,-64.77,"undercount"
"7489",36087,"New York","Rockland County","A_A",20563,21059,496,2.38,"overcount"
"7490",36087,"New York","Rockland County","A_AIC",22929,23171,242,1.05,"overcount"
"7491",36087,"New York","Rockland County","NHPI_A",469,52,-417,-160.08,"undercount"
"7492",36087,"New York","Rockland County","NHPI_AIC",833,223,-610,-115.53,"undercount"
"7493",36089,"New York","St. Lawrence County","A_A",1205,1100,-105,-9.11,"undercount"
"7494",36089,"New York","St. Lawrence County","A_AIC",1656,1532,-124,-7.78,"undercount"
"7495",36089,"New York","St. Lawrence County","NHPI_A",75,19,-56,-119.15,"undercount"
"7496",36089,"New York","St. Lawrence County","NHPI_AIC",132,127,-5,-3.86,"undercount"
"7497",36091,"New York","Saratoga County","A_A",6597,7522,925,13.1,"overcount"
"7498",36091,"New York","Saratoga County","A_AIC",8469,9481,1012,11.28,"overcount"
"7499",36091,"New York","Saratoga County","NHPI_A",122,60,-62,-68.13,"undercount"
"7500",36091,"New York","Saratoga County","NHPI_AIC",267,213,-54,-22.5,"undercount"
"7501",36093,"New York","Schenectady County","A_A",8021,10086,2065,22.81,"overcount"
"7502",36093,"New York","Schenectady County","A_AIC",9962,11855,1893,17.35,"overcount"
"7503",36093,"New York","Schenectady County","NHPI_A",374,397,23,5.97,"overcount"
"7504",36093,"New York","Schenectady County","NHPI_AIC",620,593,-27,-4.45,"undercount"
"7505",36095,"New York","Schoharie County","A_A",236,210,-26,-11.66,"undercount"
"7506",36095,"New York","Schoharie County","A_AIC",371,302,-69,-20.51,"undercount"
"7507",36095,"New York","Schoharie County","NHPI_A",10,3,-7,-107.69,"undercount"
"7508",36095,"New York","Schoharie County","NHPI_AIC",35,18,-17,-64.15,"undercount"
"7509",36097,"New York","Schuyler County","A_A",120,110,-10,-8.7,"undercount"
"7510",36097,"New York","Schuyler County","A_AIC",192,174,-18,-9.84,"undercount"
"7511",36097,"New York","Schuyler County","NHPI_A",7,1,-6,-150,"undercount"
"7512",36097,"New York","Schuyler County","NHPI_AIC",19,11,-8,-53.33,"undercount"
"7513",36099,"New York","Seneca County","A_A",310,268,-42,-14.53,"undercount"
"7514",36099,"New York","Seneca County","A_AIC",419,395,-24,-5.9,"undercount"
"7515",36099,"New York","Seneca County","NHPI_A",5,3,-2,-50,"undercount"
"7516",36099,"New York","Seneca County","NHPI_AIC",25,18,-7,-32.56,"undercount"
"7517",36101,"New York","Steuben County","A_A",1586,1626,40,2.49,"overcount"
"7518",36101,"New York","Steuben County","A_AIC",1907,2013,106,5.41,"overcount"
"7519",36101,"New York","Steuben County","NHPI_A",33,12,-21,-93.33,"undercount"
"7520",36101,"New York","Steuben County","NHPI_AIC",95,63,-32,-40.51,"undercount"
"7521",36103,"New York","Suffolk County","A_A",64656,66498,1842,2.81,"overcount"
"7522",36103,"New York","Suffolk County","A_AIC",75103,77335,2232,2.93,"overcount"
"7523",36103,"New York","Suffolk County","NHPI_A",1595,327,-1268,-131.95,"undercount"
"7524",36103,"New York","Suffolk County","NHPI_AIC",2657,1221,-1436,-74.06,"undercount"
"7525",36105,"New York","Sullivan County","A_A",1548,1611,63,3.99,"overcount"
"7526",36105,"New York","Sullivan County","A_AIC",2026,2061,35,1.71,"overcount"
"7527",36105,"New York","Sullivan County","NHPI_A",63,20,-43,-103.61,"undercount"
"7528",36105,"New York","Sullivan County","NHPI_AIC",177,90,-87,-65.17,"undercount"
"7529",36107,"New York","Tioga County","A_A",393,374,-19,-4.95,"undercount"
"7530",36107,"New York","Tioga County","A_AIC",574,575,1,0.17,"overcount"
"7531",36107,"New York","Tioga County","NHPI_A",17,23,6,30,"overcount"
"7532",36107,"New York","Tioga County","NHPI_AIC",50,63,13,23.01,"overcount"
"7533",36109,"New York","Tompkins County","A_A",10217,10598,381,3.66,"overcount"
"7534",36109,"New York","Tompkins County","A_AIC",11950,12397,447,3.67,"overcount"
"7535",36109,"New York","Tompkins County","NHPI_A",68,36,-32,-61.54,"undercount"
"7536",36109,"New York","Tompkins County","NHPI_AIC",244,162,-82,-40.39,"undercount"
"7537",36111,"New York","Ulster County","A_A",3792,3842,50,1.31,"overcount"
"7538",36111,"New York","Ulster County","A_AIC",5163,5109,-54,-1.05,"undercount"
"7539",36111,"New York","Ulster County","NHPI_A",101,45,-56,-76.71,"undercount"
"7540",36111,"New York","Ulster County","NHPI_AIC",341,189,-152,-57.36,"undercount"
"7541",36113,"New York","Warren County","A_A",612,730,118,17.59,"overcount"
"7542",36113,"New York","Warren County","A_AIC",891,1029,138,14.37,"overcount"
"7543",36113,"New York","Warren County","NHPI_A",20,3,-17,-147.83,"undercount"
"7544",36113,"New York","Warren County","NHPI_AIC",78,41,-37,-62.18,"undercount"
"7545",36115,"New York","Washington County","A_A",348,324,-24,-7.14,"undercount"
"7546",36115,"New York","Washington County","A_AIC",559,486,-73,-13.97,"undercount"
"7547",36115,"New York","Washington County","NHPI_A",26,23,-3,-12.24,"undercount"
"7548",36115,"New York","Washington County","NHPI_AIC",69,57,-12,-19.05,"undercount"
"7549",36117,"New York","Wayne County","A_A",634,514,-120,-20.91,"undercount"
"7550",36117,"New York","Wayne County","A_AIC",1023,847,-176,-18.82,"undercount"
"7551",36117,"New York","Wayne County","NHPI_A",49,13,-36,-116.13,"undercount"
"7552",36117,"New York","Wayne County","NHPI_AIC",118,57,-61,-69.71,"undercount"
"7553",36119,"New York","Westchester County","A_A",63858,66267,2409,3.7,"overcount"
"7554",36119,"New York","Westchester County","A_AIC",72672,77129,4457,5.95,"overcount"
"7555",36119,"New York","Westchester County","NHPI_A",1428,233,-1195,-143.89,"undercount"
"7556",36119,"New York","Westchester County","NHPI_AIC",2402,817,-1585,-98.48,"undercount"
"7557",36121,"New York","Wyoming County","A_A",206,217,11,5.2,"overcount"
"7558",36121,"New York","Wyoming County","A_AIC",309,336,27,8.37,"overcount"
"7559",36121,"New York","Wyoming County","NHPI_A",17,9,-8,-61.54,"undercount"
"7560",36121,"New York","Wyoming County","NHPI_AIC",38,15,-23,-86.79,"undercount"
"7561",36123,"New York","Yates County","A_A",201,93,-108,-73.47,"undercount"
"7562",36123,"New York","Yates County","A_AIC",250,151,-99,-49.38,"undercount"
"7563",36123,"New York","Yates County","NHPI_A",5,12,7,82.35,"overcount"
"7564",36123,"New York","Yates County","NHPI_AIC",26,18,-8,-36.36,"undercount"
"7565",37001,"North Carolina","Alamance County","A_A",3219,2879,-340,-11.15,"undercount"
"7566",37001,"North Carolina","Alamance County","A_AIC",4061,3753,-308,-7.88,"undercount"
"7567",37001,"North Carolina","Alamance County","NHPI_A",185,86,-99,-73.06,"undercount"
"7568",37001,"North Carolina","Alamance County","NHPI_AIC",372,199,-173,-60.6,"undercount"
"7569",37003,"North Carolina","Alexander County","A_A",392,394,2,0.51,"overcount"
"7570",37003,"North Carolina","Alexander County","A_AIC",471,482,11,2.31,"overcount"
"7571",37003,"North Carolina","Alexander County","NHPI_A",20,1,-19,-180.95,"undercount"
"7572",37003,"North Carolina","Alexander County","NHPI_AIC",33,6,-27,-138.46,"undercount"
"7573",37005,"North Carolina","Alleghany County","A_A",89,15,-74,-142.31,"undercount"
"7574",37005,"North Carolina","Alleghany County","A_AIC",115,47,-68,-83.95,"undercount"
"7575",37005,"North Carolina","Alleghany County","NHPI_A",7,6,-1,-15.38,"undercount"
"7576",37005,"North Carolina","Alleghany County","NHPI_AIC",14,24,10,52.63,"overcount"
"7577",37007,"North Carolina","Anson County","A_A",377,224,-153,-50.92,"undercount"
"7578",37007,"North Carolina","Anson County","A_AIC",430,272,-158,-45.01,"undercount"
"7579",37007,"North Carolina","Anson County","NHPI_A",15,4,-11,-115.79,"undercount"
"7580",37007,"North Carolina","Anson County","NHPI_AIC",33,13,-20,-86.96,"undercount"
"7581",37009,"North Carolina","Ashe County","A_A",134,102,-32,-27.12,"undercount"
"7582",37009,"North Carolina","Ashe County","A_AIC",172,138,-34,-21.94,"undercount"
"7583",37009,"North Carolina","Ashe County","NHPI_A",20,12,-8,-50,"undercount"
"7584",37009,"North Carolina","Ashe County","NHPI_AIC",30,20,-10,-40,"undercount"
"7585",37011,"North Carolina","Avery County","A_A",115,56,-59,-69.01,"undercount"
"7586",37011,"North Carolina","Avery County","A_AIC",157,120,-37,-26.71,"undercount"
"7587",37011,"North Carolina","Avery County","NHPI_A",13,1,-12,-171.43,"undercount"
"7588",37011,"North Carolina","Avery County","NHPI_AIC",20,13,-7,-42.42,"undercount"
"7589",37013,"North Carolina","Beaufort County","A_A",259,183,-76,-34.39,"undercount"
"7590",37013,"North Carolina","Beaufort County","A_AIC",356,293,-63,-19.41,"undercount"
"7591",37013,"North Carolina","Beaufort County","NHPI_A",36,18,-18,-66.67,"undercount"
"7592",37013,"North Carolina","Beaufort County","NHPI_AIC",59,34,-25,-53.76,"undercount"
"7593",37015,"North Carolina","Bertie County","A_A",129,63,-66,-68.75,"undercount"
"7594",37015,"North Carolina","Bertie County","A_AIC",159,122,-37,-26.33,"undercount"
"7595",37015,"North Carolina","Bertie County","NHPI_A",18,0,-18,-200,"undercount"
"7596",37015,"North Carolina","Bertie County","NHPI_AIC",24,12,-12,-66.67,"undercount"
"7597",37017,"North Carolina","Bladen County","A_A",133,47,-86,-95.56,"undercount"
"7598",37017,"North Carolina","Bladen County","A_AIC",224,117,-107,-62.76,"undercount"
"7599",37017,"North Carolina","Bladen County","NHPI_A",14,8,-6,-54.55,"undercount"
"7600",37017,"North Carolina","Bladen County","NHPI_AIC",45,32,-13,-33.77,"undercount"
"7601",37019,"North Carolina","Brunswick County","A_A",1151,899,-252,-24.59,"undercount"
"7602",37019,"North Carolina","Brunswick County","A_AIC",1597,1405,-192,-12.79,"undercount"
"7603",37019,"North Carolina","Brunswick County","NHPI_A",184,75,-109,-84.17,"undercount"
"7604",37019,"North Carolina","Brunswick County","NHPI_AIC",265,147,-118,-57.28,"undercount"
"7605",37021,"North Carolina","Buncombe County","A_A",3853,3309,-544,-15.19,"undercount"
"7606",37021,"North Carolina","Buncombe County","A_AIC",5030,5197,167,3.27,"overcount"
"7607",37021,"North Carolina","Buncombe County","NHPI_A",445,467,22,4.82,"overcount"
"7608",37021,"North Carolina","Buncombe County","NHPI_AIC",612,689,77,11.84,"overcount"
"7609",37023,"North Carolina","Burke County","A_A",3383,3163,-220,-6.72,"undercount"
"7610",37023,"North Carolina","Burke County","A_AIC",3688,3460,-228,-6.38,"undercount"
"7611",37023,"North Carolina","Burke County","NHPI_A",631,65,-566,-162.64,"undercount"
"7612",37023,"North Carolina","Burke County","NHPI_AIC",689,135,-554,-134.47,"undercount"
"7613",37025,"North Carolina","Cabarrus County","A_A",11598,12053,455,3.85,"overcount"
"7614",37025,"North Carolina","Cabarrus County","A_AIC",12751,13648,897,6.8,"overcount"
"7615",37025,"North Carolina","Cabarrus County","NHPI_A",220,124,-96,-55.81,"undercount"
"7616",37025,"North Carolina","Cabarrus County","NHPI_AIC",436,304,-132,-35.68,"undercount"
"7617",37027,"North Carolina","Caldwell County","A_A",637,530,-107,-18.34,"undercount"
"7618",37027,"North Carolina","Caldwell County","A_AIC",819,777,-42,-5.26,"undercount"
"7619",37027,"North Carolina","Caldwell County","NHPI_A",92,15,-77,-143.93,"undercount"
"7620",37027,"North Carolina","Caldwell County","NHPI_AIC",131,62,-69,-71.5,"undercount"
"7621",37029,"North Carolina","Camden County","A_A",203,122,-81,-49.85,"undercount"
"7622",37029,"North Carolina","Camden County","A_AIC",271,210,-61,-25.36,"undercount"
"7623",37029,"North Carolina","Camden County","NHPI_A",6,1,-5,-142.86,"undercount"
"7624",37029,"North Carolina","Camden County","NHPI_AIC",20,21,1,4.88,"overcount"
"7625",37031,"North Carolina","Carteret County","A_A",835,594,-241,-33.73,"undercount"
"7626",37031,"North Carolina","Carteret County","A_AIC",1223,1089,-134,-11.59,"undercount"
"7627",37031,"North Carolina","Carteret County","NHPI_A",126,63,-63,-66.67,"undercount"
"7628",37031,"North Carolina","Carteret County","NHPI_AIC",178,155,-23,-13.81,"undercount"
"7629",37033,"North Carolina","Caswell County","A_A",144,61,-83,-80.98,"undercount"
"7630",37033,"North Carolina","Caswell County","A_AIC",209,136,-73,-42.32,"undercount"
"7631",37033,"North Carolina","Caswell County","NHPI_A",6,17,11,95.65,"overcount"
"7632",37033,"North Carolina","Caswell County","NHPI_AIC",19,32,13,50.98,"overcount"
"7633",37035,"North Carolina","Catawba County","A_A",7726,6957,-769,-10.47,"undercount"
"7634",37035,"North Carolina","Catawba County","A_AIC",8310,7758,-552,-6.87,"undercount"
"7635",37035,"North Carolina","Catawba County","NHPI_A",240,78,-162,-101.89,"undercount"
"7636",37035,"North Carolina","Catawba County","NHPI_AIC",323,186,-137,-53.83,"undercount"
"7637",37037,"North Carolina","Chatham County","A_A",1759,1636,-123,-7.25,"undercount"
"7638",37037,"North Carolina","Chatham County","A_AIC",2080,2178,98,4.6,"overcount"
"7639",37037,"North Carolina","Chatham County","NHPI_A",118,34,-84,-110.53,"undercount"
"7640",37037,"North Carolina","Chatham County","NHPI_AIC",171,82,-89,-70.36,"undercount"
"7641",37039,"North Carolina","Cherokee County","A_A",213,158,-55,-29.65,"undercount"
"7642",37039,"North Carolina","Cherokee County","A_AIC",274,252,-22,-8.37,"undercount"
"7643",37039,"North Carolina","Cherokee County","NHPI_A",15,0,-15,-200,"undercount"
"7644",37039,"North Carolina","Cherokee County","NHPI_AIC",23,17,-6,-30,"undercount"
"7645",37041,"North Carolina","Chowan County","A_A",114,42,-72,-92.31,"undercount"
"7646",37041,"North Carolina","Chowan County","A_AIC",146,92,-54,-45.38,"undercount"
"7647",37041,"North Carolina","Chowan County","NHPI_A",32,1,-31,-187.88,"undercount"
"7648",37041,"North Carolina","Chowan County","NHPI_AIC",41,15,-26,-92.86,"undercount"
"7649",37043,"North Carolina","Clay County","A_A",50,46,-4,-8.33,"undercount"
"7650",37043,"North Carolina","Clay County","A_AIC",70,81,11,14.57,"overcount"
"7651",37043,"North Carolina","Clay County","NHPI_A",5,9,4,57.14,"overcount"
"7652",37043,"North Carolina","Clay County","NHPI_AIC",11,14,3,24,"overcount"
"7653",37045,"North Carolina","Cleveland County","A_A",1106,854,-252,-25.71,"undercount"
"7654",37045,"North Carolina","Cleveland County","A_AIC",1402,1200,-202,-15.53,"undercount"
"7655",37045,"North Carolina","Cleveland County","NHPI_A",38,23,-15,-49.18,"undercount"
"7656",37045,"North Carolina","Cleveland County","NHPI_AIC",106,58,-48,-58.54,"undercount"
"7657",37047,"North Carolina","Columbus County","A_A",292,157,-135,-60.13,"undercount"
"7658",37047,"North Carolina","Columbus County","A_AIC",431,231,-200,-60.42,"undercount"
"7659",37047,"North Carolina","Columbus County","NHPI_A",51,10,-41,-134.43,"undercount"
"7660",37047,"North Carolina","Columbus County","NHPI_AIC",105,52,-53,-67.52,"undercount"
"7661",37049,"North Carolina","Craven County","A_A",3063,3084,21,0.68,"overcount"
"7662",37049,"North Carolina","Craven County","A_AIC",4091,4027,-64,-1.58,"undercount"
"7663",37049,"North Carolina","Craven County","NHPI_A",219,154,-65,-34.85,"undercount"
"7664",37049,"North Carolina","Craven County","NHPI_AIC",411,266,-145,-42.84,"undercount"
"7665",37051,"North Carolina","Cumberland County","A_A",9143,9100,-43,-0.47,"undercount"
"7666",37051,"North Carolina","Cumberland County","A_AIC",14109,13582,-527,-3.81,"undercount"
"7667",37051,"North Carolina","Cumberland County","NHPI_A",1520,1368,-152,-10.53,"undercount"
"7668",37051,"North Carolina","Cumberland County","NHPI_AIC",2749,2433,-316,-12.2,"undercount"
"7669",37053,"North Carolina","Currituck County","A_A",263,265,2,0.76,"overcount"
"7670",37053,"North Carolina","Currituck County","A_AIC",427,496,69,14.95,"overcount"
"7671",37053,"North Carolina","Currituck County","NHPI_A",25,22,-3,-12.77,"undercount"
"7672",37053,"North Carolina","Currituck County","NHPI_AIC",63,71,8,11.94,"overcount"
"7673",37055,"North Carolina","Dare County","A_A",336,260,-76,-25.5,"undercount"
"7674",37055,"North Carolina","Dare County","A_AIC",464,455,-9,-1.96,"undercount"
"7675",37055,"North Carolina","Dare County","NHPI_A",21,10,-11,-70.97,"undercount"
"7676",37055,"North Carolina","Dare County","NHPI_AIC",45,43,-2,-4.55,"undercount"
"7677",37057,"North Carolina","Davidson County","A_A",2996,2461,-535,-19.61,"undercount"
"7678",37057,"North Carolina","Davidson County","A_AIC",3626,3086,-540,-16.09,"undercount"
"7679",37057,"North Carolina","Davidson County","NHPI_A",128,43,-85,-99.42,"undercount"
"7680",37057,"North Carolina","Davidson County","NHPI_AIC",241,116,-125,-70.03,"undercount"
"7681",37059,"North Carolina","Davie County","A_A",399,285,-114,-33.33,"undercount"
"7682",37059,"North Carolina","Davie County","A_AIC",520,486,-34,-6.76,"undercount"
"7683",37059,"North Carolina","Davie County","NHPI_A",13,5,-8,-88.89,"undercount"
"7684",37059,"North Carolina","Davie County","NHPI_AIC",43,32,-11,-29.33,"undercount"
"7685",37061,"North Carolina","Duplin County","A_A",462,158,-304,-98.06,"undercount"
"7686",37061,"North Carolina","Duplin County","A_AIC",579,267,-312,-73.76,"undercount"
"7687",37061,"North Carolina","Duplin County","NHPI_A",312,4,-308,-194.94,"undercount"
"7688",37061,"North Carolina","Duplin County","NHPI_AIC",372,18,-354,-181.54,"undercount"
"7689",37063,"North Carolina","Durham County","A_A",18550,16867,-1683,-9.5,"undercount"
"7690",37063,"North Carolina","Durham County","A_AIC",21342,20343,-999,-4.79,"undercount"
"7691",37063,"North Carolina","Durham County","NHPI_A",418,96,-322,-125.29,"undercount"
"7692",37063,"North Carolina","Durham County","NHPI_AIC",784,318,-466,-84.57,"undercount"
"7693",37065,"North Carolina","Edgecombe County","A_A",176,115,-61,-41.92,"undercount"
"7694",37065,"North Carolina","Edgecombe County","A_AIC",294,187,-107,-44.49,"undercount"
"7695",37065,"North Carolina","Edgecombe County","NHPI_A",73,9,-64,-156.1,"undercount"
"7696",37065,"North Carolina","Edgecombe County","NHPI_AIC",128,23,-105,-139.07,"undercount"
"7697",37067,"North Carolina","Forsyth County","A_A",10256,9303,-953,-9.74,"undercount"
"7698",37067,"North Carolina","Forsyth County","A_AIC",12340,11550,-790,-6.61,"undercount"
"7699",37067,"North Carolina","Forsyth County","NHPI_A",641,241,-400,-90.7,"undercount"
"7700",37067,"North Carolina","Forsyth County","NHPI_AIC",981,543,-438,-57.48,"undercount"
"7701",37069,"North Carolina","Franklin County","A_A",581,454,-127,-24.54,"undercount"
"7702",37069,"North Carolina","Franklin County","A_AIC",899,780,-119,-14.18,"undercount"
"7703",37069,"North Carolina","Franklin County","NHPI_A",91,17,-74,-137.04,"undercount"
"7704",37069,"North Carolina","Franklin County","NHPI_AIC",170,60,-110,-95.65,"undercount"
"7705",37071,"North Carolina","Gaston County","A_A",3845,3550,-295,-7.98,"undercount"
"7706",37071,"North Carolina","Gaston County","A_AIC",4779,4657,-122,-2.59,"undercount"
"7707",37071,"North Carolina","Gaston County","NHPI_A",154,64,-90,-82.57,"undercount"
"7708",37071,"North Carolina","Gaston County","NHPI_AIC",303,237,-66,-24.44,"undercount"
"7709",37073,"North Carolina","Gates County","A_A",42,21,-21,-66.67,"undercount"
"7710",37073,"North Carolina","Gates County","A_AIC",94,51,-43,-59.31,"undercount"
"7711",37073,"North Carolina","Gates County","NHPI_A",13,11,-2,-16.67,"undercount"
"7712",37073,"North Carolina","Gates County","NHPI_AIC",30,36,6,18.18,"overcount"
"7713",37075,"North Carolina","Graham County","A_A",51,20,-31,-87.32,"undercount"
"7714",37075,"North Carolina","Graham County","A_AIC",64,37,-27,-53.47,"undercount"
"7715",37075,"North Carolina","Graham County","NHPI_A",9,5,-4,-57.14,"undercount"
"7716",37075,"North Carolina","Graham County","NHPI_AIC",14,8,-6,-54.55,"undercount"
"7717",37077,"North Carolina","Granville County","A_A",481,392,-89,-20.39,"undercount"
"7718",37077,"North Carolina","Granville County","A_AIC",707,603,-104,-15.88,"undercount"
"7719",37077,"North Carolina","Granville County","NHPI_A",58,24,-34,-82.93,"undercount"
"7720",37077,"North Carolina","Granville County","NHPI_AIC",117,57,-60,-68.97,"undercount"
"7721",37079,"North Carolina","Greene County","A_A",124,37,-87,-108.07,"undercount"
"7722",37079,"North Carolina","Greene County","A_AIC",164,73,-91,-76.79,"undercount"
"7723",37079,"North Carolina","Greene County","NHPI_A",61,0,-61,-200,"undercount"
"7724",37079,"North Carolina","Greene County","NHPI_AIC",74,14,-60,-136.36,"undercount"
"7725",37081,"North Carolina","Guilford County","A_A",29432,28990,-442,-1.51,"undercount"
"7726",37081,"North Carolina","Guilford County","A_AIC",32960,32634,-326,-0.99,"undercount"
"7727",37081,"North Carolina","Guilford County","NHPI_A",593,264,-329,-76.78,"undercount"
"7728",37081,"North Carolina","Guilford County","NHPI_AIC",1192,658,-534,-57.73,"undercount"
"7729",37083,"North Carolina","Halifax County","A_A",426,288,-138,-38.66,"undercount"
"7730",37083,"North Carolina","Halifax County","A_AIC",550,423,-127,-26.1,"undercount"
"7731",37083,"North Carolina","Halifax County","NHPI_A",44,11,-33,-120,"undercount"
"7732",37083,"North Carolina","Halifax County","NHPI_AIC",76,65,-11,-15.6,"undercount"
"7733",37085,"North Carolina","Harnett County","A_A",1819,1463,-356,-21.69,"undercount"
"7734",37085,"North Carolina","Harnett County","A_AIC",3084,2797,-287,-9.76,"undercount"
"7735",37085,"North Carolina","Harnett County","NHPI_A",303,242,-61,-22.39,"undercount"
"7736",37085,"North Carolina","Harnett County","NHPI_AIC",548,571,23,4.11,"overcount"
"7737",37087,"North Carolina","Haywood County","A_A",458,363,-95,-23.14,"undercount"
"7738",37087,"North Carolina","Haywood County","A_AIC",641,573,-68,-11.2,"undercount"
"7739",37087,"North Carolina","Haywood County","NHPI_A",35,1,-34,-188.89,"undercount"
"7740",37087,"North Carolina","Haywood County","NHPI_AIC",55,21,-34,-89.47,"undercount"
"7741",37089,"North Carolina","Henderson County","A_A",1613,1302,-311,-21.34,"undercount"
"7742",37089,"North Carolina","Henderson County","A_AIC",2028,1828,-200,-10.37,"undercount"
"7743",37089,"North Carolina","Henderson County","NHPI_A",272,241,-31,-12.09,"undercount"
"7744",37089,"North Carolina","Henderson County","NHPI_AIC",353,349,-4,-1.14,"undercount"
"7745",37091,"North Carolina","Hertford County","A_A",215,113,-102,-62.2,"undercount"
"7746",37091,"North Carolina","Hertford County","A_AIC",270,153,-117,-55.32,"undercount"
"7747",37091,"North Carolina","Hertford County","NHPI_A",14,4,-10,-111.11,"undercount"
"7748",37091,"North Carolina","Hertford County","NHPI_AIC",40,36,-4,-10.53,"undercount"
"7749",37093,"North Carolina","Hoke County","A_A",816,738,-78,-10.04,"undercount"
"7750",37093,"North Carolina","Hoke County","A_AIC",1454,1358,-96,-6.83,"undercount"
"7751",37093,"North Carolina","Hoke County","NHPI_A",218,189,-29,-14.25,"undercount"
"7752",37093,"North Carolina","Hoke County","NHPI_AIC",365,331,-34,-9.77,"undercount"
"7753",37095,"North Carolina","Hyde County","A_A",41,7,-34,-141.67,"undercount"
"7754",37095,"North Carolina","Hyde County","A_AIC",54,18,-36,-100,"undercount"
"7755",37095,"North Carolina","Hyde County","NHPI_A",1,2,1,66.67,"overcount"
"7756",37095,"North Carolina","Hyde County","NHPI_AIC",4,5,1,22.22,"overcount"
"7757",37097,"North Carolina","Iredell County","A_A",5241,4769,-472,-9.43,"undercount"
"7758",37097,"North Carolina","Iredell County","A_AIC",6109,5908,-201,-3.35,"undercount"
"7759",37097,"North Carolina","Iredell County","NHPI_A",148,58,-90,-87.38,"undercount"
"7760",37097,"North Carolina","Iredell County","NHPI_AIC",285,205,-80,-32.65,"undercount"
"7761",37099,"North Carolina","Jackson County","A_A",515,524,9,1.73,"overcount"
"7762",37099,"North Carolina","Jackson County","A_AIC",684,720,36,5.13,"overcount"
"7763",37099,"North Carolina","Jackson County","NHPI_A",21,10,-11,-70.97,"undercount"
"7764",37099,"North Carolina","Jackson County","NHPI_AIC",46,62,16,29.63,"overcount"
"7765",37101,"North Carolina","Johnston County","A_A",2158,1848,-310,-15.48,"undercount"
"7766",37101,"North Carolina","Johnston County","A_AIC",3250,3051,-199,-6.32,"undercount"
"7767",37101,"North Carolina","Johnston County","NHPI_A",288,71,-217,-120.89,"undercount"
"7768",37101,"North Carolina","Johnston County","NHPI_AIC",487,272,-215,-56.65,"undercount"
"7769",37103,"North Carolina","Jones County","A_A",59,32,-27,-59.34,"undercount"
"7770",37103,"North Carolina","Jones County","A_AIC",86,59,-27,-37.24,"undercount"
"7771",37103,"North Carolina","Jones County","NHPI_A",4,0,-4,-200,"undercount"
"7772",37103,"North Carolina","Jones County","NHPI_AIC",13,1,-12,-171.43,"undercount"
"7773",37105,"North Carolina","Lee County","A_A",958,678,-280,-34.23,"undercount"
"7774",37105,"North Carolina","Lee County","A_AIC",1313,989,-324,-28.15,"undercount"
"7775",37105,"North Carolina","Lee County","NHPI_A",121,48,-73,-86.39,"undercount"
"7776",37105,"North Carolina","Lee County","NHPI_AIC",211,118,-93,-56.53,"undercount"
"7777",37107,"North Carolina","Lenoir County","A_A",405,332,-73,-19.81,"undercount"
"7778",37107,"North Carolina","Lenoir County","A_AIC",608,512,-96,-17.14,"undercount"
"7779",37107,"North Carolina","Lenoir County","NHPI_A",116,26,-90,-126.76,"undercount"
"7780",37107,"North Carolina","Lenoir County","NHPI_AIC",182,65,-117,-94.74,"undercount"
"7781",37109,"North Carolina","Lincoln County","A_A",762,697,-65,-8.91,"undercount"
"7782",37109,"North Carolina","Lincoln County","A_AIC",1016,1062,46,4.43,"overcount"
"7783",37109,"North Carolina","Lincoln County","NHPI_A",50,15,-35,-107.69,"undercount"
"7784",37109,"North Carolina","Lincoln County","NHPI_AIC",101,66,-35,-41.92,"undercount"
"7785",37111,"North Carolina","McDowell County","A_A",521,388,-133,-29.26,"undercount"
"7786",37111,"North Carolina","McDowell County","A_AIC",610,489,-121,-22.02,"undercount"
"7787",37111,"North Carolina","McDowell County","NHPI_A",24,0,-24,-200,"undercount"
"7788",37111,"North Carolina","McDowell County","NHPI_AIC",44,19,-25,-79.37,"undercount"
"7789",37113,"North Carolina","Macon County","A_A",400,250,-150,-46.15,"undercount"
"7790",37113,"North Carolina","Macon County","A_AIC",482,357,-125,-29.8,"undercount"
"7791",37113,"North Carolina","Macon County","NHPI_A",21,7,-14,-100,"undercount"
"7792",37113,"North Carolina","Macon County","NHPI_AIC",40,42,2,4.88,"overcount"
"7793",37115,"North Carolina","Madison County","A_A",117,84,-33,-32.84,"undercount"
"7794",37115,"North Carolina","Madison County","A_AIC",167,156,-11,-6.81,"undercount"
"7795",37115,"North Carolina","Madison County","NHPI_A",10,3,-7,-107.69,"undercount"
"7796",37115,"North Carolina","Madison County","NHPI_AIC",26,13,-13,-66.67,"undercount"
"7797",37117,"North Carolina","Martin County","A_A",133,98,-35,-30.3,"undercount"
"7798",37117,"North Carolina","Martin County","A_AIC",179,133,-46,-29.49,"undercount"
"7799",37117,"North Carolina","Martin County","NHPI_A",50,5,-45,-163.64,"undercount"
"7800",37117,"North Carolina","Martin County","NHPI_AIC",64,17,-47,-116.05,"undercount"
"7801",37119,"North Carolina","Mecklenburg County","A_A",74344,72447,-1897,-2.58,"undercount"
"7802",37119,"North Carolina","Mecklenburg County","A_AIC",82629,82051,-578,-0.7,"undercount"
"7803",37119,"North Carolina","Mecklenburg County","NHPI_A",1308,557,-751,-80.54,"undercount"
"7804",37119,"North Carolina","Mecklenburg County","NHPI_AIC",2388,1407,-981,-51.7,"undercount"
"7805",37121,"North Carolina","Mitchell County","A_A",101,52,-49,-64.05,"undercount"
"7806",37121,"North Carolina","Mitchell County","A_AIC",135,105,-30,-25,"undercount"
"7807",37121,"North Carolina","Mitchell County","NHPI_A",22,1,-21,-182.61,"undercount"
"7808",37121,"North Carolina","Mitchell County","NHPI_AIC",30,10,-20,-100,"undercount"
"7809",37123,"North Carolina","Montgomery County","A_A",457,391,-66,-15.57,"undercount"
"7810",37123,"North Carolina","Montgomery County","A_AIC",553,447,-106,-21.2,"undercount"
"7811",37123,"North Carolina","Montgomery County","NHPI_A",29,2,-27,-174.19,"undercount"
"7812",37123,"North Carolina","Montgomery County","NHPI_AIC",59,36,-23,-48.42,"undercount"
"7813",37125,"North Carolina","Moore County","A_A",1719,1244,-475,-32.06,"undercount"
"7814",37125,"North Carolina","Moore County","A_AIC",2270,2120,-150,-6.83,"undercount"
"7815",37125,"North Carolina","Moore County","NHPI_A",194,59,-135,-106.72,"undercount"
"7816",37125,"North Carolina","Moore County","NHPI_AIC",281,183,-98,-42.24,"undercount"
"7817",37127,"North Carolina","Nash County","A_A",1047,909,-138,-14.11,"undercount"
"7818",37127,"North Carolina","Nash County","A_AIC",1353,1188,-165,-12.99,"undercount"
"7819",37127,"North Carolina","Nash County","NHPI_A",80,30,-50,-90.91,"undercount"
"7820",37127,"North Carolina","Nash County","NHPI_AIC",163,76,-87,-72.8,"undercount"
"7821",37129,"North Carolina","New Hanover County","A_A",3584,3505,-79,-2.23,"undercount"
"7822",37129,"North Carolina","New Hanover County","A_AIC",5193,5269,76,1.45,"overcount"
"7823",37129,"North Carolina","New Hanover County","NHPI_A",293,152,-141,-63.37,"undercount"
"7824",37129,"North Carolina","New Hanover County","NHPI_AIC",547,458,-89,-17.71,"undercount"
"7825",37131,"North Carolina","Northampton County","A_A",60,28,-32,-72.73,"undercount"
"7826",37131,"North Carolina","Northampton County","A_AIC",103,70,-33,-38.15,"undercount"
"7827",37131,"North Carolina","Northampton County","NHPI_A",6,4,-2,-40,"undercount"
"7828",37131,"North Carolina","Northampton County","NHPI_AIC",17,17,0,0,"equal"
"7829",37133,"North Carolina","Onslow County","A_A",4579,4585,6,0.13,"overcount"
"7830",37133,"North Carolina","Onslow County","A_AIC",7995,7812,-183,-2.32,"undercount"
"7831",37133,"North Carolina","Onslow County","NHPI_A",676,790,114,15.55,"overcount"
"7832",37133,"North Carolina","Onslow County","NHPI_AIC",1308,1589,281,19.4,"overcount"
"7833",37135,"North Carolina","Orange County","A_A",11985,12736,751,6.08,"overcount"
"7834",37135,"North Carolina","Orange County","A_AIC",13666,15120,1454,10.1,"overcount"
"7835",37135,"North Carolina","Orange County","NHPI_A",133,43,-90,-102.27,"undercount"
"7836",37135,"North Carolina","Orange County","NHPI_AIC",276,161,-115,-52.63,"undercount"
"7837",37137,"North Carolina","Pamlico County","A_A",83,50,-33,-49.62,"undercount"
"7838",37137,"North Carolina","Pamlico County","A_AIC",113,101,-12,-11.21,"undercount"
"7839",37137,"North Carolina","Pamlico County","NHPI_A",25,5,-20,-133.33,"undercount"
"7840",37137,"North Carolina","Pamlico County","NHPI_AIC",30,12,-18,-85.71,"undercount"
"7841",37139,"North Carolina","Pasquotank County","A_A",566,460,-106,-20.66,"undercount"
"7842",37139,"North Carolina","Pasquotank County","A_AIC",890,707,-183,-22.92,"undercount"
"7843",37139,"North Carolina","Pasquotank County","NHPI_A",33,28,-5,-16.39,"undercount"
"7844",37139,"North Carolina","Pasquotank County","NHPI_AIC",100,72,-28,-32.56,"undercount"
"7845",37141,"North Carolina","Pender County","A_A",446,325,-121,-31.39,"undercount"
"7846",37141,"North Carolina","Pender County","A_AIC",718,695,-23,-3.26,"undercount"
"7847",37141,"North Carolina","Pender County","NHPI_A",57,23,-34,-85,"undercount"
"7848",37141,"North Carolina","Pender County","NHPI_AIC",118,109,-9,-7.93,"undercount"
"7849",37143,"North Carolina","Perquimans County","A_A",74,38,-36,-64.29,"undercount"
"7850",37143,"North Carolina","Perquimans County","A_AIC",114,88,-26,-25.74,"undercount"
"7851",37143,"North Carolina","Perquimans County","NHPI_A",2,7,5,111.11,"overcount"
"7852",37143,"North Carolina","Perquimans County","NHPI_AIC",10,26,16,88.89,"overcount"
"7853",37145,"North Carolina","Person County","A_A",185,125,-60,-38.71,"undercount"
"7854",37145,"North Carolina","Person County","A_AIC",294,232,-62,-23.57,"undercount"
"7855",37145,"North Carolina","Person County","NHPI_A",9,8,-1,-11.76,"undercount"
"7856",37145,"North Carolina","Person County","NHPI_AIC",46,26,-20,-55.56,"undercount"
"7857",37147,"North Carolina","Pitt County","A_A",3769,3080,-689,-20.12,"undercount"
"7858",37147,"North Carolina","Pitt County","A_AIC",4939,4220,-719,-15.7,"undercount"
"7859",37147,"North Carolina","Pitt County","NHPI_A",287,94,-193,-101.31,"undercount"
"7860",37147,"North Carolina","Pitt County","NHPI_AIC",469,214,-255,-74.67,"undercount"
"7861",37149,"North Carolina","Polk County","A_A",196,64,-132,-101.54,"undercount"
"7862",37149,"North Carolina","Polk County","A_AIC",255,146,-109,-54.36,"undercount"
"7863",37149,"North Carolina","Polk County","NHPI_A",5,7,2,33.33,"overcount"
"7864",37149,"North Carolina","Polk County","NHPI_AIC",15,35,20,80,"overcount"
"7865",37151,"North Carolina","Randolph County","A_A",2336,2174,-162,-7.18,"undercount"
"7866",37151,"North Carolina","Randolph County","A_AIC",2733,2616,-117,-4.37,"undercount"
"7867",37151,"North Carolina","Randolph County","NHPI_A",145,10,-135,-174.19,"undercount"
"7868",37151,"North Carolina","Randolph County","NHPI_AIC",220,82,-138,-91.39,"undercount"
"7869",37153,"North Carolina","Richmond County","A_A",444,367,-77,-18.99,"undercount"
"7870",37153,"North Carolina","Richmond County","A_AIC",639,468,-171,-30.89,"undercount"
"7871",37153,"North Carolina","Richmond County","NHPI_A",79,7,-72,-167.44,"undercount"
"7872",37153,"North Carolina","Richmond County","NHPI_AIC",137,50,-87,-93.05,"undercount"
"7873",37155,"North Carolina","Robeson County","A_A",856,904,48,5.45,"overcount"
"7874",37155,"North Carolina","Robeson County","A_AIC",1338,1174,-164,-13.06,"undercount"
"7875",37155,"North Carolina","Robeson County","NHPI_A",280,64,-216,-125.58,"undercount"
"7876",37155,"North Carolina","Robeson County","NHPI_AIC",415,165,-250,-86.21,"undercount"
"7877",37157,"North Carolina","Rockingham County","A_A",645,495,-150,-26.32,"undercount"
"7878",37157,"North Carolina","Rockingham County","A_AIC",929,737,-192,-23.05,"undercount"
"7879",37157,"North Carolina","Rockingham County","NHPI_A",122,29,-93,-123.18,"undercount"
"7880",37157,"North Carolina","Rockingham County","NHPI_AIC",219,81,-138,-92,"undercount"
"7881",37159,"North Carolina","Rowan County","A_A",1634,1513,-121,-7.69,"undercount"
"7882",37159,"North Carolina","Rowan County","A_AIC",2112,1988,-124,-6.05,"undercount"
"7883",37159,"North Carolina","Rowan County","NHPI_A",167,71,-96,-80.67,"undercount"
"7884",37159,"North Carolina","Rowan County","NHPI_AIC",283,146,-137,-63.87,"undercount"
"7885",37161,"North Carolina","Rutherford County","A_A",432,343,-89,-22.97,"undercount"
"7886",37161,"North Carolina","Rutherford County","A_AIC",619,512,-107,-18.92,"undercount"
"7887",37161,"North Carolina","Rutherford County","NHPI_A",47,23,-24,-68.57,"undercount"
"7888",37161,"North Carolina","Rutherford County","NHPI_AIC",100,71,-29,-33.92,"undercount"
"7889",37163,"North Carolina","Sampson County","A_A",408,217,-191,-61.12,"undercount"
"7890",37163,"North Carolina","Sampson County","A_AIC",673,362,-311,-60.1,"undercount"
"7891",37163,"North Carolina","Sampson County","NHPI_A",214,18,-196,-168.97,"undercount"
"7892",37163,"North Carolina","Sampson County","NHPI_AIC",295,59,-236,-133.33,"undercount"
"7893",37165,"North Carolina","Scotland County","A_A",330,343,13,3.86,"overcount"
"7894",37165,"North Carolina","Scotland County","A_AIC",467,427,-40,-8.95,"undercount"
"7895",37165,"North Carolina","Scotland County","NHPI_A",24,15,-9,-46.15,"undercount"
"7896",37165,"North Carolina","Scotland County","NHPI_AIC",66,42,-24,-44.44,"undercount"
"7897",37167,"North Carolina","Stanly County","A_A",1239,1140,-99,-8.32,"undercount"
"7898",37167,"North Carolina","Stanly County","A_AIC",1397,1345,-52,-3.79,"undercount"
"7899",37167,"North Carolina","Stanly County","NHPI_A",166,9,-157,-179.43,"undercount"
"7900",37167,"North Carolina","Stanly County","NHPI_AIC",199,28,-171,-150.66,"undercount"
"7901",37169,"North Carolina","Stokes County","A_A",193,160,-33,-18.7,"undercount"
"7902",37169,"North Carolina","Stokes County","A_AIC",277,288,11,3.89,"overcount"
"7903",37169,"North Carolina","Stokes County","NHPI_A",17,11,-6,-42.86,"undercount"
"7904",37169,"North Carolina","Stokes County","NHPI_AIC",35,44,9,22.78,"overcount"
"7905",37171,"North Carolina","Surry County","A_A",567,379,-188,-39.75,"undercount"
"7906",37171,"North Carolina","Surry County","A_AIC",755,535,-220,-34.11,"undercount"
"7907",37171,"North Carolina","Surry County","NHPI_A",75,14,-61,-137.08,"undercount"
"7908",37171,"North Carolina","Surry County","NHPI_AIC",121,33,-88,-114.29,"undercount"
"7909",37173,"North Carolina","Swain County","A_A",104,53,-51,-64.97,"undercount"
"7910",37173,"North Carolina","Swain County","A_AIC",168,109,-59,-42.6,"undercount"
"7911",37173,"North Carolina","Swain County","NHPI_A",8,10,2,22.22,"overcount"
"7912",37173,"North Carolina","Swain County","NHPI_AIC",26,25,-1,-3.92,"undercount"
"7913",37175,"North Carolina","Transylvania County","A_A",221,178,-43,-21.55,"undercount"
"7914",37175,"North Carolina","Transylvania County","A_AIC",320,328,8,2.47,"overcount"
"7915",37175,"North Carolina","Transylvania County","NHPI_A",24,22,-2,-8.7,"undercount"
"7916",37175,"North Carolina","Transylvania County","NHPI_AIC",49,45,-4,-8.51,"undercount"
"7917",37177,"North Carolina","Tyrrell County","A_A",67,43,-24,-43.64,"undercount"
"7918",37177,"North Carolina","Tyrrell County","A_AIC",73,56,-17,-26.36,"undercount"
"7919",37177,"North Carolina","Tyrrell County","NHPI_A",0,3,3,200,"overcount"
"7920",37177,"North Carolina","Tyrrell County","NHPI_AIC",4,13,9,105.88,"overcount"
"7921",37179,"North Carolina","Union County","A_A",9578,9618,40,0.42,"overcount"
"7922",37179,"North Carolina","Union County","A_AIC",10980,11456,476,4.24,"overcount"
"7923",37179,"North Carolina","Union County","NHPI_A",207,98,-109,-71.48,"undercount"
"7924",37179,"North Carolina","Union County","NHPI_AIC",391,229,-162,-52.26,"undercount"
"7925",37181,"North Carolina","Vance County","A_A",390,288,-102,-30.09,"undercount"
"7926",37181,"North Carolina","Vance County","A_AIC",522,433,-89,-18.64,"undercount"
"7927",37181,"North Carolina","Vance County","NHPI_A",28,9,-19,-102.7,"undercount"
"7928",37181,"North Carolina","Vance County","NHPI_AIC",77,28,-49,-93.33,"undercount"
"7929",37183,"North Carolina","Wake County","A_A",91685,97633,5948,6.28,"overcount"
"7930",37183,"North Carolina","Wake County","A_AIC",103100,111289,8189,7.64,"overcount"
"7931",37183,"North Carolina","Wake County","NHPI_A",1029,472,-557,-74.22,"undercount"
"7932",37183,"North Carolina","Wake County","NHPI_AIC",2191,1570,-621,-33.02,"undercount"
"7933",37185,"North Carolina","Warren County","A_A",79,68,-11,-14.97,"undercount"
"7934",37185,"North Carolina","Warren County","A_AIC",133,119,-14,-11.11,"undercount"
"7935",37185,"North Carolina","Warren County","NHPI_A",6,6,0,0,"equal"
"7936",37185,"North Carolina","Warren County","NHPI_AIC",22,48,26,74.29,"overcount"
"7937",37187,"North Carolina","Washington County","A_A",51,37,-14,-31.82,"undercount"
"7938",37187,"North Carolina","Washington County","A_AIC",72,56,-16,-25,"undercount"
"7939",37187,"North Carolina","Washington County","NHPI_A",4,3,-1,-28.57,"undercount"
"7940",37187,"North Carolina","Washington County","NHPI_AIC",13,10,-3,-26.09,"undercount"
"7941",37189,"North Carolina","Watauga County","A_A",699,950,251,30.44,"overcount"
"7942",37189,"North Carolina","Watauga County","A_AIC",940,1372,432,37.37,"overcount"
"7943",37189,"North Carolina","Watauga County","NHPI_A",27,11,-16,-84.21,"undercount"
"7944",37189,"North Carolina","Watauga County","NHPI_AIC",65,178,113,93,"overcount"
"7945",37191,"North Carolina","Wayne County","A_A",1647,1547,-100,-6.26,"undercount"
"7946",37191,"North Carolina","Wayne County","A_AIC",2737,2387,-350,-13.66,"undercount"
"7947",37191,"North Carolina","Wayne County","NHPI_A",221,75,-146,-98.65,"undercount"
"7948",37191,"North Carolina","Wayne County","NHPI_AIC",398,218,-180,-58.44,"undercount"
"7949",37193,"North Carolina","Wilkes County","A_A",391,324,-67,-18.74,"undercount"
"7950",37193,"North Carolina","Wilkes County","A_AIC",551,459,-92,-18.22,"undercount"
"7951",37193,"North Carolina","Wilkes County","NHPI_A",77,5,-72,-175.61,"undercount"
"7952",37193,"North Carolina","Wilkes County","NHPI_AIC",115,30,-85,-117.24,"undercount"
"7953",37195,"North Carolina","Wilson County","A_A",1023,905,-118,-12.24,"undercount"
"7954",37195,"North Carolina","Wilson County","A_AIC",1356,1231,-125,-9.66,"undercount"
"7955",37195,"North Carolina","Wilson County","NHPI_A",116,10,-106,-168.25,"undercount"
"7956",37195,"North Carolina","Wilson County","NHPI_AIC",185,75,-110,-84.62,"undercount"
"7957",37197,"North Carolina","Yadkin County","A_A",212,142,-70,-39.55,"undercount"
"7958",37197,"North Carolina","Yadkin County","A_AIC",276,212,-64,-26.23,"undercount"
"7959",37197,"North Carolina","Yadkin County","NHPI_A",67,0,-67,-200,"undercount"
"7960",37197,"North Carolina","Yadkin County","NHPI_AIC",78,24,-54,-105.88,"undercount"
"7961",37199,"North Carolina","Yancey County","A_A",64,45,-19,-34.86,"undercount"
"7962",37199,"North Carolina","Yancey County","A_AIC",94,83,-11,-12.43,"undercount"
"7963",37199,"North Carolina","Yancey County","NHPI_A",53,1,-52,-192.59,"undercount"
"7964",37199,"North Carolina","Yancey County","NHPI_AIC",60,5,-55,-169.23,"undercount"
"7965",38001,"North Dakota","Adams County","A_A",72,39,-33,-59.46,"undercount"
"7966",38001,"North Dakota","Adams County","A_AIC",86,48,-38,-56.72,"undercount"
"7967",38001,"North Dakota","Adams County","NHPI_A",1,1,0,0,"equal"
"7968",38001,"North Dakota","Adams County","NHPI_AIC",4,9,5,76.92,"overcount"
"7969",38003,"North Dakota","Barnes County","A_A",103,69,-34,-39.53,"undercount"
"7970",38003,"North Dakota","Barnes County","A_AIC",139,130,-9,-6.69,"undercount"
"7971",38003,"North Dakota","Barnes County","NHPI_A",7,2,-5,-111.11,"undercount"
"7972",38003,"North Dakota","Barnes County","NHPI_AIC",14,20,6,35.29,"overcount"
"7973",38005,"North Dakota","Benson County","A_A",18,7,-11,-88,"undercount"
"7974",38005,"North Dakota","Benson County","A_AIC",31,22,-9,-33.96,"undercount"
"7975",38005,"North Dakota","Benson County","NHPI_A",1,0,-1,-200,"undercount"
"7976",38005,"North Dakota","Benson County","NHPI_AIC",3,6,3,66.67,"overcount"
"7977",38007,"North Dakota","Billings County","A_A",38,6,-32,-145.45,"undercount"
"7978",38007,"North Dakota","Billings County","A_AIC",40,8,-32,-133.33,"undercount"
"7979",38007,"North Dakota","Billings County","NHPI_A",0,0,0,0,"equal"
"7980",38007,"North Dakota","Billings County","NHPI_AIC",1,1,0,0,"equal"
"7981",38009,"North Dakota","Bottineau County","A_A",44,48,4,8.7,"overcount"
"7982",38009,"North Dakota","Bottineau County","A_AIC",72,66,-6,-8.7,"undercount"
"7983",38009,"North Dakota","Bottineau County","NHPI_A",0,1,1,200,"overcount"
"7984",38009,"North Dakota","Bottineau County","NHPI_AIC",9,5,-4,-57.14,"undercount"
"7985",38011,"North Dakota","Bowman County","A_A",5,17,12,109.09,"overcount"
"7986",38011,"North Dakota","Bowman County","A_AIC",9,17,8,61.54,"overcount"
"7987",38011,"North Dakota","Bowman County","NHPI_A",4,3,-1,-28.57,"undercount"
"7988",38011,"North Dakota","Bowman County","NHPI_AIC",5,3,-2,-50,"undercount"
"7989",38013,"North Dakota","Burke County","A_A",18,12,-6,-40,"undercount"
"7990",38013,"North Dakota","Burke County","A_AIC",24,22,-2,-8.7,"undercount"
"7991",38013,"North Dakota","Burke County","NHPI_A",2,0,-2,-200,"undercount"
"7992",38013,"North Dakota","Burke County","NHPI_AIC",2,2,0,0,"equal"
"7993",38015,"North Dakota","Burleigh County","A_A",849,1043,194,20.51,"overcount"
"7994",38015,"North Dakota","Burleigh County","A_AIC",1273,1537,264,18.79,"overcount"
"7995",38015,"North Dakota","Burleigh County","NHPI_A",118,320,202,92.24,"overcount"
"7996",38015,"North Dakota","Burleigh County","NHPI_AIC",195,419,224,72.96,"overcount"
"7997",38017,"North Dakota","Cass County","A_A",6054,6065,11,0.18,"overcount"
"7998",38017,"North Dakota","Cass County","A_AIC",7384,7517,133,1.79,"overcount"
"7999",38017,"North Dakota","Cass County","NHPI_A",115,79,-36,-37.11,"undercount"
"8000",38017,"North Dakota","Cass County","NHPI_AIC",277,215,-62,-25.2,"undercount"
"8001",38019,"North Dakota","Cavalier County","A_A",22,16,-6,-31.58,"undercount"
"8002",38019,"North Dakota","Cavalier County","A_AIC",31,23,-8,-29.63,"undercount"
"8003",38019,"North Dakota","Cavalier County","NHPI_A",0,0,0,0,"equal"
"8004",38019,"North Dakota","Cavalier County","NHPI_AIC",2,1,-1,-66.67,"undercount"
"8005",38021,"North Dakota","Dickey County","A_A",34,44,10,25.64,"overcount"
"8006",38021,"North Dakota","Dickey County","A_AIC",51,67,16,27.12,"overcount"
"8007",38021,"North Dakota","Dickey County","NHPI_A",1,0,-1,-200,"undercount"
"8008",38021,"North Dakota","Dickey County","NHPI_AIC",6,1,-5,-142.86,"undercount"
"8009",38023,"North Dakota","Divide County","A_A",43,12,-31,-112.73,"undercount"
"8010",38023,"North Dakota","Divide County","A_AIC",56,22,-34,-87.18,"undercount"
"8011",38023,"North Dakota","Divide County","NHPI_A",5,4,-1,-22.22,"undercount"
"8012",38023,"North Dakota","Divide County","NHPI_AIC",11,6,-5,-58.82,"undercount"
"8013",38025,"North Dakota","Dunn County","A_A",65,33,-32,-65.31,"undercount"
"8014",38025,"North Dakota","Dunn County","A_AIC",86,59,-27,-37.24,"undercount"
"8015",38025,"North Dakota","Dunn County","NHPI_A",0,0,0,0,"equal"
"8016",38025,"North Dakota","Dunn County","NHPI_AIC",9,15,6,50,"overcount"
"8017",38027,"North Dakota","Eddy County","A_A",11,0,-11,-200,"undercount"
"8018",38027,"North Dakota","Eddy County","A_AIC",17,4,-13,-123.81,"undercount"
"8019",38027,"North Dakota","Eddy County","NHPI_A",1,0,-1,-200,"undercount"
"8020",38027,"North Dakota","Eddy County","NHPI_AIC",3,4,1,28.57,"overcount"
"8021",38029,"North Dakota","Emmons County","A_A",24,12,-12,-66.67,"undercount"
"8022",38029,"North Dakota","Emmons County","A_AIC",29,21,-8,-32,"undercount"
"8023",38029,"North Dakota","Emmons County","NHPI_A",0,0,0,0,"equal"
"8024",38029,"North Dakota","Emmons County","NHPI_AIC",0,1,1,200,"overcount"
"8025",38031,"North Dakota","Foster County","A_A",16,13,-3,-20.69,"undercount"
"8026",38031,"North Dakota","Foster County","A_AIC",20,27,7,29.79,"overcount"
"8027",38031,"North Dakota","Foster County","NHPI_A",0,1,1,200,"overcount"
"8028",38031,"North Dakota","Foster County","NHPI_AIC",0,8,8,200,"overcount"
"8029",38033,"North Dakota","Golden Valley County","A_A",2,1,-1,-66.67,"undercount"
"8030",38033,"North Dakota","Golden Valley County","A_AIC",5,24,19,131.03,"overcount"
"8031",38033,"North Dakota","Golden Valley County","NHPI_A",2,1,-1,-66.67,"undercount"
"8032",38033,"North Dakota","Golden Valley County","NHPI_AIC",2,5,3,85.71,"overcount"
"8033",38035,"North Dakota","Grand Forks County","A_A",2071,2494,423,18.53,"overcount"
"8034",38035,"North Dakota","Grand Forks County","A_AIC",2752,3225,473,15.83,"overcount"
"8035",38035,"North Dakota","Grand Forks County","NHPI_A",52,52,0,0,"equal"
"8036",38035,"North Dakota","Grand Forks County","NHPI_AIC",191,162,-29,-16.43,"undercount"
"8037",38037,"North Dakota","Grant County","A_A",6,11,5,58.82,"overcount"
"8038",38037,"North Dakota","Grant County","A_AIC",18,19,1,5.41,"overcount"
"8039",38037,"North Dakota","Grant County","NHPI_A",0,0,0,0,"equal"
"8040",38037,"North Dakota","Grant County","NHPI_AIC",3,6,3,66.67,"overcount"
"8041",38039,"North Dakota","Griggs County","A_A",3,7,4,80,"overcount"
"8042",38039,"North Dakota","Griggs County","A_AIC",3,11,8,114.29,"overcount"
"8043",38039,"North Dakota","Griggs County","NHPI_A",0,0,0,0,"equal"
"8044",38039,"North Dakota","Griggs County","NHPI_AIC",0,4,4,200,"overcount"
"8045",38041,"North Dakota","Hettinger County","A_A",8,5,-3,-46.15,"undercount"
"8046",38041,"North Dakota","Hettinger County","A_AIC",13,21,8,47.06,"overcount"
"8047",38041,"North Dakota","Hettinger County","NHPI_A",4,7,3,54.55,"overcount"
"8048",38041,"North Dakota","Hettinger County","NHPI_AIC",5,14,9,94.74,"overcount"
"8049",38043,"North Dakota","Kidder County","A_A",18,5,-13,-113.04,"undercount"
"8050",38043,"North Dakota","Kidder County","A_AIC",24,16,-8,-40,"undercount"
"8051",38043,"North Dakota","Kidder County","NHPI_A",0,5,5,200,"overcount"
"8052",38043,"North Dakota","Kidder County","NHPI_AIC",1,13,12,171.43,"overcount"
"8053",38045,"North Dakota","LaMoure County","A_A",5,7,2,33.33,"overcount"
"8054",38045,"North Dakota","LaMoure County","A_AIC",10,7,-3,-35.29,"undercount"
"8055",38045,"North Dakota","LaMoure County","NHPI_A",2,4,2,66.67,"overcount"
"8056",38045,"North Dakota","LaMoure County","NHPI_AIC",3,9,6,100,"overcount"
"8057",38047,"North Dakota","Logan County","A_A",10,0,-10,-200,"undercount"
"8058",38047,"North Dakota","Logan County","A_AIC",19,8,-11,-81.48,"undercount"
"8059",38047,"North Dakota","Logan County","NHPI_A",0,0,0,0,"equal"
"8060",38047,"North Dakota","Logan County","NHPI_AIC",1,3,2,100,"overcount"
"8061",38049,"North Dakota","McHenry County","A_A",18,12,-6,-40,"undercount"
"8062",38049,"North Dakota","McHenry County","A_AIC",29,23,-6,-23.08,"undercount"
"8063",38049,"North Dakota","McHenry County","NHPI_A",0,6,6,200,"overcount"
"8064",38049,"North Dakota","McHenry County","NHPI_AIC",2,10,8,133.33,"overcount"
"8065",38051,"North Dakota","McIntosh County","A_A",23,23,0,0,"equal"
"8066",38051,"North Dakota","McIntosh County","A_AIC",24,38,14,45.16,"overcount"
"8067",38051,"North Dakota","McIntosh County","NHPI_A",0,0,0,0,"equal"
"8068",38051,"North Dakota","McIntosh County","NHPI_AIC",0,6,6,200,"overcount"
"8069",38053,"North Dakota","McKenzie County","A_A",161,171,10,6.02,"overcount"
"8070",38053,"North Dakota","McKenzie County","A_AIC",206,289,83,33.54,"overcount"
"8071",38053,"North Dakota","McKenzie County","NHPI_A",13,5,-8,-88.89,"undercount"
"8072",38053,"North Dakota","McKenzie County","NHPI_AIC",26,24,-2,-8,"undercount"
"8073",38055,"North Dakota","McLean County","A_A",31,48,17,43.04,"overcount"
"8074",38055,"North Dakota","McLean County","A_AIC",49,86,37,54.81,"overcount"
"8075",38055,"North Dakota","McLean County","NHPI_A",8,7,-1,-13.33,"undercount"
"8076",38055,"North Dakota","McLean County","NHPI_AIC",9,17,8,61.54,"overcount"
"8077",38057,"North Dakota","Mercer County","A_A",46,44,-2,-4.44,"undercount"
"8078",38057,"North Dakota","Mercer County","A_AIC",65,78,13,18.18,"overcount"
"8079",38057,"North Dakota","Mercer County","NHPI_A",6,1,-5,-142.86,"undercount"
"8080",38057,"North Dakota","Mercer County","NHPI_AIC",11,6,-5,-58.82,"undercount"
"8081",38059,"North Dakota","Morton County","A_A",172,172,0,0,"equal"
"8082",38059,"North Dakota","Morton County","A_AIC",296,313,17,5.58,"overcount"
"8083",38059,"North Dakota","Morton County","NHPI_A",31,39,8,22.86,"overcount"
"8084",38059,"North Dakota","Morton County","NHPI_AIC",69,74,5,6.99,"overcount"
"8085",38061,"North Dakota","Mountrail County","A_A",58,109,51,61.08,"overcount"
"8086",38061,"North Dakota","Mountrail County","A_AIC",106,150,44,34.38,"overcount"
"8087",38061,"North Dakota","Mountrail County","NHPI_A",4,3,-1,-28.57,"undercount"
"8088",38061,"North Dakota","Mountrail County","NHPI_AIC",18,16,-2,-11.76,"undercount"
"8089",38063,"North Dakota","Nelson County","A_A",7,9,2,25,"overcount"
"8090",38063,"North Dakota","Nelson County","A_AIC",15,16,1,6.45,"overcount"
"8091",38063,"North Dakota","Nelson County","NHPI_A",1,1,0,0,"equal"
"8092",38063,"North Dakota","Nelson County","NHPI_AIC",3,1,-2,-100,"undercount"
"8093",38065,"North Dakota","Oliver County","A_A",7,5,-2,-33.33,"undercount"
"8094",38065,"North Dakota","Oliver County","A_AIC",10,10,0,0,"equal"
"8095",38065,"North Dakota","Oliver County","NHPI_A",0,3,3,200,"overcount"
"8096",38065,"North Dakota","Oliver County","NHPI_AIC",1,10,9,163.64,"overcount"
"8097",38067,"North Dakota","Pembina County","A_A",28,27,-1,-3.64,"undercount"
"8098",38067,"North Dakota","Pembina County","A_AIC",45,44,-1,-2.25,"undercount"
"8099",38067,"North Dakota","Pembina County","NHPI_A",1,0,-1,-200,"undercount"
"8100",38067,"North Dakota","Pembina County","NHPI_AIC",5,0,-5,-200,"undercount"
"8101",38069,"North Dakota","Pierce County","A_A",47,17,-30,-93.75,"undercount"
"8102",38069,"North Dakota","Pierce County","A_AIC",53,20,-33,-90.41,"undercount"
"8103",38069,"North Dakota","Pierce County","NHPI_A",0,5,5,200,"overcount"
"8104",38069,"North Dakota","Pierce County","NHPI_AIC",0,9,9,200,"overcount"
"8105",38071,"North Dakota","Ramsey County","A_A",114,72,-42,-45.16,"undercount"
"8106",38071,"North Dakota","Ramsey County","A_AIC",148,124,-24,-17.65,"undercount"
"8107",38071,"North Dakota","Ramsey County","NHPI_A",4,12,8,100,"overcount"
"8108",38071,"North Dakota","Ramsey County","NHPI_AIC",18,34,16,61.54,"overcount"
"8109",38073,"North Dakota","Ransom County","A_A",51,24,-27,-72,"undercount"
"8110",38073,"North Dakota","Ransom County","A_AIC",66,50,-16,-27.59,"undercount"
"8111",38073,"North Dakota","Ransom County","NHPI_A",1,0,-1,-200,"undercount"
"8112",38073,"North Dakota","Ransom County","NHPI_AIC",6,4,-2,-40,"undercount"
"8113",38075,"North Dakota","Renville County","A_A",7,0,-7,-200,"undercount"
"8114",38075,"North Dakota","Renville County","A_AIC",17,11,-6,-42.86,"undercount"
"8115",38075,"North Dakota","Renville County","NHPI_A",2,0,-2,-200,"undercount"
"8116",38075,"North Dakota","Renville County","NHPI_AIC",2,1,-1,-66.67,"undercount"
"8117",38077,"North Dakota","Richland County","A_A",110,126,16,13.56,"overcount"
"8118",38077,"North Dakota","Richland County","A_AIC",186,177,-9,-4.96,"undercount"
"8119",38077,"North Dakota","Richland County","NHPI_A",8,19,11,81.48,"overcount"
"8120",38077,"North Dakota","Richland County","NHPI_AIC",23,36,13,44.07,"overcount"
"8121",38079,"North Dakota","Rolette County","A_A",26,23,-3,-12.24,"undercount"
"8122",38079,"North Dakota","Rolette County","A_AIC",54,42,-12,-25,"undercount"
"8123",38079,"North Dakota","Rolette County","NHPI_A",1,8,7,155.56,"overcount"
"8124",38079,"North Dakota","Rolette County","NHPI_AIC",5,19,14,116.67,"overcount"
"8125",38081,"North Dakota","Sargent County","A_A",38,14,-24,-92.31,"undercount"
"8126",38081,"North Dakota","Sargent County","A_AIC",54,57,3,5.41,"overcount"
"8127",38081,"North Dakota","Sargent County","NHPI_A",5,0,-5,-200,"undercount"
"8128",38081,"North Dakota","Sargent County","NHPI_AIC",10,7,-3,-35.29,"undercount"
"8129",38083,"North Dakota","Sheridan County","A_A",7,6,-1,-15.38,"undercount"
"8130",38083,"North Dakota","Sheridan County","A_AIC",12,8,-4,-40,"undercount"
"8131",38083,"North Dakota","Sheridan County","NHPI_A",1,0,-1,-200,"undercount"
"8132",38083,"North Dakota","Sheridan County","NHPI_AIC",1,0,-1,-200,"undercount"
"8133",38085,"North Dakota","Sioux County","A_A",7,3,-4,-80,"undercount"
"8134",38085,"North Dakota","Sioux County","A_AIC",26,8,-18,-105.88,"undercount"
"8135",38085,"North Dakota","Sioux County","NHPI_A",1,0,-1,-200,"undercount"
"8136",38085,"North Dakota","Sioux County","NHPI_AIC",7,2,-5,-111.11,"undercount"
"8137",38087,"North Dakota","Slope County","A_A",0,0,0,0,"equal"
"8138",38087,"North Dakota","Slope County","A_AIC",0,3,3,200,"overcount"
"8139",38087,"North Dakota","Slope County","NHPI_A",0,0,0,0,"equal"
"8140",38087,"North Dakota","Slope County","NHPI_AIC",0,1,1,200,"overcount"
"8141",38089,"North Dakota","Stark County","A_A",509,344,-165,-38.69,"undercount"
"8142",38089,"North Dakota","Stark County","A_AIC",636,537,-99,-16.88,"undercount"
"8143",38089,"North Dakota","Stark County","NHPI_A",29,51,22,55,"overcount"
"8144",38089,"North Dakota","Stark County","NHPI_AIC",71,98,27,31.95,"overcount"
"8145",38091,"North Dakota","Steele County","A_A",4,0,-4,-200,"undercount"
"8146",38091,"North Dakota","Steele County","A_AIC",9,5,-4,-57.14,"undercount"
"8147",38091,"North Dakota","Steele County","NHPI_A",0,0,0,0,"equal"
"8148",38091,"North Dakota","Steele County","NHPI_AIC",1,6,5,142.86,"overcount"
"8149",38093,"North Dakota","Stutsman County","A_A",190,137,-53,-32.42,"undercount"
"8150",38093,"North Dakota","Stutsman County","A_AIC",261,210,-51,-21.66,"undercount"
"8151",38093,"North Dakota","Stutsman County","NHPI_A",14,4,-10,-111.11,"undercount"
"8152",38093,"North Dakota","Stutsman County","NHPI_AIC",42,25,-17,-50.75,"undercount"
"8153",38095,"North Dakota","Towner County","A_A",13,10,-3,-26.09,"undercount"
"8154",38095,"North Dakota","Towner County","A_AIC",19,13,-6,-37.5,"undercount"
"8155",38095,"North Dakota","Towner County","NHPI_A",0,2,2,200,"overcount"
"8156",38095,"North Dakota","Towner County","NHPI_AIC",1,7,6,150,"overcount"
"8157",38097,"North Dakota","Traill County","A_A",42,24,-18,-54.55,"undercount"
"8158",38097,"North Dakota","Traill County","A_AIC",80,45,-35,-56,"undercount"
"8159",38097,"North Dakota","Traill County","NHPI_A",2,7,5,111.11,"overcount"
"8160",38097,"North Dakota","Traill County","NHPI_AIC",15,19,4,23.53,"overcount"
"8161",38099,"North Dakota","Walsh County","A_A",100,45,-55,-75.86,"undercount"
"8162",38099,"North Dakota","Walsh County","A_AIC",131,66,-65,-65.99,"undercount"
"8163",38099,"North Dakota","Walsh County","NHPI_A",6,0,-6,-200,"undercount"
"8164",38099,"North Dakota","Walsh County","NHPI_AIC",10,5,-5,-66.67,"undercount"
"8165",38101,"North Dakota","Ward County","A_A",1264,1100,-164,-13.87,"undercount"
"8166",38101,"North Dakota","Ward County","A_AIC",1928,1912,-16,-0.83,"undercount"
"8167",38101,"North Dakota","Ward County","NHPI_A",120,138,18,13.95,"overcount"
"8168",38101,"North Dakota","Ward County","NHPI_AIC",263,301,38,13.48,"overcount"
"8169",38103,"North Dakota","Wells County","A_A",10,12,2,18.18,"overcount"
"8170",38103,"North Dakota","Wells County","A_AIC",18,19,1,5.41,"overcount"
"8171",38103,"North Dakota","Wells County","NHPI_A",2,0,-2,-200,"undercount"
"8172",38103,"North Dakota","Wells County","NHPI_AIC",3,4,1,28.57,"overcount"
"8173",38105,"North Dakota","Williams County","A_A",461,612,151,28.15,"overcount"
"8174",38105,"North Dakota","Williams County","A_AIC",657,876,219,28.57,"overcount"
"8175",38105,"North Dakota","Williams County","NHPI_A",91,98,7,7.41,"overcount"
"8176",38105,"North Dakota","Williams County","NHPI_AIC",135,164,29,19.4,"overcount"
"8177",39001,"Ohio","Adams County","A_A",99,45,-54,-75,"undercount"
"8178",39001,"Ohio","Adams County","A_AIC",148,93,-55,-45.64,"undercount"
"8179",39001,"Ohio","Adams County","NHPI_A",6,1,-5,-142.86,"undercount"
"8180",39001,"Ohio","Adams County","NHPI_AIC",15,26,11,53.66,"overcount"
"8181",39003,"Ohio","Allen County","A_A",867,852,-15,-1.75,"undercount"
"8182",39003,"Ohio","Allen County","A_AIC",1247,1253,6,0.48,"overcount"
"8183",39003,"Ohio","Allen County","NHPI_A",30,42,12,33.33,"overcount"
"8184",39003,"Ohio","Allen County","NHPI_AIC",115,90,-25,-24.39,"undercount"
"8185",39005,"Ohio","Ashland County","A_A",401,331,-70,-19.13,"undercount"
"8186",39005,"Ohio","Ashland County","A_AIC",572,488,-84,-15.85,"undercount"
"8187",39005,"Ohio","Ashland County","NHPI_A",41,33,-8,-21.62,"undercount"
"8188",39005,"Ohio","Ashland County","NHPI_AIC",63,62,-1,-1.6,"undercount"
"8189",39007,"Ohio","Ashtabula County","A_A",496,342,-154,-36.75,"undercount"
"8190",39007,"Ohio","Ashtabula County","A_AIC",761,638,-123,-17.58,"undercount"
"8191",39007,"Ohio","Ashtabula County","NHPI_A",46,12,-34,-117.24,"undercount"
"8192",39007,"Ohio","Ashtabula County","NHPI_AIC",108,82,-26,-27.37,"undercount"
"8193",39009,"Ohio","Athens County","A_A",1945,1216,-729,-46.12,"undercount"
"8194",39009,"Ohio","Athens County","A_AIC",2389,1618,-771,-38.48,"undercount"
"8195",39009,"Ohio","Athens County","NHPI_A",39,1,-38,-190,"undercount"
"8196",39009,"Ohio","Athens County","NHPI_AIC",113,50,-63,-77.3,"undercount"
"8197",39011,"Ohio","Auglaize County","A_A",253,251,-2,-0.79,"undercount"
"8198",39011,"Ohio","Auglaize County","A_AIC",383,375,-8,-2.11,"undercount"
"8199",39011,"Ohio","Auglaize County","NHPI_A",42,40,-2,-4.88,"undercount"
"8200",39011,"Ohio","Auglaize County","NHPI_AIC",60,64,4,6.45,"overcount"
"8201",39013,"Ohio","Belmont County","A_A",363,267,-96,-30.48,"undercount"
"8202",39013,"Ohio","Belmont County","A_AIC",506,400,-106,-23.4,"undercount"
"8203",39013,"Ohio","Belmont County","NHPI_A",17,12,-5,-34.48,"undercount"
"8204",39013,"Ohio","Belmont County","NHPI_AIC",49,36,-13,-30.59,"undercount"
"8205",39015,"Ohio","Brown County","A_A",154,84,-70,-58.82,"undercount"
"8206",39015,"Ohio","Brown County","A_AIC",239,182,-57,-27.08,"undercount"
"8207",39015,"Ohio","Brown County","NHPI_A",10,2,-8,-133.33,"undercount"
"8208",39015,"Ohio","Brown County","NHPI_AIC",19,24,5,23.26,"overcount"
"8209",39017,"Ohio","Butler County","A_A",15851,15797,-54,-0.34,"undercount"
"8210",39017,"Ohio","Butler County","A_AIC",18262,18719,457,2.47,"overcount"
"8211",39017,"Ohio","Butler County","NHPI_A",576,481,-95,-17.98,"undercount"
"8212",39017,"Ohio","Butler County","NHPI_AIC",802,762,-40,-5.12,"undercount"
"8213",39019,"Ohio","Carroll County","A_A",93,52,-41,-56.55,"undercount"
"8214",39019,"Ohio","Carroll County","A_AIC",140,115,-25,-19.61,"undercount"
"8215",39019,"Ohio","Carroll County","NHPI_A",3,5,2,50,"overcount"
"8216",39019,"Ohio","Carroll County","NHPI_AIC",14,22,8,44.44,"overcount"
"8217",39021,"Ohio","Champaign County","A_A",197,129,-68,-41.72,"undercount"
"8218",39021,"Ohio","Champaign County","A_AIC",322,263,-59,-20.17,"undercount"
"8219",39021,"Ohio","Champaign County","NHPI_A",16,7,-9,-78.26,"undercount"
"8220",39021,"Ohio","Champaign County","NHPI_AIC",44,38,-6,-14.63,"undercount"
"8221",39023,"Ohio","Clark County","A_A",980,926,-54,-5.67,"undercount"
"8222",39023,"Ohio","Clark County","A_AIC",1547,1477,-70,-4.63,"undercount"
"8223",39023,"Ohio","Clark County","NHPI_A",98,91,-7,-7.41,"undercount"
"8224",39023,"Ohio","Clark County","NHPI_AIC",215,221,6,2.75,"overcount"
"8225",39025,"Ohio","Clermont County","A_A",2980,2541,-439,-15.9,"undercount"
"8226",39025,"Ohio","Clermont County","A_AIC",3874,3670,-204,-5.41,"undercount"
"8227",39025,"Ohio","Clermont County","NHPI_A",114,68,-46,-50.55,"undercount"
"8228",39025,"Ohio","Clermont County","NHPI_AIC",194,227,33,15.68,"overcount"
"8229",39027,"Ohio","Clinton County","A_A",240,207,-33,-14.77,"undercount"
"8230",39027,"Ohio","Clinton County","A_AIC",365,364,-1,-0.27,"undercount"
"8231",39027,"Ohio","Clinton County","NHPI_A",22,6,-16,-114.29,"undercount"
"8232",39027,"Ohio","Clinton County","NHPI_AIC",54,40,-14,-29.79,"undercount"
"8233",39029,"Ohio","Columbiana County","A_A",336,349,13,3.8,"overcount"
"8234",39029,"Ohio","Columbiana County","A_AIC",570,608,38,6.45,"overcount"
"8235",39029,"Ohio","Columbiana County","NHPI_A",44,19,-25,-79.37,"undercount"
"8236",39029,"Ohio","Columbiana County","NHPI_AIC",89,72,-17,-21.12,"undercount"
"8237",39031,"Ohio","Coshocton County","A_A",141,101,-40,-33.06,"undercount"
"8238",39031,"Ohio","Coshocton County","A_AIC",207,175,-32,-16.75,"undercount"
"8239",39031,"Ohio","Coshocton County","NHPI_A",16,7,-9,-78.26,"undercount"
"8240",39031,"Ohio","Coshocton County","NHPI_AIC",26,29,3,10.91,"overcount"
"8241",39033,"Ohio","Crawford County","A_A",265,136,-129,-64.34,"undercount"
"8242",39033,"Ohio","Crawford County","A_AIC",329,232,-97,-34.58,"undercount"
"8243",39033,"Ohio","Crawford County","NHPI_A",56,12,-44,-129.41,"undercount"
"8244",39033,"Ohio","Crawford County","NHPI_AIC",63,20,-43,-103.61,"undercount"
"8245",39035,"Ohio","Cuyahoga County","A_A",42069,44251,2182,5.06,"overcount"
"8246",39035,"Ohio","Cuyahoga County","A_AIC",49731,53063,3332,6.48,"overcount"
"8247",39035,"Ohio","Cuyahoga County","NHPI_A",602,281,-321,-72.71,"undercount"
"8248",39035,"Ohio","Cuyahoga County","NHPI_AIC",1557,1149,-408,-30.16,"undercount"
"8249",39037,"Ohio","Darke County","A_A",249,181,-68,-31.63,"undercount"
"8250",39037,"Ohio","Darke County","A_AIC",369,270,-99,-30.99,"undercount"
"8251",39037,"Ohio","Darke County","NHPI_A",28,26,-2,-7.41,"undercount"
"8252",39037,"Ohio","Darke County","NHPI_AIC",54,41,-13,-27.37,"undercount"
"8253",39039,"Ohio","Defiance County","A_A",187,144,-43,-25.98,"undercount"
"8254",39039,"Ohio","Defiance County","A_AIC",270,220,-50,-20.41,"undercount"
"8255",39039,"Ohio","Defiance County","NHPI_A",17,15,-2,-12.5,"undercount"
"8256",39039,"Ohio","Defiance County","NHPI_AIC",38,34,-4,-11.11,"undercount"
"8257",39041,"Ohio","Delaware County","A_A",17546,18246,700,3.91,"overcount"
"8258",39041,"Ohio","Delaware County","A_AIC",19346,20596,1250,6.26,"overcount"
"8259",39041,"Ohio","Delaware County","NHPI_A",130,60,-70,-73.68,"undercount"
"8260",39041,"Ohio","Delaware County","NHPI_AIC",274,226,-48,-19.2,"undercount"
"8261",39043,"Ohio","Erie County","A_A",588,481,-107,-20.02,"undercount"
"8262",39043,"Ohio","Erie County","A_AIC",799,771,-28,-3.57,"undercount"
"8263",39043,"Ohio","Erie County","NHPI_A",52,10,-42,-135.48,"undercount"
"8264",39043,"Ohio","Erie County","NHPI_AIC",108,36,-72,-100,"undercount"
"8265",39045,"Ohio","Fairfield County","A_A",3469,3074,-395,-12.07,"undercount"
"8266",39045,"Ohio","Fairfield County","A_AIC",4389,4123,-266,-6.25,"undercount"
"8267",39045,"Ohio","Fairfield County","NHPI_A",98,31,-67,-103.88,"undercount"
"8268",39045,"Ohio","Fairfield County","NHPI_AIC",237,148,-89,-46.23,"undercount"
"8269",39047,"Ohio","Fayette County","A_A",312,179,-133,-54.18,"undercount"
"8270",39047,"Ohio","Fayette County","A_AIC",382,263,-119,-36.9,"undercount"
"8271",39047,"Ohio","Fayette County","NHPI_A",14,11,-3,-24,"undercount"
"8272",39047,"Ohio","Fayette County","NHPI_AIC",43,46,3,6.74,"overcount"
"8273",39049,"Ohio","Franklin County","A_A",78355,74346,-4009,-5.25,"undercount"
"8274",39049,"Ohio","Franklin County","A_AIC",89861,87956,-1905,-2.14,"undercount"
"8275",39049,"Ohio","Franklin County","NHPI_A",821,449,-372,-58.58,"undercount"
"8276",39049,"Ohio","Franklin County","NHPI_AIC",2134,1663,-471,-24.81,"undercount"
"8277",39051,"Ohio","Fulton County","A_A",205,154,-51,-28.41,"undercount"
"8278",39051,"Ohio","Fulton County","A_AIC",324,282,-42,-13.86,"undercount"
"8279",39051,"Ohio","Fulton County","NHPI_A",23,6,-17,-117.24,"undercount"
"8280",39051,"Ohio","Fulton County","NHPI_AIC",45,33,-12,-30.77,"undercount"
"8281",39053,"Ohio","Gallia County","A_A",219,153,-66,-35.48,"undercount"
"8282",39053,"Ohio","Gallia County","A_AIC",276,186,-90,-38.96,"undercount"
"8283",39053,"Ohio","Gallia County","NHPI_A",77,5,-72,-175.61,"undercount"
"8284",39053,"Ohio","Gallia County","NHPI_AIC",98,16,-82,-143.86,"undercount"
"8285",39055,"Ohio","Geauga County","A_A",647,682,35,5.27,"overcount"
"8286",39055,"Ohio","Geauga County","A_AIC",936,1137,201,19.39,"overcount"
"8287",39055,"Ohio","Geauga County","NHPI_A",13,9,-4,-36.36,"undercount"
"8288",39055,"Ohio","Geauga County","NHPI_AIC",42,60,18,35.29,"overcount"
"8289",39057,"Ohio","Greene County","A_A",5376,5582,206,3.76,"overcount"
"8290",39057,"Ohio","Greene County","A_AIC",7128,7724,596,8.03,"overcount"
"8291",39057,"Ohio","Greene County","NHPI_A",135,90,-45,-40,"undercount"
"8292",39057,"Ohio","Greene County","NHPI_AIC",348,308,-40,-12.2,"undercount"
"8293",39059,"Ohio","Guernsey County","A_A",176,152,-24,-14.63,"undercount"
"8294",39059,"Ohio","Guernsey County","A_AIC",279,246,-33,-12.57,"undercount"
"8295",39059,"Ohio","Guernsey County","NHPI_A",16,7,-9,-78.26,"undercount"
"8296",39059,"Ohio","Guernsey County","NHPI_AIC",41,19,-22,-73.33,"undercount"
"8297",39061,"Ohio","Hamilton County","A_A",24428,25408,980,3.93,"overcount"
"8298",39061,"Ohio","Hamilton County","A_AIC",29556,31860,2304,7.5,"overcount"
"8299",39061,"Ohio","Hamilton County","NHPI_A",1109,636,-473,-54.21,"undercount"
"8300",39061,"Ohio","Hamilton County","NHPI_AIC",1717,1310,-407,-26.89,"undercount"
"8301",39063,"Ohio","Hancock County","A_A",1633,1415,-218,-14.3,"undercount"
"8302",39063,"Ohio","Hancock County","A_AIC",1927,1774,-153,-8.27,"undercount"
"8303",39063,"Ohio","Hancock County","NHPI_A",15,26,11,53.66,"overcount"
"8304",39063,"Ohio","Hancock County","NHPI_AIC",59,45,-14,-26.92,"undercount"
"8305",39065,"Ohio","Hardin County","A_A",253,169,-84,-39.81,"undercount"
"8306",39065,"Ohio","Hardin County","A_AIC",359,270,-89,-28.3,"undercount"
"8307",39065,"Ohio","Hardin County","NHPI_A",19,19,0,0,"equal"
"8308",39065,"Ohio","Hardin County","NHPI_AIC",38,57,19,40,"overcount"
"8309",39067,"Ohio","Harrison County","A_A",42,40,-2,-4.88,"undercount"
"8310",39067,"Ohio","Harrison County","A_AIC",65,80,15,20.69,"overcount"
"8311",39067,"Ohio","Harrison County","NHPI_A",2,7,5,111.11,"overcount"
"8312",39067,"Ohio","Harrison County","NHPI_AIC",5,12,7,82.35,"overcount"
"8313",39069,"Ohio","Henry County","A_A",152,126,-26,-18.71,"undercount"
"8314",39069,"Ohio","Henry County","A_AIC",201,184,-17,-8.83,"undercount"
"8315",39069,"Ohio","Henry County","NHPI_A",9,4,-5,-76.92,"undercount"
"8316",39069,"Ohio","Henry County","NHPI_AIC",19,8,-11,-81.48,"undercount"
"8317",39071,"Ohio","Highland County","A_A",199,110,-89,-57.61,"undercount"
"8318",39071,"Ohio","Highland County","A_AIC",281,209,-72,-29.39,"undercount"
"8319",39071,"Ohio","Highland County","NHPI_A",14,8,-6,-54.55,"undercount"
"8320",39071,"Ohio","Highland County","NHPI_AIC",34,37,3,8.45,"overcount"
"8321",39073,"Ohio","Hocking County","A_A",132,71,-61,-60.1,"undercount"
"8322",39073,"Ohio","Hocking County","A_AIC",188,135,-53,-32.82,"undercount"
"8323",39073,"Ohio","Hocking County","NHPI_A",10,0,-10,-200,"undercount"
"8324",39073,"Ohio","Hocking County","NHPI_AIC",19,13,-6,-37.5,"undercount"
"8325",39075,"Ohio","Holmes County","A_A",112,66,-46,-51.69,"undercount"
"8326",39075,"Ohio","Holmes County","A_AIC",162,109,-53,-39.11,"undercount"
"8327",39075,"Ohio","Holmes County","NHPI_A",31,7,-24,-126.32,"undercount"
"8328",39075,"Ohio","Holmes County","NHPI_AIC",43,25,-18,-52.94,"undercount"
"8329",39077,"Ohio","Huron County","A_A",222,216,-6,-2.74,"undercount"
"8330",39077,"Ohio","Huron County","A_AIC",346,376,30,8.31,"overcount"
"8331",39077,"Ohio","Huron County","NHPI_A",27,12,-15,-76.92,"undercount"
"8332",39077,"Ohio","Huron County","NHPI_AIC",59,43,-16,-31.37,"undercount"
"8333",39079,"Ohio","Jackson County","A_A",130,103,-27,-23.18,"undercount"
"8334",39079,"Ohio","Jackson County","A_AIC",183,162,-21,-12.17,"undercount"
"8335",39079,"Ohio","Jackson County","NHPI_A",14,2,-12,-150,"undercount"
"8336",39079,"Ohio","Jackson County","NHPI_AIC",25,21,-4,-17.39,"undercount"
"8337",39081,"Ohio","Jefferson County","A_A",348,346,-2,-0.58,"undercount"
"8338",39081,"Ohio","Jefferson County","A_AIC",557,577,20,3.53,"overcount"
"8339",39081,"Ohio","Jefferson County","NHPI_A",25,29,4,14.81,"overcount"
"8340",39081,"Ohio","Jefferson County","NHPI_AIC",77,60,-17,-24.82,"undercount"
"8341",39083,"Ohio","Knox County","A_A",399,366,-33,-8.63,"undercount"
"8342",39083,"Ohio","Knox County","A_AIC",621,587,-34,-5.63,"undercount"
"8343",39083,"Ohio","Knox County","NHPI_A",25,17,-8,-38.1,"undercount"
"8344",39083,"Ohio","Knox County","NHPI_AIC",55,67,12,19.67,"overcount"
"8345",39085,"Ohio","Lake County","A_A",3628,3292,-336,-9.71,"undercount"
"8346",39085,"Ohio","Lake County","A_AIC",4636,4607,-29,-0.63,"undercount"
"8347",39085,"Ohio","Lake County","NHPI_A",68,38,-30,-56.6,"undercount"
"8348",39085,"Ohio","Lake County","NHPI_AIC",212,188,-24,-12,"undercount"
"8349",39087,"Ohio","Lawrence County","A_A",275,226,-49,-19.56,"undercount"
"8350",39087,"Ohio","Lawrence County","A_AIC",376,332,-44,-12.43,"undercount"
"8351",39087,"Ohio","Lawrence County","NHPI_A",12,7,-5,-52.63,"undercount"
"8352",39087,"Ohio","Lawrence County","NHPI_AIC",47,25,-22,-61.11,"undercount"
"8353",39089,"Ohio","Licking County","A_A",4915,5035,120,2.41,"overcount"
"8354",39089,"Ohio","Licking County","A_AIC",5740,6033,293,4.98,"overcount"
"8355",39089,"Ohio","Licking County","NHPI_A",89,45,-44,-65.67,"undercount"
"8356",39089,"Ohio","Licking County","NHPI_AIC",214,189,-25,-12.41,"undercount"
"8357",39091,"Ohio","Logan County","A_A",410,339,-71,-18.96,"undercount"
"8358",39091,"Ohio","Logan County","A_AIC",558,575,17,3,"overcount"
"8359",39091,"Ohio","Logan County","NHPI_A",23,11,-12,-70.59,"undercount"
"8360",39091,"Ohio","Logan County","NHPI_AIC",56,59,3,5.22,"overcount"
"8361",39093,"Ohio","Lorain County","A_A",4453,3638,-815,-20.15,"undercount"
"8362",39093,"Ohio","Lorain County","A_AIC",5980,5302,-678,-12.02,"undercount"
"8363",39093,"Ohio","Lorain County","NHPI_A",237,50,-187,-130.31,"undercount"
"8364",39093,"Ohio","Lorain County","NHPI_AIC",456,237,-219,-63.2,"undercount"
"8365",39095,"Ohio","Lucas County","A_A",7582,7224,-358,-4.84,"undercount"
"8366",39095,"Ohio","Lucas County","A_AIC",10185,9662,-523,-5.27,"undercount"
"8367",39095,"Ohio","Lucas County","NHPI_A",238,115,-123,-69.69,"undercount"
"8368",39095,"Ohio","Lucas County","NHPI_AIC",550,339,-211,-47.47,"undercount"
"8369",39097,"Ohio","Madison County","A_A",647,267,-380,-83.15,"undercount"
"8370",39097,"Ohio","Madison County","A_AIC",756,456,-300,-49.5,"undercount"
"8371",39097,"Ohio","Madison County","NHPI_A",13,4,-9,-105.88,"undercount"
"8372",39097,"Ohio","Madison County","NHPI_AIC",46,29,-17,-45.33,"undercount"
"8373",39099,"Ohio","Mahoning County","A_A",2087,1972,-115,-5.67,"undercount"
"8374",39099,"Ohio","Mahoning County","A_AIC",3045,2865,-180,-6.09,"undercount"
"8375",39099,"Ohio","Mahoning County","NHPI_A",150,69,-81,-73.97,"undercount"
"8376",39099,"Ohio","Mahoning County","NHPI_AIC",346,184,-162,-61.13,"undercount"
"8377",39101,"Ohio","Marion County","A_A",390,370,-20,-5.26,"undercount"
"8378",39101,"Ohio","Marion County","A_AIC",539,544,5,0.92,"overcount"
"8379",39101,"Ohio","Marion County","NHPI_A",53,15,-38,-111.76,"undercount"
"8380",39101,"Ohio","Marion County","NHPI_AIC",88,65,-23,-30.07,"undercount"
"8381",39103,"Ohio","Medina County","A_A",2445,2205,-240,-10.32,"undercount"
"8382",39103,"Ohio","Medina County","A_AIC",3109,3233,124,3.91,"overcount"
"8383",39103,"Ohio","Medina County","NHPI_A",53,28,-25,-61.73,"undercount"
"8384",39103,"Ohio","Medina County","NHPI_AIC",112,133,21,17.14,"overcount"
"8385",39105,"Ohio","Meigs County","A_A",60,22,-38,-92.68,"undercount"
"8386",39105,"Ohio","Meigs County","A_AIC",98,46,-52,-72.22,"undercount"
"8387",39105,"Ohio","Meigs County","NHPI_A",4,0,-4,-200,"undercount"
"8388",39105,"Ohio","Meigs County","NHPI_AIC",14,12,-2,-15.38,"undercount"
"8389",39107,"Ohio","Mercer County","A_A",248,189,-59,-27,"undercount"
"8390",39107,"Ohio","Mercer County","A_AIC",364,306,-58,-17.31,"undercount"
"8391",39107,"Ohio","Mercer County","NHPI_A",401,564,163,33.78,"overcount"
"8392",39107,"Ohio","Mercer County","NHPI_AIC",420,579,159,31.83,"overcount"
"8393",39109,"Ohio","Miami County","A_A",1933,1672,-261,-14.48,"undercount"
"8394",39109,"Ohio","Miami County","A_AIC",2322,2299,-23,-1,"undercount"
"8395",39109,"Ohio","Miami County","NHPI_A",45,21,-24,-72.73,"undercount"
"8396",39109,"Ohio","Miami County","NHPI_AIC",96,119,23,21.4,"overcount"
"8397",39111,"Ohio","Monroe County","A_A",32,22,-10,-37.04,"undercount"
"8398",39111,"Ohio","Monroe County","A_AIC",65,70,5,7.41,"overcount"
"8399",39111,"Ohio","Monroe County","NHPI_A",2,3,1,40,"overcount"
"8400",39111,"Ohio","Monroe County","NHPI_AIC",6,20,14,107.69,"overcount"
"8401",39113,"Ohio","Montgomery County","A_A",12791,12843,52,0.41,"overcount"
"8402",39113,"Ohio","Montgomery County","A_AIC",16773,17295,522,3.06,"overcount"
"8403",39113,"Ohio","Montgomery County","NHPI_A",348,244,-104,-35.14,"undercount"
"8404",39113,"Ohio","Montgomery County","NHPI_AIC",800,820,20,2.47,"overcount"
"8405",39115,"Ohio","Morgan County","A_A",28,24,-4,-15.38,"undercount"
"8406",39115,"Ohio","Morgan County","A_AIC",108,51,-57,-71.7,"undercount"
"8407",39115,"Ohio","Morgan County","NHPI_A",1,3,2,100,"overcount"
"8408",39115,"Ohio","Morgan County","NHPI_AIC",27,10,-17,-91.89,"undercount"
"8409",39117,"Ohio","Morrow County","A_A",164,90,-74,-58.27,"undercount"
"8410",39117,"Ohio","Morrow County","A_AIC",247,178,-69,-32.47,"undercount"
"8411",39117,"Ohio","Morrow County","NHPI_A",17,8,-9,-72,"undercount"
"8412",39117,"Ohio","Morrow County","NHPI_AIC",34,22,-12,-42.86,"undercount"
"8413",39119,"Ohio","Muskingum County","A_A",491,384,-107,-24.46,"undercount"
"8414",39119,"Ohio","Muskingum County","A_AIC",783,605,-178,-25.65,"undercount"
"8415",39119,"Ohio","Muskingum County","NHPI_A",29,8,-21,-113.51,"undercount"
"8416",39119,"Ohio","Muskingum County","NHPI_AIC",99,53,-46,-60.53,"undercount"
"8417",39121,"Ohio","Noble County","A_A",44,27,-17,-47.89,"undercount"
"8418",39121,"Ohio","Noble County","A_AIC",66,53,-13,-21.85,"undercount"
"8419",39121,"Ohio","Noble County","NHPI_A",3,0,-3,-200,"undercount"
"8420",39121,"Ohio","Noble County","NHPI_AIC",5,8,3,46.15,"overcount"
"8421",39123,"Ohio","Ottawa County","A_A",156,158,2,1.27,"overcount"
"8422",39123,"Ohio","Ottawa County","A_AIC",235,270,35,13.86,"overcount"
"8423",39123,"Ohio","Ottawa County","NHPI_A",15,6,-9,-85.71,"undercount"
"8424",39123,"Ohio","Ottawa County","NHPI_AIC",33,31,-2,-6.25,"undercount"
"8425",39125,"Ohio","Paulding County","A_A",73,30,-43,-83.5,"undercount"
"8426",39125,"Ohio","Paulding County","A_AIC",125,55,-70,-77.78,"undercount"
"8427",39125,"Ohio","Paulding County","NHPI_A",6,5,-1,-18.18,"undercount"
"8428",39125,"Ohio","Paulding County","NHPI_AIC",13,13,0,0,"equal"
"8429",39127,"Ohio","Perry County","A_A",75,68,-7,-9.79,"undercount"
"8430",39127,"Ohio","Perry County","A_AIC",147,142,-5,-3.46,"undercount"
"8431",39127,"Ohio","Perry County","NHPI_A",49,0,-49,-200,"undercount"
"8432",39127,"Ohio","Perry County","NHPI_AIC",70,17,-53,-121.84,"undercount"
"8433",39129,"Ohio","Pickaway County","A_A",328,299,-29,-9.25,"undercount"
"8434",39129,"Ohio","Pickaway County","A_AIC",524,548,24,4.48,"overcount"
"8435",39129,"Ohio","Pickaway County","NHPI_A",18,12,-6,-40,"undercount"
"8436",39129,"Ohio","Pickaway County","NHPI_AIC",53,36,-17,-38.2,"undercount"
"8437",39131,"Ohio","Pike County","A_A",79,77,-2,-2.56,"undercount"
"8438",39131,"Ohio","Pike County","A_AIC",141,132,-9,-6.59,"undercount"
"8439",39131,"Ohio","Pike County","NHPI_A",21,6,-15,-111.11,"undercount"
"8440",39131,"Ohio","Pike County","NHPI_AIC",32,32,0,0,"equal"
"8441",39133,"Ohio","Portage County","A_A",3444,3428,-16,-0.47,"undercount"
"8442",39133,"Ohio","Portage County","A_AIC",4249,4369,120,2.78,"overcount"
"8443",39133,"Ohio","Portage County","NHPI_A",94,45,-49,-70.5,"undercount"
"8444",39133,"Ohio","Portage County","NHPI_AIC",220,173,-47,-23.92,"undercount"
"8445",39135,"Ohio","Preble County","A_A",278,172,-106,-47.11,"undercount"
"8446",39135,"Ohio","Preble County","A_AIC",377,318,-59,-16.98,"undercount"
"8447",39135,"Ohio","Preble County","NHPI_A",9,4,-5,-76.92,"undercount"
"8448",39135,"Ohio","Preble County","NHPI_AIC",24,16,-8,-40,"undercount"
"8449",39137,"Ohio","Putnam County","A_A",100,61,-39,-48.45,"undercount"
"8450",39137,"Ohio","Putnam County","A_AIC",163,133,-30,-20.27,"undercount"
"8451",39137,"Ohio","Putnam County","NHPI_A",8,3,-5,-90.91,"undercount"
"8452",39137,"Ohio","Putnam County","NHPI_AIC",26,33,7,23.73,"overcount"
"8453",39139,"Ohio","Richland County","A_A",1018,817,-201,-21.91,"undercount"
"8454",39139,"Ohio","Richland County","A_AIC",1429,1211,-218,-16.52,"undercount"
"8455",39139,"Ohio","Richland County","NHPI_A",64,59,-5,-8.13,"undercount"
"8456",39139,"Ohio","Richland County","NHPI_AIC",167,128,-39,-26.44,"undercount"
"8457",39141,"Ohio","Ross County","A_A",399,392,-7,-1.77,"undercount"
"8458",39141,"Ohio","Ross County","A_AIC",663,665,2,0.3,"overcount"
"8459",39141,"Ohio","Ross County","NHPI_A",24,20,-4,-18.18,"undercount"
"8460",39141,"Ohio","Ross County","NHPI_AIC",98,52,-46,-61.33,"undercount"
"8461",39143,"Ohio","Sandusky County","A_A",289,208,-81,-32.6,"undercount"
"8462",39143,"Ohio","Sandusky County","A_AIC",447,392,-55,-13.11,"undercount"
"8463",39143,"Ohio","Sandusky County","NHPI_A",12,7,-5,-52.63,"undercount"
"8464",39143,"Ohio","Sandusky County","NHPI_AIC",43,34,-9,-23.38,"undercount"
"8465",39145,"Ohio","Scioto County","A_A",297,279,-18,-6.25,"undercount"
"8466",39145,"Ohio","Scioto County","A_AIC",473,428,-45,-9.99,"undercount"
"8467",39145,"Ohio","Scioto County","NHPI_A",15,12,-3,-22.22,"undercount"
"8468",39145,"Ohio","Scioto County","NHPI_AIC",59,52,-7,-12.61,"undercount"
"8469",39147,"Ohio","Seneca County","A_A",447,365,-82,-20.2,"undercount"
"8470",39147,"Ohio","Seneca County","A_AIC",602,570,-32,-5.46,"undercount"
"8471",39147,"Ohio","Seneca County","NHPI_A",28,36,8,25,"overcount"
"8472",39147,"Ohio","Seneca County","NHPI_AIC",65,60,-5,-8,"undercount"
"8473",39149,"Ohio","Shelby County","A_A",591,474,-117,-21.97,"undercount"
"8474",39149,"Ohio","Shelby County","A_AIC",737,604,-133,-19.84,"undercount"
"8475",39149,"Ohio","Shelby County","NHPI_A",56,29,-27,-63.53,"undercount"
"8476",39149,"Ohio","Shelby County","NHPI_AIC",87,100,13,13.9,"overcount"
"8477",39151,"Ohio","Stark County","A_A",3649,3221,-428,-12.46,"undercount"
"8478",39151,"Ohio","Stark County","A_AIC",5056,4926,-130,-2.6,"undercount"
"8479",39151,"Ohio","Stark County","NHPI_A",155,100,-55,-43.14,"undercount"
"8480",39151,"Ohio","Stark County","NHPI_AIC",352,316,-36,-10.78,"undercount"
"8481",39153,"Ohio","Summit County","A_A",22428,22682,254,1.13,"overcount"
"8482",39153,"Ohio","Summit County","A_AIC",25709,26294,585,2.25,"overcount"
"8483",39153,"Ohio","Summit County","NHPI_A",234,151,-83,-43.12,"undercount"
"8484",39153,"Ohio","Summit County","NHPI_AIC",555,517,-38,-7.09,"undercount"
"8485",39155,"Ohio","Trumbull County","A_A",1119,1124,5,0.45,"overcount"
"8486",39155,"Ohio","Trumbull County","A_AIC",1768,1823,55,3.06,"overcount"
"8487",39155,"Ohio","Trumbull County","NHPI_A",59,26,-33,-77.65,"undercount"
"8488",39155,"Ohio","Trumbull County","NHPI_AIC",171,155,-16,-9.82,"undercount"
"8489",39157,"Ohio","Tuscarawas County","A_A",409,306,-103,-28.81,"undercount"
"8490",39157,"Ohio","Tuscarawas County","A_AIC",600,518,-82,-14.67,"undercount"
"8491",39157,"Ohio","Tuscarawas County","NHPI_A",234,29,-205,-155.89,"undercount"
"8492",39157,"Ohio","Tuscarawas County","NHPI_AIC",266,53,-213,-133.54,"undercount"
"8493",39159,"Ohio","Union County","A_A",3240,4059,819,22.44,"overcount"
"8494",39159,"Ohio","Union County","A_AIC",3584,4584,1000,24.49,"overcount"
"8495",39159,"Ohio","Union County","NHPI_A",18,0,-18,-200,"undercount"
"8496",39159,"Ohio","Union County","NHPI_AIC",57,46,-11,-21.36,"undercount"
"8497",39161,"Ohio","Van Wert County","A_A",91,89,-2,-2.22,"undercount"
"8498",39161,"Ohio","Van Wert County","A_AIC",144,185,41,24.92,"overcount"
"8499",39161,"Ohio","Van Wert County","NHPI_A",3,13,10,125,"overcount"
"8500",39161,"Ohio","Van Wert County","NHPI_AIC",13,39,26,100,"overcount"
"8501",39163,"Ohio","Vinton County","A_A",37,22,-15,-50.85,"undercount"
"8502",39163,"Ohio","Vinton County","A_AIC",65,38,-27,-52.43,"undercount"
"8503",39163,"Ohio","Vinton County","NHPI_A",0,0,0,0,"equal"
"8504",39163,"Ohio","Vinton County","NHPI_AIC",9,5,-4,-57.14,"undercount"
"8505",39165,"Ohio","Warren County","A_A",15938,17378,1440,8.64,"overcount"
"8506",39165,"Ohio","Warren County","A_AIC",17816,19863,2047,10.87,"overcount"
"8507",39165,"Ohio","Warren County","NHPI_A",247,161,-86,-42.16,"undercount"
"8508",39165,"Ohio","Warren County","NHPI_AIC",395,381,-14,-3.61,"undercount"
"8509",39167,"Ohio","Washington County","A_A",420,322,-98,-26.42,"undercount"
"8510",39167,"Ohio","Washington County","A_AIC",631,528,-103,-17.77,"undercount"
"8511",39167,"Ohio","Washington County","NHPI_A",15,8,-7,-60.87,"undercount"
"8512",39167,"Ohio","Washington County","NHPI_AIC",56,50,-6,-11.32,"undercount"
"8513",39169,"Ohio","Wayne County","A_A",1247,961,-286,-25.91,"undercount"
"8514",39169,"Ohio","Wayne County","A_AIC",1613,1339,-274,-18.56,"undercount"
"8515",39169,"Ohio","Wayne County","NHPI_A",71,37,-34,-62.96,"undercount"
"8516",39169,"Ohio","Wayne County","NHPI_AIC",128,112,-16,-13.33,"undercount"
"8517",39171,"Ohio","Williams County","A_A",219,205,-14,-6.6,"undercount"
"8518",39171,"Ohio","Williams County","A_AIC",292,299,7,2.37,"overcount"
"8519",39171,"Ohio","Williams County","NHPI_A",12,0,-12,-200,"undercount"
"8520",39171,"Ohio","Williams County","NHPI_AIC",22,23,1,4.44,"overcount"
"8521",39173,"Ohio","Wood County","A_A",2536,2777,241,9.07,"overcount"
"8522",39173,"Ohio","Wood County","A_AIC",3244,3636,392,11.4,"overcount"
"8523",39173,"Ohio","Wood County","NHPI_A",62,9,-53,-149.3,"undercount"
"8524",39173,"Ohio","Wood County","NHPI_AIC",142,108,-34,-27.2,"undercount"
"8525",39175,"Ohio","Wyandot County","A_A",165,85,-80,-64,"undercount"
"8526",39175,"Ohio","Wyandot County","A_AIC",194,153,-41,-23.63,"undercount"
"8527",39175,"Ohio","Wyandot County","NHPI_A",9,3,-6,-100,"undercount"
"8528",39175,"Ohio","Wyandot County","NHPI_AIC",14,20,6,35.29,"overcount"
"8529",40001,"Oklahoma","Adair County","A_A",188,162,-26,-14.86,"undercount"
"8530",40001,"Oklahoma","Adair County","A_AIC",254,196,-58,-25.78,"undercount"
"8531",40001,"Oklahoma","Adair County","NHPI_A",13,12,-1,-8,"undercount"
"8532",40001,"Oklahoma","Adair County","NHPI_AIC",39,23,-16,-51.61,"undercount"
"8533",40003,"Oklahoma","Alfalfa County","A_A",27,7,-20,-117.65,"undercount"
"8534",40003,"Oklahoma","Alfalfa County","A_AIC",43,37,-6,-15,"undercount"
"8535",40003,"Oklahoma","Alfalfa County","NHPI_A",8,0,-8,-200,"undercount"
"8536",40003,"Oklahoma","Alfalfa County","NHPI_AIC",16,8,-8,-66.67,"undercount"
"8537",40005,"Oklahoma","Atoka County","A_A",90,49,-41,-58.99,"undercount"
"8538",40005,"Oklahoma","Atoka County","A_AIC",153,97,-56,-44.8,"undercount"
"8539",40005,"Oklahoma","Atoka County","NHPI_A",6,4,-2,-40,"undercount"
"8540",40005,"Oklahoma","Atoka County","NHPI_AIC",19,7,-12,-92.31,"undercount"
"8541",40007,"Oklahoma","Beaver County","A_A",23,11,-12,-70.59,"undercount"
"8542",40007,"Oklahoma","Beaver County","A_AIC",41,28,-13,-37.68,"undercount"
"8543",40007,"Oklahoma","Beaver County","NHPI_A",1,6,5,142.86,"overcount"
"8544",40007,"Oklahoma","Beaver County","NHPI_AIC",5,12,7,82.35,"overcount"
"8545",40009,"Oklahoma","Beckham County","A_A",226,137,-89,-49.04,"undercount"
"8546",40009,"Oklahoma","Beckham County","A_AIC",284,205,-79,-32.31,"undercount"
"8547",40009,"Oklahoma","Beckham County","NHPI_A",3,12,9,120,"overcount"
"8548",40009,"Oklahoma","Beckham County","NHPI_AIC",20,25,5,22.22,"overcount"
"8549",40011,"Oklahoma","Blaine County","A_A",35,32,-3,-8.96,"undercount"
"8550",40011,"Oklahoma","Blaine County","A_AIC",92,58,-34,-45.33,"undercount"
"8551",40011,"Oklahoma","Blaine County","NHPI_A",14,5,-9,-94.74,"undercount"
"8552",40011,"Oklahoma","Blaine County","NHPI_AIC",34,14,-20,-83.33,"undercount"
"8553",40013,"Oklahoma","Bryan County","A_A",291,293,2,0.68,"overcount"
"8554",40013,"Oklahoma","Bryan County","A_AIC",440,454,14,3.13,"overcount"
"8555",40013,"Oklahoma","Bryan County","NHPI_A",47,14,-33,-108.2,"undercount"
"8556",40013,"Oklahoma","Bryan County","NHPI_AIC",96,58,-38,-49.35,"undercount"
"8557",40015,"Oklahoma","Caddo County","A_A",148,63,-85,-80.57,"undercount"
"8558",40015,"Oklahoma","Caddo County","A_AIC",269,119,-150,-77.32,"undercount"
"8559",40015,"Oklahoma","Caddo County","NHPI_A",29,13,-16,-76.19,"undercount"
"8560",40015,"Oklahoma","Caddo County","NHPI_AIC",76,46,-30,-49.18,"undercount"
"8561",40017,"Oklahoma","Canadian County","A_A",5093,4846,-247,-4.97,"undercount"
"8562",40017,"Oklahoma","Canadian County","A_AIC",6227,6198,-29,-0.47,"undercount"
"8563",40017,"Oklahoma","Canadian County","NHPI_A",197,120,-77,-48.58,"undercount"
"8564",40017,"Oklahoma","Canadian County","NHPI_AIC",377,340,-37,-10.32,"undercount"
"8565",40019,"Oklahoma","Carter County","A_A",676,593,-83,-13.08,"undercount"
"8566",40019,"Oklahoma","Carter County","A_AIC",883,754,-129,-15.76,"undercount"
"8567",40019,"Oklahoma","Carter County","NHPI_A",39,44,5,12.05,"overcount"
"8568",40019,"Oklahoma","Carter County","NHPI_AIC",94,104,10,10.1,"overcount"
"8569",40021,"Oklahoma","Cherokee County","A_A",535,311,-224,-52.96,"undercount"
"8570",40021,"Oklahoma","Cherokee County","A_AIC",687,498,-189,-31.9,"undercount"
"8571",40021,"Oklahoma","Cherokee County","NHPI_A",33,21,-12,-44.44,"undercount"
"8572",40021,"Oklahoma","Cherokee County","NHPI_AIC",81,54,-27,-40,"undercount"
"8573",40023,"Oklahoma","Choctaw County","A_A",71,29,-42,-84,"undercount"
"8574",40023,"Oklahoma","Choctaw County","A_AIC",146,47,-99,-102.59,"undercount"
"8575",40023,"Oklahoma","Choctaw County","NHPI_A",6,5,-1,-18.18,"undercount"
"8576",40023,"Oklahoma","Choctaw County","NHPI_AIC",32,15,-17,-72.34,"undercount"
"8577",40025,"Oklahoma","Cimarron County","A_A",11,1,-10,-166.67,"undercount"
"8578",40025,"Oklahoma","Cimarron County","A_AIC",22,14,-8,-44.44,"undercount"
"8579",40025,"Oklahoma","Cimarron County","NHPI_A",0,0,0,0,"equal"
"8580",40025,"Oklahoma","Cimarron County","NHPI_AIC",0,2,2,200,"overcount"
"8581",40027,"Oklahoma","Cleveland County","A_A",13493,12841,-652,-4.95,"undercount"
"8582",40027,"Oklahoma","Cleveland County","A_AIC",17067,16556,-511,-3.04,"undercount"
"8583",40027,"Oklahoma","Cleveland County","NHPI_A",349,244,-105,-35.41,"undercount"
"8584",40027,"Oklahoma","Cleveland County","NHPI_AIC",774,767,-7,-0.91,"undercount"
"8585",40029,"Oklahoma","Coal County","A_A",14,15,1,6.9,"overcount"
"8586",40029,"Oklahoma","Coal County","A_AIC",40,49,9,20.22,"overcount"
"8587",40029,"Oklahoma","Coal County","NHPI_A",0,0,0,0,"equal"
"8588",40029,"Oklahoma","Coal County","NHPI_AIC",8,6,-2,-28.57,"undercount"
"8589",40031,"Oklahoma","Comanche County","A_A",3256,3029,-227,-7.22,"undercount"
"8590",40031,"Oklahoma","Comanche County","A_AIC",5729,5059,-670,-12.42,"undercount"
"8591",40031,"Oklahoma","Comanche County","NHPI_A",787,803,16,2.01,"overcount"
"8592",40031,"Oklahoma","Comanche County","NHPI_AIC",1372,1278,-94,-7.09,"undercount"
"8593",40033,"Oklahoma","Cotton County","A_A",20,28,8,33.33,"overcount"
"8594",40033,"Oklahoma","Cotton County","A_AIC",53,77,24,36.92,"overcount"
"8595",40033,"Oklahoma","Cotton County","NHPI_A",15,9,-6,-50,"undercount"
"8596",40033,"Oklahoma","Cotton County","NHPI_AIC",20,16,-4,-22.22,"undercount"
"8597",40035,"Oklahoma","Craig County","A_A",106,78,-28,-30.43,"undercount"
"8598",40035,"Oklahoma","Craig County","A_AIC",175,136,-39,-25.08,"undercount"
"8599",40035,"Oklahoma","Craig County","NHPI_A",19,1,-18,-180,"undercount"
"8600",40035,"Oklahoma","Craig County","NHPI_AIC",44,21,-23,-70.77,"undercount"
"8601",40037,"Oklahoma","Creek County","A_A",496,294,-202,-51.14,"undercount"
"8602",40037,"Oklahoma","Creek County","A_AIC",776,575,-201,-29.76,"undercount"
"8603",40037,"Oklahoma","Creek County","NHPI_A",73,67,-6,-8.57,"undercount"
"8604",40037,"Oklahoma","Creek County","NHPI_AIC",142,120,-22,-16.79,"undercount"
"8605",40039,"Oklahoma","Custer County","A_A",395,296,-99,-28.65,"undercount"
"8606",40039,"Oklahoma","Custer County","A_AIC",542,433,-109,-22.36,"undercount"
"8607",40039,"Oklahoma","Custer County","NHPI_A",25,7,-18,-112.5,"undercount"
"8608",40039,"Oklahoma","Custer County","NHPI_AIC",64,39,-25,-48.54,"undercount"
"8609",40041,"Oklahoma","Delaware County","A_A",512,471,-41,-8.34,"undercount"
"8610",40041,"Oklahoma","Delaware County","A_AIC",598,609,11,1.82,"overcount"
"8611",40041,"Oklahoma","Delaware County","NHPI_A",67,36,-31,-60.19,"undercount"
"8612",40041,"Oklahoma","Delaware County","NHPI_AIC",95,58,-37,-48.37,"undercount"
"8613",40043,"Oklahoma","Dewey County","A_A",60,4,-56,-175,"undercount"
"8614",40043,"Oklahoma","Dewey County","A_AIC",74,22,-52,-108.33,"undercount"
"8615",40043,"Oklahoma","Dewey County","NHPI_A",0,2,2,200,"overcount"
"8616",40043,"Oklahoma","Dewey County","NHPI_AIC",7,8,1,13.33,"overcount"
"8617",40045,"Oklahoma","Ellis County","A_A",21,13,-8,-47.06,"undercount"
"8618",40045,"Oklahoma","Ellis County","A_AIC",30,25,-5,-18.18,"undercount"
"8619",40045,"Oklahoma","Ellis County","NHPI_A",3,0,-3,-200,"undercount"
"8620",40045,"Oklahoma","Ellis County","NHPI_AIC",11,6,-5,-58.82,"undercount"
"8621",40047,"Oklahoma","Garfield County","A_A",803,685,-118,-15.86,"undercount"
"8622",40047,"Oklahoma","Garfield County","A_AIC",1196,1223,27,2.23,"overcount"
"8623",40047,"Oklahoma","Garfield County","NHPI_A",2580,2972,392,14.12,"overcount"
"8624",40047,"Oklahoma","Garfield County","NHPI_AIC",2672,3140,468,16.1,"overcount"
"8625",40049,"Oklahoma","Garvin County","A_A",132,118,-14,-11.2,"undercount"
"8626",40049,"Oklahoma","Garvin County","A_AIC",234,177,-57,-27.74,"undercount"
"8627",40049,"Oklahoma","Garvin County","NHPI_A",35,8,-27,-125.58,"undercount"
"8628",40049,"Oklahoma","Garvin County","NHPI_AIC",75,32,-43,-80.37,"undercount"
"8629",40051,"Oklahoma","Grady County","A_A",262,205,-57,-24.41,"undercount"
"8630",40051,"Oklahoma","Grady County","A_AIC",490,459,-31,-6.53,"undercount"
"8631",40051,"Oklahoma","Grady County","NHPI_A",50,38,-12,-27.27,"undercount"
"8632",40051,"Oklahoma","Grady County","NHPI_AIC",120,97,-23,-21.2,"undercount"
"8633",40053,"Oklahoma","Grant County","A_A",14,12,-2,-15.38,"undercount"
"8634",40053,"Oklahoma","Grant County","A_AIC",33,16,-17,-69.39,"undercount"
"8635",40053,"Oklahoma","Grant County","NHPI_A",1,8,7,155.56,"overcount"
"8636",40053,"Oklahoma","Grant County","NHPI_AIC",7,14,7,66.67,"overcount"
"8637",40055,"Oklahoma","Greer County","A_A",18,7,-11,-88,"undercount"
"8638",40055,"Oklahoma","Greer County","A_AIC",38,15,-23,-86.79,"undercount"
"8639",40055,"Oklahoma","Greer County","NHPI_A",8,1,-7,-155.56,"undercount"
"8640",40055,"Oklahoma","Greer County","NHPI_AIC",14,10,-4,-33.33,"undercount"
"8641",40057,"Oklahoma","Harmon County","A_A",39,7,-32,-139.13,"undercount"
"8642",40057,"Oklahoma","Harmon County","A_AIC",49,21,-28,-80,"undercount"
"8643",40057,"Oklahoma","Harmon County","NHPI_A",0,0,0,0,"equal"
"8644",40057,"Oklahoma","Harmon County","NHPI_AIC",3,7,4,80,"overcount"
"8645",40059,"Oklahoma","Harper County","A_A",8,0,-8,-200,"undercount"
"8646",40059,"Oklahoma","Harper County","A_AIC",19,16,-3,-17.14,"undercount"
"8647",40059,"Oklahoma","Harper County","NHPI_A",8,0,-8,-200,"undercount"
"8648",40059,"Oklahoma","Harper County","NHPI_AIC",9,14,5,43.48,"overcount"
"8649",40061,"Oklahoma","Haskell County","A_A",115,24,-91,-130.94,"undercount"
"8650",40061,"Oklahoma","Haskell County","A_AIC",147,45,-102,-106.25,"undercount"
"8651",40061,"Oklahoma","Haskell County","NHPI_A",7,7,0,0,"equal"
"8652",40061,"Oklahoma","Haskell County","NHPI_AIC",17,27,10,45.45,"overcount"
"8653",40063,"Oklahoma","Hughes County","A_A",42,38,-4,-10,"undercount"
"8654",40063,"Oklahoma","Hughes County","A_AIC",78,69,-9,-12.24,"undercount"
"8655",40063,"Oklahoma","Hughes County","NHPI_A",15,14,-1,-6.9,"undercount"
"8656",40063,"Oklahoma","Hughes County","NHPI_AIC",26,35,9,29.51,"overcount"
"8657",40065,"Oklahoma","Jackson County","A_A",429,320,-109,-29.11,"undercount"
"8658",40065,"Oklahoma","Jackson County","A_AIC",621,532,-89,-15.44,"undercount"
"8659",40065,"Oklahoma","Jackson County","NHPI_A",91,78,-13,-15.38,"undercount"
"8660",40065,"Oklahoma","Jackson County","NHPI_AIC",148,132,-16,-11.43,"undercount"
"8661",40067,"Oklahoma","Jefferson County","A_A",34,30,-4,-12.5,"undercount"
"8662",40067,"Oklahoma","Jefferson County","A_AIC",51,46,-5,-10.31,"undercount"
"8663",40067,"Oklahoma","Jefferson County","NHPI_A",1,5,4,133.33,"overcount"
"8664",40067,"Oklahoma","Jefferson County","NHPI_AIC",7,12,5,52.63,"overcount"
"8665",40069,"Oklahoma","Johnston County","A_A",66,52,-14,-23.73,"undercount"
"8666",40069,"Oklahoma","Johnston County","A_AIC",104,77,-27,-29.83,"undercount"
"8667",40069,"Oklahoma","Johnston County","NHPI_A",6,5,-1,-18.18,"undercount"
"8668",40069,"Oklahoma","Johnston County","NHPI_AIC",15,35,20,80,"overcount"
"8669",40071,"Oklahoma","Kay County","A_A",290,258,-32,-11.68,"undercount"
"8670",40071,"Oklahoma","Kay County","A_AIC",459,434,-25,-5.6,"undercount"
"8671",40071,"Oklahoma","Kay County","NHPI_A",224,274,50,20.08,"overcount"
"8672",40071,"Oklahoma","Kay County","NHPI_AIC",281,331,50,16.34,"overcount"
"8673",40073,"Oklahoma","Kingfisher County","A_A",71,46,-25,-42.74,"undercount"
"8674",40073,"Oklahoma","Kingfisher County","A_AIC",111,76,-35,-37.43,"undercount"
"8675",40073,"Oklahoma","Kingfisher County","NHPI_A",9,0,-9,-200,"undercount"
"8676",40073,"Oklahoma","Kingfisher County","NHPI_AIC",22,16,-6,-31.58,"undercount"
"8677",40075,"Oklahoma","Kiowa County","A_A",27,47,20,54.05,"overcount"
"8678",40075,"Oklahoma","Kiowa County","A_AIC",70,69,-1,-1.44,"undercount"
"8679",40075,"Oklahoma","Kiowa County","NHPI_A",14,3,-11,-129.41,"undercount"
"8680",40075,"Oklahoma","Kiowa County","NHPI_AIC",32,30,-2,-6.45,"undercount"
"8681",40077,"Oklahoma","Latimer County","A_A",70,68,-2,-2.9,"undercount"
"8682",40077,"Oklahoma","Latimer County","A_AIC",109,84,-25,-25.91,"undercount"
"8683",40077,"Oklahoma","Latimer County","NHPI_A",3,5,2,50,"overcount"
"8684",40077,"Oklahoma","Latimer County","NHPI_AIC",18,22,4,20,"overcount"
"8685",40079,"Oklahoma","Le Flore County","A_A",375,292,-83,-24.89,"undercount"
"8686",40079,"Oklahoma","Le Flore County","A_AIC",544,445,-99,-20.02,"undercount"
"8687",40079,"Oklahoma","Le Flore County","NHPI_A",107,32,-75,-107.91,"undercount"
"8688",40079,"Oklahoma","Le Flore County","NHPI_AIC",169,79,-90,-72.58,"undercount"
"8689",40081,"Oklahoma","Lincoln County","A_A",139,116,-23,-18.04,"undercount"
"8690",40081,"Oklahoma","Lincoln County","A_AIC",283,255,-28,-10.41,"undercount"
"8691",40081,"Oklahoma","Lincoln County","NHPI_A",27,14,-13,-63.41,"undercount"
"8692",40081,"Oklahoma","Lincoln County","NHPI_AIC",76,29,-47,-89.52,"undercount"
"8693",40083,"Oklahoma","Logan County","A_A",324,260,-64,-21.92,"undercount"
"8694",40083,"Oklahoma","Logan County","A_AIC",541,603,62,10.84,"overcount"
"8695",40083,"Oklahoma","Logan County","NHPI_A",31,31,0,0,"equal"
"8696",40083,"Oklahoma","Logan County","NHPI_AIC",116,117,1,0.86,"overcount"
"8697",40085,"Oklahoma","Love County","A_A",66,74,8,11.43,"overcount"
"8698",40085,"Oklahoma","Love County","A_AIC",98,110,12,11.54,"overcount"
"8699",40085,"Oklahoma","Love County","NHPI_A",1,0,-1,-200,"undercount"
"8700",40085,"Oklahoma","Love County","NHPI_AIC",11,19,8,53.33,"overcount"
"8701",40087,"Oklahoma","McClain County","A_A",234,209,-25,-11.29,"undercount"
"8702",40087,"Oklahoma","McClain County","A_AIC",392,392,0,0,"equal"
"8703",40087,"Oklahoma","McClain County","NHPI_A",48,36,-12,-28.57,"undercount"
"8704",40087,"Oklahoma","McClain County","NHPI_AIC",79,84,5,6.13,"overcount"
"8705",40089,"Oklahoma","McCurtain County","A_A",323,124,-199,-89.04,"undercount"
"8706",40089,"Oklahoma","McCurtain County","A_AIC",429,195,-234,-75,"undercount"
"8707",40089,"Oklahoma","McCurtain County","NHPI_A",494,461,-33,-6.91,"undercount"
"8708",40089,"Oklahoma","McCurtain County","NHPI_AIC",535,473,-62,-12.3,"undercount"
"8709",40091,"Oklahoma","McIntosh County","A_A",97,68,-29,-35.15,"undercount"
"8710",40091,"Oklahoma","McIntosh County","A_AIC",174,89,-85,-64.64,"undercount"
"8711",40091,"Oklahoma","McIntosh County","NHPI_A",15,4,-11,-115.79,"undercount"
"8712",40091,"Oklahoma","McIntosh County","NHPI_AIC",48,23,-25,-70.42,"undercount"
"8713",40093,"Oklahoma","Major County","A_A",65,40,-25,-47.62,"undercount"
"8714",40093,"Oklahoma","Major County","A_AIC",99,58,-41,-52.23,"undercount"
"8715",40093,"Oklahoma","Major County","NHPI_A",7,0,-7,-200,"undercount"
"8716",40093,"Oklahoma","Major County","NHPI_AIC",14,3,-11,-129.41,"undercount"
"8717",40095,"Oklahoma","Marshall County","A_A",77,44,-33,-54.55,"undercount"
"8718",40095,"Oklahoma","Marshall County","A_AIC",135,101,-34,-28.81,"undercount"
"8719",40095,"Oklahoma","Marshall County","NHPI_A",17,4,-13,-123.81,"undercount"
"8720",40095,"Oklahoma","Marshall County","NHPI_AIC",34,10,-24,-109.09,"undercount"
"8721",40097,"Oklahoma","Mayes County","A_A",222,192,-30,-14.49,"undercount"
"8722",40097,"Oklahoma","Mayes County","A_AIC",330,343,13,3.86,"overcount"
"8723",40097,"Oklahoma","Mayes County","NHPI_A",28,27,-1,-3.64,"undercount"
"8724",40097,"Oklahoma","Mayes County","NHPI_AIC",66,54,-12,-20,"undercount"
"8725",40099,"Oklahoma","Murray County","A_A",81,45,-36,-57.14,"undercount"
"8726",40099,"Oklahoma","Murray County","A_AIC",131,88,-43,-39.27,"undercount"
"8727",40099,"Oklahoma","Murray County","NHPI_A",15,19,4,23.53,"overcount"
"8728",40099,"Oklahoma","Murray County","NHPI_AIC",26,37,11,34.92,"overcount"
"8729",40101,"Oklahoma","Muskogee County","A_A",476,512,36,7.29,"overcount"
"8730",40101,"Oklahoma","Muskogee County","A_AIC",710,766,56,7.59,"overcount"
"8731",40101,"Oklahoma","Muskogee County","NHPI_A",94,39,-55,-82.71,"undercount"
"8732",40101,"Oklahoma","Muskogee County","NHPI_AIC",174,104,-70,-50.36,"undercount"
"8733",40103,"Oklahoma","Noble County","A_A",57,48,-9,-17.14,"undercount"
"8734",40103,"Oklahoma","Noble County","A_AIC",100,76,-24,-27.27,"undercount"
"8735",40103,"Oklahoma","Noble County","NHPI_A",9,1,-8,-160,"undercount"
"8736",40103,"Oklahoma","Noble County","NHPI_AIC",16,22,6,31.58,"overcount"
"8737",40105,"Oklahoma","Nowata County","A_A",17,5,-12,-109.09,"undercount"
"8738",40105,"Oklahoma","Nowata County","A_AIC",66,38,-28,-53.85,"undercount"
"8739",40105,"Oklahoma","Nowata County","NHPI_A",3,5,2,50,"overcount"
"8740",40105,"Oklahoma","Nowata County","NHPI_AIC",15,16,1,6.45,"overcount"
"8741",40107,"Oklahoma","Okfuskee County","A_A",50,32,-18,-43.9,"undercount"
"8742",40107,"Oklahoma","Okfuskee County","A_AIC",109,50,-59,-74.21,"undercount"
"8743",40107,"Oklahoma","Okfuskee County","NHPI_A",24,0,-24,-200,"undercount"
"8744",40107,"Oklahoma","Okfuskee County","NHPI_AIC",38,9,-29,-123.4,"undercount"
"8745",40109,"Oklahoma","Oklahoma County","A_A",29404,28037,-1367,-4.76,"undercount"
"8746",40109,"Oklahoma","Oklahoma County","A_AIC",37698,36077,-1621,-4.39,"undercount"
"8747",40109,"Oklahoma","Oklahoma County","NHPI_A",1209,1179,-30,-2.51,"undercount"
"8748",40109,"Oklahoma","Oklahoma County","NHPI_AIC",2460,2262,-198,-8.39,"undercount"
"8749",40111,"Oklahoma","Okmulgee County","A_A",185,160,-25,-14.49,"undercount"
"8750",40111,"Oklahoma","Okmulgee County","A_AIC",350,299,-51,-15.72,"undercount"
"8751",40111,"Oklahoma","Okmulgee County","NHPI_A",28,26,-2,-7.41,"undercount"
"8752",40111,"Oklahoma","Okmulgee County","NHPI_AIC",85,63,-22,-29.73,"undercount"
"8753",40113,"Oklahoma","Osage County","A_A",202,129,-73,-44.11,"undercount"
"8754",40113,"Oklahoma","Osage County","A_AIC",337,288,-49,-15.68,"undercount"
"8755",40113,"Oklahoma","Osage County","NHPI_A",33,19,-14,-53.85,"undercount"
"8756",40113,"Oklahoma","Osage County","NHPI_AIC",79,76,-3,-3.87,"undercount"
"8757",40115,"Oklahoma","Ottawa County","A_A",211,154,-57,-31.23,"undercount"
"8758",40115,"Oklahoma","Ottawa County","A_AIC",362,275,-87,-27.32,"undercount"
"8759",40115,"Oklahoma","Ottawa County","NHPI_A",281,239,-42,-16.15,"undercount"
"8760",40115,"Oklahoma","Ottawa County","NHPI_AIC",312,277,-35,-11.88,"undercount"
"8761",40117,"Oklahoma","Pawnee County","A_A",77,49,-28,-44.44,"undercount"
"8762",40117,"Oklahoma","Pawnee County","A_AIC",139,103,-36,-29.75,"undercount"
"8763",40117,"Oklahoma","Pawnee County","NHPI_A",12,0,-12,-200,"undercount"
"8764",40117,"Oklahoma","Pawnee County","NHPI_AIC",27,13,-14,-70,"undercount"
"8765",40119,"Oklahoma","Payne County","A_A",3589,2714,-875,-27.76,"undercount"
"8766",40119,"Oklahoma","Payne County","A_AIC",4330,3581,-749,-18.94,"undercount"
"8767",40119,"Oklahoma","Payne County","NHPI_A",78,53,-25,-38.17,"undercount"
"8768",40119,"Oklahoma","Payne County","NHPI_AIC",162,190,28,15.91,"overcount"
"8769",40121,"Oklahoma","Pittsburg County","A_A",219,280,61,24.45,"overcount"
"8770",40121,"Oklahoma","Pittsburg County","A_AIC",377,454,77,18.53,"overcount"
"8771",40121,"Oklahoma","Pittsburg County","NHPI_A",37,35,-2,-5.56,"undercount"
"8772",40121,"Oklahoma","Pittsburg County","NHPI_AIC",82,66,-16,-21.62,"undercount"
"8773",40123,"Oklahoma","Pontotoc County","A_A",378,391,13,3.38,"overcount"
"8774",40123,"Oklahoma","Pontotoc County","A_AIC",556,589,33,5.76,"overcount"
"8775",40123,"Oklahoma","Pontotoc County","NHPI_A",18,13,-5,-32.26,"undercount"
"8776",40123,"Oklahoma","Pontotoc County","NHPI_AIC",68,38,-30,-56.6,"undercount"
"8777",40125,"Oklahoma","Pottawatomie County","A_A",526,503,-23,-4.47,"undercount"
"8778",40125,"Oklahoma","Pottawatomie County","A_AIC",1007,878,-129,-13.69,"undercount"
"8779",40125,"Oklahoma","Pottawatomie County","NHPI_A",87,39,-48,-76.19,"undercount"
"8780",40125,"Oklahoma","Pottawatomie County","NHPI_AIC",203,141,-62,-36.05,"undercount"
"8781",40127,"Oklahoma","Pushmataha County","A_A",44,52,8,16.67,"overcount"
"8782",40127,"Oklahoma","Pushmataha County","A_AIC",82,74,-8,-10.26,"undercount"
"8783",40127,"Oklahoma","Pushmataha County","NHPI_A",5,1,-4,-133.33,"undercount"
"8784",40127,"Oklahoma","Pushmataha County","NHPI_AIC",19,10,-9,-62.07,"undercount"
"8785",40129,"Oklahoma","Roger Mills County","A_A",20,5,-15,-120,"undercount"
"8786",40129,"Oklahoma","Roger Mills County","A_AIC",38,17,-21,-76.36,"undercount"
"8787",40129,"Oklahoma","Roger Mills County","NHPI_A",3,1,-2,-100,"undercount"
"8788",40129,"Oklahoma","Roger Mills County","NHPI_AIC",5,4,-1,-22.22,"undercount"
"8789",40131,"Oklahoma","Rogers County","A_A",1507,1680,173,10.86,"overcount"
"8790",40131,"Oklahoma","Rogers County","A_AIC",1926,2230,304,14.63,"overcount"
"8791",40131,"Oklahoma","Rogers County","NHPI_A",101,39,-62,-88.57,"undercount"
"8792",40131,"Oklahoma","Rogers County","NHPI_AIC",195,167,-28,-15.47,"undercount"
"8793",40133,"Oklahoma","Seminole County","A_A",114,72,-42,-45.16,"undercount"
"8794",40133,"Oklahoma","Seminole County","A_AIC",243,152,-91,-46.08,"undercount"
"8795",40133,"Oklahoma","Seminole County","NHPI_A",33,8,-25,-121.95,"undercount"
"8796",40133,"Oklahoma","Seminole County","NHPI_AIC",71,20,-51,-112.09,"undercount"
"8797",40135,"Oklahoma","Sequoyah County","A_A",330,288,-42,-13.59,"undercount"
"8798",40135,"Oklahoma","Sequoyah County","A_AIC",515,431,-84,-17.76,"undercount"
"8799",40135,"Oklahoma","Sequoyah County","NHPI_A",51,14,-37,-113.85,"undercount"
"8800",40135,"Oklahoma","Sequoyah County","NHPI_AIC",88,26,-62,-108.77,"undercount"
"8801",40137,"Oklahoma","Stephens County","A_A",309,244,-65,-23.51,"undercount"
"8802",40137,"Oklahoma","Stephens County","A_AIC",484,423,-61,-13.45,"undercount"
"8803",40137,"Oklahoma","Stephens County","NHPI_A",24,13,-11,-59.46,"undercount"
"8804",40137,"Oklahoma","Stephens County","NHPI_AIC",62,31,-31,-66.67,"undercount"
"8805",40139,"Oklahoma","Texas County","A_A",706,448,-258,-44.71,"undercount"
"8806",40139,"Oklahoma","Texas County","A_AIC",760,524,-236,-36.76,"undercount"
"8807",40139,"Oklahoma","Texas County","NHPI_A",111,1,-110,-196.43,"undercount"
"8808",40139,"Oklahoma","Texas County","NHPI_AIC",124,30,-94,-122.08,"undercount"
"8809",40141,"Oklahoma","Tillman County","A_A",40,32,-8,-22.22,"undercount"
"8810",40141,"Oklahoma","Tillman County","A_AIC",64,50,-14,-24.56,"undercount"
"8811",40141,"Oklahoma","Tillman County","NHPI_A",11,0,-11,-200,"undercount"
"8812",40141,"Oklahoma","Tillman County","NHPI_AIC",18,8,-10,-76.92,"undercount"
"8813",40143,"Oklahoma","Tulsa County","A_A",24262,25029,767,3.11,"overcount"
"8814",40143,"Oklahoma","Tulsa County","A_AIC",29766,30366,600,2,"overcount"
"8815",40143,"Oklahoma","Tulsa County","NHPI_A",1235,1047,-188,-16.48,"undercount"
"8816",40143,"Oklahoma","Tulsa County","NHPI_AIC",2009,1891,-118,-6.05,"undercount"
"8817",40145,"Oklahoma","Wagoner County","A_A",1564,1410,-154,-10.36,"undercount"
"8818",40145,"Oklahoma","Wagoner County","A_AIC",2041,1948,-93,-4.66,"undercount"
"8819",40145,"Oklahoma","Wagoner County","NHPI_A",66,29,-37,-77.89,"undercount"
"8820",40145,"Oklahoma","Wagoner County","NHPI_AIC",171,93,-78,-59.09,"undercount"
"8821",40147,"Oklahoma","Washington County","A_A",1178,975,-203,-18.86,"undercount"
"8822",40147,"Oklahoma","Washington County","A_AIC",1452,1295,-157,-11.43,"undercount"
"8823",40147,"Oklahoma","Washington County","NHPI_A",48,10,-38,-131.03,"undercount"
"8824",40147,"Oklahoma","Washington County","NHPI_AIC",107,87,-20,-20.62,"undercount"
"8825",40149,"Oklahoma","Washita County","A_A",62,22,-40,-95.24,"undercount"
"8826",40149,"Oklahoma","Washita County","A_AIC",84,36,-48,-80,"undercount"
"8827",40149,"Oklahoma","Washita County","NHPI_A",5,0,-5,-200,"undercount"
"8828",40149,"Oklahoma","Washita County","NHPI_AIC",11,0,-11,-200,"undercount"
"8829",40151,"Oklahoma","Woods County","A_A",107,74,-33,-36.46,"undercount"
"8830",40151,"Oklahoma","Woods County","A_AIC",137,108,-29,-23.67,"undercount"
"8831",40151,"Oklahoma","Woods County","NHPI_A",5,1,-4,-133.33,"undercount"
"8832",40151,"Oklahoma","Woods County","NHPI_AIC",12,16,4,28.57,"overcount"
"8833",40153,"Oklahoma","Woodward County","A_A",172,130,-42,-27.81,"undercount"
"8834",40153,"Oklahoma","Woodward County","A_AIC",216,203,-13,-6.21,"undercount"
"8835",40153,"Oklahoma","Woodward County","NHPI_A",15,0,-15,-200,"undercount"
"8836",40153,"Oklahoma","Woodward County","NHPI_AIC",32,35,3,8.96,"overcount"
"8837",41001,"Oregon","Baker County","A_A",121,64,-57,-61.62,"undercount"
"8838",41001,"Oregon","Baker County","A_AIC",231,142,-89,-47.72,"undercount"
"8839",41001,"Oregon","Baker County","NHPI_A",20,15,-5,-28.57,"undercount"
"8840",41001,"Oregon","Baker County","NHPI_AIC",53,53,0,0,"equal"
"8841",41003,"Oregon","Benton County","A_A",6349,6422,73,1.14,"overcount"
"8842",41003,"Oregon","Benton County","A_AIC",8281,8363,82,0.99,"overcount"
"8843",41003,"Oregon","Benton County","NHPI_A",272,283,11,3.96,"overcount"
"8844",41003,"Oregon","Benton County","NHPI_AIC",699,695,-4,-0.57,"undercount"
"8845",41005,"Oregon","Clackamas County","A_A",21234,20600,-634,-3.03,"undercount"
"8846",41005,"Oregon","Clackamas County","A_AIC",28769,28820,51,0.18,"overcount"
"8847",41005,"Oregon","Clackamas County","NHPI_A",1342,1073,-269,-22.28,"undercount"
"8848",41005,"Oregon","Clackamas County","NHPI_AIC",3041,2783,-258,-8.86,"undercount"
"8849",41007,"Oregon","Clatsop County","A_A",677,555,-122,-19.81,"undercount"
"8850",41007,"Oregon","Clatsop County","A_AIC",1092,1023,-69,-6.52,"undercount"
"8851",41007,"Oregon","Clatsop County","NHPI_A",127,91,-36,-33.03,"undercount"
"8852",41007,"Oregon","Clatsop County","NHPI_AIC",244,245,1,0.41,"overcount"
"8853",41009,"Oregon","Columbia County","A_A",569,563,-6,-1.06,"undercount"
"8854",41009,"Oregon","Columbia County","A_AIC",1255,1255,0,0,"equal"
"8855",41009,"Oregon","Columbia County","NHPI_A",137,117,-20,-15.75,"undercount"
"8856",41009,"Oregon","Columbia County","NHPI_AIC",295,298,3,1.01,"overcount"
"8857",41011,"Oregon","Coos County","A_A",815,739,-76,-9.78,"undercount"
"8858",41011,"Oregon","Coos County","A_AIC",1414,1325,-89,-6.5,"undercount"
"8859",41011,"Oregon","Coos County","NHPI_A",185,120,-65,-42.62,"undercount"
"8860",41011,"Oregon","Coos County","NHPI_AIC",388,345,-43,-11.73,"undercount"
"8861",41013,"Oregon","Crook County","A_A",168,114,-54,-38.3,"undercount"
"8862",41013,"Oregon","Crook County","A_AIC",274,260,-14,-5.24,"undercount"
"8863",41013,"Oregon","Crook County","NHPI_A",26,28,2,7.41,"overcount"
"8864",41013,"Oregon","Crook County","NHPI_AIC",62,79,17,24.11,"overcount"
"8865",41015,"Oregon","Curry County","A_A",229,218,-11,-4.92,"undercount"
"8866",41015,"Oregon","Curry County","A_AIC",363,407,44,11.43,"overcount"
"8867",41015,"Oregon","Curry County","NHPI_A",38,28,-10,-30.3,"undercount"
"8868",41015,"Oregon","Curry County","NHPI_AIC",101,74,-27,-30.86,"undercount"
"8869",41017,"Oregon","Deschutes County","A_A",2650,2466,-184,-7.19,"undercount"
"8870",41017,"Oregon","Deschutes County","A_AIC",4787,5137,350,7.05,"overcount"
"8871",41017,"Oregon","Deschutes County","NHPI_A",323,264,-59,-20.1,"undercount"
"8872",41017,"Oregon","Deschutes County","NHPI_AIC",955,1008,53,5.4,"overcount"
"8873",41019,"Oregon","Douglas County","A_A",1283,1217,-66,-5.28,"undercount"
"8874",41019,"Oregon","Douglas County","A_AIC",2276,2133,-143,-6.49,"undercount"
"8875",41019,"Oregon","Douglas County","NHPI_A",209,151,-58,-32.22,"undercount"
"8876",41019,"Oregon","Douglas County","NHPI_AIC",557,540,-17,-3.1,"undercount"
"8877",41021,"Oregon","Gilliam County","A_A",19,6,-13,-104,"undercount"
"8878",41021,"Oregon","Gilliam County","A_AIC",26,20,-6,-26.09,"undercount"
"8879",41021,"Oregon","Gilliam County","NHPI_A",10,9,-1,-10.53,"undercount"
"8880",41021,"Oregon","Gilliam County","NHPI_AIC",13,21,8,47.06,"overcount"
"8881",41023,"Oregon","Grant County","A_A",46,23,-23,-66.67,"undercount"
"8882",41023,"Oregon","Grant County","A_AIC",81,49,-32,-49.23,"undercount"
"8883",41023,"Oregon","Grant County","NHPI_A",10,10,0,0,"equal"
"8884",41023,"Oregon","Grant County","NHPI_AIC",27,23,-4,-16,"undercount"
"8885",41025,"Oregon","Harney County","A_A",44,36,-8,-20,"undercount"
"8886",41025,"Oregon","Harney County","A_AIC",93,90,-3,-3.28,"undercount"
"8887",41025,"Oregon","Harney County","NHPI_A",2,0,-2,-200,"undercount"
"8888",41025,"Oregon","Harney County","NHPI_AIC",18,24,6,28.57,"overcount"
"8889",41027,"Oregon","Hood River County","A_A",409,381,-28,-7.09,"undercount"
"8890",41027,"Oregon","Hood River County","A_AIC",635,712,77,11.43,"overcount"
"8891",41027,"Oregon","Hood River County","NHPI_A",56,35,-21,-46.15,"undercount"
"8892",41027,"Oregon","Hood River County","NHPI_AIC",114,103,-11,-10.14,"undercount"
"8893",41029,"Oregon","Jackson County","A_A",3597,3382,-215,-6.16,"undercount"
"8894",41029,"Oregon","Jackson County","A_AIC",5863,5927,64,1.09,"overcount"
"8895",41029,"Oregon","Jackson County","NHPI_A",780,812,32,4.02,"overcount"
"8896",41029,"Oregon","Jackson County","NHPI_AIC",1593,1587,-6,-0.38,"undercount"
"8897",41031,"Oregon","Jefferson County","A_A",206,136,-70,-40.94,"undercount"
"8898",41031,"Oregon","Jefferson County","A_AIC",366,314,-52,-15.29,"undercount"
"8899",41031,"Oregon","Jefferson County","NHPI_A",59,18,-41,-106.49,"undercount"
"8900",41031,"Oregon","Jefferson County","NHPI_AIC",147,94,-53,-43.98,"undercount"
"8901",41033,"Oregon","Josephine County","A_A",954,881,-73,-7.96,"undercount"
"8902",41033,"Oregon","Josephine County","A_AIC",1732,1812,80,4.51,"overcount"
"8903",41033,"Oregon","Josephine County","NHPI_A",241,124,-117,-64.11,"undercount"
"8904",41033,"Oregon","Josephine County","NHPI_AIC",510,477,-33,-6.69,"undercount"
"8905",41035,"Oregon","Klamath County","A_A",796,779,-17,-2.16,"undercount"
"8906",41035,"Oregon","Klamath County","A_AIC",1376,1451,75,5.31,"overcount"
"8907",41035,"Oregon","Klamath County","NHPI_A",159,104,-55,-41.83,"undercount"
"8908",41035,"Oregon","Klamath County","NHPI_AIC",366,338,-28,-7.95,"undercount"
"8909",41037,"Oregon","Lake County","A_A",101,65,-36,-43.37,"undercount"
"8910",41037,"Oregon","Lake County","A_AIC",152,129,-23,-16.37,"undercount"
"8911",41037,"Oregon","Lake County","NHPI_A",13,10,-3,-26.09,"undercount"
"8912",41037,"Oregon","Lake County","NHPI_AIC",40,52,12,26.09,"overcount"
"8913",41039,"Oregon","Lane County","A_A",12046,9614,-2432,-22.46,"undercount"
"8914",41039,"Oregon","Lane County","A_AIC",18329,16052,-2277,-13.25,"undercount"
"8915",41039,"Oregon","Lane County","NHPI_A",1050,972,-78,-7.72,"undercount"
"8916",41039,"Oregon","Lane County","NHPI_AIC",2533,2604,71,2.76,"overcount"
"8917",41041,"Oregon","Lincoln County","A_A",731,653,-78,-11.27,"undercount"
"8918",41041,"Oregon","Lincoln County","A_AIC",1176,1176,0,0,"equal"
"8919",41041,"Oregon","Lincoln County","NHPI_A",105,96,-9,-8.96,"undercount"
"8920",41041,"Oregon","Lincoln County","NHPI_AIC",244,285,41,15.5,"overcount"
"8921",41043,"Oregon","Linn County","A_A",1671,1447,-224,-14.37,"undercount"
"8922",41043,"Oregon","Linn County","A_AIC",2977,2655,-322,-11.43,"undercount"
"8923",41043,"Oregon","Linn County","NHPI_A",308,280,-28,-9.52,"undercount"
"8924",41043,"Oregon","Linn County","NHPI_AIC",699,746,47,6.51,"overcount"
"8925",41045,"Oregon","Malheur County","A_A",468,397,-71,-16.42,"undercount"
"8926",41045,"Oregon","Malheur County","A_AIC",703,597,-106,-16.31,"undercount"
"8927",41045,"Oregon","Malheur County","NHPI_A",76,40,-36,-62.07,"undercount"
"8928",41045,"Oregon","Malheur County","NHPI_AIC",127,64,-63,-65.97,"undercount"
"8929",41047,"Oregon","Marion County","A_A",8950,7391,-1559,-19.08,"undercount"
"8930",41047,"Oregon","Marion County","A_AIC",13255,11293,-1962,-15.99,"undercount"
"8931",41047,"Oregon","Marion County","NHPI_A",3891,3678,-213,-5.63,"undercount"
"8932",41047,"Oregon","Marion County","NHPI_AIC",5296,4980,-316,-6.15,"undercount"
"8933",41049,"Oregon","Morrow County","A_A",95,30,-65,-104,"undercount"
"8934",41049,"Oregon","Morrow County","A_AIC",163,87,-76,-60.8,"undercount"
"8935",41049,"Oregon","Morrow County","NHPI_A",38,5,-33,-153.49,"undercount"
"8936",41049,"Oregon","Morrow County","NHPI_AIC",65,30,-35,-73.68,"undercount"
"8937",41051,"Oregon","Multnomah County","A_A",66151,61842,-4309,-6.73,"undercount"
"8938",41051,"Oregon","Multnomah County","A_AIC",83268,81285,-1983,-2.41,"undercount"
"8939",41051,"Oregon","Multnomah County","NHPI_A",5642,5339,-303,-5.52,"undercount"
"8940",41051,"Oregon","Multnomah County","NHPI_AIC",9422,8848,-574,-6.28,"undercount"
"8941",41053,"Oregon","Polk County","A_A",1881,1730,-151,-8.36,"undercount"
"8942",41053,"Oregon","Polk County","A_AIC",3210,2932,-278,-9.05,"undercount"
"8943",41053,"Oregon","Polk County","NHPI_A",439,345,-94,-23.98,"undercount"
"8944",41053,"Oregon","Polk County","NHPI_AIC",854,722,-132,-16.75,"undercount"
"8945",41055,"Oregon","Sherman County","A_A",14,11,-3,-24,"undercount"
"8946",41055,"Oregon","Sherman County","A_AIC",25,38,13,41.27,"overcount"
"8947",41055,"Oregon","Sherman County","NHPI_A",1,0,-1,-200,"undercount"
"8948",41055,"Oregon","Sherman County","NHPI_AIC",4,13,9,105.88,"overcount"
"8949",41057,"Oregon","Tillamook County","A_A",286,280,-6,-2.12,"undercount"
"8950",41057,"Oregon","Tillamook County","A_AIC",506,516,10,1.96,"overcount"
"8951",41057,"Oregon","Tillamook County","NHPI_A",99,89,-10,-10.64,"undercount"
"8952",41057,"Oregon","Tillamook County","NHPI_AIC",202,209,7,3.41,"overcount"
"8953",41059,"Oregon","Umatilla County","A_A",947,717,-230,-27.64,"undercount"
"8954",41059,"Oregon","Umatilla County","A_AIC",1452,1187,-265,-20.08,"undercount"
"8955",41059,"Oregon","Umatilla County","NHPI_A",190,138,-52,-31.71,"undercount"
"8956",41059,"Oregon","Umatilla County","NHPI_AIC",352,293,-59,-18.29,"undercount"
"8957",41061,"Oregon","Union County","A_A",341,218,-123,-44.01,"undercount"
"8958",41061,"Oregon","Union County","A_AIC",550,412,-138,-28.69,"undercount"
"8959",41061,"Oregon","Union County","NHPI_A",392,496,104,23.42,"overcount"
"8960",41061,"Oregon","Union County","NHPI_AIC",461,597,136,25.71,"overcount"
"8961",41063,"Oregon","Wallowa County","A_A",35,32,-3,-8.96,"undercount"
"8962",41063,"Oregon","Wallowa County","A_AIC",74,80,6,7.79,"overcount"
"8963",41063,"Oregon","Wallowa County","NHPI_A",10,4,-6,-85.71,"undercount"
"8964",41063,"Oregon","Wallowa County","NHPI_AIC",28,29,1,3.51,"overcount"
"8965",41065,"Oregon","Wasco County","A_A",271,248,-23,-8.86,"undercount"
"8966",41065,"Oregon","Wasco County","A_AIC",466,455,-11,-2.39,"undercount"
"8967",41065,"Oregon","Wasco County","NHPI_A",197,226,29,13.71,"overcount"
"8968",41065,"Oregon","Wasco County","NHPI_AIC",248,356,108,35.76,"overcount"
"8969",41067,"Oregon","Washington County","A_A",72350,69011,-3339,-4.72,"undercount"
"8970",41067,"Oregon","Washington County","A_AIC",87687,84606,-3081,-3.58,"undercount"
"8971",41067,"Oregon","Washington County","NHPI_A",3399,3293,-106,-3.17,"undercount"
"8972",41067,"Oregon","Washington County","NHPI_AIC",7055,6741,-314,-4.55,"undercount"
"8973",41069,"Oregon","Wheeler County","A_A",12,8,-4,-40,"undercount"
"8974",41069,"Oregon","Wheeler County","A_AIC",20,28,8,33.33,"overcount"
"8975",41069,"Oregon","Wheeler County","NHPI_A",3,0,-3,-200,"undercount"
"8976",41069,"Oregon","Wheeler County","NHPI_AIC",7,14,7,66.67,"overcount"
"8977",41071,"Oregon","Yamhill County","A_A",2048,1545,-503,-28,"undercount"
"8978",41071,"Oregon","Yamhill County","A_AIC",3337,2926,-411,-13.12,"undercount"
"8979",41071,"Oregon","Yamhill County","NHPI_A",289,196,-93,-38.35,"undercount"
"8980",41071,"Oregon","Yamhill County","NHPI_AIC",649,593,-56,-9.02,"undercount"
"8981",42001,"Pennsylvania","Adams County","A_A",908,965,57,6.09,"overcount"
"8982",42001,"Pennsylvania","Adams County","A_AIC",1306,1427,121,8.85,"overcount"
"8983",42001,"Pennsylvania","Adams County","NHPI_A",68,33,-35,-69.31,"undercount"
"8984",42001,"Pennsylvania","Adams County","NHPI_AIC",126,107,-19,-16.31,"undercount"
"8985",42003,"Pennsylvania","Allegheny County","A_A",52267,58988,6721,12.08,"overcount"
"8986",42003,"Pennsylvania","Allegheny County","A_AIC",59920,68865,8945,13.89,"overcount"
"8987",42003,"Pennsylvania","Allegheny County","NHPI_A",456,328,-128,-32.65,"undercount"
"8988",42003,"Pennsylvania","Allegheny County","NHPI_AIC",1166,1178,12,1.02,"overcount"
"8989",42005,"Pennsylvania","Armstrong County","A_A",187,150,-37,-21.96,"undercount"
"8990",42005,"Pennsylvania","Armstrong County","A_AIC",294,269,-25,-8.88,"undercount"
"8991",42005,"Pennsylvania","Armstrong County","NHPI_A",8,14,6,54.55,"overcount"
"8992",42005,"Pennsylvania","Armstrong County","NHPI_AIC",27,47,20,54.05,"overcount"
"8993",42007,"Pennsylvania","Beaver County","A_A",960,1025,65,6.55,"overcount"
"8994",42007,"Pennsylvania","Beaver County","A_AIC",1500,1639,139,8.86,"overcount"
"8995",42007,"Pennsylvania","Beaver County","NHPI_A",74,53,-21,-33.07,"undercount"
"8996",42007,"Pennsylvania","Beaver County","NHPI_AIC",179,155,-24,-14.37,"undercount"
"8997",42009,"Pennsylvania","Bedford County","A_A",223,155,-68,-35.98,"undercount"
"8998",42009,"Pennsylvania","Bedford County","A_AIC",319,246,-73,-25.84,"undercount"
"8999",42009,"Pennsylvania","Bedford County","NHPI_A",21,0,-21,-200,"undercount"
"9000",42009,"Pennsylvania","Bedford County","NHPI_AIC",35,10,-25,-111.11,"undercount"
"9001",42011,"Pennsylvania","Berks County","A_A",6790,6323,-467,-7.12,"undercount"
"9002",42011,"Pennsylvania","Berks County","A_AIC",8961,8230,-731,-8.5,"undercount"
"9003",42011,"Pennsylvania","Berks County","NHPI_A",912,68,-844,-172.24,"undercount"
"9004",42011,"Pennsylvania","Berks County","NHPI_AIC",1441,351,-1090,-121.65,"undercount"
"9005",42013,"Pennsylvania","Blair County","A_A",843,868,25,2.92,"overcount"
"9006",42013,"Pennsylvania","Blair County","A_AIC",1217,1271,54,4.34,"overcount"
"9007",42013,"Pennsylvania","Blair County","NHPI_A",34,12,-22,-95.65,"undercount"
"9008",42013,"Pennsylvania","Blair County","NHPI_AIC",82,101,19,20.77,"overcount"
"9009",42015,"Pennsylvania","Bradford County","A_A",433,478,45,9.88,"overcount"
"9010",42015,"Pennsylvania","Bradford County","A_AIC",595,633,38,6.19,"overcount"
"9011",42015,"Pennsylvania","Bradford County","NHPI_A",15,13,-2,-14.29,"undercount"
"9012",42015,"Pennsylvania","Bradford County","NHPI_AIC",32,61,29,62.37,"overcount"
"9013",42017,"Pennsylvania","Bucks County","A_A",33975,35386,1411,4.07,"overcount"
"9014",42017,"Pennsylvania","Bucks County","A_AIC",38430,41093,2663,6.7,"overcount"
"9015",42017,"Pennsylvania","Bucks County","NHPI_A",439,162,-277,-92.18,"undercount"
"9016",42017,"Pennsylvania","Bucks County","NHPI_AIC",830,577,-253,-35.96,"undercount"
"9017",42019,"Pennsylvania","Butler County","A_A",2886,2822,-64,-2.24,"undercount"
"9018",42019,"Pennsylvania","Butler County","A_AIC",3642,3787,145,3.9,"overcount"
"9019",42019,"Pennsylvania","Butler County","NHPI_A",66,36,-30,-58.82,"undercount"
"9020",42019,"Pennsylvania","Butler County","NHPI_AIC",138,132,-6,-4.44,"undercount"
"9021",42021,"Pennsylvania","Cambria County","A_A",690,787,97,13.13,"overcount"
"9022",42021,"Pennsylvania","Cambria County","A_AIC",1049,1120,71,6.55,"overcount"
"9023",42021,"Pennsylvania","Cambria County","NHPI_A",67,35,-32,-62.75,"undercount"
"9024",42021,"Pennsylvania","Cambria County","NHPI_AIC",148,109,-39,-30.35,"undercount"
"9025",42023,"Pennsylvania","Cameron County","A_A",20,30,10,40,"overcount"
"9026",42023,"Pennsylvania","Cameron County","A_AIC",32,42,10,27.03,"overcount"
"9027",42023,"Pennsylvania","Cameron County","NHPI_A",3,0,-3,-200,"undercount"
"9028",42023,"Pennsylvania","Cameron County","NHPI_AIC",4,5,1,22.22,"overcount"
"9029",42025,"Pennsylvania","Carbon County","A_A",393,367,-26,-6.84,"undercount"
"9030",42025,"Pennsylvania","Carbon County","A_AIC",572,592,20,3.44,"overcount"
"9031",42025,"Pennsylvania","Carbon County","NHPI_A",63,14,-49,-127.27,"undercount"
"9032",42025,"Pennsylvania","Carbon County","NHPI_AIC",98,42,-56,-80,"undercount"
"9033",42027,"Pennsylvania","Centre County","A_A",10129,11528,1399,12.92,"overcount"
"9034",42027,"Pennsylvania","Centre County","A_AIC",11432,13338,1906,15.39,"overcount"
"9035",42027,"Pennsylvania","Centre County","NHPI_A",143,39,-104,-114.29,"undercount"
"9036",42027,"Pennsylvania","Centre County","NHPI_AIC",267,325,58,19.59,"overcount"
"9037",42029,"Pennsylvania","Chester County","A_A",34380,35426,1046,3,"overcount"
"9038",42029,"Pennsylvania","Chester County","A_AIC",37933,40059,2126,5.45,"overcount"
"9039",42029,"Pennsylvania","Chester County","NHPI_A",357,132,-225,-92.02,"undercount"
"9040",42029,"Pennsylvania","Chester County","NHPI_AIC",719,468,-251,-42.29,"undercount"
"9041",42031,"Pennsylvania","Clarion County","A_A",276,175,-101,-44.79,"undercount"
"9042",42031,"Pennsylvania","Clarion County","A_AIC",372,276,-96,-29.63,"undercount"
"9043",42031,"Pennsylvania","Clarion County","NHPI_A",10,15,5,40,"overcount"
"9044",42031,"Pennsylvania","Clarion County","NHPI_AIC",34,29,-5,-15.87,"undercount"
"9045",42033,"Pennsylvania","Clearfield County","A_A",512,452,-60,-12.45,"undercount"
"9046",42033,"Pennsylvania","Clearfield County","A_AIC",719,638,-81,-11.94,"undercount"
"9047",42033,"Pennsylvania","Clearfield County","NHPI_A",20,0,-20,-200,"undercount"
"9048",42033,"Pennsylvania","Clearfield County","NHPI_AIC",64,25,-39,-87.64,"undercount"
"9049",42035,"Pennsylvania","Clinton County","A_A",272,215,-57,-23.41,"undercount"
"9050",42035,"Pennsylvania","Clinton County","A_AIC",364,367,3,0.82,"overcount"
"9051",42035,"Pennsylvania","Clinton County","NHPI_A",27,9,-18,-100,"undercount"
"9052",42035,"Pennsylvania","Clinton County","NHPI_AIC",37,43,6,15,"overcount"
"9053",42037,"Pennsylvania","Columbia County","A_A",748,770,22,2.9,"overcount"
"9054",42037,"Pennsylvania","Columbia County","A_AIC",912,1053,141,14.35,"overcount"
"9055",42037,"Pennsylvania","Columbia County","NHPI_A",46,17,-29,-92.06,"undercount"
"9056",42037,"Pennsylvania","Columbia County","NHPI_AIC",82,51,-31,-46.62,"undercount"
"9057",42039,"Pennsylvania","Crawford County","A_A",504,375,-129,-29.35,"undercount"
"9058",42039,"Pennsylvania","Crawford County","A_AIC",699,580,-119,-18.61,"undercount"
"9059",42039,"Pennsylvania","Crawford County","NHPI_A",28,32,4,13.33,"overcount"
"9060",42039,"Pennsylvania","Crawford County","NHPI_AIC",62,60,-2,-3.28,"undercount"
"9061",42041,"Pennsylvania","Cumberland County","A_A",13050,13985,935,6.92,"overcount"
"9062",42041,"Pennsylvania","Cumberland County","A_AIC",15022,16233,1211,7.75,"overcount"
"9063",42041,"Pennsylvania","Cumberland County","NHPI_A",154,118,-36,-26.47,"undercount"
"9064",42041,"Pennsylvania","Cumberland County","NHPI_AIC",369,353,-16,-4.43,"undercount"
"9065",42043,"Pennsylvania","Dauphin County","A_A",16627,17341,714,4.2,"overcount"
"9066",42043,"Pennsylvania","Dauphin County","A_AIC",18355,19329,974,5.17,"overcount"
"9067",42043,"Pennsylvania","Dauphin County","NHPI_A",304,93,-211,-106.3,"undercount"
"9068",42043,"Pennsylvania","Dauphin County","NHPI_AIC",609,319,-290,-62.5,"undercount"
"9069",42045,"Pennsylvania","Delaware County","A_A",36324,36683,359,0.98,"overcount"
"9070",42045,"Pennsylvania","Delaware County","A_AIC",40633,41651,1018,2.47,"overcount"
"9071",42045,"Pennsylvania","Delaware County","NHPI_A",349,144,-205,-83.16,"undercount"
"9072",42045,"Pennsylvania","Delaware County","NHPI_AIC",864,567,-297,-41.51,"undercount"
"9073",42047,"Pennsylvania","Elk County","A_A",114,113,-1,-0.88,"undercount"
"9074",42047,"Pennsylvania","Elk County","A_AIC",181,184,3,1.64,"overcount"
"9075",42047,"Pennsylvania","Elk County","NHPI_A",6,12,6,66.67,"overcount"
"9076",42047,"Pennsylvania","Elk County","NHPI_AIC",23,34,11,38.6,"overcount"
"9077",42049,"Pennsylvania","Erie County","A_A",5534,6407,873,14.62,"overcount"
"9078",42049,"Pennsylvania","Erie County","A_AIC",6760,7898,1138,15.53,"overcount"
"9079",42049,"Pennsylvania","Erie County","NHPI_A",185,62,-123,-99.6,"undercount"
"9080",42049,"Pennsylvania","Erie County","NHPI_AIC",391,211,-180,-59.8,"undercount"
"9081",42051,"Pennsylvania","Fayette County","A_A",543,383,-160,-34.56,"undercount"
"9082",42051,"Pennsylvania","Fayette County","A_AIC",835,662,-173,-23.11,"undercount"
"9083",42051,"Pennsylvania","Fayette County","NHPI_A",232,165,-67,-33.75,"undercount"
"9084",42051,"Pennsylvania","Fayette County","NHPI_AIC",296,229,-67,-25.52,"undercount"
"9085",42053,"Pennsylvania","Forest County","A_A",13,17,4,26.67,"overcount"
"9086",42053,"Pennsylvania","Forest County","A_AIC",24,37,13,42.62,"overcount"
"9087",42053,"Pennsylvania","Forest County","NHPI_A",1,0,-1,-200,"undercount"
"9088",42053,"Pennsylvania","Forest County","NHPI_AIC",6,11,5,58.82,"overcount"
"9089",42055,"Pennsylvania","Franklin County","A_A",1741,1434,-307,-19.34,"undercount"
"9090",42055,"Pennsylvania","Franklin County","A_AIC",2401,2054,-347,-15.58,"undercount"
"9091",42055,"Pennsylvania","Franklin County","NHPI_A",113,41,-72,-93.51,"undercount"
"9092",42055,"Pennsylvania","Franklin County","NHPI_AIC",236,130,-106,-57.92,"undercount"
"9093",42057,"Pennsylvania","Fulton County","A_A",35,41,6,15.79,"overcount"
"9094",42057,"Pennsylvania","Fulton County","A_AIC",59,88,29,39.46,"overcount"
"9095",42057,"Pennsylvania","Fulton County","NHPI_A",1,3,2,100,"overcount"
"9096",42057,"Pennsylvania","Fulton County","NHPI_AIC",7,23,16,106.67,"overcount"
"9097",42059,"Pennsylvania","Greene County","A_A",132,125,-7,-5.45,"undercount"
"9098",42059,"Pennsylvania","Greene County","A_AIC",226,271,45,18.11,"overcount"
"9099",42059,"Pennsylvania","Greene County","NHPI_A",9,6,-3,-40,"undercount"
"9100",42059,"Pennsylvania","Greene County","NHPI_AIC",29,42,13,36.62,"overcount"
"9101",42061,"Pennsylvania","Huntingdon County","A_A",342,241,-101,-34.65,"undercount"
"9102",42061,"Pennsylvania","Huntingdon County","A_AIC",483,328,-155,-38.22,"undercount"
"9103",42061,"Pennsylvania","Huntingdon County","NHPI_A",14,9,-5,-43.48,"undercount"
"9104",42061,"Pennsylvania","Huntingdon County","NHPI_AIC",42,24,-18,-54.55,"undercount"
"9105",42063,"Pennsylvania","Indiana County","A_A",883,825,-58,-6.79,"undercount"
"9106",42063,"Pennsylvania","Indiana County","A_AIC",1118,1092,-26,-2.35,"undercount"
"9107",42063,"Pennsylvania","Indiana County","NHPI_A",12,7,-5,-52.63,"undercount"
"9108",42063,"Pennsylvania","Indiana County","NHPI_AIC",57,42,-15,-30.3,"undercount"
"9109",42065,"Pennsylvania","Jefferson County","A_A",130,100,-30,-26.09,"undercount"
"9110",42065,"Pennsylvania","Jefferson County","A_AIC",223,205,-18,-8.41,"undercount"
"9111",42065,"Pennsylvania","Jefferson County","NHPI_A",7,8,1,13.33,"overcount"
"9112",42065,"Pennsylvania","Jefferson County","NHPI_AIC",23,32,9,32.73,"overcount"
"9113",42067,"Pennsylvania","Juniata County","A_A",112,69,-43,-47.51,"undercount"
"9114",42067,"Pennsylvania","Juniata County","A_AIC",163,122,-41,-28.77,"undercount"
"9115",42067,"Pennsylvania","Juniata County","NHPI_A",7,4,-3,-54.55,"undercount"
"9116",42067,"Pennsylvania","Juniata County","NHPI_AIC",26,14,-12,-60,"undercount"
"9117",42069,"Pennsylvania","Lackawanna County","A_A",6700,6818,118,1.75,"overcount"
"9118",42069,"Pennsylvania","Lackawanna County","A_AIC",7648,7853,205,2.64,"overcount"
"9119",42069,"Pennsylvania","Lackawanna County","NHPI_A",148,37,-111,-120,"undercount"
"9120",42069,"Pennsylvania","Lackawanna County","NHPI_AIC",300,186,-114,-46.91,"undercount"
"9121",42071,"Pennsylvania","Lancaster County","A_A",14258,14123,-135,-0.95,"undercount"
"9122",42071,"Pennsylvania","Lancaster County","A_AIC",16530,17009,479,2.86,"overcount"
"9123",42071,"Pennsylvania","Lancaster County","NHPI_A",600,136,-464,-126.09,"undercount"
"9124",42071,"Pennsylvania","Lancaster County","NHPI_AIC",954,454,-500,-71.02,"undercount"
"9125",42073,"Pennsylvania","Lawrence County","A_A",384,329,-55,-15.43,"undercount"
"9126",42073,"Pennsylvania","Lawrence County","A_AIC",665,629,-36,-5.56,"undercount"
"9127",42073,"Pennsylvania","Lawrence County","NHPI_A",19,4,-15,-130.43,"undercount"
"9128",42073,"Pennsylvania","Lawrence County","NHPI_AIC",78,31,-47,-86.24,"undercount"
"9129",42075,"Pennsylvania","Lebanon County","A_A",2408,2242,-166,-7.14,"undercount"
"9130",42075,"Pennsylvania","Lebanon County","A_AIC",2884,2833,-51,-1.78,"undercount"
"9131",42075,"Pennsylvania","Lebanon County","NHPI_A",128,43,-85,-99.42,"undercount"
"9132",42075,"Pennsylvania","Lebanon County","NHPI_AIC",227,125,-102,-57.95,"undercount"
"9133",42077,"Pennsylvania","Lehigh County","A_A",14455,13844,-611,-4.32,"undercount"
"9134",42077,"Pennsylvania","Lehigh County","A_AIC",16744,16028,-716,-4.37,"undercount"
"9135",42077,"Pennsylvania","Lehigh County","NHPI_A",709,101,-608,-150.12,"undercount"
"9136",42077,"Pennsylvania","Lehigh County","NHPI_AIC",1113,239,-874,-129.29,"undercount"
"9137",42079,"Pennsylvania","Luzerne County","A_A",4584,3968,-616,-14.41,"undercount"
"9138",42079,"Pennsylvania","Luzerne County","A_AIC",5809,5147,-662,-12.08,"undercount"
"9139",42079,"Pennsylvania","Luzerne County","NHPI_A",305,69,-236,-126.2,"undercount"
"9140",42079,"Pennsylvania","Luzerne County","NHPI_AIC",540,261,-279,-69.66,"undercount"
"9141",42081,"Pennsylvania","Lycoming County","A_A",855,931,76,8.51,"overcount"
"9142",42081,"Pennsylvania","Lycoming County","A_AIC",1219,1396,177,13.54,"overcount"
"9143",42081,"Pennsylvania","Lycoming County","NHPI_A",50,27,-23,-59.74,"undercount"
"9144",42081,"Pennsylvania","Lycoming County","NHPI_AIC",125,107,-18,-15.52,"undercount"
"9145",42083,"Pennsylvania","McKean County","A_A",261,196,-65,-28.45,"undercount"
"9146",42083,"Pennsylvania","McKean County","A_AIC",381,322,-59,-16.79,"undercount"
"9147",42083,"Pennsylvania","McKean County","NHPI_A",26,2,-24,-171.43,"undercount"
"9148",42083,"Pennsylvania","McKean County","NHPI_AIC",44,30,-14,-37.84,"undercount"
"9149",42085,"Pennsylvania","Mercer County","A_A",808,686,-122,-16.33,"undercount"
"9150",42085,"Pennsylvania","Mercer County","A_AIC",1145,1044,-101,-9.23,"undercount"
"9151",42085,"Pennsylvania","Mercer County","NHPI_A",28,14,-14,-66.67,"undercount"
"9152",42085,"Pennsylvania","Mercer County","NHPI_AIC",94,90,-4,-4.35,"undercount"
"9153",42087,"Pennsylvania","Mifflin County","A_A",249,163,-86,-41.75,"undercount"
"9154",42087,"Pennsylvania","Mifflin County","A_AIC",377,317,-60,-17.29,"undercount"
"9155",42087,"Pennsylvania","Mifflin County","NHPI_A",16,0,-16,-200,"undercount"
"9156",42087,"Pennsylvania","Mifflin County","NHPI_AIC",36,15,-21,-82.35,"undercount"
"9157",42089,"Pennsylvania","Monroe County","A_A",4605,4127,-478,-10.95,"undercount"
"9158",42089,"Pennsylvania","Monroe County","A_AIC",5771,5164,-607,-11.1,"undercount"
"9159",42089,"Pennsylvania","Monroe County","NHPI_A",244,97,-147,-86.22,"undercount"
"9160",42089,"Pennsylvania","Monroe County","NHPI_AIC",480,241,-239,-66.3,"undercount"
"9161",42091,"Pennsylvania","Montgomery County","A_A",68778,68278,-500,-0.73,"undercount"
"9162",42091,"Pennsylvania","Montgomery County","A_AIC",75780,77120,1340,1.75,"overcount"
"9163",42091,"Pennsylvania","Montgomery County","NHPI_A",570,191,-379,-99.61,"undercount"
"9164",42091,"Pennsylvania","Montgomery County","NHPI_AIC",1145,788,-357,-36.94,"undercount"
"9165",42093,"Pennsylvania","Montour County","A_A",636,668,32,4.91,"overcount"
"9166",42093,"Pennsylvania","Montour County","A_AIC",678,770,92,12.71,"overcount"
"9167",42093,"Pennsylvania","Montour County","NHPI_A",6,1,-5,-142.86,"undercount"
"9168",42093,"Pennsylvania","Montour County","NHPI_AIC",18,29,11,46.81,"overcount"
"9169",42095,"Pennsylvania","Northampton County","A_A",9599,10096,497,5.05,"overcount"
"9170",42095,"Pennsylvania","Northampton County","A_AIC",11410,12120,710,6.03,"overcount"
"9171",42095,"Pennsylvania","Northampton County","NHPI_A",394,77,-317,-134.61,"undercount"
"9172",42095,"Pennsylvania","Northampton County","NHPI_AIC",645,272,-373,-81.35,"undercount"
"9173",42097,"Pennsylvania","Northumberland County","A_A",439,448,9,2.03,"overcount"
"9174",42097,"Pennsylvania","Northumberland County","A_AIC",665,727,62,8.91,"overcount"
"9175",42097,"Pennsylvania","Northumberland County","NHPI_A",39,24,-15,-47.62,"undercount"
"9176",42097,"Pennsylvania","Northumberland County","NHPI_AIC",91,74,-17,-20.61,"undercount"
"9177",42099,"Pennsylvania","Perry County","A_A",239,143,-96,-50.26,"undercount"
"9178",42099,"Pennsylvania","Perry County","A_AIC",348,307,-41,-12.52,"undercount"
"9179",42099,"Pennsylvania","Perry County","NHPI_A",24,4,-20,-142.86,"undercount"
"9180",42099,"Pennsylvania","Perry County","NHPI_AIC",52,38,-14,-31.11,"undercount"
"9181",42101,"Pennsylvania","Philadelphia County","A_A",124711,134078,9367,7.24,"overcount"
"9182",42101,"Pennsylvania","Philadelphia County","A_AIC",137401,148568,11167,7.81,"overcount"
"9183",42101,"Pennsylvania","Philadelphia County","NHPI_A",2834,648,-2186,-125.56,"undercount"
"9184",42101,"Pennsylvania","Philadelphia County","NHPI_AIC",5243,2046,-3197,-87.72,"undercount"
"9185",42103,"Pennsylvania","Pike County","A_A",890,853,-37,-4.25,"undercount"
"9186",42103,"Pennsylvania","Pike County","A_AIC",1161,1171,10,0.86,"overcount"
"9187",42103,"Pennsylvania","Pike County","NHPI_A",21,17,-4,-21.05,"undercount"
"9188",42103,"Pennsylvania","Pike County","NHPI_AIC",90,57,-33,-44.9,"undercount"
"9189",42105,"Pennsylvania","Potter County","A_A",71,69,-2,-2.86,"undercount"
"9190",42105,"Pennsylvania","Potter County","A_AIC",106,130,24,20.34,"overcount"
"9191",42105,"Pennsylvania","Potter County","NHPI_A",1,0,-1,-200,"undercount"
"9192",42105,"Pennsylvania","Potter County","NHPI_AIC",10,8,-2,-22.22,"undercount"
"9193",42107,"Pennsylvania","Schuylkill County","A_A",837,748,-89,-11.23,"undercount"
"9194",42107,"Pennsylvania","Schuylkill County","A_AIC",1293,1149,-144,-11.79,"undercount"
"9195",42107,"Pennsylvania","Schuylkill County","NHPI_A",71,13,-58,-138.1,"undercount"
"9196",42107,"Pennsylvania","Schuylkill County","NHPI_AIC",170,95,-75,-56.6,"undercount"
"9197",42109,"Pennsylvania","Snyder County","A_A",273,297,24,8.42,"overcount"
"9198",42109,"Pennsylvania","Snyder County","A_AIC",360,384,24,6.45,"overcount"
"9199",42109,"Pennsylvania","Snyder County","NHPI_A",30,18,-12,-50,"undercount"
"9200",42109,"Pennsylvania","Snyder County","NHPI_AIC",49,32,-17,-41.98,"undercount"
"9201",42111,"Pennsylvania","Somerset County","A_A",375,194,-181,-63.62,"undercount"
"9202",42111,"Pennsylvania","Somerset County","A_AIC",544,358,-186,-41.24,"undercount"
"9203",42111,"Pennsylvania","Somerset County","NHPI_A",25,7,-18,-112.5,"undercount"
"9204",42111,"Pennsylvania","Somerset County","NHPI_AIC",53,24,-29,-75.32,"undercount"
"9205",42113,"Pennsylvania","Sullivan County","A_A",27,19,-8,-34.78,"undercount"
"9206",42113,"Pennsylvania","Sullivan County","A_AIC",38,35,-3,-8.22,"undercount"
"9207",42113,"Pennsylvania","Sullivan County","NHPI_A",0,2,2,200,"overcount"
"9208",42113,"Pennsylvania","Sullivan County","NHPI_AIC",0,9,9,200,"overcount"
"9209",42115,"Pennsylvania","Susquehanna County","A_A",163,137,-26,-17.33,"undercount"
"9210",42115,"Pennsylvania","Susquehanna County","A_AIC",292,261,-31,-11.21,"undercount"
"9211",42115,"Pennsylvania","Susquehanna County","NHPI_A",25,0,-25,-200,"undercount"
"9212",42115,"Pennsylvania","Susquehanna County","NHPI_AIC",38,19,-19,-66.67,"undercount"
"9213",42117,"Pennsylvania","Tioga County","A_A",238,209,-29,-12.98,"undercount"
"9214",42117,"Pennsylvania","Tioga County","A_AIC",333,332,-1,-0.3,"undercount"
"9215",42117,"Pennsylvania","Tioga County","NHPI_A",8,7,-1,-13.33,"undercount"
"9216",42117,"Pennsylvania","Tioga County","NHPI_AIC",21,38,17,57.63,"overcount"
"9217",42119,"Pennsylvania","Union County","A_A",733,818,85,10.96,"overcount"
"9218",42119,"Pennsylvania","Union County","A_AIC",932,1100,168,16.54,"overcount"
"9219",42119,"Pennsylvania","Union County","NHPI_A",29,8,-21,-113.51,"undercount"
"9220",42119,"Pennsylvania","Union County","NHPI_AIC",90,32,-58,-95.08,"undercount"
"9221",42121,"Pennsylvania","Venango County","A_A",248,176,-72,-33.96,"undercount"
"9222",42121,"Pennsylvania","Venango County","A_AIC",358,338,-20,-5.75,"undercount"
"9223",42121,"Pennsylvania","Venango County","NHPI_A",24,10,-14,-82.35,"undercount"
"9224",42121,"Pennsylvania","Venango County","NHPI_AIC",49,33,-16,-39.02,"undercount"
"9225",42123,"Pennsylvania","Warren County","A_A",187,158,-29,-16.81,"undercount"
"9226",42123,"Pennsylvania","Warren County","A_AIC",289,299,10,3.4,"overcount"
"9227",42123,"Pennsylvania","Warren County","NHPI_A",26,5,-21,-135.48,"undercount"
"9228",42123,"Pennsylvania","Warren County","NHPI_AIC",40,25,-15,-46.15,"undercount"
"9229",42125,"Pennsylvania","Washington County","A_A",2445,2035,-410,-18.3,"undercount"
"9230",42125,"Pennsylvania","Washington County","A_AIC",3129,2923,-206,-6.81,"undercount"
"9231",42125,"Pennsylvania","Washington County","NHPI_A",58,63,5,8.26,"overcount"
"9232",42125,"Pennsylvania","Washington County","NHPI_AIC",174,215,41,21.08,"overcount"
"9233",42127,"Pennsylvania","Wayne County","A_A",398,432,34,8.19,"overcount"
"9234",42127,"Pennsylvania","Wayne County","A_AIC",556,640,84,14.05,"overcount"
"9235",42127,"Pennsylvania","Wayne County","NHPI_A",21,0,-21,-200,"undercount"
"9236",42127,"Pennsylvania","Wayne County","NHPI_AIC",61,11,-50,-138.89,"undercount"
"9237",42129,"Pennsylvania","Westmoreland County","A_A",3490,3327,-163,-4.78,"undercount"
"9238",42129,"Pennsylvania","Westmoreland County","A_AIC",4527,4682,155,3.37,"overcount"
"9239",42129,"Pennsylvania","Westmoreland County","NHPI_A",83,36,-47,-78.99,"undercount"
"9240",42129,"Pennsylvania","Westmoreland County","NHPI_AIC",252,219,-33,-14.01,"undercount"
"9241",42131,"Pennsylvania","Wyoming County","A_A",146,120,-26,-19.55,"undercount"
"9242",42131,"Pennsylvania","Wyoming County","A_AIC",191,204,13,6.58,"overcount"
"9243",42131,"Pennsylvania","Wyoming County","NHPI_A",5,3,-2,-50,"undercount"
"9244",42131,"Pennsylvania","Wyoming County","NHPI_AIC",12,22,10,58.82,"overcount"
"9245",42133,"Pennsylvania","York County","A_A",7077,6649,-428,-6.24,"undercount"
"9246",42133,"Pennsylvania","York County","A_AIC",9189,9185,-4,-0.04,"undercount"
"9247",42133,"Pennsylvania","York County","NHPI_A",364,118,-246,-102.07,"undercount"
"9248",42133,"Pennsylvania","York County","NHPI_AIC",678,404,-274,-50.65,"undercount"
"9249",44001,"Rhode Island","Bristol County","A_A",1230,1293,63,4.99,"overcount"
"9250",44001,"Rhode Island","Bristol County","A_AIC",1635,1787,152,8.88,"overcount"
"9251",44001,"Rhode Island","Bristol County","NHPI_A",31,8,-23,-117.95,"undercount"
"9252",44001,"Rhode Island","Bristol County","NHPI_AIC",110,51,-59,-73.29,"undercount"
"9253",44003,"Rhode Island","Kent County","A_A",4950,4898,-52,-1.06,"undercount"
"9254",44003,"Rhode Island","Kent County","A_AIC",6131,6181,50,0.81,"overcount"
"9255",44003,"Rhode Island","Kent County","NHPI_A",171,47,-124,-113.76,"undercount"
"9256",44003,"Rhode Island","Kent County","NHPI_AIC",331,198,-133,-50.28,"undercount"
"9257",44005,"Rhode Island","Newport County","A_A",1633,1551,-82,-5.15,"undercount"
"9258",44005,"Rhode Island","Newport County","A_AIC",2414,2506,92,3.74,"overcount"
"9259",44005,"Rhode Island","Newport County","NHPI_A",114,50,-64,-78.05,"undercount"
"9260",44005,"Rhode Island","Newport County","NHPI_AIC",252,210,-42,-18.18,"undercount"
"9261",44007,"Rhode Island","Providence County","A_A",28532,28500,-32,-0.11,"undercount"
"9262",44007,"Rhode Island","Providence County","A_AIC",33254,33138,-116,-0.35,"undercount"
"9263",44007,"Rhode Island","Providence County","NHPI_A",1849,354,-1495,-135.72,"undercount"
"9264",44007,"Rhode Island","Providence County","NHPI_AIC",2856,859,-1997,-107.51,"undercount"
"9265",44009,"Rhode Island","Washington County","A_A",2613,2626,13,0.5,"overcount"
"9266",44009,"Rhode Island","Washington County","A_AIC",3440,3604,164,4.66,"overcount"
"9267",44009,"Rhode Island","Washington County","NHPI_A",53,49,-4,-7.84,"undercount"
"9268",44009,"Rhode Island","Washington County","NHPI_AIC",178,160,-18,-10.65,"undercount"
"9269",45001,"South Carolina","Abbeville County","A_A",90,74,-16,-19.51,"undercount"
"9270",45001,"South Carolina","Abbeville County","A_AIC",139,109,-30,-24.19,"undercount"
"9271",45001,"South Carolina","Abbeville County","NHPI_A",6,7,1,15.38,"overcount"
"9272",45001,"South Carolina","Abbeville County","NHPI_AIC",18,24,6,28.57,"overcount"
"9273",45003,"South Carolina","Aiken County","A_A",2132,1791,-341,-17.38,"undercount"
"9274",45003,"South Carolina","Aiken County","A_AIC",2946,2728,-218,-7.68,"undercount"
"9275",45003,"South Carolina","Aiken County","NHPI_A",121,96,-25,-23.04,"undercount"
"9276",45003,"South Carolina","Aiken County","NHPI_AIC",277,264,-13,-4.81,"undercount"
"9277",45005,"South Carolina","Allendale County","A_A",70,17,-53,-121.84,"undercount"
"9278",45005,"South Carolina","Allendale County","A_AIC",81,35,-46,-79.31,"undercount"
"9279",45005,"South Carolina","Allendale County","NHPI_A",5,1,-4,-133.33,"undercount"
"9280",45005,"South Carolina","Allendale County","NHPI_AIC",9,11,2,20,"overcount"
"9281",45007,"South Carolina","Anderson County","A_A",2284,2432,148,6.28,"overcount"
"9282",45007,"South Carolina","Anderson County","A_AIC",2887,3222,335,10.97,"overcount"
"9283",45007,"South Carolina","Anderson County","NHPI_A",108,46,-62,-80.52,"undercount"
"9284",45007,"South Carolina","Anderson County","NHPI_AIC",221,203,-18,-8.49,"undercount"
"9285",45009,"South Carolina","Bamberg County","A_A",92,72,-20,-24.39,"undercount"
"9286",45009,"South Carolina","Bamberg County","A_AIC",114,113,-1,-0.88,"undercount"
"9287",45009,"South Carolina","Bamberg County","NHPI_A",9,2,-7,-127.27,"undercount"
"9288",45009,"South Carolina","Bamberg County","NHPI_AIC",11,20,9,58.06,"overcount"
"9289",45011,"South Carolina","Barnwell County","A_A",186,161,-25,-14.41,"undercount"
"9290",45011,"South Carolina","Barnwell County","A_AIC",235,196,-39,-18.1,"undercount"
"9291",45011,"South Carolina","Barnwell County","NHPI_A",5,14,9,94.74,"overcount"
"9292",45011,"South Carolina","Barnwell County","NHPI_AIC",17,21,4,21.05,"overcount"
"9293",45013,"South Carolina","Beaufort County","A_A",2860,2400,-460,-17.49,"undercount"
"9294",45013,"South Carolina","Beaufort County","A_AIC",4023,3516,-507,-13.45,"undercount"
"9295",45013,"South Carolina","Beaufort County","NHPI_A",255,122,-133,-70.56,"undercount"
"9296",45013,"South Carolina","Beaufort County","NHPI_AIC",498,321,-177,-43.22,"undercount"
"9297",45015,"South Carolina","Berkeley County","A_A",6439,5434,-1005,-16.93,"undercount"
"9298",45015,"South Carolina","Berkeley County","A_AIC",8937,8131,-806,-9.44,"undercount"
"9299",45015,"South Carolina","Berkeley County","NHPI_A",338,181,-157,-60.5,"undercount"
"9300",45015,"South Carolina","Berkeley County","NHPI_AIC",662,569,-93,-15.11,"undercount"
"9301",45017,"South Carolina","Calhoun County","A_A",53,47,-6,-12,"undercount"
"9302",45017,"South Carolina","Calhoun County","A_AIC",86,105,19,19.9,"overcount"
"9303",45017,"South Carolina","Calhoun County","NHPI_A",15,6,-9,-85.71,"undercount"
"9304",45017,"South Carolina","Calhoun County","NHPI_AIC",21,20,-1,-4.88,"undercount"
"9305",45019,"South Carolina","Charleston County","A_A",8080,7582,-498,-6.36,"undercount"
"9306",45019,"South Carolina","Charleston County","A_AIC",10506,10775,269,2.53,"overcount"
"9307",45019,"South Carolina","Charleston County","NHPI_A",370,322,-48,-13.87,"undercount"
"9308",45019,"South Carolina","Charleston County","NHPI_AIC",698,676,-22,-3.2,"undercount"
"9309",45021,"South Carolina","Cherokee County","A_A",381,346,-35,-9.63,"undercount"
"9310",45021,"South Carolina","Cherokee County","A_AIC",473,434,-39,-8.6,"undercount"
"9311",45021,"South Carolina","Cherokee County","NHPI_A",87,14,-73,-144.55,"undercount"
"9312",45021,"South Carolina","Cherokee County","NHPI_AIC",117,37,-80,-103.9,"undercount"
"9313",45023,"South Carolina","Chester County","A_A",174,146,-28,-17.5,"undercount"
"9314",45023,"South Carolina","Chester County","A_AIC",243,217,-26,-11.3,"undercount"
"9315",45023,"South Carolina","Chester County","NHPI_A",17,14,-3,-19.35,"undercount"
"9316",45023,"South Carolina","Chester County","NHPI_AIC",53,32,-21,-49.41,"undercount"
"9317",45025,"South Carolina","Chesterfield County","A_A",291,269,-22,-7.86,"undercount"
"9318",45025,"South Carolina","Chesterfield County","A_AIC",409,375,-34,-8.67,"undercount"
"9319",45025,"South Carolina","Chesterfield County","NHPI_A",34,4,-30,-157.89,"undercount"
"9320",45025,"South Carolina","Chesterfield County","NHPI_AIC",87,29,-58,-100,"undercount"
"9321",45027,"South Carolina","Clarendon County","A_A",268,225,-43,-17.44,"undercount"
"9322",45027,"South Carolina","Clarendon County","A_AIC",317,271,-46,-15.65,"undercount"
"9323",45027,"South Carolina","Clarendon County","NHPI_A",15,8,-7,-60.87,"undercount"
"9324",45027,"South Carolina","Clarendon County","NHPI_AIC",30,16,-14,-60.87,"undercount"
"9325",45029,"South Carolina","Colleton County","A_A",173,207,34,17.89,"overcount"
"9326",45029,"South Carolina","Colleton County","A_AIC",268,295,27,9.59,"overcount"
"9327",45029,"South Carolina","Colleton County","NHPI_A",24,16,-8,-40,"undercount"
"9328",45029,"South Carolina","Colleton County","NHPI_AIC",65,44,-21,-38.53,"undercount"
"9329",45031,"South Carolina","Darlington County","A_A",354,297,-57,-17.51,"undercount"
"9330",45031,"South Carolina","Darlington County","A_AIC",484,407,-77,-17.28,"undercount"
"9331",45031,"South Carolina","Darlington County","NHPI_A",38,7,-31,-137.78,"undercount"
"9332",45031,"South Carolina","Darlington County","NHPI_AIC",90,30,-60,-100,"undercount"
"9333",45033,"South Carolina","Dillon County","A_A",173,64,-109,-91.98,"undercount"
"9334",45033,"South Carolina","Dillon County","A_AIC",249,116,-133,-72.88,"undercount"
"9335",45033,"South Carolina","Dillon County","NHPI_A",11,1,-10,-166.67,"undercount"
"9336",45033,"South Carolina","Dillon County","NHPI_AIC",41,43,2,4.76,"overcount"
"9337",45035,"South Carolina","Dorchester County","A_A",3757,3320,-437,-12.35,"undercount"
"9338",45035,"South Carolina","Dorchester County","A_AIC",5349,4982,-367,-7.1,"undercount"
"9339",45035,"South Carolina","Dorchester County","NHPI_A",249,199,-50,-22.32,"undercount"
"9340",45035,"South Carolina","Dorchester County","NHPI_AIC",475,434,-41,-9.02,"undercount"
"9341",45037,"South Carolina","Edgefield County","A_A",153,127,-26,-18.57,"undercount"
"9342",45037,"South Carolina","Edgefield County","A_AIC",228,266,38,15.38,"overcount"
"9343",45037,"South Carolina","Edgefield County","NHPI_A",16,6,-10,-90.91,"undercount"
"9344",45037,"South Carolina","Edgefield County","NHPI_AIC",36,26,-10,-32.26,"undercount"
"9345",45039,"South Carolina","Fairfield County","A_A",167,102,-65,-48.33,"undercount"
"9346",45039,"South Carolina","Fairfield County","A_AIC",214,173,-41,-21.19,"undercount"
"9347",45039,"South Carolina","Fairfield County","NHPI_A",6,7,1,15.38,"overcount"
"9348",45039,"South Carolina","Fairfield County","NHPI_AIC",25,47,22,61.11,"overcount"
"9349",45041,"South Carolina","Florence County","A_A",2190,2349,159,7.01,"overcount"
"9350",45041,"South Carolina","Florence County","A_AIC",2581,2775,194,7.24,"overcount"
"9351",45041,"South Carolina","Florence County","NHPI_A",85,48,-37,-55.64,"undercount"
"9352",45041,"South Carolina","Florence County","NHPI_AIC",183,121,-62,-40.79,"undercount"
"9353",45043,"South Carolina","Georgetown County","A_A",341,260,-81,-26.96,"undercount"
"9354",45043,"South Carolina","Georgetown County","A_AIC",454,392,-62,-14.66,"undercount"
"9355",45043,"South Carolina","Georgetown County","NHPI_A",47,27,-20,-54.05,"undercount"
"9356",45043,"South Carolina","Georgetown County","NHPI_AIC",95,57,-38,-50,"undercount"
"9357",45045,"South Carolina","Greenville County","A_A",14877,12995,-1882,-13.5,"undercount"
"9358",45045,"South Carolina","Greenville County","A_AIC",17993,16567,-1426,-8.25,"undercount"
"9359",45045,"South Carolina","Greenville County","NHPI_A",425,402,-23,-5.56,"undercount"
"9360",45045,"South Carolina","Greenville County","NHPI_AIC",895,832,-63,-7.3,"undercount"
"9361",45047,"South Carolina","Greenwood County","A_A",917,678,-239,-29.97,"undercount"
"9362",45047,"South Carolina","Greenwood County","A_AIC",1123,945,-178,-17.21,"undercount"
"9363",45047,"South Carolina","Greenwood County","NHPI_A",83,41,-42,-67.74,"undercount"
"9364",45047,"South Carolina","Greenwood County","NHPI_AIC",136,83,-53,-48.4,"undercount"
"9365",45049,"South Carolina","Hampton County","A_A",118,100,-18,-16.51,"undercount"
"9366",45049,"South Carolina","Hampton County","A_AIC",169,139,-30,-19.48,"undercount"
"9367",45049,"South Carolina","Hampton County","NHPI_A",9,17,8,61.54,"overcount"
"9368",45049,"South Carolina","Hampton County","NHPI_AIC",31,33,2,6.25,"overcount"
"9369",45051,"South Carolina","Horry County","A_A",5488,4640,-848,-16.75,"undercount"
"9370",45051,"South Carolina","Horry County","A_AIC",7346,6617,-729,-10.44,"undercount"
"9371",45051,"South Carolina","Horry County","NHPI_A",524,303,-221,-53.45,"undercount"
"9372",45051,"South Carolina","Horry County","NHPI_AIC",790,590,-200,-28.99,"undercount"
"9373",45053,"South Carolina","Jasper County","A_A",281,187,-94,-40.17,"undercount"
"9374",45053,"South Carolina","Jasper County","A_AIC",367,260,-107,-34.13,"undercount"
"9375",45053,"South Carolina","Jasper County","NHPI_A",34,23,-11,-38.6,"undercount"
"9376",45053,"South Carolina","Jasper County","NHPI_AIC",74,38,-36,-64.29,"undercount"
"9377",45055,"South Carolina","Kershaw County","A_A",536,427,-109,-22.64,"undercount"
"9378",45055,"South Carolina","Kershaw County","A_AIC",773,725,-48,-6.41,"undercount"
"9379",45055,"South Carolina","Kershaw County","NHPI_A",54,29,-25,-60.24,"undercount"
"9380",45055,"South Carolina","Kershaw County","NHPI_AIC",123,71,-52,-53.61,"undercount"
"9381",45057,"South Carolina","Lancaster County","A_A",1817,1783,-34,-1.89,"undercount"
"9382",45057,"South Carolina","Lancaster County","A_AIC",2098,2239,141,6.5,"overcount"
"9383",45057,"South Carolina","Lancaster County","NHPI_A",49,16,-33,-101.54,"undercount"
"9384",45057,"South Carolina","Lancaster County","NHPI_AIC",101,56,-45,-57.32,"undercount"
"9385",45059,"South Carolina","Laurens County","A_A",441,295,-146,-39.67,"undercount"
"9386",45059,"South Carolina","Laurens County","A_AIC",608,481,-127,-23.32,"undercount"
"9387",45059,"South Carolina","Laurens County","NHPI_A",104,29,-75,-112.78,"undercount"
"9388",45059,"South Carolina","Laurens County","NHPI_AIC",147,64,-83,-78.67,"undercount"
"9389",45061,"South Carolina","Lee County","A_A",79,34,-45,-79.65,"undercount"
"9390",45061,"South Carolina","Lee County","A_AIC",119,64,-55,-60.11,"undercount"
"9391",45061,"South Carolina","Lee County","NHPI_A",4,0,-4,-200,"undercount"
"9392",45061,"South Carolina","Lee County","NHPI_AIC",16,17,1,6.06,"overcount"
"9393",45063,"South Carolina","Lexington County","A_A",7134,6705,-429,-6.2,"undercount"
"9394",45063,"South Carolina","Lexington County","A_AIC",8558,8689,131,1.52,"overcount"
"9395",45063,"South Carolina","Lexington County","NHPI_A",324,195,-129,-49.71,"undercount"
"9396",45063,"South Carolina","Lexington County","NHPI_AIC",545,418,-127,-26.38,"undercount"
"9397",45065,"South Carolina","McCormick County","A_A",57,36,-21,-45.16,"undercount"
"9398",45065,"South Carolina","McCormick County","A_AIC",70,60,-10,-15.38,"undercount"
"9399",45065,"South Carolina","McCormick County","NHPI_A",7,2,-5,-111.11,"undercount"
"9400",45065,"South Carolina","McCormick County","NHPI_AIC",8,13,5,47.62,"overcount"
"9401",45067,"South Carolina","Marion County","A_A",208,136,-72,-41.86,"undercount"
"9402",45067,"South Carolina","Marion County","A_AIC",300,184,-116,-47.93,"undercount"
"9403",45067,"South Carolina","Marion County","NHPI_A",6,3,-3,-66.67,"undercount"
"9404",45067,"South Carolina","Marion County","NHPI_AIC",34,29,-5,-15.87,"undercount"
"9405",45069,"South Carolina","Marlboro County","A_A",105,99,-6,-5.88,"undercount"
"9406",45069,"South Carolina","Marlboro County","A_AIC",181,117,-64,-42.95,"undercount"
"9407",45069,"South Carolina","Marlboro County","NHPI_A",12,8,-4,-40,"undercount"
"9408",45069,"South Carolina","Marlboro County","NHPI_AIC",40,9,-31,-126.53,"undercount"
"9409",45071,"South Carolina","Newberry County","A_A",292,135,-157,-73.54,"undercount"
"9410",45071,"South Carolina","Newberry County","A_AIC",377,214,-163,-55.16,"undercount"
"9411",45071,"South Carolina","Newberry County","NHPI_A",118,4,-114,-186.89,"undercount"
"9412",45071,"South Carolina","Newberry County","NHPI_AIC",138,17,-121,-156.13,"undercount"
"9413",45073,"South Carolina","Oconee County","A_A",714,603,-111,-16.86,"undercount"
"9414",45073,"South Carolina","Oconee County","A_AIC",967,919,-48,-5.09,"undercount"
"9415",45073,"South Carolina","Oconee County","NHPI_A",33,16,-17,-69.39,"undercount"
"9416",45073,"South Carolina","Oconee County","NHPI_AIC",99,79,-20,-22.47,"undercount"
"9417",45075,"South Carolina","Orangeburg County","A_A",817,918,101,11.64,"overcount"
"9418",45075,"South Carolina","Orangeburg County","A_AIC",1055,1128,73,6.69,"overcount"
"9419",45075,"South Carolina","Orangeburg County","NHPI_A",37,41,4,10.26,"overcount"
"9420",45075,"South Carolina","Orangeburg County","NHPI_AIC",122,76,-46,-46.46,"undercount"
"9421",45077,"South Carolina","Pickens County","A_A",2491,2752,261,9.96,"overcount"
"9422",45077,"South Carolina","Pickens County","A_AIC",3074,3494,420,12.79,"overcount"
"9423",45077,"South Carolina","Pickens County","NHPI_A",56,40,-16,-33.33,"undercount"
"9424",45077,"South Carolina","Pickens County","NHPI_AIC",151,137,-14,-9.72,"undercount"
"9425",45079,"South Carolina","Richland County","A_A",12456,11420,-1036,-8.68,"undercount"
"9426",45079,"South Carolina","Richland County","A_AIC",15889,14704,-1185,-7.75,"undercount"
"9427",45079,"South Carolina","Richland County","NHPI_A",636,440,-196,-36.43,"undercount"
"9428",45079,"South Carolina","Richland County","NHPI_AIC",1270,923,-347,-31.65,"undercount"
"9429",45081,"South Carolina","Saluda County","A_A",88,39,-49,-77.17,"undercount"
"9430",45081,"South Carolina","Saluda County","A_AIC",144,72,-72,-66.67,"undercount"
"9431",45081,"South Carolina","Saluda County","NHPI_A",200,0,-200,-200,"undercount"
"9432",45081,"South Carolina","Saluda County","NHPI_AIC",217,7,-210,-187.5,"undercount"
"9433",45083,"South Carolina","Spartanburg County","A_A",8623,8241,-382,-4.53,"undercount"
"9434",45083,"South Carolina","Spartanburg County","A_AIC",10116,9860,-256,-2.56,"undercount"
"9435",45083,"South Carolina","Spartanburg County","NHPI_A",272,190,-82,-35.5,"undercount"
"9436",45083,"South Carolina","Spartanburg County","NHPI_AIC",543,385,-158,-34.05,"undercount"
"9437",45085,"South Carolina","Sumter County","A_A",1548,1423,-125,-8.41,"undercount"
"9438",45085,"South Carolina","Sumter County","A_AIC",2364,2218,-146,-6.37,"undercount"
"9439",45085,"South Carolina","Sumter County","NHPI_A",147,87,-60,-51.28,"undercount"
"9440",45085,"South Carolina","Sumter County","NHPI_AIC",290,241,-49,-18.46,"undercount"
"9441",45087,"South Carolina","Union County","A_A",112,79,-33,-34.55,"undercount"
"9442",45087,"South Carolina","Union County","A_AIC",161,149,-12,-7.74,"undercount"
"9443",45087,"South Carolina","Union County","NHPI_A",13,3,-10,-125,"undercount"
"9444",45087,"South Carolina","Union County","NHPI_AIC",32,37,5,14.49,"overcount"
"9445",45089,"South Carolina","Williamsburg County","A_A",216,150,-66,-36.07,"undercount"
"9446",45089,"South Carolina","Williamsburg County","A_AIC",270,197,-73,-31.26,"undercount"
"9447",45089,"South Carolina","Williamsburg County","NHPI_A",11,1,-10,-166.67,"undercount"
"9448",45089,"South Carolina","Williamsburg County","NHPI_AIC",29,27,-2,-7.14,"undercount"
"9449",45091,"South Carolina","York County","A_A",8866,8822,-44,-0.5,"undercount"
"9450",45091,"South Carolina","York County","A_AIC",10304,10752,448,4.26,"overcount"
"9451",45091,"South Carolina","York County","NHPI_A",251,111,-140,-77.35,"undercount"
"9452",45091,"South Carolina","York County","NHPI_AIC",467,338,-129,-32.05,"undercount"
"9453",46003,"South Dakota","Aurora County","A_A",21,13,-8,-47.06,"undercount"
"9454",46003,"South Dakota","Aurora County","A_AIC",27,17,-10,-45.45,"undercount"
"9455",46003,"South Dakota","Aurora County","NHPI_A",0,0,0,0,"equal"
"9456",46003,"South Dakota","Aurora County","NHPI_AIC",1,6,5,142.86,"overcount"
"9457",46005,"South Dakota","Beadle County","A_A",1970,2068,98,4.85,"overcount"
"9458",46005,"South Dakota","Beadle County","A_AIC",2005,2134,129,6.23,"overcount"
"9459",46005,"South Dakota","Beadle County","NHPI_A",80,57,-23,-33.58,"undercount"
"9460",46005,"South Dakota","Beadle County","NHPI_AIC",91,77,-14,-16.67,"undercount"
"9461",46007,"South Dakota","Bennett County","A_A",18,7,-11,-88,"undercount"
"9462",46007,"South Dakota","Bennett County","A_AIC",31,7,-24,-126.32,"undercount"
"9463",46007,"South Dakota","Bennett County","NHPI_A",2,0,-2,-200,"undercount"
"9464",46007,"South Dakota","Bennett County","NHPI_AIC",3,3,0,0,"equal"
"9465",46009,"South Dakota","Bon Homme County","A_A",25,11,-14,-77.78,"undercount"
"9466",46009,"South Dakota","Bon Homme County","A_AIC",38,23,-15,-49.18,"undercount"
"9467",46009,"South Dakota","Bon Homme County","NHPI_A",3,5,2,50,"overcount"
"9468",46009,"South Dakota","Bon Homme County","NHPI_AIC",7,12,5,52.63,"overcount"
"9469",46011,"South Dakota","Brookings County","A_A",1062,927,-135,-13.57,"undercount"
"9470",46011,"South Dakota","Brookings County","A_AIC",1277,1131,-146,-12.13,"undercount"
"9471",46011,"South Dakota","Brookings County","NHPI_A",30,13,-17,-79.07,"undercount"
"9472",46011,"South Dakota","Brookings County","NHPI_AIC",57,25,-32,-78.05,"undercount"
"9473",46013,"South Dakota","Brown County","A_A",1377,919,-458,-39.9,"undercount"
"9474",46013,"South Dakota","Brown County","A_AIC",1531,1067,-464,-35.72,"undercount"
"9475",46013,"South Dakota","Brown County","NHPI_A",103,44,-59,-80.27,"undercount"
"9476",46013,"South Dakota","Brown County","NHPI_AIC",143,56,-87,-87.44,"undercount"
"9477",46015,"South Dakota","Brule County","A_A",24,26,2,8,"overcount"
"9478",46015,"South Dakota","Brule County","A_AIC",45,42,-3,-6.9,"undercount"
"9479",46015,"South Dakota","Brule County","NHPI_A",2,5,3,85.71,"overcount"
"9480",46015,"South Dakota","Brule County","NHPI_AIC",7,7,0,0,"equal"
"9481",46017,"South Dakota","Buffalo County","A_A",2,1,-1,-66.67,"undercount"
"9482",46017,"South Dakota","Buffalo County","A_AIC",14,2,-12,-150,"undercount"
"9483",46017,"South Dakota","Buffalo County","NHPI_A",2,0,-2,-200,"undercount"
"9484",46017,"South Dakota","Buffalo County","NHPI_AIC",2,0,-2,-200,"undercount"
"9485",46019,"South Dakota","Butte County","A_A",50,30,-20,-50,"undercount"
"9486",46019,"South Dakota","Butte County","A_AIC",88,55,-33,-46.15,"undercount"
"9487",46019,"South Dakota","Butte County","NHPI_A",16,5,-11,-104.76,"undercount"
"9488",46019,"South Dakota","Butte County","NHPI_AIC",25,16,-9,-43.9,"undercount"
"9489",46021,"South Dakota","Campbell County","A_A",7,6,-1,-15.38,"undercount"
"9490",46021,"South Dakota","Campbell County","A_AIC",8,13,5,47.62,"overcount"
"9491",46021,"South Dakota","Campbell County","NHPI_A",0,0,0,0,"equal"
"9492",46021,"South Dakota","Campbell County","NHPI_AIC",0,1,1,200,"overcount"
"9493",46023,"South Dakota","Charles Mix County","A_A",23,32,9,32.73,"overcount"
"9494",46023,"South Dakota","Charles Mix County","A_AIC",75,46,-29,-47.93,"undercount"
"9495",46023,"South Dakota","Charles Mix County","NHPI_A",1,14,13,173.33,"overcount"
"9496",46023,"South Dakota","Charles Mix County","NHPI_AIC",13,28,15,73.17,"overcount"
"9497",46025,"South Dakota","Clark County","A_A",10,2,-8,-133.33,"undercount"
"9498",46025,"South Dakota","Clark County","A_AIC",14,6,-8,-80,"undercount"
"9499",46025,"South Dakota","Clark County","NHPI_A",0,2,2,200,"overcount"
"9500",46025,"South Dakota","Clark County","NHPI_AIC",0,7,7,200,"overcount"
"9501",46027,"South Dakota","Clay County","A_A",365,361,-4,-1.1,"undercount"
"9502",46027,"South Dakota","Clay County","A_AIC",445,456,11,2.44,"overcount"
"9503",46027,"South Dakota","Clay County","NHPI_A",12,4,-8,-100,"undercount"
"9504",46027,"South Dakota","Clay County","NHPI_AIC",28,11,-17,-87.18,"undercount"
"9505",46029,"South Dakota","Codington County","A_A",215,197,-18,-8.74,"undercount"
"9506",46029,"South Dakota","Codington County","A_AIC",342,318,-24,-7.27,"undercount"
"9507",46029,"South Dakota","Codington County","NHPI_A",3,3,0,0,"equal"
"9508",46029,"South Dakota","Codington County","NHPI_AIC",24,15,-9,-46.15,"undercount"
"9509",46031,"South Dakota","Corson County","A_A",18,21,3,15.38,"overcount"
"9510",46031,"South Dakota","Corson County","A_AIC",39,28,-11,-32.84,"undercount"
"9511",46031,"South Dakota","Corson County","NHPI_A",2,0,-2,-200,"undercount"
"9512",46031,"South Dakota","Corson County","NHPI_AIC",6,5,-1,-18.18,"undercount"
"9513",46033,"South Dakota","Custer County","A_A",73,25,-48,-97.96,"undercount"
"9514",46033,"South Dakota","Custer County","A_AIC",95,48,-47,-65.73,"undercount"
"9515",46033,"South Dakota","Custer County","NHPI_A",2,0,-2,-200,"undercount"
"9516",46033,"South Dakota","Custer County","NHPI_AIC",5,6,1,18.18,"overcount"
"9517",46035,"South Dakota","Davison County","A_A",164,117,-47,-33.45,"undercount"
"9518",46035,"South Dakota","Davison County","A_AIC",250,190,-60,-27.27,"undercount"
"9519",46035,"South Dakota","Davison County","NHPI_A",16,0,-16,-200,"undercount"
"9520",46035,"South Dakota","Davison County","NHPI_AIC",38,13,-25,-98.04,"undercount"
"9521",46037,"South Dakota","Day County","A_A",35,21,-14,-50,"undercount"
"9522",46037,"South Dakota","Day County","A_AIC",52,34,-18,-41.86,"undercount"
"9523",46037,"South Dakota","Day County","NHPI_A",0,4,4,200,"overcount"
"9524",46037,"South Dakota","Day County","NHPI_AIC",8,8,0,0,"equal"
"9525",46039,"South Dakota","Deuel County","A_A",7,2,-5,-111.11,"undercount"
"9526",46039,"South Dakota","Deuel County","A_AIC",15,12,-3,-22.22,"undercount"
"9527",46039,"South Dakota","Deuel County","NHPI_A",0,5,5,200,"overcount"
"9528",46039,"South Dakota","Deuel County","NHPI_AIC",7,6,-1,-15.38,"undercount"
"9529",46041,"South Dakota","Dewey County","A_A",15,6,-9,-85.71,"undercount"
"9530",46041,"South Dakota","Dewey County","A_AIC",39,15,-24,-88.89,"undercount"
"9531",46041,"South Dakota","Dewey County","NHPI_A",1,0,-1,-200,"undercount"
"9532",46041,"South Dakota","Dewey County","NHPI_AIC",10,5,-5,-66.67,"undercount"
"9533",46043,"South Dakota","Douglas County","A_A",4,3,-1,-28.57,"undercount"
"9534",46043,"South Dakota","Douglas County","A_AIC",9,9,0,0,"equal"
"9535",46043,"South Dakota","Douglas County","NHPI_A",0,1,1,200,"overcount"
"9536",46043,"South Dakota","Douglas County","NHPI_AIC",3,11,8,114.29,"overcount"
"9537",46045,"South Dakota","Edmunds County","A_A",21,23,2,9.09,"overcount"
"9538",46045,"South Dakota","Edmunds County","A_AIC",28,36,8,25,"overcount"
"9539",46045,"South Dakota","Edmunds County","NHPI_A",0,0,0,0,"equal"
"9540",46045,"South Dakota","Edmunds County","NHPI_AIC",1,2,1,66.67,"overcount"
"9541",46047,"South Dakota","Fall River County","A_A",115,49,-66,-80.49,"undercount"
"9542",46047,"South Dakota","Fall River County","A_AIC",142,70,-72,-67.92,"undercount"
"9543",46047,"South Dakota","Fall River County","NHPI_A",4,11,7,93.33,"overcount"
"9544",46047,"South Dakota","Fall River County","NHPI_AIC",11,26,15,81.08,"overcount"
"9545",46049,"South Dakota","Faulk County","A_A",10,3,-7,-107.69,"undercount"
"9546",46049,"South Dakota","Faulk County","A_AIC",14,7,-7,-66.67,"undercount"
"9547",46049,"South Dakota","Faulk County","NHPI_A",0,0,0,0,"equal"
"9548",46049,"South Dakota","Faulk County","NHPI_AIC",0,0,0,0,"equal"
"9549",46051,"South Dakota","Grant County","A_A",26,22,-4,-16.67,"undercount"
"9550",46051,"South Dakota","Grant County","A_AIC",51,51,0,0,"equal"
"9551",46051,"South Dakota","Grant County","NHPI_A",6,3,-3,-66.67,"undercount"
"9552",46051,"South Dakota","Grant County","NHPI_AIC",6,5,-1,-18.18,"undercount"
"9553",46053,"South Dakota","Gregory County","A_A",22,21,-1,-4.65,"undercount"
"9554",46053,"South Dakota","Gregory County","A_AIC",38,52,14,31.11,"overcount"
"9555",46053,"South Dakota","Gregory County","NHPI_A",4,4,0,0,"equal"
"9556",46053,"South Dakota","Gregory County","NHPI_AIC",5,7,2,33.33,"overcount"
"9557",46055,"South Dakota","Haakon County","A_A",8,17,9,72,"overcount"
"9558",46055,"South Dakota","Haakon County","A_AIC",21,21,0,0,"equal"
"9559",46055,"South Dakota","Haakon County","NHPI_A",2,2,0,0,"equal"
"9560",46055,"South Dakota","Haakon County","NHPI_AIC",8,6,-2,-28.57,"undercount"
"9561",46057,"South Dakota","Hamlin County","A_A",23,14,-9,-48.65,"undercount"
"9562",46057,"South Dakota","Hamlin County","A_AIC",42,26,-16,-47.06,"undercount"
"9563",46057,"South Dakota","Hamlin County","NHPI_A",1,6,5,142.86,"overcount"
"9564",46057,"South Dakota","Hamlin County","NHPI_AIC",4,9,5,76.92,"overcount"
"9565",46059,"South Dakota","Hand County","A_A",13,7,-6,-60,"undercount"
"9566",46059,"South Dakota","Hand County","A_AIC",21,20,-1,-4.88,"undercount"
"9567",46059,"South Dakota","Hand County","NHPI_A",1,0,-1,-200,"undercount"
"9568",46059,"South Dakota","Hand County","NHPI_AIC",2,3,1,40,"overcount"
"9569",46061,"South Dakota","Hanson County","A_A",13,0,-13,-200,"undercount"
"9570",46061,"South Dakota","Hanson County","A_AIC",30,14,-16,-72.73,"undercount"
"9571",46061,"South Dakota","Hanson County","NHPI_A",2,0,-2,-200,"undercount"
"9572",46061,"South Dakota","Hanson County","NHPI_AIC",3,3,0,0,"equal"
"9573",46063,"South Dakota","Harding County","A_A",7,0,-7,-200,"undercount"
"9574",46063,"South Dakota","Harding County","A_AIC",9,1,-8,-160,"undercount"
"9575",46063,"South Dakota","Harding County","NHPI_A",0,0,0,0,"equal"
"9576",46063,"South Dakota","Harding County","NHPI_AIC",0,0,0,0,"equal"
"9577",46065,"South Dakota","Hughes County","A_A",138,128,-10,-7.52,"undercount"
"9578",46065,"South Dakota","Hughes County","A_AIC",211,202,-9,-4.36,"undercount"
"9579",46065,"South Dakota","Hughes County","NHPI_A",6,4,-2,-40,"undercount"
"9580",46065,"South Dakota","Hughes County","NHPI_AIC",19,13,-6,-37.5,"undercount"
"9581",46067,"South Dakota","Hutchinson County","A_A",26,21,-5,-21.28,"undercount"
"9582",46067,"South Dakota","Hutchinson County","A_AIC",34,31,-3,-9.23,"undercount"
"9583",46067,"South Dakota","Hutchinson County","NHPI_A",2,0,-2,-200,"undercount"
"9584",46067,"South Dakota","Hutchinson County","NHPI_AIC",5,12,7,82.35,"overcount"
"9585",46069,"South Dakota","Hyde County","A_A",3,5,2,50,"overcount"
"9586",46069,"South Dakota","Hyde County","A_AIC",7,16,9,78.26,"overcount"
"9587",46069,"South Dakota","Hyde County","NHPI_A",1,1,0,0,"equal"
"9588",46069,"South Dakota","Hyde County","NHPI_AIC",2,1,-1,-66.67,"undercount"
"9589",46071,"South Dakota","Jackson County","A_A",8,8,0,0,"equal"
"9590",46071,"South Dakota","Jackson County","A_AIC",20,15,-5,-28.57,"undercount"
"9591",46071,"South Dakota","Jackson County","NHPI_A",1,3,2,100,"overcount"
"9592",46071,"South Dakota","Jackson County","NHPI_AIC",2,10,8,133.33,"overcount"
"9593",46073,"South Dakota","Jerauld County","A_A",5,3,-2,-50,"undercount"
"9594",46073,"South Dakota","Jerauld County","A_AIC",7,5,-2,-33.33,"undercount"
"9595",46073,"South Dakota","Jerauld County","NHPI_A",3,0,-3,-200,"undercount"
"9596",46073,"South Dakota","Jerauld County","NHPI_AIC",3,6,3,66.67,"overcount"
"9597",46075,"South Dakota","Jones County","A_A",0,0,0,0,"equal"
"9598",46075,"South Dakota","Jones County","A_AIC",4,3,-1,-28.57,"undercount"
"9599",46075,"South Dakota","Jones County","NHPI_A",2,0,-2,-200,"undercount"
"9600",46075,"South Dakota","Jones County","NHPI_AIC",2,8,6,120,"overcount"
"9601",46077,"South Dakota","Kingsbury County","A_A",32,13,-19,-84.44,"undercount"
"9602",46077,"South Dakota","Kingsbury County","A_AIC",41,34,-7,-18.67,"undercount"
"9603",46077,"South Dakota","Kingsbury County","NHPI_A",1,7,6,150,"overcount"
"9604",46077,"South Dakota","Kingsbury County","NHPI_AIC",2,13,11,146.67,"overcount"
"9605",46079,"South Dakota","Lake County","A_A",113,66,-47,-52.51,"undercount"
"9606",46079,"South Dakota","Lake County","A_AIC",148,118,-30,-22.56,"undercount"
"9607",46079,"South Dakota","Lake County","NHPI_A",17,11,-6,-42.86,"undercount"
"9608",46079,"South Dakota","Lake County","NHPI_AIC",26,14,-12,-60,"undercount"
"9609",46081,"South Dakota","Lawrence County","A_A",386,197,-189,-64.84,"undercount"
"9610",46081,"South Dakota","Lawrence County","A_AIC",492,302,-190,-47.86,"undercount"
"9611",46081,"South Dakota","Lawrence County","NHPI_A",20,18,-2,-10.53,"undercount"
"9612",46081,"South Dakota","Lawrence County","NHPI_AIC",39,25,-14,-43.75,"undercount"
"9613",46083,"South Dakota","Lincoln County","A_A",974,996,22,2.23,"overcount"
"9614",46083,"South Dakota","Lincoln County","A_AIC",1272,1468,196,14.31,"overcount"
"9615",46083,"South Dakota","Lincoln County","NHPI_A",43,9,-34,-130.77,"undercount"
"9616",46083,"South Dakota","Lincoln County","NHPI_AIC",99,60,-39,-49.06,"undercount"
"9617",46085,"South Dakota","Lyman County","A_A",15,4,-11,-115.79,"undercount"
"9618",46085,"South Dakota","Lyman County","A_AIC",34,14,-20,-83.33,"undercount"
"9619",46085,"South Dakota","Lyman County","NHPI_A",2,0,-2,-200,"undercount"
"9620",46085,"South Dakota","Lyman County","NHPI_AIC",5,3,-2,-50,"undercount"
"9621",46087,"South Dakota","McCook County","A_A",15,6,-9,-85.71,"undercount"
"9622",46087,"South Dakota","McCook County","A_AIC",32,22,-10,-37.04,"undercount"
"9623",46087,"South Dakota","McCook County","NHPI_A",6,0,-6,-200,"undercount"
"9624",46087,"South Dakota","McCook County","NHPI_AIC",10,4,-6,-85.71,"undercount"
"9625",46089,"South Dakota","McPherson County","A_A",9,3,-6,-100,"undercount"
"9626",46089,"South Dakota","McPherson County","A_AIC",12,8,-4,-40,"undercount"
"9627",46089,"South Dakota","McPherson County","NHPI_A",2,3,1,40,"overcount"
"9628",46089,"South Dakota","McPherson County","NHPI_AIC",2,11,9,138.46,"overcount"
"9629",46091,"South Dakota","Marshall County","A_A",14,12,-2,-15.38,"undercount"
"9630",46091,"South Dakota","Marshall County","A_AIC",22,27,5,20.41,"overcount"
"9631",46091,"South Dakota","Marshall County","NHPI_A",0,1,1,200,"overcount"
"9632",46091,"South Dakota","Marshall County","NHPI_AIC",1,5,4,133.33,"overcount"
"9633",46093,"South Dakota","Meade County","A_A",377,275,-102,-31.29,"undercount"
"9634",46093,"South Dakota","Meade County","A_AIC",570,555,-15,-2.67,"undercount"
"9635",46093,"South Dakota","Meade County","NHPI_A",28,49,21,54.55,"overcount"
"9636",46093,"South Dakota","Meade County","NHPI_AIC",69,113,44,48.35,"overcount"
"9637",46095,"South Dakota","Mellette County","A_A",6,3,-3,-66.67,"undercount"
"9638",46095,"South Dakota","Mellette County","A_AIC",17,4,-13,-123.81,"undercount"
"9639",46095,"South Dakota","Mellette County","NHPI_A",0,0,0,0,"equal"
"9640",46095,"South Dakota","Mellette County","NHPI_AIC",0,0,0,0,"equal"
"9641",46097,"South Dakota","Miner County","A_A",12,6,-6,-66.67,"undercount"
"9642",46097,"South Dakota","Miner County","A_AIC",15,10,-5,-40,"undercount"
"9643",46097,"South Dakota","Miner County","NHPI_A",0,0,0,0,"equal"
"9644",46097,"South Dakota","Miner County","NHPI_AIC",2,3,1,40,"overcount"
"9645",46099,"South Dakota","Minnehaha County","A_A",4415,4597,182,4.04,"overcount"
"9646",46099,"South Dakota","Minnehaha County","A_AIC",5568,5841,273,4.79,"overcount"
"9647",46099,"South Dakota","Minnehaha County","NHPI_A",248,71,-177,-110.97,"undercount"
"9648",46099,"South Dakota","Minnehaha County","NHPI_AIC",453,281,-172,-46.87,"undercount"
"9649",46101,"South Dakota","Moody County","A_A",131,88,-43,-39.27,"undercount"
"9650",46101,"South Dakota","Moody County","A_AIC",163,108,-55,-40.59,"undercount"
"9651",46101,"South Dakota","Moody County","NHPI_A",0,0,0,0,"equal"
"9652",46101,"South Dakota","Moody County","NHPI_AIC",4,6,2,40,"overcount"
"9653",46102,"South Dakota","Oglala Lakota County","A_A",19,39,20,68.97,"overcount"
"9654",46102,"South Dakota","Oglala Lakota County","A_AIC",54,58,4,7.14,"overcount"
"9655",46102,"South Dakota","Oglala Lakota County","NHPI_A",4,0,-4,-200,"undercount"
"9656",46102,"South Dakota","Oglala Lakota County","NHPI_AIC",12,6,-6,-66.67,"undercount"
"9657",46103,"South Dakota","Pennington County","A_A",1532,1551,19,1.23,"overcount"
"9658",46103,"South Dakota","Pennington County","A_AIC",2454,2469,15,0.61,"overcount"
"9659",46103,"South Dakota","Pennington County","NHPI_A",131,82,-49,-46.01,"undercount"
"9660",46103,"South Dakota","Pennington County","NHPI_AIC",312,295,-17,-5.6,"undercount"
"9661",46105,"South Dakota","Perkins County","A_A",12,5,-7,-82.35,"undercount"
"9662",46105,"South Dakota","Perkins County","A_AIC",21,6,-15,-111.11,"undercount"
"9663",46105,"South Dakota","Perkins County","NHPI_A",2,4,2,66.67,"overcount"
"9664",46105,"South Dakota","Perkins County","NHPI_AIC",2,6,4,100,"overcount"
"9665",46107,"South Dakota","Potter County","A_A",23,14,-9,-48.65,"undercount"
"9666",46107,"South Dakota","Potter County","A_AIC",33,18,-15,-58.82,"undercount"
"9667",46107,"South Dakota","Potter County","NHPI_A",1,0,-1,-200,"undercount"
"9668",46107,"South Dakota","Potter County","NHPI_AIC",3,3,0,0,"equal"
"9669",46109,"South Dakota","Roberts County","A_A",36,27,-9,-28.57,"undercount"
"9670",46109,"South Dakota","Roberts County","A_AIC",80,53,-27,-40.6,"undercount"
"9671",46109,"South Dakota","Roberts County","NHPI_A",1,0,-1,-200,"undercount"
"9672",46109,"South Dakota","Roberts County","NHPI_AIC",18,1,-17,-178.95,"undercount"
"9673",46111,"South Dakota","Sanborn County","A_A",5,9,4,57.14,"overcount"
"9674",46111,"South Dakota","Sanborn County","A_AIC",13,13,0,0,"equal"
"9675",46111,"South Dakota","Sanborn County","NHPI_A",1,0,-1,-200,"undercount"
"9676",46111,"South Dakota","Sanborn County","NHPI_AIC",1,1,0,0,"equal"
"9677",46115,"South Dakota","Spink County","A_A",10,2,-8,-133.33,"undercount"
"9678",46115,"South Dakota","Spink County","A_AIC",19,14,-5,-30.3,"undercount"
"9679",46115,"South Dakota","Spink County","NHPI_A",2,0,-2,-200,"undercount"
"9680",46115,"South Dakota","Spink County","NHPI_AIC",4,3,-1,-28.57,"undercount"
"9681",46117,"South Dakota","Stanley County","A_A",8,5,-3,-46.15,"undercount"
"9682",46117,"South Dakota","Stanley County","A_AIC",15,11,-4,-30.77,"undercount"
"9683",46117,"South Dakota","Stanley County","NHPI_A",0,9,9,200,"overcount"
"9684",46117,"South Dakota","Stanley County","NHPI_AIC",2,15,13,152.94,"overcount"
"9685",46119,"South Dakota","Sully County","A_A",3,6,3,66.67,"overcount"
"9686",46119,"South Dakota","Sully County","A_AIC",6,10,4,50,"overcount"
"9687",46119,"South Dakota","Sully County","NHPI_A",0,0,0,0,"equal"
"9688",46119,"South Dakota","Sully County","NHPI_AIC",0,8,8,200,"overcount"
"9689",46121,"South Dakota","Todd County","A_A",341,45,-296,-153.37,"undercount"
"9690",46121,"South Dakota","Todd County","A_AIC",361,61,-300,-142.18,"undercount"
"9691",46121,"South Dakota","Todd County","NHPI_A",0,0,0,0,"equal"
"9692",46121,"South Dakota","Todd County","NHPI_AIC",8,2,-6,-120,"undercount"
"9693",46123,"South Dakota","Tripp County","A_A",21,5,-16,-123.08,"undercount"
"9694",46123,"South Dakota","Tripp County","A_AIC",29,13,-16,-76.19,"undercount"
"9695",46123,"South Dakota","Tripp County","NHPI_A",0,0,0,0,"equal"
"9696",46123,"South Dakota","Tripp County","NHPI_AIC",3,2,-1,-40,"undercount"
"9697",46125,"South Dakota","Turner County","A_A",21,15,-6,-33.33,"undercount"
"9698",46125,"South Dakota","Turner County","A_AIC",38,34,-4,-11.11,"undercount"
"9699",46125,"South Dakota","Turner County","NHPI_A",3,2,-1,-40,"undercount"
"9700",46125,"South Dakota","Turner County","NHPI_AIC",6,10,4,50,"overcount"
"9701",46127,"South Dakota","Union County","A_A",254,257,3,1.17,"overcount"
"9702",46127,"South Dakota","Union County","A_AIC",319,337,18,5.49,"overcount"
"9703",46127,"South Dakota","Union County","NHPI_A",24,27,3,11.76,"overcount"
"9704",46127,"South Dakota","Union County","NHPI_AIC",35,31,-4,-12.12,"undercount"
"9705",46129,"South Dakota","Walworth County","A_A",95,11,-84,-158.49,"undercount"
"9706",46129,"South Dakota","Walworth County","A_AIC",107,20,-87,-137.01,"undercount"
"9707",46129,"South Dakota","Walworth County","NHPI_A",1,0,-1,-200,"undercount"
"9708",46129,"South Dakota","Walworth County","NHPI_AIC",3,5,2,50,"overcount"
"9709",46135,"South Dakota","Yankton County","A_A",163,130,-33,-22.53,"undercount"
"9710",46135,"South Dakota","Yankton County","A_AIC",226,189,-37,-17.83,"undercount"
"9711",46135,"South Dakota","Yankton County","NHPI_A",14,9,-5,-43.48,"undercount"
"9712",46135,"South Dakota","Yankton County","NHPI_AIC",29,19,-10,-41.67,"undercount"
"9713",46137,"South Dakota","Ziebach County","A_A",6,3,-3,-66.67,"undercount"
"9714",46137,"South Dakota","Ziebach County","A_AIC",12,7,-5,-52.63,"undercount"
"9715",46137,"South Dakota","Ziebach County","NHPI_A",1,3,2,100,"overcount"
"9716",46137,"South Dakota","Ziebach County","NHPI_AIC",2,5,3,85.71,"overcount"
"9717",47001,"Tennessee","Anderson County","A_A",1086,993,-93,-8.95,"undercount"
"9718",47001,"Tennessee","Anderson County","A_AIC",1395,1404,9,0.64,"overcount"
"9719",47001,"Tennessee","Anderson County","NHPI_A",75,53,-22,-34.38,"undercount"
"9720",47001,"Tennessee","Anderson County","NHPI_AIC",119,91,-28,-26.67,"undercount"
"9721",47003,"Tennessee","Bedford County","A_A",544,344,-200,-45.05,"undercount"
"9722",47003,"Tennessee","Bedford County","A_AIC",684,487,-197,-33.65,"undercount"
"9723",47003,"Tennessee","Bedford County","NHPI_A",93,13,-80,-150.94,"undercount"
"9724",47003,"Tennessee","Bedford County","NHPI_AIC",119,49,-70,-83.33,"undercount"
"9725",47005,"Tennessee","Benton County","A_A",99,107,8,7.77,"overcount"
"9726",47005,"Tennessee","Benton County","A_AIC",136,150,14,9.79,"overcount"
"9727",47005,"Tennessee","Benton County","NHPI_A",3,4,1,28.57,"overcount"
"9728",47005,"Tennessee","Benton County","NHPI_AIC",9,18,9,66.67,"overcount"
"9729",47007,"Tennessee","Bledsoe County","A_A",43,37,-6,-15,"undercount"
"9730",47007,"Tennessee","Bledsoe County","A_AIC",65,65,0,0,"equal"
"9731",47007,"Tennessee","Bledsoe County","NHPI_A",5,0,-5,-200,"undercount"
"9732",47007,"Tennessee","Bledsoe County","NHPI_AIC",11,8,-3,-31.58,"undercount"
"9733",47009,"Tennessee","Blount County","A_A",1271,1295,24,1.87,"overcount"
"9734",47009,"Tennessee","Blount County","A_AIC",1736,1900,164,9.02,"overcount"
"9735",47009,"Tennessee","Blount County","NHPI_A",156,23,-133,-148.6,"undercount"
"9736",47009,"Tennessee","Blount County","NHPI_AIC",233,99,-134,-80.72,"undercount"
"9737",47011,"Tennessee","Bradley County","A_A",1393,1210,-183,-14.06,"undercount"
"9738",47011,"Tennessee","Bradley County","A_AIC",1770,1699,-71,-4.09,"undercount"
"9739",47011,"Tennessee","Bradley County","NHPI_A",157,117,-40,-29.2,"undercount"
"9740",47011,"Tennessee","Bradley County","NHPI_AIC",229,200,-29,-13.52,"undercount"
"9741",47013,"Tennessee","Campbell County","A_A",151,97,-54,-43.55,"undercount"
"9742",47013,"Tennessee","Campbell County","A_AIC",208,171,-37,-19.53,"undercount"
"9743",47013,"Tennessee","Campbell County","NHPI_A",30,1,-29,-187.1,"undercount"
"9744",47013,"Tennessee","Campbell County","NHPI_AIC",42,19,-23,-75.41,"undercount"
"9745",47015,"Tennessee","Cannon County","A_A",56,39,-17,-35.79,"undercount"
"9746",47015,"Tennessee","Cannon County","A_AIC",81,93,12,13.79,"overcount"
"9747",47015,"Tennessee","Cannon County","NHPI_A",14,4,-10,-111.11,"undercount"
"9748",47015,"Tennessee","Cannon County","NHPI_AIC",21,13,-8,-47.06,"undercount"
"9749",47017,"Tennessee","Carroll County","A_A",134,124,-10,-7.75,"undercount"
"9750",47017,"Tennessee","Carroll County","A_AIC",190,189,-1,-0.53,"undercount"
"9751",47017,"Tennessee","Carroll County","NHPI_A",18,5,-13,-113.04,"undercount"
"9752",47017,"Tennessee","Carroll County","NHPI_AIC",27,37,10,31.25,"overcount"
"9753",47019,"Tennessee","Carter County","A_A",229,243,14,5.93,"overcount"
"9754",47019,"Tennessee","Carter County","A_AIC",350,397,47,12.58,"overcount"
"9755",47019,"Tennessee","Carter County","NHPI_A",20,9,-11,-75.86,"undercount"
"9756",47019,"Tennessee","Carter County","NHPI_AIC",46,38,-8,-19.05,"undercount"
"9757",47021,"Tennessee","Cheatham County","A_A",188,193,5,2.62,"overcount"
"9758",47021,"Tennessee","Cheatham County","A_AIC",353,353,0,0,"equal"
"9759",47021,"Tennessee","Cheatham County","NHPI_A",25,25,0,0,"equal"
"9760",47021,"Tennessee","Cheatham County","NHPI_AIC",55,59,4,7.02,"overcount"
"9761",47023,"Tennessee","Chester County","A_A",118,70,-48,-51.06,"undercount"
"9762",47023,"Tennessee","Chester County","A_AIC",169,126,-43,-29.15,"undercount"
"9763",47023,"Tennessee","Chester County","NHPI_A",3,1,-2,-100,"undercount"
"9764",47023,"Tennessee","Chester County","NHPI_AIC",12,13,1,8,"overcount"
"9765",47025,"Tennessee","Claiborne County","A_A",276,149,-127,-59.76,"undercount"
"9766",47025,"Tennessee","Claiborne County","A_AIC",339,226,-113,-40,"undercount"
"9767",47025,"Tennessee","Claiborne County","NHPI_A",7,11,4,44.44,"overcount"
"9768",47025,"Tennessee","Claiborne County","NHPI_AIC",27,20,-7,-29.79,"undercount"
"9769",47027,"Tennessee","Clay County","A_A",8,5,-3,-46.15,"undercount"
"9770",47027,"Tennessee","Clay County","A_AIC",21,22,1,4.65,"overcount"
"9771",47027,"Tennessee","Clay County","NHPI_A",9,1,-8,-160,"undercount"
"9772",47027,"Tennessee","Clay County","NHPI_AIC",10,12,2,18.18,"overcount"
"9773",47029,"Tennessee","Cocke County","A_A",173,150,-23,-14.24,"undercount"
"9774",47029,"Tennessee","Cocke County","A_AIC",240,239,-1,-0.42,"undercount"
"9775",47029,"Tennessee","Cocke County","NHPI_A",25,10,-15,-85.71,"undercount"
"9776",47029,"Tennessee","Cocke County","NHPI_AIC",43,24,-19,-56.72,"undercount"
"9777",47031,"Tennessee","Coffee County","A_A",652,611,-41,-6.49,"undercount"
"9778",47031,"Tennessee","Coffee County","A_AIC",856,821,-35,-4.17,"undercount"
"9779",47031,"Tennessee","Coffee County","NHPI_A",62,37,-25,-50.51,"undercount"
"9780",47031,"Tennessee","Coffee County","NHPI_AIC",108,64,-44,-51.16,"undercount"
"9781",47033,"Tennessee","Crockett County","A_A",54,51,-3,-5.71,"undercount"
"9782",47033,"Tennessee","Crockett County","A_AIC",94,72,-22,-26.51,"undercount"
"9783",47033,"Tennessee","Crockett County","NHPI_A",4,1,-3,-120,"undercount"
"9784",47033,"Tennessee","Crockett County","NHPI_AIC",16,9,-7,-56,"undercount"
"9785",47035,"Tennessee","Cumberland County","A_A",399,366,-33,-8.63,"undercount"
"9786",47035,"Tennessee","Cumberland County","A_AIC",506,528,22,4.26,"overcount"
"9787",47035,"Tennessee","Cumberland County","NHPI_A",69,14,-55,-132.53,"undercount"
"9788",47035,"Tennessee","Cumberland County","NHPI_AIC",88,42,-46,-70.77,"undercount"
"9789",47037,"Tennessee","Davidson County","A_A",27183,27905,722,2.62,"overcount"
"9790",47037,"Tennessee","Davidson County","A_AIC",33210,34637,1427,4.21,"overcount"
"9791",47037,"Tennessee","Davidson County","NHPI_A",769,303,-466,-86.94,"undercount"
"9792",47037,"Tennessee","Davidson County","NHPI_AIC",1633,1011,-622,-47.05,"undercount"
"9793",47039,"Tennessee","Decatur County","A_A",74,42,-32,-55.17,"undercount"
"9794",47039,"Tennessee","Decatur County","A_AIC",102,46,-56,-75.68,"undercount"
"9795",47039,"Tennessee","Decatur County","NHPI_A",11,5,-6,-75,"undercount"
"9796",47039,"Tennessee","Decatur County","NHPI_AIC",16,11,-5,-37.04,"undercount"
"9797",47041,"Tennessee","DeKalb County","A_A",218,76,-142,-96.6,"undercount"
"9798",47041,"Tennessee","DeKalb County","A_AIC",251,134,-117,-60.78,"undercount"
"9799",47041,"Tennessee","DeKalb County","NHPI_A",6,6,0,0,"equal"
"9800",47041,"Tennessee","DeKalb County","NHPI_AIC",18,24,6,28.57,"overcount"
"9801",47043,"Tennessee","Dickson County","A_A",372,320,-52,-15.03,"undercount"
"9802",47043,"Tennessee","Dickson County","A_AIC",503,469,-34,-7,"undercount"
"9803",47043,"Tennessee","Dickson County","NHPI_A",34,6,-28,-140,"undercount"
"9804",47043,"Tennessee","Dickson County","NHPI_AIC",65,20,-45,-105.88,"undercount"
"9805",47045,"Tennessee","Dyer County","A_A",258,213,-45,-19.11,"undercount"
"9806",47045,"Tennessee","Dyer County","A_AIC",318,278,-40,-13.42,"undercount"
"9807",47045,"Tennessee","Dyer County","NHPI_A",12,11,-1,-8.7,"undercount"
"9808",47045,"Tennessee","Dyer County","NHPI_AIC",40,41,1,2.47,"overcount"
"9809",47047,"Tennessee","Fayette County","A_A",327,269,-58,-19.46,"undercount"
"9810",47047,"Tennessee","Fayette County","A_AIC",436,405,-31,-7.37,"undercount"
"9811",47047,"Tennessee","Fayette County","NHPI_A",19,18,-1,-5.41,"undercount"
"9812",47047,"Tennessee","Fayette County","NHPI_AIC",45,55,10,20,"overcount"
"9813",47049,"Tennessee","Fentress County","A_A",102,33,-69,-102.22,"undercount"
"9814",47049,"Tennessee","Fentress County","A_AIC",130,74,-56,-54.9,"undercount"
"9815",47049,"Tennessee","Fentress County","NHPI_A",4,3,-1,-28.57,"undercount"
"9816",47049,"Tennessee","Fentress County","NHPI_AIC",15,11,-4,-30.77,"undercount"
"9817",47051,"Tennessee","Franklin County","A_A",400,352,-48,-12.77,"undercount"
"9818",47051,"Tennessee","Franklin County","A_AIC",519,501,-18,-3.53,"undercount"
"9819",47051,"Tennessee","Franklin County","NHPI_A",39,17,-22,-78.57,"undercount"
"9820",47051,"Tennessee","Franklin County","NHPI_AIC",68,44,-24,-42.86,"undercount"
"9821",47053,"Tennessee","Gibson County","A_A",194,200,6,3.05,"overcount"
"9822",47053,"Tennessee","Gibson County","A_AIC",288,317,29,9.59,"overcount"
"9823",47053,"Tennessee","Gibson County","NHPI_A",11,15,4,30.77,"overcount"
"9824",47053,"Tennessee","Gibson County","NHPI_AIC",45,44,-1,-2.25,"undercount"
"9825",47055,"Tennessee","Giles County","A_A",151,186,35,20.77,"overcount"
"9826",47055,"Tennessee","Giles County","A_AIC",220,271,51,20.77,"overcount"
"9827",47055,"Tennessee","Giles County","NHPI_A",19,9,-10,-71.43,"undercount"
"9828",47055,"Tennessee","Giles County","NHPI_AIC",46,18,-28,-87.5,"undercount"
"9829",47057,"Tennessee","Grainger County","A_A",65,53,-12,-20.34,"undercount"
"9830",47057,"Tennessee","Grainger County","A_AIC",93,97,4,4.21,"overcount"
"9831",47057,"Tennessee","Grainger County","NHPI_A",14,3,-11,-129.41,"undercount"
"9832",47057,"Tennessee","Grainger County","NHPI_AIC",23,19,-4,-19.05,"undercount"
"9833",47059,"Tennessee","Greene County","A_A",413,299,-114,-32.02,"undercount"
"9834",47059,"Tennessee","Greene County","A_AIC",521,520,-1,-0.19,"undercount"
"9835",47059,"Tennessee","Greene County","NHPI_A",56,16,-40,-111.11,"undercount"
"9836",47059,"Tennessee","Greene County","NHPI_AIC",101,75,-26,-29.55,"undercount"
"9837",47061,"Tennessee","Grundy County","A_A",67,48,-19,-33.04,"undercount"
"9838",47061,"Tennessee","Grundy County","A_AIC",88,79,-9,-10.78,"undercount"
"9839",47061,"Tennessee","Grundy County","NHPI_A",1,0,-1,-200,"undercount"
"9840",47061,"Tennessee","Grundy County","NHPI_AIC",9,2,-7,-127.27,"undercount"
"9841",47063,"Tennessee","Hamblen County","A_A",704,718,14,1.97,"overcount"
"9842",47063,"Tennessee","Hamblen County","A_AIC",904,907,3,0.33,"overcount"
"9843",47063,"Tennessee","Hamblen County","NHPI_A",215,268,53,21.95,"overcount"
"9844",47063,"Tennessee","Hamblen County","NHPI_AIC",284,305,21,7.13,"overcount"
"9845",47065,"Tennessee","Hamilton County","A_A",8123,8238,115,1.41,"overcount"
"9846",47065,"Tennessee","Hamilton County","A_AIC",9888,10457,569,5.59,"overcount"
"9847",47065,"Tennessee","Hamilton County","NHPI_A",558,138,-420,-120.69,"undercount"
"9848",47065,"Tennessee","Hamilton County","NHPI_AIC",914,429,-485,-72.23,"undercount"
"9849",47067,"Tennessee","Hancock County","A_A",16,1,-15,-176.47,"undercount"
"9850",47067,"Tennessee","Hancock County","A_AIC",27,6,-21,-127.27,"undercount"
"9851",47067,"Tennessee","Hancock County","NHPI_A",3,0,-3,-200,"undercount"
"9852",47067,"Tennessee","Hancock County","NHPI_AIC",5,7,2,33.33,"overcount"
"9853",47069,"Tennessee","Hardeman County","A_A",214,173,-41,-21.19,"undercount"
"9854",47069,"Tennessee","Hardeman County","A_AIC",263,200,-63,-27.21,"undercount"
"9855",47069,"Tennessee","Hardeman County","NHPI_A",6,6,0,0,"equal"
"9856",47069,"Tennessee","Hardeman County","NHPI_AIC",21,30,9,35.29,"overcount"
"9857",47071,"Tennessee","Hardin County","A_A",151,150,-1,-0.66,"undercount"
"9858",47071,"Tennessee","Hardin County","A_AIC",185,198,13,6.79,"overcount"
"9859",47071,"Tennessee","Hardin County","NHPI_A",12,0,-12,-200,"undercount"
"9860",47071,"Tennessee","Hardin County","NHPI_AIC",18,13,-5,-32.26,"undercount"
"9861",47073,"Tennessee","Hawkins County","A_A",321,277,-44,-14.72,"undercount"
"9862",47073,"Tennessee","Hawkins County","A_AIC",404,384,-20,-5.08,"undercount"
"9863",47073,"Tennessee","Hawkins County","NHPI_A",64,13,-51,-132.47,"undercount"
"9864",47073,"Tennessee","Hawkins County","NHPI_AIC",89,43,-46,-69.7,"undercount"
"9865",47075,"Tennessee","Haywood County","A_A",55,30,-25,-58.82,"undercount"
"9866",47075,"Tennessee","Haywood County","A_AIC",76,49,-27,-43.2,"undercount"
"9867",47075,"Tennessee","Haywood County","NHPI_A",14,8,-6,-54.55,"undercount"
"9868",47075,"Tennessee","Haywood County","NHPI_AIC",20,13,-7,-42.42,"undercount"
"9869",47077,"Tennessee","Henderson County","A_A",107,92,-15,-15.08,"undercount"
"9870",47077,"Tennessee","Henderson County","A_AIC",143,123,-20,-15.04,"undercount"
"9871",47077,"Tennessee","Henderson County","NHPI_A",5,2,-3,-85.71,"undercount"
"9872",47077,"Tennessee","Henderson County","NHPI_AIC",17,15,-2,-12.5,"undercount"
"9873",47079,"Tennessee","Henry County","A_A",198,202,4,2,"overcount"
"9874",47079,"Tennessee","Henry County","A_AIC",251,308,57,20.39,"overcount"
"9875",47079,"Tennessee","Henry County","NHPI_A",11,7,-4,-44.44,"undercount"
"9876",47079,"Tennessee","Henry County","NHPI_AIC",27,14,-13,-63.41,"undercount"
"9877",47081,"Tennessee","Hickman County","A_A",107,72,-35,-39.11,"undercount"
"9878",47081,"Tennessee","Hickman County","A_AIC",161,135,-26,-17.57,"undercount"
"9879",47081,"Tennessee","Hickman County","NHPI_A",8,1,-7,-155.56,"undercount"
"9880",47081,"Tennessee","Hickman County","NHPI_AIC",25,14,-11,-56.41,"undercount"
"9881",47083,"Tennessee","Houston County","A_A",42,17,-25,-84.75,"undercount"
"9882",47083,"Tennessee","Houston County","A_AIC",62,21,-41,-98.8,"undercount"
"9883",47083,"Tennessee","Houston County","NHPI_A",6,8,2,28.57,"overcount"
"9884",47083,"Tennessee","Houston County","NHPI_AIC",11,11,0,0,"equal"
"9885",47085,"Tennessee","Humphreys County","A_A",126,59,-67,-72.43,"undercount"
"9886",47085,"Tennessee","Humphreys County","A_AIC",164,121,-43,-30.18,"undercount"
"9887",47085,"Tennessee","Humphreys County","NHPI_A",8,0,-8,-200,"undercount"
"9888",47085,"Tennessee","Humphreys County","NHPI_AIC",21,29,8,32,"overcount"
"9889",47087,"Tennessee","Jackson County","A_A",16,17,1,6.06,"overcount"
"9890",47087,"Tennessee","Jackson County","A_AIC",39,68,29,54.21,"overcount"
"9891",47087,"Tennessee","Jackson County","NHPI_A",4,0,-4,-200,"undercount"
"9892",47087,"Tennessee","Jackson County","NHPI_AIC",12,10,-2,-18.18,"undercount"
"9893",47089,"Tennessee","Jefferson County","A_A",371,260,-111,-35.18,"undercount"
"9894",47089,"Tennessee","Jefferson County","A_AIC",491,406,-85,-18.95,"undercount"
"9895",47089,"Tennessee","Jefferson County","NHPI_A",44,20,-24,-75,"undercount"
"9896",47089,"Tennessee","Jefferson County","NHPI_AIC",80,35,-45,-78.26,"undercount"
"9897",47091,"Tennessee","Johnson County","A_A",43,32,-11,-29.33,"undercount"
"9898",47091,"Tennessee","Johnson County","A_AIC",72,64,-8,-11.76,"undercount"
"9899",47091,"Tennessee","Johnson County","NHPI_A",8,9,1,11.76,"overcount"
"9900",47091,"Tennessee","Johnson County","NHPI_AIC",15,21,6,33.33,"overcount"
"9901",47093,"Tennessee","Knox County","A_A",11737,11973,236,1.99,"overcount"
"9902",47093,"Tennessee","Knox County","A_AIC",14516,15167,651,4.39,"overcount"
"9903",47093,"Tennessee","Knox County","NHPI_A",585,310,-275,-61.45,"undercount"
"9904",47093,"Tennessee","Knox County","NHPI_AIC",973,713,-260,-30.84,"undercount"
"9905",47095,"Tennessee","Lake County","A_A",17,12,-5,-34.48,"undercount"
"9906",47095,"Tennessee","Lake County","A_AIC",36,31,-5,-14.93,"undercount"
"9907",47095,"Tennessee","Lake County","NHPI_A",2,5,3,85.71,"overcount"
"9908",47095,"Tennessee","Lake County","NHPI_AIC",5,13,8,88.89,"overcount"
"9909",47097,"Tennessee","Lauderdale County","A_A",140,53,-87,-90.16,"undercount"
"9910",47097,"Tennessee","Lauderdale County","A_AIC",201,131,-70,-42.17,"undercount"
"9911",47097,"Tennessee","Lauderdale County","NHPI_A",3,0,-3,-200,"undercount"
"9912",47097,"Tennessee","Lauderdale County","NHPI_AIC",26,22,-4,-16.67,"undercount"
"9913",47099,"Tennessee","Lawrence County","A_A",217,168,-49,-25.45,"undercount"
"9914",47099,"Tennessee","Lawrence County","A_AIC",314,293,-21,-6.92,"undercount"
"9915",47099,"Tennessee","Lawrence County","NHPI_A",42,1,-41,-190.7,"undercount"
"9916",47099,"Tennessee","Lawrence County","NHPI_AIC",72,41,-31,-54.87,"undercount"
"9917",47101,"Tennessee","Lewis County","A_A",81,55,-26,-38.24,"undercount"
"9918",47101,"Tennessee","Lewis County","A_AIC",109,107,-2,-1.85,"undercount"
"9919",47101,"Tennessee","Lewis County","NHPI_A",7,5,-2,-33.33,"undercount"
"9920",47101,"Tennessee","Lewis County","NHPI_AIC",15,25,10,50,"overcount"
"9921",47103,"Tennessee","Lincoln County","A_A",229,178,-51,-25.06,"undercount"
"9922",47103,"Tennessee","Lincoln County","A_AIC",293,302,9,3.03,"overcount"
"9923",47103,"Tennessee","Lincoln County","NHPI_A",63,16,-47,-118.99,"undercount"
"9924",47103,"Tennessee","Lincoln County","NHPI_AIC",96,53,-43,-57.72,"undercount"
"9925",47105,"Tennessee","Loudon County","A_A",513,485,-28,-5.61,"undercount"
"9926",47105,"Tennessee","Loudon County","A_AIC",630,637,7,1.1,"overcount"
"9927",47105,"Tennessee","Loudon County","NHPI_A",129,21,-108,-144,"undercount"
"9928",47105,"Tennessee","Loudon County","NHPI_AIC",165,54,-111,-101.37,"undercount"
"9929",47107,"Tennessee","McMinn County","A_A",398,430,32,7.73,"overcount"
"9930",47107,"Tennessee","McMinn County","A_AIC",517,601,84,15.03,"overcount"
"9931",47107,"Tennessee","McMinn County","NHPI_A",23,18,-5,-24.39,"undercount"
"9932",47107,"Tennessee","McMinn County","NHPI_AIC",51,55,4,7.55,"overcount"
"9933",47109,"Tennessee","McNairy County","A_A",109,78,-31,-33.16,"undercount"
"9934",47109,"Tennessee","McNairy County","A_AIC",152,113,-39,-29.43,"undercount"
"9935",47109,"Tennessee","McNairy County","NHPI_A",2,0,-2,-200,"undercount"
"9936",47109,"Tennessee","McNairy County","NHPI_AIC",13,2,-11,-146.67,"undercount"
"9937",47111,"Tennessee","Macon County","A_A",255,49,-206,-135.53,"undercount"
"9938",47111,"Tennessee","Macon County","A_AIC",301,85,-216,-111.92,"undercount"
"9939",47111,"Tennessee","Macon County","NHPI_A",11,11,0,0,"equal"
"9940",47111,"Tennessee","Macon County","NHPI_AIC",25,21,-4,-17.39,"undercount"
"9941",47113,"Tennessee","Madison County","A_A",1140,1236,96,8.08,"overcount"
"9942",47113,"Tennessee","Madison County","A_AIC",1506,1623,117,7.48,"overcount"
"9943",47113,"Tennessee","Madison County","NHPI_A",45,13,-32,-110.34,"undercount"
"9944",47113,"Tennessee","Madison County","NHPI_AIC",145,53,-92,-92.93,"undercount"
"9945",47115,"Tennessee","Marion County","A_A",195,149,-46,-26.74,"undercount"
"9946",47115,"Tennessee","Marion County","A_AIC",248,220,-28,-11.97,"undercount"
"9947",47115,"Tennessee","Marion County","NHPI_A",12,2,-10,-142.86,"undercount"
"9948",47115,"Tennessee","Marion County","NHPI_AIC",28,20,-8,-33.33,"undercount"
"9949",47117,"Tennessee","Marshall County","A_A",237,143,-94,-49.47,"undercount"
"9950",47117,"Tennessee","Marshall County","A_AIC",343,221,-122,-43.26,"undercount"
"9951",47117,"Tennessee","Marshall County","NHPI_A",32,7,-25,-128.21,"undercount"
"9952",47117,"Tennessee","Marshall County","NHPI_AIC",63,27,-36,-80,"undercount"
"9953",47119,"Tennessee","Maury County","A_A",986,942,-44,-4.56,"undercount"
"9954",47119,"Tennessee","Maury County","A_AIC",1358,1404,46,3.33,"overcount"
"9955",47119,"Tennessee","Maury County","NHPI_A",85,45,-40,-61.54,"undercount"
"9956",47119,"Tennessee","Maury County","NHPI_AIC",166,116,-50,-35.46,"undercount"
"9957",47121,"Tennessee","Meigs County","A_A",42,26,-16,-47.06,"undercount"
"9958",47121,"Tennessee","Meigs County","A_AIC",73,43,-30,-51.72,"undercount"
"9959",47121,"Tennessee","Meigs County","NHPI_A",7,1,-6,-150,"undercount"
"9960",47121,"Tennessee","Meigs County","NHPI_AIC",15,13,-2,-14.29,"undercount"
"9961",47123,"Tennessee","Monroe County","A_A",247,194,-53,-24.04,"undercount"
"9962",47123,"Tennessee","Monroe County","A_AIC",347,312,-35,-10.62,"undercount"
"9963",47123,"Tennessee","Monroe County","NHPI_A",32,2,-30,-176.47,"undercount"
"9964",47123,"Tennessee","Monroe County","NHPI_AIC",52,32,-20,-47.62,"undercount"
"9965",47125,"Tennessee","Montgomery County","A_A",4878,5148,270,5.39,"overcount"
"9966",47125,"Tennessee","Montgomery County","A_AIC",8373,8520,147,1.74,"overcount"
"9967",47125,"Tennessee","Montgomery County","NHPI_A",904,936,32,3.48,"overcount"
"9968",47125,"Tennessee","Montgomery County","NHPI_AIC",1597,1775,178,10.56,"overcount"
"9969",47127,"Tennessee","Moore County","A_A",113,33,-80,-109.59,"undercount"
"9970",47127,"Tennessee","Moore County","A_AIC",124,66,-58,-61.05,"undercount"
"9971",47127,"Tennessee","Moore County","NHPI_A",1,2,1,66.67,"overcount"
"9972",47127,"Tennessee","Moore County","NHPI_AIC",2,11,9,138.46,"overcount"
"9973",47129,"Tennessee","Morgan County","A_A",58,45,-13,-25.24,"undercount"
"9974",47129,"Tennessee","Morgan County","A_AIC",96,99,3,3.08,"overcount"
"9975",47129,"Tennessee","Morgan County","NHPI_A",15,8,-7,-60.87,"undercount"
"9976",47129,"Tennessee","Morgan County","NHPI_AIC",21,26,5,21.28,"overcount"
"9977",47131,"Tennessee","Obion County","A_A",139,103,-36,-29.75,"undercount"
"9978",47131,"Tennessee","Obion County","A_AIC",192,161,-31,-17.56,"undercount"
"9979",47131,"Tennessee","Obion County","NHPI_A",39,0,-39,-200,"undercount"
"9980",47131,"Tennessee","Obion County","NHPI_AIC",55,19,-36,-97.3,"undercount"
"9981",47133,"Tennessee","Overton County","A_A",82,62,-20,-27.78,"undercount"
"9982",47133,"Tennessee","Overton County","A_AIC",117,115,-2,-1.72,"undercount"
"9983",47133,"Tennessee","Overton County","NHPI_A",2,0,-2,-200,"undercount"
"9984",47133,"Tennessee","Overton County","NHPI_AIC",7,10,3,35.29,"overcount"
"9985",47135,"Tennessee","Perry County","A_A",79,26,-53,-100.95,"undercount"
"9986",47135,"Tennessee","Perry County","A_AIC",100,47,-53,-72.11,"undercount"
"9987",47135,"Tennessee","Perry County","NHPI_A",2,1,-1,-66.67,"undercount"
"9988",47135,"Tennessee","Perry County","NHPI_AIC",4,3,-1,-28.57,"undercount"
"9989",47137,"Tennessee","Pickett County","A_A",7,15,8,72.73,"overcount"
"9990",47137,"Tennessee","Pickett County","A_AIC",15,25,10,50,"overcount"
"9991",47137,"Tennessee","Pickett County","NHPI_A",4,1,-3,-120,"undercount"
"9992",47137,"Tennessee","Pickett County","NHPI_AIC",4,4,0,0,"equal"
"9993",47139,"Tennessee","Polk County","A_A",71,34,-37,-70.48,"undercount"
"9994",47139,"Tennessee","Polk County","A_AIC",102,56,-46,-58.23,"undercount"
"9995",47139,"Tennessee","Polk County","NHPI_A",11,10,-1,-9.52,"undercount"
"9996",47139,"Tennessee","Polk County","NHPI_AIC",16,11,-5,-37.04,"undercount"
"9997",47141,"Tennessee","Putnam County","A_A",1205,1095,-110,-9.57,"undercount"
"9998",47141,"Tennessee","Putnam County","A_AIC",1523,1526,3,0.2,"overcount"
"9999",47141,"Tennessee","Putnam County","NHPI_A",123,35,-88,-111.39,"undercount"
"10000",47141,"Tennessee","Putnam County","NHPI_AIC",181,102,-79,-55.83,"undercount"
"10001",47143,"Tennessee","Rhea County","A_A",210,195,-15,-7.41,"undercount"
"10002",47143,"Tennessee","Rhea County","A_AIC",271,291,20,7.12,"overcount"
"10003",47143,"Tennessee","Rhea County","NHPI_A",23,6,-17,-117.24,"undercount"
"10004",47143,"Tennessee","Rhea County","NHPI_AIC",47,16,-31,-98.41,"undercount"
"10005",47145,"Tennessee","Roane County","A_A",374,343,-31,-8.65,"undercount"
"10006",47145,"Tennessee","Roane County","A_AIC",504,568,64,11.94,"overcount"
"10007",47145,"Tennessee","Roane County","NHPI_A",30,19,-11,-44.9,"undercount"
"10008",47145,"Tennessee","Roane County","NHPI_AIC",55,65,10,16.67,"overcount"
"10009",47147,"Tennessee","Robertson County","A_A",581,462,-119,-22.82,"undercount"
"10010",47147,"Tennessee","Robertson County","A_AIC",780,759,-21,-2.73,"undercount"
"10011",47147,"Tennessee","Robertson County","NHPI_A",89,23,-66,-117.86,"undercount"
"10012",47147,"Tennessee","Robertson County","NHPI_AIC",128,72,-56,-56,"undercount"
"10013",47149,"Tennessee","Rutherford County","A_A",12705,12579,-126,-1,"undercount"
"10014",47149,"Tennessee","Rutherford County","A_AIC",15452,15857,405,2.59,"overcount"
"10015",47149,"Tennessee","Rutherford County","NHPI_A",429,235,-194,-58.43,"undercount"
"10016",47149,"Tennessee","Rutherford County","NHPI_AIC",756,556,-200,-30.49,"undercount"
"10017",47151,"Tennessee","Scott County","A_A",76,51,-25,-39.37,"undercount"
"10018",47151,"Tennessee","Scott County","A_AIC",108,96,-12,-11.76,"undercount"
"10019",47151,"Tennessee","Scott County","NHPI_A",4,0,-4,-200,"undercount"
"10020",47151,"Tennessee","Scott County","NHPI_AIC",11,13,2,16.67,"overcount"
"10021",47153,"Tennessee","Sequatchie County","A_A",65,65,0,0,"equal"
"10022",47153,"Tennessee","Sequatchie County","A_AIC",94,107,13,12.94,"overcount"
"10023",47153,"Tennessee","Sequatchie County","NHPI_A",10,5,-5,-66.67,"undercount"
"10024",47153,"Tennessee","Sequatchie County","NHPI_AIC",19,17,-2,-11.11,"undercount"
"10025",47155,"Tennessee","Sevier County","A_A",1269,1121,-148,-12.38,"undercount"
"10026",47155,"Tennessee","Sevier County","A_AIC",1670,1497,-173,-10.93,"undercount"
"10027",47155,"Tennessee","Sevier County","NHPI_A",58,24,-34,-82.93,"undercount"
"10028",47155,"Tennessee","Sevier County","NHPI_AIC",121,78,-43,-43.22,"undercount"
"10029",47157,"Tennessee","Shelby County","A_A",26691,28288,1597,5.81,"overcount"
"10030",47157,"Tennessee","Shelby County","A_AIC",31641,33537,1896,5.82,"overcount"
"10031",47157,"Tennessee","Shelby County","NHPI_A",729,264,-465,-93.66,"undercount"
"10032",47157,"Tennessee","Shelby County","NHPI_AIC",1485,919,-566,-47.09,"undercount"
"10033",47159,"Tennessee","Smith County","A_A",106,85,-21,-21.99,"undercount"
"10034",47159,"Tennessee","Smith County","A_AIC",146,140,-6,-4.2,"undercount"
"10035",47159,"Tennessee","Smith County","NHPI_A",6,0,-6,-200,"undercount"
"10036",47159,"Tennessee","Smith County","NHPI_AIC",12,14,2,15.38,"overcount"
"10037",47161,"Tennessee","Stewart County","A_A",144,76,-68,-61.82,"undercount"
"10038",47161,"Tennessee","Stewart County","A_AIC",202,134,-68,-40.48,"undercount"
"10039",47161,"Tennessee","Stewart County","NHPI_A",10,5,-5,-66.67,"undercount"
"10040",47161,"Tennessee","Stewart County","NHPI_AIC",22,26,4,16.67,"overcount"
"10041",47163,"Tennessee","Sullivan County","A_A",1259,1270,11,0.87,"overcount"
"10042",47163,"Tennessee","Sullivan County","A_AIC",1694,1821,127,7.23,"overcount"
"10043",47163,"Tennessee","Sullivan County","NHPI_A",79,38,-41,-70.09,"undercount"
"10044",47163,"Tennessee","Sullivan County","NHPI_AIC",150,114,-36,-27.27,"undercount"
"10045",47165,"Tennessee","Sumner County","A_A",3147,2976,-171,-5.59,"undercount"
"10046",47165,"Tennessee","Sumner County","A_AIC",4197,4167,-30,-0.72,"undercount"
"10047",47165,"Tennessee","Sumner County","NHPI_A",200,117,-83,-52.37,"undercount"
"10048",47165,"Tennessee","Sumner County","NHPI_AIC",348,268,-80,-25.97,"undercount"
"10049",47167,"Tennessee","Tipton County","A_A",489,398,-91,-20.52,"undercount"
"10050",47167,"Tennessee","Tipton County","A_AIC",818,788,-30,-3.74,"undercount"
"10051",47167,"Tennessee","Tipton County","NHPI_A",87,39,-48,-76.19,"undercount"
"10052",47167,"Tennessee","Tipton County","NHPI_AIC",150,121,-29,-21.4,"undercount"
"10053",47169,"Tennessee","Trousdale County","A_A",51,27,-24,-61.54,"undercount"
"10054",47169,"Tennessee","Trousdale County","A_AIC",66,85,19,25.17,"overcount"
"10055",47169,"Tennessee","Trousdale County","NHPI_A",3,0,-3,-200,"undercount"
"10056",47169,"Tennessee","Trousdale County","NHPI_AIC",5,22,17,125.93,"overcount"
"10057",47171,"Tennessee","Unicoi County","A_A",66,37,-29,-56.31,"undercount"
"10058",47171,"Tennessee","Unicoi County","A_AIC",88,75,-13,-15.95,"undercount"
"10059",47171,"Tennessee","Unicoi County","NHPI_A",8,0,-8,-200,"undercount"
"10060",47171,"Tennessee","Unicoi County","NHPI_AIC",14,10,-4,-33.33,"undercount"
"10061",47173,"Tennessee","Union County","A_A",44,36,-8,-20,"undercount"
"10062",47173,"Tennessee","Union County","A_AIC",65,63,-2,-3.12,"undercount"
"10063",47173,"Tennessee","Union County","NHPI_A",17,5,-12,-109.09,"undercount"
"10064",47173,"Tennessee","Union County","NHPI_AIC",19,22,3,14.63,"overcount"
"10065",47175,"Tennessee","Van Buren County","A_A",17,10,-7,-51.85,"undercount"
"10066",47175,"Tennessee","Van Buren County","A_AIC",26,32,6,20.69,"overcount"
"10067",47175,"Tennessee","Van Buren County","NHPI_A",0,1,1,200,"overcount"
"10068",47175,"Tennessee","Van Buren County","NHPI_AIC",2,3,1,40,"overcount"
"10069",47177,"Tennessee","Warren County","A_A",368,263,-105,-33.28,"undercount"
"10070",47177,"Tennessee","Warren County","A_AIC",454,362,-92,-22.55,"undercount"
"10071",47177,"Tennessee","Warren County","NHPI_A",45,10,-35,-127.27,"undercount"
"10072",47177,"Tennessee","Warren County","NHPI_AIC",63,42,-21,-40,"undercount"
"10073",47179,"Tennessee","Washington County","A_A",2195,1990,-205,-9.8,"undercount"
"10074",47179,"Tennessee","Washington County","A_AIC",2778,2664,-114,-4.19,"undercount"
"10075",47179,"Tennessee","Washington County","NHPI_A",86,58,-28,-38.89,"undercount"
"10076",47179,"Tennessee","Washington County","NHPI_AIC",193,138,-55,-33.23,"undercount"
"10077",47181,"Tennessee","Wayne County","A_A",45,27,-18,-50,"undercount"
"10078",47181,"Tennessee","Wayne County","A_AIC",67,45,-22,-39.29,"undercount"
"10079",47181,"Tennessee","Wayne County","NHPI_A",5,1,-4,-133.33,"undercount"
"10080",47181,"Tennessee","Wayne County","NHPI_AIC",9,17,8,61.54,"overcount"
"10081",47183,"Tennessee","Weakley County","A_A",405,196,-209,-69.55,"undercount"
"10082",47183,"Tennessee","Weakley County","A_AIC",496,316,-180,-44.33,"undercount"
"10083",47183,"Tennessee","Weakley County","NHPI_A",21,3,-18,-150,"undercount"
"10084",47183,"Tennessee","Weakley County","NHPI_AIC",42,40,-2,-4.88,"undercount"
"10085",47185,"Tennessee","White County","A_A",127,132,5,3.86,"overcount"
"10086",47185,"Tennessee","White County","A_AIC",180,205,25,12.99,"overcount"
"10087",47185,"Tennessee","White County","NHPI_A",25,10,-15,-85.71,"undercount"
"10088",47185,"Tennessee","White County","NHPI_AIC",39,26,-13,-40,"undercount"
"10089",47187,"Tennessee","Williamson County","A_A",13063,12947,-116,-0.89,"undercount"
"10090",47187,"Tennessee","Williamson County","A_AIC",15076,15328,252,1.66,"overcount"
"10091",47187,"Tennessee","Williamson County","NHPI_A",141,121,-20,-15.27,"undercount"
"10092",47187,"Tennessee","Williamson County","NHPI_AIC",332,360,28,8.09,"overcount"
"10093",47189,"Tennessee","Wilson County","A_A",2872,3132,260,8.66,"overcount"
"10094",47189,"Tennessee","Wilson County","A_AIC",3648,4173,525,13.43,"overcount"
"10095",47189,"Tennessee","Wilson County","NHPI_A",143,48,-95,-99.48,"undercount"
"10096",47189,"Tennessee","Wilson County","NHPI_AIC",273,174,-99,-44.3,"undercount"
"10097",48001,"Texas","Anderson County","A_A",542,381,-161,-34.89,"undercount"
"10098",48001,"Texas","Anderson County","A_AIC",781,500,-281,-43.87,"undercount"
"10099",48001,"Texas","Anderson County","NHPI_A",116,13,-103,-159.69,"undercount"
"10100",48001,"Texas","Anderson County","NHPI_AIC",222,45,-177,-132.58,"undercount"
"10101",48003,"Texas","Andrews County","A_A",152,106,-46,-35.66,"undercount"
"10102",48003,"Texas","Andrews County","A_AIC",191,127,-64,-40.25,"undercount"
"10103",48003,"Texas","Andrews County","NHPI_A",5,0,-5,-200,"undercount"
"10104",48003,"Texas","Andrews County","NHPI_AIC",18,12,-6,-40,"undercount"
"10105",48005,"Texas","Angelina County","A_A",934,897,-37,-4.04,"undercount"
"10106",48005,"Texas","Angelina County","A_AIC",1171,1092,-79,-6.98,"undercount"
"10107",48005,"Texas","Angelina County","NHPI_A",59,31,-28,-62.22,"undercount"
"10108",48005,"Texas","Angelina County","NHPI_AIC",112,56,-56,-66.67,"undercount"
"10109",48007,"Texas","Aransas County","A_A",473,481,8,1.68,"overcount"
"10110",48007,"Texas","Aransas County","A_AIC",546,598,52,9.09,"overcount"
"10111",48007,"Texas","Aransas County","NHPI_A",30,15,-15,-66.67,"undercount"
"10112",48007,"Texas","Aransas County","NHPI_AIC",41,42,1,2.41,"overcount"
"10113",48009,"Texas","Archer County","A_A",49,20,-29,-84.06,"undercount"
"10114",48009,"Texas","Archer County","A_AIC",79,57,-22,-32.35,"undercount"
"10115",48009,"Texas","Archer County","NHPI_A",5,0,-5,-200,"undercount"
"10116",48009,"Texas","Archer County","NHPI_AIC",13,13,0,0,"equal"
"10117",48011,"Texas","Armstrong County","A_A",10,10,0,0,"equal"
"10118",48011,"Texas","Armstrong County","A_AIC",14,14,0,0,"equal"
"10119",48011,"Texas","Armstrong County","NHPI_A",0,0,0,0,"equal"
"10120",48011,"Texas","Armstrong County","NHPI_AIC",0,2,2,200,"overcount"
"10121",48013,"Texas","Atascosa County","A_A",353,172,-181,-68.95,"undercount"
"10122",48013,"Texas","Atascosa County","A_AIC",459,291,-168,-44.8,"undercount"
"10123",48013,"Texas","Atascosa County","NHPI_A",84,16,-68,-136,"undercount"
"10124",48013,"Texas","Atascosa County","NHPI_AIC",110,54,-56,-68.29,"undercount"
"10125",48015,"Texas","Austin County","A_A",261,201,-60,-25.97,"undercount"
"10126",48015,"Texas","Austin County","A_AIC",331,272,-59,-19.57,"undercount"
"10127",48015,"Texas","Austin County","NHPI_A",13,8,-5,-47.62,"undercount"
"10128",48015,"Texas","Austin County","NHPI_AIC",36,16,-20,-76.92,"undercount"
"10129",48017,"Texas","Bailey County","A_A",69,8,-61,-158.44,"undercount"
"10130",48017,"Texas","Bailey County","A_AIC",80,13,-67,-144.09,"undercount"
"10131",48017,"Texas","Bailey County","NHPI_A",9,0,-9,-200,"undercount"
"10132",48017,"Texas","Bailey County","NHPI_AIC",16,0,-16,-200,"undercount"
"10133",48019,"Texas","Bandera County","A_A",137,95,-42,-36.21,"undercount"
"10134",48019,"Texas","Bandera County","A_AIC",192,187,-5,-2.64,"undercount"
"10135",48019,"Texas","Bandera County","NHPI_A",11,11,0,0,"equal"
"10136",48019,"Texas","Bandera County","NHPI_AIC",23,47,24,68.57,"overcount"
"10137",48021,"Texas","Bastrop County","A_A",870,718,-152,-19.14,"undercount"
"10138",48021,"Texas","Bastrop County","A_AIC",1237,1106,-131,-11.18,"undercount"
"10139",48021,"Texas","Bastrop County","NHPI_A",156,67,-89,-79.82,"undercount"
"10140",48021,"Texas","Bastrop County","NHPI_AIC",257,131,-126,-64.95,"undercount"
"10141",48023,"Texas","Baylor County","A_A",16,9,-7,-56,"undercount"
"10142",48023,"Texas","Baylor County","A_AIC",26,22,-4,-16.67,"undercount"
"10143",48023,"Texas","Baylor County","NHPI_A",3,0,-3,-200,"undercount"
"10144",48023,"Texas","Baylor County","NHPI_AIC",8,6,-2,-28.57,"undercount"
"10145",48025,"Texas","Bee County","A_A",228,213,-15,-6.8,"undercount"
"10146",48025,"Texas","Bee County","A_AIC",306,262,-44,-15.49,"undercount"
"10147",48025,"Texas","Bee County","NHPI_A",33,3,-30,-166.67,"undercount"
"10148",48025,"Texas","Bee County","NHPI_AIC",58,25,-33,-79.52,"undercount"
"10149",48027,"Texas","Bell County","A_A",11805,11095,-710,-6.2,"undercount"
"10150",48027,"Texas","Bell County","A_AIC",17969,16570,-1399,-8.1,"undercount"
"10151",48027,"Texas","Bell County","NHPI_A",3227,3477,250,7.46,"overcount"
"10152",48027,"Texas","Bell County","NHPI_AIC",4854,5163,309,6.17,"overcount"
"10153",48029,"Texas","Bexar County","A_A",68260,65951,-2309,-3.44,"undercount"
"10154",48029,"Texas","Bexar County","A_AIC",88987,83798,-5189,-6.01,"undercount"
"10155",48029,"Texas","Bexar County","NHPI_A",4850,2818,-2032,-53,"undercount"
"10156",48029,"Texas","Bexar County","NHPI_AIC",8520,5908,-2612,-36.21,"undercount"
"10157",48031,"Texas","Blanco County","A_A",107,47,-60,-77.92,"undercount"
"10158",48031,"Texas","Blanco County","A_AIC",136,85,-51,-46.15,"undercount"
"10159",48031,"Texas","Blanco County","NHPI_A",12,0,-12,-200,"undercount"
"10160",48031,"Texas","Blanco County","NHPI_AIC",19,13,-6,-37.5,"undercount"
"10161",48033,"Texas","Borden County","A_A",1,1,0,0,"equal"
"10162",48033,"Texas","Borden County","A_AIC",3,10,7,107.69,"overcount"
"10163",48033,"Texas","Borden County","NHPI_A",0,0,0,0,"equal"
"10164",48033,"Texas","Borden County","NHPI_AIC",0,4,4,200,"overcount"
"10165",48035,"Texas","Bosque County","A_A",126,86,-40,-37.74,"undercount"
"10166",48035,"Texas","Bosque County","A_AIC",163,145,-18,-11.69,"undercount"
"10167",48035,"Texas","Bosque County","NHPI_A",13,3,-10,-125,"undercount"
"10168",48035,"Texas","Bosque County","NHPI_AIC",26,11,-15,-81.08,"undercount"
"10169",48037,"Texas","Bowie County","A_A",1193,1086,-107,-9.39,"undercount"
"10170",48037,"Texas","Bowie County","A_AIC",1585,1448,-137,-9.03,"undercount"
"10171",48037,"Texas","Bowie County","NHPI_A",107,69,-38,-43.18,"undercount"
"10172",48037,"Texas","Bowie County","NHPI_AIC",220,140,-80,-44.44,"undercount"
"10173",48039,"Texas","Brazoria County","A_A",27441,26389,-1052,-3.91,"undercount"
"10174",48039,"Texas","Brazoria County","A_AIC",30168,29110,-1058,-3.57,"undercount"
"10175",48039,"Texas","Brazoria County","NHPI_A",400,129,-271,-102.46,"undercount"
"10176",48039,"Texas","Brazoria County","NHPI_AIC",766,460,-306,-49.92,"undercount"
"10177",48041,"Texas","Brazos County","A_A",14200,14723,523,3.62,"overcount"
"10178",48041,"Texas","Brazos County","A_AIC",16281,16563,282,1.72,"overcount"
"10179",48041,"Texas","Brazos County","NHPI_A",282,211,-71,-28.8,"undercount"
"10180",48041,"Texas","Brazos County","NHPI_AIC",522,429,-93,-19.56,"undercount"
"10181",48043,"Texas","Brewster County","A_A",172,94,-78,-58.65,"undercount"
"10182",48043,"Texas","Brewster County","A_AIC",216,143,-73,-40.67,"undercount"
"10183",48043,"Texas","Brewster County","NHPI_A",13,11,-2,-16.67,"undercount"
"10184",48043,"Texas","Brewster County","NHPI_AIC",21,17,-4,-21.05,"undercount"
"10185",48045,"Texas","Briscoe County","A_A",4,0,-4,-200,"undercount"
"10186",48045,"Texas","Briscoe County","A_AIC",10,5,-5,-66.67,"undercount"
"10187",48045,"Texas","Briscoe County","NHPI_A",0,0,0,0,"equal"
"10188",48045,"Texas","Briscoe County","NHPI_AIC",1,0,-1,-200,"undercount"
"10189",48047,"Texas","Brooks County","A_A",84,29,-55,-97.35,"undercount"
"10190",48047,"Texas","Brooks County","A_AIC",90,37,-53,-83.46,"undercount"
"10191",48047,"Texas","Brooks County","NHPI_A",3,0,-3,-200,"undercount"
"10192",48047,"Texas","Brooks County","NHPI_AIC",5,7,2,33.33,"overcount"
"10193",48049,"Texas","Brown County","A_A",291,269,-22,-7.86,"undercount"
"10194",48049,"Texas","Brown County","A_AIC",365,357,-8,-2.22,"undercount"
"10195",48049,"Texas","Brown County","NHPI_A",32,27,-5,-16.95,"undercount"
"10196",48049,"Texas","Brown County","NHPI_AIC",49,61,12,21.82,"overcount"
"10197",48051,"Texas","Burleson County","A_A",99,70,-29,-34.32,"undercount"
"10198",48051,"Texas","Burleson County","A_AIC",141,105,-36,-29.27,"undercount"
"10199",48051,"Texas","Burleson County","NHPI_A",7,0,-7,-200,"undercount"
"10200",48051,"Texas","Burleson County","NHPI_AIC",17,29,12,52.17,"overcount"
"10201",48053,"Texas","Burnet County","A_A",482,424,-58,-12.8,"undercount"
"10202",48053,"Texas","Burnet County","A_AIC",622,592,-30,-4.94,"undercount"
"10203",48053,"Texas","Burnet County","NHPI_A",46,15,-31,-101.64,"undercount"
"10204",48053,"Texas","Burnet County","NHPI_AIC",80,43,-37,-60.16,"undercount"
"10205",48055,"Texas","Caldwell County","A_A",471,232,-239,-67.99,"undercount"
"10206",48055,"Texas","Caldwell County","A_AIC",586,339,-247,-53.41,"undercount"
"10207",48055,"Texas","Caldwell County","NHPI_A",49,4,-45,-169.81,"undercount"
"10208",48055,"Texas","Caldwell County","NHPI_AIC",79,19,-60,-122.45,"undercount"
"10209",48057,"Texas","Calhoun County","A_A",1165,1127,-38,-3.32,"undercount"
"10210",48057,"Texas","Calhoun County","A_AIC",1214,1157,-57,-4.81,"undercount"
"10211",48057,"Texas","Calhoun County","NHPI_A",13,0,-13,-200,"undercount"
"10212",48057,"Texas","Calhoun County","NHPI_AIC",22,18,-4,-20,"undercount"
"10213",48059,"Texas","Callahan County","A_A",98,57,-41,-52.9,"undercount"
"10214",48059,"Texas","Callahan County","A_AIC",144,100,-44,-36.07,"undercount"
"10215",48059,"Texas","Callahan County","NHPI_A",13,7,-6,-60,"undercount"
"10216",48059,"Texas","Callahan County","NHPI_AIC",27,22,-5,-20.41,"undercount"
"10217",48061,"Texas","Cameron County","A_A",3408,2640,-768,-25.4,"undercount"
"10218",48061,"Texas","Cameron County","A_AIC",4131,2965,-1166,-32.86,"undercount"
"10219",48061,"Texas","Cameron County","NHPI_A",326,83,-243,-118.83,"undercount"
"10220",48061,"Texas","Cameron County","NHPI_AIC",492,167,-325,-98.63,"undercount"
"10221",48063,"Texas","Camp County","A_A",160,106,-54,-40.6,"undercount"
"10222",48063,"Texas","Camp County","A_AIC",203,131,-72,-43.11,"undercount"
"10223",48063,"Texas","Camp County","NHPI_A",22,8,-14,-93.33,"undercount"
"10224",48063,"Texas","Camp County","NHPI_AIC",31,24,-7,-25.45,"undercount"
"10225",48065,"Texas","Carson County","A_A",37,20,-17,-59.65,"undercount"
"10226",48065,"Texas","Carson County","A_AIC",64,30,-34,-72.34,"undercount"
"10227",48065,"Texas","Carson County","NHPI_A",4,2,-2,-66.67,"undercount"
"10228",48065,"Texas","Carson County","NHPI_AIC",9,6,-3,-40,"undercount"
"10229",48067,"Texas","Cass County","A_A",177,126,-51,-33.66,"undercount"
"10230",48067,"Texas","Cass County","A_AIC",262,195,-67,-29.32,"undercount"
"10231",48067,"Texas","Cass County","NHPI_A",17,10,-7,-51.85,"undercount"
"10232",48067,"Texas","Cass County","NHPI_AIC",43,48,5,10.99,"overcount"
"10233",48069,"Texas","Castro County","A_A",57,29,-28,-65.12,"undercount"
"10234",48069,"Texas","Castro County","A_AIC",68,45,-23,-40.71,"undercount"
"10235",48069,"Texas","Castro County","NHPI_A",1,4,3,120,"overcount"
"10236",48069,"Texas","Castro County","NHPI_AIC",5,12,7,82.35,"overcount"
"10237",48071,"Texas","Chambers County","A_A",648,631,-17,-2.66,"undercount"
"10238",48071,"Texas","Chambers County","A_AIC",801,827,26,3.19,"overcount"
"10239",48071,"Texas","Chambers County","NHPI_A",64,0,-64,-200,"undercount"
"10240",48071,"Texas","Chambers County","NHPI_AIC",98,28,-70,-111.11,"undercount"
"10241",48073,"Texas","Cherokee County","A_A",326,266,-60,-20.27,"undercount"
"10242",48073,"Texas","Cherokee County","A_AIC",456,385,-71,-16.88,"undercount"
"10243",48073,"Texas","Cherokee County","NHPI_A",44,18,-26,-83.87,"undercount"
"10244",48073,"Texas","Cherokee County","NHPI_AIC",83,36,-47,-78.99,"undercount"
"10245",48075,"Texas","Childress County","A_A",58,53,-5,-9.01,"undercount"
"10246",48075,"Texas","Childress County","A_AIC",80,74,-6,-7.79,"undercount"
"10247",48075,"Texas","Childress County","NHPI_A",4,2,-2,-66.67,"undercount"
"10248",48075,"Texas","Childress County","NHPI_AIC",8,23,15,96.77,"overcount"
"10249",48077,"Texas","Clay County","A_A",80,56,-24,-35.29,"undercount"
"10250",48077,"Texas","Clay County","A_AIC",121,79,-42,-42,"undercount"
"10251",48077,"Texas","Clay County","NHPI_A",1,0,-1,-200,"undercount"
"10252",48077,"Texas","Clay County","NHPI_AIC",11,4,-7,-93.33,"undercount"
"10253",48079,"Texas","Cochran County","A_A",19,0,-19,-200,"undercount"
"10254",48079,"Texas","Cochran County","A_AIC",28,3,-25,-161.29,"undercount"
"10255",48079,"Texas","Cochran County","NHPI_A",7,0,-7,-200,"undercount"
"10256",48079,"Texas","Cochran County","NHPI_AIC",9,0,-9,-200,"undercount"
"10257",48081,"Texas","Coke County","A_A",5,2,-3,-85.71,"undercount"
"10258",48081,"Texas","Coke County","A_AIC",14,11,-3,-24,"undercount"
"10259",48081,"Texas","Coke County","NHPI_A",1,6,5,142.86,"overcount"
"10260",48081,"Texas","Coke County","NHPI_AIC",1,9,8,160,"overcount"
"10261",48083,"Texas","Coleman County","A_A",93,32,-61,-97.6,"undercount"
"10262",48083,"Texas","Coleman County","A_AIC",122,44,-78,-93.98,"undercount"
"10263",48083,"Texas","Coleman County","NHPI_A",3,0,-3,-200,"undercount"
"10264",48083,"Texas","Coleman County","NHPI_AIC",10,7,-3,-35.29,"undercount"
"10265",48085,"Texas","Collin County","A_A",183227,189375,6148,3.3,"overcount"
"10266",48085,"Texas","Collin County","A_AIC",198721,204746,6025,2.99,"overcount"
"10267",48085,"Texas","Collin County","NHPI_A",1125,647,-478,-53.95,"undercount"
"10268",48085,"Texas","Collin County","NHPI_AIC",2519,2042,-477,-20.92,"undercount"
"10269",48087,"Texas","Collingsworth County","A_A",15,7,-8,-72.73,"undercount"
"10270",48087,"Texas","Collingsworth County","A_AIC",30,20,-10,-40,"undercount"
"10271",48087,"Texas","Collingsworth County","NHPI_A",0,1,1,200,"overcount"
"10272",48087,"Texas","Collingsworth County","NHPI_AIC",0,14,14,200,"overcount"
"10273",48089,"Texas","Colorado County","A_A",161,80,-81,-67.22,"undercount"
"10274",48089,"Texas","Colorado County","A_AIC",223,126,-97,-55.59,"undercount"
"10275",48089,"Texas","Colorado County","NHPI_A",16,0,-16,-200,"undercount"
"10276",48089,"Texas","Colorado County","NHPI_AIC",34,11,-23,-102.22,"undercount"
"10277",48091,"Texas","Comal County","A_A",2391,1858,-533,-25.09,"undercount"
"10278",48091,"Texas","Comal County","A_AIC",3378,3056,-322,-10.01,"undercount"
"10279",48091,"Texas","Comal County","NHPI_A",215,137,-78,-44.32,"undercount"
"10280",48091,"Texas","Comal County","NHPI_AIC",331,328,-3,-0.91,"undercount"
"10281",48093,"Texas","Comanche County","A_A",86,41,-45,-70.87,"undercount"
"10282",48093,"Texas","Comanche County","A_AIC",115,60,-55,-62.86,"undercount"
"10283",48093,"Texas","Comanche County","NHPI_A",6,3,-3,-66.67,"undercount"
"10284",48093,"Texas","Comanche County","NHPI_AIC",11,13,2,16.67,"overcount"
"10285",48095,"Texas","Concho County","A_A",57,27,-30,-71.43,"undercount"
"10286",48095,"Texas","Concho County","A_AIC",63,42,-21,-40,"undercount"
"10287",48095,"Texas","Concho County","NHPI_A",1,1,0,0,"equal"
"10288",48095,"Texas","Concho County","NHPI_AIC",2,9,7,127.27,"overcount"
"10289",48097,"Texas","Cooke County","A_A",438,308,-130,-34.85,"undercount"
"10290",48097,"Texas","Cooke County","A_AIC",521,426,-95,-20.06,"undercount"
"10291",48097,"Texas","Cooke County","NHPI_A",25,14,-11,-56.41,"undercount"
"10292",48097,"Texas","Cooke County","NHPI_AIC",55,31,-24,-55.81,"undercount"
"10293",48099,"Texas","Coryell County","A_A",1799,1821,22,1.22,"overcount"
"10294",48099,"Texas","Coryell County","A_AIC",2936,2946,10,0.34,"overcount"
"10295",48099,"Texas","Coryell County","NHPI_A",737,1051,314,35.12,"overcount"
"10296",48099,"Texas","Coryell County","NHPI_AIC",1022,1389,367,30.44,"overcount"
"10297",48101,"Texas","Cottle County","A_A",2,0,-2,-200,"undercount"
"10298",48101,"Texas","Cottle County","A_AIC",5,15,10,100,"overcount"
"10299",48101,"Texas","Cottle County","NHPI_A",1,1,0,0,"equal"
"10300",48101,"Texas","Cottle County","NHPI_AIC",2,11,9,138.46,"overcount"
"10301",48103,"Texas","Crane County","A_A",55,22,-33,-85.71,"undercount"
"10302",48103,"Texas","Crane County","A_AIC",64,30,-34,-72.34,"undercount"
"10303",48103,"Texas","Crane County","NHPI_A",13,0,-13,-200,"undercount"
"10304",48103,"Texas","Crane County","NHPI_AIC",16,5,-11,-104.76,"undercount"
"10305",48105,"Texas","Crockett County","A_A",37,11,-26,-108.33,"undercount"
"10306",48105,"Texas","Crockett County","A_AIC",39,15,-24,-88.89,"undercount"
"10307",48105,"Texas","Crockett County","NHPI_A",3,0,-3,-200,"undercount"
"10308",48105,"Texas","Crockett County","NHPI_AIC",4,4,0,0,"equal"
"10309",48107,"Texas","Crosby County","A_A",21,12,-9,-54.55,"undercount"
"10310",48107,"Texas","Crosby County","A_AIC",43,20,-23,-73.02,"undercount"
"10311",48107,"Texas","Crosby County","NHPI_A",4,0,-4,-200,"undercount"
"10312",48107,"Texas","Crosby County","NHPI_AIC",6,9,3,40,"overcount"
"10313",48109,"Texas","Culberson County","A_A",48,28,-20,-52.63,"undercount"
"10314",48109,"Texas","Culberson County","A_AIC",63,44,-19,-35.51,"undercount"
"10315",48109,"Texas","Culberson County","NHPI_A",1,0,-1,-200,"undercount"
"10316",48109,"Texas","Culberson County","NHPI_AIC",5,3,-2,-50,"undercount"
"10317",48111,"Texas","Dallam County","A_A",109,10,-99,-166.39,"undercount"
"10318",48111,"Texas","Dallam County","A_AIC",121,16,-105,-153.28,"undercount"
"10319",48111,"Texas","Dallam County","NHPI_A",10,3,-7,-107.69,"undercount"
"10320",48111,"Texas","Dallam County","NHPI_AIC",14,10,-4,-33.33,"undercount"
"10321",48113,"Texas","Dallas County","A_A",182776,182873,97,0.05,"overcount"
"10322",48113,"Texas","Dallas County","A_AIC",200155,199036,-1119,-0.56,"undercount"
"10323",48113,"Texas","Dallas County","NHPI_A",2906,1200,-1706,-83.1,"undercount"
"10324",48113,"Texas","Dallas County","NHPI_AIC",5535,3086,-2449,-56.81,"undercount"
"10325",48115,"Texas","Dawson County","A_A",131,57,-74,-78.72,"undercount"
"10326",48115,"Texas","Dawson County","A_AIC",172,75,-97,-78.54,"undercount"
"10327",48115,"Texas","Dawson County","NHPI_A",17,4,-13,-123.81,"undercount"
"10328",48115,"Texas","Dawson County","NHPI_AIC",31,11,-20,-95.24,"undercount"
"10329",48117,"Texas","Deaf Smith County","A_A",108,44,-64,-84.21,"undercount"
"10330",48117,"Texas","Deaf Smith County","A_AIC",159,57,-102,-94.44,"undercount"
"10331",48117,"Texas","Deaf Smith County","NHPI_A",14,0,-14,-200,"undercount"
"10332",48117,"Texas","Deaf Smith County","NHPI_AIC",27,3,-24,-160,"undercount"
"10333",48119,"Texas","Delta County","A_A",35,37,2,5.56,"overcount"
"10334",48119,"Texas","Delta County","A_AIC",60,48,-12,-22.22,"undercount"
"10335",48119,"Texas","Delta County","NHPI_A",3,5,2,50,"overcount"
"10336",48119,"Texas","Delta County","NHPI_AIC",7,10,3,35.29,"overcount"
"10337",48121,"Texas","Denton County","A_A",93060,93339,279,0.3,"overcount"
"10338",48121,"Texas","Denton County","A_AIC",103236,104224,988,0.95,"overcount"
"10339",48121,"Texas","Denton County","NHPI_A",1124,669,-455,-50.75,"undercount"
"10340",48121,"Texas","Denton County","NHPI_AIC",2441,1952,-489,-22.26,"undercount"
"10341",48123,"Texas","DeWitt County","A_A",96,70,-26,-31.33,"undercount"
"10342",48123,"Texas","DeWitt County","A_AIC",122,94,-28,-25.93,"undercount"
"10343",48123,"Texas","DeWitt County","NHPI_A",10,2,-8,-133.33,"undercount"
"10344",48123,"Texas","DeWitt County","NHPI_AIC",20,11,-9,-58.06,"undercount"
"10345",48125,"Texas","Dickens County","A_A",28,2,-26,-173.33,"undercount"
"10346",48125,"Texas","Dickens County","A_AIC",35,9,-26,-118.18,"undercount"
"10347",48125,"Texas","Dickens County","NHPI_A",2,3,1,40,"overcount"
"10348",48125,"Texas","Dickens County","NHPI_AIC",4,9,5,76.92,"overcount"
"10349",48127,"Texas","Dimmit County","A_A",79,68,-11,-14.97,"undercount"
"10350",48127,"Texas","Dimmit County","A_AIC",92,76,-16,-19.05,"undercount"
"10351",48127,"Texas","Dimmit County","NHPI_A",2,10,8,133.33,"overcount"
"10352",48127,"Texas","Dimmit County","NHPI_AIC",6,13,7,73.68,"overcount"
"10353",48129,"Texas","Donley County","A_A",23,11,-12,-70.59,"undercount"
"10354",48129,"Texas","Donley County","A_AIC",35,30,-5,-15.38,"undercount"
"10355",48129,"Texas","Donley County","NHPI_A",2,1,-1,-66.67,"undercount"
"10356",48129,"Texas","Donley County","NHPI_AIC",6,9,3,40,"overcount"
"10357",48131,"Texas","Duval County","A_A",56,46,-10,-19.61,"undercount"
"10358",48131,"Texas","Duval County","A_AIC",62,60,-2,-3.28,"undercount"
"10359",48131,"Texas","Duval County","NHPI_A",13,0,-13,-200,"undercount"
"10360",48131,"Texas","Duval County","NHPI_AIC",15,3,-12,-133.33,"undercount"
"10361",48133,"Texas","Eastland County","A_A",138,98,-40,-33.9,"undercount"
"10362",48133,"Texas","Eastland County","A_AIC",178,149,-29,-17.74,"undercount"
"10363",48133,"Texas","Eastland County","NHPI_A",16,16,0,0,"equal"
"10364",48133,"Texas","Eastland County","NHPI_AIC",26,25,-1,-3.92,"undercount"
"10365",48135,"Texas","Ector County","A_A",2292,2279,-13,-0.57,"undercount"
"10366",48135,"Texas","Ector County","A_AIC",2698,2677,-21,-0.78,"undercount"
"10367",48135,"Texas","Ector County","NHPI_A",497,327,-170,-41.26,"undercount"
"10368",48135,"Texas","Ector County","NHPI_AIC",582,377,-205,-42.75,"undercount"
"10369",48137,"Texas","Edwards County","A_A",19,11,-8,-53.33,"undercount"
"10370",48137,"Texas","Edwards County","A_AIC",23,19,-4,-19.05,"undercount"
"10371",48137,"Texas","Edwards County","NHPI_A",0,1,1,200,"overcount"
"10372",48137,"Texas","Edwards County","NHPI_AIC",0,6,6,200,"overcount"
"10373",48139,"Texas","Ellis County","A_A",1781,1536,-245,-14.77,"undercount"
"10374",48139,"Texas","Ellis County","A_AIC",2632,2402,-230,-9.14,"undercount"
"10375",48139,"Texas","Ellis County","NHPI_A",244,202,-42,-18.83,"undercount"
"10376",48139,"Texas","Ellis County","NHPI_AIC",426,370,-56,-14.07,"undercount"
"10377",48141,"Texas","El Paso County","A_A",11972,10826,-1146,-10.05,"undercount"
"10378",48141,"Texas","El Paso County","A_AIC",17064,14296,-2768,-17.65,"undercount"
"10379",48141,"Texas","El Paso County","NHPI_A",1957,1544,-413,-23.59,"undercount"
"10380",48141,"Texas","El Paso County","NHPI_AIC",2975,2265,-710,-27.1,"undercount"
"10381",48143,"Texas","Erath County","A_A",498,349,-149,-35.18,"undercount"
"10382",48143,"Texas","Erath County","A_AIC",615,511,-104,-18.47,"undercount"
"10383",48143,"Texas","Erath County","NHPI_A",53,13,-40,-121.21,"undercount"
"10384",48143,"Texas","Erath County","NHPI_AIC",85,66,-19,-25.17,"undercount"
"10385",48145,"Texas","Falls County","A_A",104,51,-53,-68.39,"undercount"
"10386",48145,"Texas","Falls County","A_AIC",146,79,-67,-59.56,"undercount"
"10387",48145,"Texas","Falls County","NHPI_A",41,8,-33,-134.69,"undercount"
"10388",48145,"Texas","Falls County","NHPI_AIC",57,12,-45,-130.43,"undercount"
"10389",48147,"Texas","Fannin County","A_A",287,145,-142,-65.74,"undercount"
"10390",48147,"Texas","Fannin County","A_AIC",382,284,-98,-29.43,"undercount"
"10391",48147,"Texas","Fannin County","NHPI_A",29,20,-9,-36.73,"undercount"
"10392",48147,"Texas","Fannin County","NHPI_AIC",67,29,-38,-79.17,"undercount"
"10393",48149,"Texas","Fayette County","A_A",119,68,-51,-54.55,"undercount"
"10394",48149,"Texas","Fayette County","A_AIC",157,109,-48,-36.09,"undercount"
"10395",48149,"Texas","Fayette County","NHPI_A",19,6,-13,-104,"undercount"
"10396",48149,"Texas","Fayette County","NHPI_AIC",34,17,-17,-66.67,"undercount"
"10397",48151,"Texas","Fisher County","A_A",20,13,-7,-42.42,"undercount"
"10398",48151,"Texas","Fisher County","A_AIC",27,18,-9,-40,"undercount"
"10399",48151,"Texas","Fisher County","NHPI_A",0,2,2,200,"overcount"
"10400",48151,"Texas","Fisher County","NHPI_AIC",3,7,4,80,"overcount"
"10401",48153,"Texas","Floyd County","A_A",28,12,-16,-80,"undercount"
"10402",48153,"Texas","Floyd County","A_AIC",40,33,-7,-19.18,"undercount"
"10403",48153,"Texas","Floyd County","NHPI_A",3,1,-2,-100,"undercount"
"10404",48153,"Texas","Floyd County","NHPI_AIC",8,6,-2,-28.57,"undercount"
"10405",48155,"Texas","Foard County","A_A",12,3,-9,-120,"undercount"
"10406",48155,"Texas","Foard County","A_AIC",14,5,-9,-94.74,"undercount"
"10407",48155,"Texas","Foard County","NHPI_A",0,1,1,200,"overcount"
"10408",48155,"Texas","Foard County","NHPI_AIC",1,4,3,120,"overcount"
"10409",48157,"Texas","Fort Bend County","A_A",180564,182977,2413,1.33,"overcount"
"10410",48157,"Texas","Fort Bend County","A_AIC",190848,192533,1685,0.88,"overcount"
"10411",48157,"Texas","Fort Bend County","NHPI_A",838,299,-539,-94.81,"undercount"
"10412",48157,"Texas","Fort Bend County","NHPI_AIC",1817,1083,-734,-50.62,"undercount"
"10413",48159,"Texas","Franklin County","A_A",112,68,-44,-48.89,"undercount"
"10414",48159,"Texas","Franklin County","A_AIC",144,93,-51,-43.04,"undercount"
"10415",48159,"Texas","Franklin County","NHPI_A",8,6,-2,-28.57,"undercount"
"10416",48159,"Texas","Franklin County","NHPI_AIC",20,24,4,18.18,"overcount"
"10417",48161,"Texas","Freestone County","A_A",187,66,-121,-95.65,"undercount"
"10418",48161,"Texas","Freestone County","A_AIC",250,110,-140,-77.78,"undercount"
"10419",48161,"Texas","Freestone County","NHPI_A",13,11,-2,-16.67,"undercount"
"10420",48161,"Texas","Freestone County","NHPI_AIC",48,23,-25,-70.42,"undercount"
"10421",48163,"Texas","Frio County","A_A",569,224,-345,-87.01,"undercount"
"10422",48163,"Texas","Frio County","A_AIC",598,227,-371,-89.94,"undercount"
"10423",48163,"Texas","Frio County","NHPI_A",5,9,4,57.14,"overcount"
"10424",48163,"Texas","Frio County","NHPI_AIC",17,9,-8,-61.54,"undercount"
"10425",48165,"Texas","Gaines County","A_A",112,72,-40,-43.48,"undercount"
"10426",48165,"Texas","Gaines County","A_AIC",156,105,-51,-39.08,"undercount"
"10427",48165,"Texas","Gaines County","NHPI_A",8,3,-5,-90.91,"undercount"
"10428",48165,"Texas","Gaines County","NHPI_AIC",19,12,-7,-45.16,"undercount"
"10429",48167,"Texas","Galveston County","A_A",12205,12303,98,0.8,"overcount"
"10430",48167,"Texas","Galveston County","A_AIC",14726,14862,136,0.92,"overcount"
"10431",48167,"Texas","Galveston County","NHPI_A",340,247,-93,-31.69,"undercount"
"10432",48167,"Texas","Galveston County","NHPI_AIC",710,619,-91,-13.69,"undercount"
"10433",48169,"Texas","Garza County","A_A",41,25,-16,-48.48,"undercount"
"10434",48169,"Texas","Garza County","A_AIC",47,39,-8,-18.6,"undercount"
"10435",48169,"Texas","Garza County","NHPI_A",9,0,-9,-200,"undercount"
"10436",48169,"Texas","Garza County","NHPI_AIC",10,8,-2,-22.22,"undercount"
"10437",48171,"Texas","Gillespie County","A_A",153,131,-22,-15.49,"undercount"
"10438",48171,"Texas","Gillespie County","A_AIC",192,195,3,1.55,"overcount"
"10439",48171,"Texas","Gillespie County","NHPI_A",35,1,-34,-188.89,"undercount"
"10440",48171,"Texas","Gillespie County","NHPI_AIC",48,18,-30,-90.91,"undercount"
"10441",48173,"Texas","Glasscock County","A_A",2,0,-2,-200,"undercount"
"10442",48173,"Texas","Glasscock County","A_AIC",3,0,-3,-200,"undercount"
"10443",48173,"Texas","Glasscock County","NHPI_A",2,3,1,40,"overcount"
"10444",48173,"Texas","Glasscock County","NHPI_AIC",2,3,1,40,"overcount"
"10445",48175,"Texas","Goliad County","A_A",50,27,-23,-59.74,"undercount"
"10446",48175,"Texas","Goliad County","A_AIC",70,50,-20,-33.33,"undercount"
"10447",48175,"Texas","Goliad County","NHPI_A",2,0,-2,-200,"undercount"
"10448",48175,"Texas","Goliad County","NHPI_AIC",8,7,-1,-13.33,"undercount"
"10449",48177,"Texas","Gonzales County","A_A",127,70,-57,-57.87,"undercount"
"10450",48177,"Texas","Gonzales County","A_AIC",163,105,-58,-43.28,"undercount"
"10451",48177,"Texas","Gonzales County","NHPI_A",33,6,-27,-138.46,"undercount"
"10452",48177,"Texas","Gonzales County","NHPI_AIC",42,19,-23,-75.41,"undercount"
"10453",48179,"Texas","Gray County","A_A",169,127,-42,-28.38,"undercount"
"10454",48179,"Texas","Gray County","A_AIC",236,173,-63,-30.81,"undercount"
"10455",48179,"Texas","Gray County","NHPI_A",2,0,-2,-200,"undercount"
"10456",48179,"Texas","Gray County","NHPI_AIC",20,12,-8,-50,"undercount"
"10457",48181,"Texas","Grayson County","A_A",2075,1970,-105,-5.19,"undercount"
"10458",48181,"Texas","Grayson County","A_AIC",2800,2565,-235,-8.76,"undercount"
"10459",48181,"Texas","Grayson County","NHPI_A",117,59,-58,-65.91,"undercount"
"10460",48181,"Texas","Grayson County","NHPI_AIC",254,177,-77,-35.73,"undercount"
"10461",48183,"Texas","Gregg County","A_A",1736,1633,-103,-6.11,"undercount"
"10462",48183,"Texas","Gregg County","A_AIC",2288,2068,-220,-10.1,"undercount"
"10463",48183,"Texas","Gregg County","NHPI_A",131,50,-81,-89.5,"undercount"
"10464",48183,"Texas","Gregg County","NHPI_AIC",291,114,-177,-87.41,"undercount"
"10465",48185,"Texas","Grimes County","A_A",130,126,-4,-3.12,"undercount"
"10466",48185,"Texas","Grimes County","A_AIC",199,197,-2,-1.01,"undercount"
"10467",48185,"Texas","Grimes County","NHPI_A",36,8,-28,-127.27,"undercount"
"10468",48185,"Texas","Grimes County","NHPI_AIC",56,18,-38,-102.7,"undercount"
"10469",48187,"Texas","Guadalupe County","A_A",3516,3164,-352,-10.54,"undercount"
"10470",48187,"Texas","Guadalupe County","A_AIC",5411,4947,-464,-8.96,"undercount"
"10471",48187,"Texas","Guadalupe County","NHPI_A",458,369,-89,-21.52,"undercount"
"10472",48187,"Texas","Guadalupe County","NHPI_AIC",817,656,-161,-21.86,"undercount"
"10473",48189,"Texas","Hale County","A_A",215,153,-62,-33.7,"undercount"
"10474",48189,"Texas","Hale County","A_AIC",315,211,-104,-39.54,"undercount"
"10475",48189,"Texas","Hale County","NHPI_A",65,30,-35,-73.68,"undercount"
"10476",48189,"Texas","Hale County","NHPI_AIC",99,49,-50,-67.57,"undercount"
"10477",48191,"Texas","Hall County","A_A",14,9,-5,-43.48,"undercount"
"10478",48191,"Texas","Hall County","A_AIC",22,19,-3,-14.63,"undercount"
"10479",48191,"Texas","Hall County","NHPI_A",3,0,-3,-200,"undercount"
"10480",48191,"Texas","Hall County","NHPI_AIC",3,4,1,28.57,"overcount"
"10481",48193,"Texas","Hamilton County","A_A",74,37,-37,-66.67,"undercount"
"10482",48193,"Texas","Hamilton County","A_AIC",96,48,-48,-66.67,"undercount"
"10483",48193,"Texas","Hamilton County","NHPI_A",6,2,-4,-100,"undercount"
"10484",48193,"Texas","Hamilton County","NHPI_AIC",10,6,-4,-50,"undercount"
"10485",48195,"Texas","Hansford County","A_A",25,9,-16,-94.12,"undercount"
"10486",48195,"Texas","Hansford County","A_AIC",37,10,-27,-114.89,"undercount"
"10487",48195,"Texas","Hansford County","NHPI_A",3,3,0,0,"equal"
"10488",48195,"Texas","Hansford County","NHPI_AIC",3,4,1,28.57,"overcount"
"10489",48197,"Texas","Hardeman County","A_A",27,18,-9,-40,"undercount"
"10490",48197,"Texas","Hardeman County","A_AIC",45,26,-19,-53.52,"undercount"
"10491",48197,"Texas","Hardeman County","NHPI_A",0,1,1,200,"overcount"
"10492",48197,"Texas","Hardeman County","NHPI_AIC",6,6,0,0,"equal"
"10493",48199,"Texas","Hardin County","A_A",469,411,-58,-13.18,"undercount"
"10494",48199,"Texas","Hardin County","A_AIC",652,597,-55,-8.81,"undercount"
"10495",48199,"Texas","Hardin County","NHPI_A",16,37,21,79.25,"overcount"
"10496",48199,"Texas","Hardin County","NHPI_AIC",51,81,30,45.45,"overcount"
"10497",48201,"Texas","Harris County","A_A",353338,348281,-5057,-1.44,"undercount"
"10498",48201,"Texas","Harris County","A_AIC",390805,382276,-8529,-2.21,"undercount"
"10499",48201,"Texas","Harris County","NHPI_A",5552,3374,-2178,-48.8,"undercount"
"10500",48201,"Texas","Harris County","NHPI_AIC",11238,7573,-3665,-38.97,"undercount"
"10501",48203,"Texas","Harrison County","A_A",510,489,-21,-4.2,"undercount"
"10502",48203,"Texas","Harrison County","A_AIC",697,694,-3,-0.43,"undercount"
"10503",48203,"Texas","Harrison County","NHPI_A",79,33,-46,-82.14,"undercount"
"10504",48203,"Texas","Harrison County","NHPI_AIC",132,80,-52,-49.06,"undercount"
"10505",48205,"Texas","Hartley County","A_A",46,24,-22,-62.86,"undercount"
"10506",48205,"Texas","Hartley County","A_AIC",55,28,-27,-65.06,"undercount"
"10507",48205,"Texas","Hartley County","NHPI_A",2,5,3,85.71,"overcount"
"10508",48205,"Texas","Hartley County","NHPI_AIC",6,10,4,50,"overcount"
"10509",48207,"Texas","Haskell County","A_A",53,22,-31,-82.67,"undercount"
"10510",48207,"Texas","Haskell County","A_AIC",82,30,-52,-92.86,"undercount"
"10511",48207,"Texas","Haskell County","NHPI_A",0,5,5,200,"overcount"
"10512",48207,"Texas","Haskell County","NHPI_AIC",15,6,-9,-85.71,"undercount"
"10513",48209,"Texas","Hays County","A_A",4492,4890,398,8.48,"overcount"
"10514",48209,"Texas","Hays County","A_AIC",6481,9409,2928,36.85,"overcount"
"10515",48209,"Texas","Hays County","NHPI_A",359,146,-213,-84.36,"undercount"
"10516",48209,"Texas","Hays County","NHPI_AIC",653,2790,2137,124.14,"overcount"
"10517",48211,"Texas","Hemphill County","A_A",55,10,-45,-138.46,"undercount"
"10518",48211,"Texas","Hemphill County","A_AIC",68,31,-37,-74.75,"undercount"
"10519",48211,"Texas","Hemphill County","NHPI_A",6,0,-6,-200,"undercount"
"10520",48211,"Texas","Hemphill County","NHPI_AIC",8,3,-5,-90.91,"undercount"
"10521",48213,"Texas","Henderson County","A_A",572,510,-62,-11.46,"undercount"
"10522",48213,"Texas","Henderson County","A_AIC",751,733,-18,-2.43,"undercount"
"10523",48213,"Texas","Henderson County","NHPI_A",84,31,-53,-92.17,"undercount"
"10524",48213,"Texas","Henderson County","NHPI_AIC",134,106,-28,-23.33,"undercount"
"10525",48215,"Texas","Hidalgo County","A_A",9384,8831,-553,-6.07,"undercount"
"10526",48215,"Texas","Hidalgo County","A_AIC",10639,9395,-1244,-12.42,"undercount"
"10527",48215,"Texas","Hidalgo County","NHPI_A",443,78,-365,-140.12,"undercount"
"10528",48215,"Texas","Hidalgo County","NHPI_AIC",765,173,-592,-126.23,"undercount"
"10529",48217,"Texas","Hill County","A_A",283,188,-95,-40.34,"undercount"
"10530",48217,"Texas","Hill County","A_AIC",383,260,-123,-38.26,"undercount"
"10531",48217,"Texas","Hill County","NHPI_A",51,15,-36,-109.09,"undercount"
"10532",48217,"Texas","Hill County","NHPI_AIC",86,38,-48,-77.42,"undercount"
"10533",48219,"Texas","Hockley County","A_A",110,52,-58,-71.6,"undercount"
"10534",48219,"Texas","Hockley County","A_AIC",165,70,-95,-80.85,"undercount"
"10535",48219,"Texas","Hockley County","NHPI_A",18,4,-14,-127.27,"undercount"
"10536",48219,"Texas","Hockley County","NHPI_AIC",33,13,-20,-86.96,"undercount"
"10537",48221,"Texas","Hood County","A_A",542,471,-71,-14.02,"undercount"
"10538",48221,"Texas","Hood County","A_AIC",702,713,11,1.55,"overcount"
"10539",48221,"Texas","Hood County","NHPI_A",63,53,-10,-17.24,"undercount"
"10540",48221,"Texas","Hood County","NHPI_AIC",104,109,5,4.69,"overcount"
"10541",48223,"Texas","Hopkins County","A_A",284,284,0,0,"equal"
"10542",48223,"Texas","Hopkins County","A_AIC",397,376,-21,-5.43,"undercount"
"10543",48223,"Texas","Hopkins County","NHPI_A",53,4,-49,-171.93,"undercount"
"10544",48223,"Texas","Hopkins County","NHPI_AIC",74,56,-18,-27.69,"undercount"
"10545",48225,"Texas","Houston County","A_A",171,143,-28,-17.83,"undercount"
"10546",48225,"Texas","Houston County","A_AIC",221,174,-47,-23.8,"undercount"
"10547",48225,"Texas","Houston County","NHPI_A",2,8,6,120,"overcount"
"10548",48225,"Texas","Houston County","NHPI_AIC",18,18,0,0,"equal"
"10549",48227,"Texas","Howard County","A_A",496,397,-99,-22.17,"undercount"
"10550",48227,"Texas","Howard County","A_AIC",650,485,-165,-29.07,"undercount"
"10551",48227,"Texas","Howard County","NHPI_A",34,12,-22,-95.65,"undercount"
"10552",48227,"Texas","Howard County","NHPI_AIC",88,22,-66,-120,"undercount"
"10553",48229,"Texas","Hudspeth County","A_A",80,10,-70,-155.56,"undercount"
"10554",48229,"Texas","Hudspeth County","A_AIC",93,16,-77,-141.28,"undercount"
"10555",48229,"Texas","Hudspeth County","NHPI_A",8,0,-8,-200,"undercount"
"10556",48229,"Texas","Hudspeth County","NHPI_AIC",10,2,-8,-133.33,"undercount"
"10557",48231,"Texas","Hunt County","A_A",1564,1019,-545,-42.2,"undercount"
"10558",48231,"Texas","Hunt County","A_AIC",1923,1439,-484,-28.79,"undercount"
"10559",48231,"Texas","Hunt County","NHPI_A",214,154,-60,-32.61,"undercount"
"10560",48231,"Texas","Hunt County","NHPI_AIC",314,270,-44,-15.07,"undercount"
"10561",48233,"Texas","Hutchinson County","A_A",155,111,-44,-33.08,"undercount"
"10562",48233,"Texas","Hutchinson County","A_AIC",217,180,-37,-18.64,"undercount"
"10563",48233,"Texas","Hutchinson County","NHPI_A",13,2,-11,-146.67,"undercount"
"10564",48233,"Texas","Hutchinson County","NHPI_AIC",32,11,-21,-97.67,"undercount"
"10565",48235,"Texas","Irion County","A_A",8,2,-6,-120,"undercount"
"10566",48235,"Texas","Irion County","A_AIC",17,13,-4,-26.67,"undercount"
"10567",48235,"Texas","Irion County","NHPI_A",0,1,1,200,"overcount"
"10568",48235,"Texas","Irion County","NHPI_AIC",4,14,10,111.11,"overcount"
"10569",48237,"Texas","Jack County","A_A",54,41,-13,-27.37,"undercount"
"10570",48237,"Texas","Jack County","A_AIC",69,62,-7,-10.69,"undercount"
"10571",48237,"Texas","Jack County","NHPI_A",11,5,-6,-75,"undercount"
"10572",48237,"Texas","Jack County","NHPI_AIC",17,11,-6,-42.86,"undercount"
"10573",48239,"Texas","Jackson County","A_A",169,158,-11,-6.73,"undercount"
"10574",48239,"Texas","Jackson County","A_AIC",210,200,-10,-4.88,"undercount"
"10575",48239,"Texas","Jackson County","NHPI_A",5,5,0,0,"equal"
"10576",48239,"Texas","Jackson County","NHPI_AIC",18,19,1,5.41,"overcount"
"10577",48241,"Texas","Jasper County","A_A",221,121,-100,-58.48,"undercount"
"10578",48241,"Texas","Jasper County","A_AIC",299,182,-117,-48.65,"undercount"
"10579",48241,"Texas","Jasper County","NHPI_A",29,16,-13,-57.78,"undercount"
"10580",48241,"Texas","Jasper County","NHPI_AIC",57,34,-23,-50.55,"undercount"
"10581",48243,"Texas","Jeff Davis County","A_A",36,14,-22,-88,"undercount"
"10582",48243,"Texas","Jeff Davis County","A_AIC",43,25,-18,-52.94,"undercount"
"10583",48243,"Texas","Jeff Davis County","NHPI_A",2,0,-2,-200,"undercount"
"10584",48243,"Texas","Jeff Davis County","NHPI_AIC",3,16,13,136.84,"overcount"
"10585",48245,"Texas","Jefferson County","A_A",10001,10059,58,0.58,"overcount"
"10586",48245,"Texas","Jefferson County","A_AIC",11082,10981,-101,-0.92,"undercount"
"10587",48245,"Texas","Jefferson County","NHPI_A",245,84,-161,-97.87,"undercount"
"10588",48245,"Texas","Jefferson County","NHPI_AIC",575,196,-379,-98.31,"undercount"
"10589",48247,"Texas","Jim Hogg County","A_A",31,27,-4,-13.79,"undercount"
"10590",48247,"Texas","Jim Hogg County","A_AIC",39,31,-8,-22.86,"undercount"
"10591",48247,"Texas","Jim Hogg County","NHPI_A",2,5,3,85.71,"overcount"
"10592",48247,"Texas","Jim Hogg County","NHPI_AIC",5,14,9,94.74,"overcount"
"10593",48249,"Texas","Jim Wells County","A_A",259,143,-116,-57.71,"undercount"
"10594",48249,"Texas","Jim Wells County","A_AIC",320,173,-147,-59.63,"undercount"
"10595",48249,"Texas","Jim Wells County","NHPI_A",27,15,-12,-57.14,"undercount"
"10596",48249,"Texas","Jim Wells County","NHPI_AIC",57,20,-37,-96.1,"undercount"
"10597",48251,"Texas","Johnson County","A_A",1930,1737,-193,-10.53,"undercount"
"10598",48251,"Texas","Johnson County","A_AIC",2816,2597,-219,-8.09,"undercount"
"10599",48251,"Texas","Johnson County","NHPI_A",947,929,-18,-1.92,"undercount"
"10600",48251,"Texas","Johnson County","NHPI_AIC",1137,1130,-7,-0.62,"undercount"
"10601",48253,"Texas","Jones County","A_A",153,111,-42,-31.82,"undercount"
"10602",48253,"Texas","Jones County","A_AIC",250,147,-103,-51.89,"undercount"
"10603",48253,"Texas","Jones County","NHPI_A",4,4,0,0,"equal"
"10604",48253,"Texas","Jones County","NHPI_AIC",37,23,-14,-46.67,"undercount"
"10605",48255,"Texas","Karnes County","A_A",80,145,65,57.78,"overcount"
"10606",48255,"Texas","Karnes County","A_AIC",106,177,71,50.18,"overcount"
"10607",48255,"Texas","Karnes County","NHPI_A",6,1,-5,-142.86,"undercount"
"10608",48255,"Texas","Karnes County","NHPI_AIC",13,13,0,0,"equal"
"10609",48257,"Texas","Kaufman County","A_A",2364,2111,-253,-11.31,"undercount"
"10610",48257,"Texas","Kaufman County","A_AIC",2937,2774,-163,-5.71,"undercount"
"10611",48257,"Texas","Kaufman County","NHPI_A",142,70,-72,-67.92,"undercount"
"10612",48257,"Texas","Kaufman County","NHPI_AIC",310,211,-99,-38,"undercount"
"10613",48259,"Texas","Kendall County","A_A",701,380,-321,-59.39,"undercount"
"10614",48259,"Texas","Kendall County","A_AIC",968,685,-283,-34.24,"undercount"
"10615",48259,"Texas","Kendall County","NHPI_A",46,36,-10,-24.39,"undercount"
"10616",48259,"Texas","Kendall County","NHPI_AIC",91,85,-6,-6.82,"undercount"
"10617",48261,"Texas","Kenedy County","A_A",7,0,-7,-200,"undercount"
"10618",48261,"Texas","Kenedy County","A_AIC",7,3,-4,-80,"undercount"
"10619",48261,"Texas","Kenedy County","NHPI_A",0,1,1,200,"overcount"
"10620",48261,"Texas","Kenedy County","NHPI_AIC",0,5,5,200,"overcount"
"10621",48263,"Texas","Kent County","A_A",1,2,1,66.67,"overcount"
"10622",48263,"Texas","Kent County","A_AIC",4,6,2,40,"overcount"
"10623",48263,"Texas","Kent County","NHPI_A",1,0,-1,-200,"undercount"
"10624",48263,"Texas","Kent County","NHPI_AIC",3,4,1,28.57,"overcount"
"10625",48265,"Texas","Kerr County","A_A",691,576,-115,-18.15,"undercount"
"10626",48265,"Texas","Kerr County","A_AIC",854,754,-100,-12.44,"undercount"
"10627",48265,"Texas","Kerr County","NHPI_A",62,41,-21,-40.78,"undercount"
"10628",48265,"Texas","Kerr County","NHPI_AIC",113,86,-27,-27.14,"undercount"
"10629",48267,"Texas","Kimble County","A_A",38,33,-5,-14.08,"undercount"
"10630",48267,"Texas","Kimble County","A_AIC",45,49,4,8.51,"overcount"
"10631",48267,"Texas","Kimble County","NHPI_A",5,3,-2,-50,"undercount"
"10632",48267,"Texas","Kimble County","NHPI_AIC",7,15,8,72.73,"overcount"
"10633",48269,"Texas","King County","A_A",0,0,0,0,"equal"
"10634",48269,"Texas","King County","A_AIC",1,0,-1,-200,"undercount"
"10635",48269,"Texas","King County","NHPI_A",1,4,3,120,"overcount"
"10636",48269,"Texas","King County","NHPI_AIC",1,4,3,120,"overcount"
"10637",48271,"Texas","Kinney County","A_A",19,10,-9,-62.07,"undercount"
"10638",48271,"Texas","Kinney County","A_AIC",33,35,2,5.88,"overcount"
"10639",48271,"Texas","Kinney County","NHPI_A",7,2,-5,-111.11,"undercount"
"10640",48271,"Texas","Kinney County","NHPI_AIC",9,14,5,43.48,"overcount"
"10641",48273,"Texas","Kleberg County","A_A",753,807,54,6.92,"overcount"
"10642",48273,"Texas","Kleberg County","A_AIC",873,890,17,1.93,"overcount"
"10643",48273,"Texas","Kleberg County","NHPI_A",52,1,-51,-192.45,"undercount"
"10644",48273,"Texas","Kleberg County","NHPI_AIC",88,9,-79,-162.89,"undercount"
"10645",48275,"Texas","Knox County","A_A",12,24,12,66.67,"overcount"
"10646",48275,"Texas","Knox County","A_AIC",29,29,0,0,"equal"
"10647",48275,"Texas","Knox County","NHPI_A",2,3,1,40,"overcount"
"10648",48275,"Texas","Knox County","NHPI_AIC",10,5,-5,-66.67,"undercount"
"10649",48277,"Texas","Lamar County","A_A",421,474,53,11.84,"overcount"
"10650",48277,"Texas","Lamar County","A_AIC",615,599,-16,-2.64,"undercount"
"10651",48277,"Texas","Lamar County","NHPI_A",40,26,-14,-42.42,"undercount"
"10652",48277,"Texas","Lamar County","NHPI_AIC",127,50,-77,-87.01,"undercount"
"10653",48279,"Texas","Lamb County","A_A",81,5,-76,-176.74,"undercount"
"10654",48279,"Texas","Lamb County","A_AIC",116,30,-86,-117.81,"undercount"
"10655",48279,"Texas","Lamb County","NHPI_A",21,5,-16,-123.08,"undercount"
"10656",48279,"Texas","Lamb County","NHPI_AIC",33,22,-11,-40,"undercount"
"10657",48281,"Texas","Lampasas County","A_A",319,254,-65,-22.69,"undercount"
"10658",48281,"Texas","Lampasas County","A_AIC",510,469,-41,-8.38,"undercount"
"10659",48281,"Texas","Lampasas County","NHPI_A",120,86,-34,-33.01,"undercount"
"10660",48281,"Texas","Lampasas County","NHPI_AIC",168,156,-12,-7.41,"undercount"
"10661",48283,"Texas","La Salle County","A_A",33,4,-29,-156.76,"undercount"
"10662",48283,"Texas","La Salle County","A_AIC",46,18,-28,-87.5,"undercount"
"10663",48283,"Texas","La Salle County","NHPI_A",2,0,-2,-200,"undercount"
"10664",48283,"Texas","La Salle County","NHPI_AIC",8,0,-8,-200,"undercount"
"10665",48285,"Texas","Lavaca County","A_A",112,77,-35,-37.04,"undercount"
"10666",48285,"Texas","Lavaca County","A_AIC",150,105,-45,-35.29,"undercount"
"10667",48285,"Texas","Lavaca County","NHPI_A",18,5,-13,-113.04,"undercount"
"10668",48285,"Texas","Lavaca County","NHPI_AIC",27,12,-15,-76.92,"undercount"
"10669",48287,"Texas","Lee County","A_A",98,57,-41,-52.9,"undercount"
"10670",48287,"Texas","Lee County","A_AIC",153,102,-51,-40,"undercount"
"10671",48287,"Texas","Lee County","NHPI_A",40,1,-39,-190.24,"undercount"
"10672",48287,"Texas","Lee County","NHPI_AIC",59,10,-49,-142.03,"undercount"
"10673",48289,"Texas","Leon County","A_A",140,112,-28,-22.22,"undercount"
"10674",48289,"Texas","Leon County","A_AIC",178,145,-33,-20.43,"undercount"
"10675",48289,"Texas","Leon County","NHPI_A",3,7,4,80,"overcount"
"10676",48289,"Texas","Leon County","NHPI_AIC",12,15,3,22.22,"overcount"
"10677",48291,"Texas","Liberty County","A_A",659,487,-172,-30.02,"undercount"
"10678",48291,"Texas","Liberty County","A_AIC",905,639,-266,-34.46,"undercount"
"10679",48291,"Texas","Liberty County","NHPI_A",105,13,-92,-155.93,"undercount"
"10680",48291,"Texas","Liberty County","NHPI_AIC",203,82,-121,-84.91,"undercount"
"10681",48293,"Texas","Limestone County","A_A",230,160,-70,-35.9,"undercount"
"10682",48293,"Texas","Limestone County","A_AIC",286,205,-81,-32.99,"undercount"
"10683",48293,"Texas","Limestone County","NHPI_A",19,18,-1,-5.41,"undercount"
"10684",48293,"Texas","Limestone County","NHPI_AIC",36,32,-4,-11.76,"undercount"
"10685",48295,"Texas","Lipscomb County","A_A",28,2,-26,-173.33,"undercount"
"10686",48295,"Texas","Lipscomb County","A_AIC",46,7,-39,-147.17,"undercount"
"10687",48295,"Texas","Lipscomb County","NHPI_A",7,0,-7,-200,"undercount"
"10688",48295,"Texas","Lipscomb County","NHPI_AIC",12,4,-8,-100,"undercount"
"10689",48297,"Texas","Live Oak County","A_A",108,35,-73,-102.1,"undercount"
"10690",48297,"Texas","Live Oak County","A_AIC",134,49,-85,-92.9,"undercount"
"10691",48297,"Texas","Live Oak County","NHPI_A",10,6,-4,-50,"undercount"
"10692",48297,"Texas","Live Oak County","NHPI_AIC",21,16,-5,-27.03,"undercount"
"10693",48299,"Texas","Llano County","A_A",145,121,-24,-18.05,"undercount"
"10694",48299,"Texas","Llano County","A_AIC",191,175,-16,-8.74,"undercount"
"10695",48299,"Texas","Llano County","NHPI_A",10,4,-6,-85.71,"undercount"
"10696",48299,"Texas","Llano County","NHPI_AIC",26,12,-14,-73.68,"undercount"
"10697",48301,"Texas","Loving County","A_A",0,0,0,0,"equal"
"10698",48301,"Texas","Loving County","A_AIC",0,2,2,200,"overcount"
"10699",48301,"Texas","Loving County","NHPI_A",0,0,0,0,"equal"
"10700",48301,"Texas","Loving County","NHPI_AIC",0,2,2,200,"overcount"
"10701",48303,"Texas","Lubbock County","A_A",7555,9544,1989,23.26,"overcount"
"10702",48303,"Texas","Lubbock County","A_AIC",9307,10953,1646,16.25,"overcount"
"10703",48303,"Texas","Lubbock County","NHPI_A",443,186,-257,-81.72,"undercount"
"10704",48303,"Texas","Lubbock County","NHPI_AIC",901,378,-523,-81.78,"undercount"
"10705",48305,"Texas","Lynn County","A_A",24,10,-14,-82.35,"undercount"
"10706",48305,"Texas","Lynn County","A_AIC",42,28,-14,-40,"undercount"
"10707",48305,"Texas","Lynn County","NHPI_A",1,4,3,120,"overcount"
"10708",48305,"Texas","Lynn County","NHPI_AIC",7,16,9,78.26,"overcount"
"10709",48307,"Texas","McCulloch County","A_A",61,39,-22,-44,"undercount"
"10710",48307,"Texas","McCulloch County","A_AIC",87,51,-36,-52.17,"undercount"
"10711",48307,"Texas","McCulloch County","NHPI_A",7,0,-7,-200,"undercount"
"10712",48307,"Texas","McCulloch County","NHPI_AIC",16,8,-8,-66.67,"undercount"
"10713",48309,"Texas","McLennan County","A_A",4713,4911,198,4.11,"overcount"
"10714",48309,"Texas","McLennan County","A_AIC",6341,6386,45,0.71,"overcount"
"10715",48309,"Texas","McLennan County","NHPI_A",309,150,-159,-69.28,"undercount"
"10716",48309,"Texas","McLennan County","NHPI_AIC",610,378,-232,-46.96,"undercount"
"10717",48311,"Texas","McMullen County","A_A",4,3,-1,-28.57,"undercount"
"10718",48311,"Texas","McMullen County","A_AIC",5,10,5,66.67,"overcount"
"10719",48311,"Texas","McMullen County","NHPI_A",0,5,5,200,"overcount"
"10720",48311,"Texas","McMullen County","NHPI_AIC",1,7,6,150,"overcount"
"10721",48313,"Texas","Madison County","A_A",165,101,-64,-48.12,"undercount"
"10722",48313,"Texas","Madison County","A_AIC",207,117,-90,-55.56,"undercount"
"10723",48313,"Texas","Madison County","NHPI_A",12,0,-12,-200,"undercount"
"10724",48313,"Texas","Madison County","NHPI_AIC",31,4,-27,-154.29,"undercount"
"10725",48315,"Texas","Marion County","A_A",94,48,-46,-64.79,"undercount"
"10726",48315,"Texas","Marion County","A_AIC",129,78,-51,-49.28,"undercount"
"10727",48315,"Texas","Marion County","NHPI_A",3,0,-3,-200,"undercount"
"10728",48315,"Texas","Marion County","NHPI_AIC",12,9,-3,-28.57,"undercount"
"10729",48317,"Texas","Martin County","A_A",34,9,-25,-116.28,"undercount"
"10730",48317,"Texas","Martin County","A_AIC",50,21,-29,-81.69,"undercount"
"10731",48317,"Texas","Martin County","NHPI_A",5,1,-4,-133.33,"undercount"
"10732",48317,"Texas","Martin County","NHPI_AIC",5,9,4,57.14,"overcount"
"10733",48319,"Texas","Mason County","A_A",11,2,-9,-138.46,"undercount"
"10734",48319,"Texas","Mason County","A_AIC",19,15,-4,-23.53,"undercount"
"10735",48319,"Texas","Mason County","NHPI_A",11,0,-11,-200,"undercount"
"10736",48319,"Texas","Mason County","NHPI_AIC",12,10,-2,-18.18,"undercount"
"10737",48321,"Texas","Matagorda County","A_A",694,705,11,1.57,"overcount"
"10738",48321,"Texas","Matagorda County","A_AIC",833,795,-38,-4.67,"undercount"
"10739",48321,"Texas","Matagorda County","NHPI_A",55,7,-48,-154.84,"undercount"
"10740",48321,"Texas","Matagorda County","NHPI_AIC",103,22,-81,-129.6,"undercount"
"10741",48323,"Texas","Maverick County","A_A",375,186,-189,-67.38,"undercount"
"10742",48323,"Texas","Maverick County","A_AIC",453,199,-254,-77.91,"undercount"
"10743",48323,"Texas","Maverick County","NHPI_A",20,4,-16,-133.33,"undercount"
"10744",48323,"Texas","Maverick County","NHPI_AIC",39,16,-23,-83.64,"undercount"
"10745",48325,"Texas","Medina County","A_A",432,216,-216,-66.67,"undercount"
"10746",48325,"Texas","Medina County","A_AIC",626,392,-234,-45.97,"undercount"
"10747",48325,"Texas","Medina County","NHPI_A",111,38,-73,-97.99,"undercount"
"10748",48325,"Texas","Medina County","NHPI_AIC",161,68,-93,-81.22,"undercount"
"10749",48327,"Texas","Menard County","A_A",7,6,-1,-15.38,"undercount"
"10750",48327,"Texas","Menard County","A_AIC",13,8,-5,-47.62,"undercount"
"10751",48327,"Texas","Menard County","NHPI_A",0,3,3,200,"overcount"
"10752",48327,"Texas","Menard County","NHPI_AIC",1,5,4,133.33,"overcount"
"10753",48329,"Texas","Midland County","A_A",4127,3946,-181,-4.48,"undercount"
"10754",48329,"Texas","Midland County","A_AIC",4721,4551,-170,-3.67,"undercount"
"10755",48329,"Texas","Midland County","NHPI_A",226,152,-74,-39.15,"undercount"
"10756",48329,"Texas","Midland County","NHPI_AIC",353,230,-123,-42.2,"undercount"
"10757",48331,"Texas","Milam County","A_A",209,111,-98,-61.25,"undercount"
"10758",48331,"Texas","Milam County","A_AIC",268,166,-102,-47,"undercount"
"10759",48331,"Texas","Milam County","NHPI_A",18,11,-7,-48.28,"undercount"
"10760",48331,"Texas","Milam County","NHPI_AIC",30,33,3,9.52,"overcount"
"10761",48333,"Texas","Mills County","A_A",31,8,-23,-117.95,"undercount"
"10762",48333,"Texas","Mills County","A_AIC",47,24,-23,-64.79,"undercount"
"10763",48333,"Texas","Mills County","NHPI_A",1,0,-1,-200,"undercount"
"10764",48333,"Texas","Mills County","NHPI_AIC",5,3,-2,-50,"undercount"
"10765",48335,"Texas","Mitchell County","A_A",70,55,-15,-24,"undercount"
"10766",48335,"Texas","Mitchell County","A_AIC",117,62,-55,-61.45,"undercount"
"10767",48335,"Texas","Mitchell County","NHPI_A",12,1,-11,-169.23,"undercount"
"10768",48335,"Texas","Mitchell County","NHPI_AIC",25,9,-16,-94.12,"undercount"
"10769",48337,"Texas","Montague County","A_A",102,85,-17,-18.18,"undercount"
"10770",48337,"Texas","Montague County","A_AIC",150,125,-25,-18.18,"undercount"
"10771",48337,"Texas","Montague County","NHPI_A",12,8,-4,-40,"undercount"
"10772",48337,"Texas","Montague County","NHPI_AIC",21,17,-4,-21.05,"undercount"
"10773",48339,"Texas","Montgomery County","A_A",21555,21719,164,0.76,"overcount"
"10774",48339,"Texas","Montgomery County","A_AIC",26040,26623,583,2.21,"overcount"
"10775",48339,"Texas","Montgomery County","NHPI_A",741,634,-107,-15.56,"undercount"
"10776",48339,"Texas","Montgomery County","NHPI_AIC",1515,1379,-136,-9.4,"undercount"
"10777",48341,"Texas","Moore County","A_A",1166,1004,-162,-14.93,"undercount"
"10778",48341,"Texas","Moore County","A_AIC",1238,1048,-190,-16.62,"undercount"
"10779",48341,"Texas","Moore County","NHPI_A",54,13,-41,-122.39,"undercount"
"10780",48341,"Texas","Moore County","NHPI_AIC",69,23,-46,-100,"undercount"
"10781",48343,"Texas","Morris County","A_A",87,37,-50,-80.65,"undercount"
"10782",48343,"Texas","Morris County","A_AIC",137,77,-60,-56.07,"undercount"
"10783",48343,"Texas","Morris County","NHPI_A",16,9,-7,-56,"undercount"
"10784",48343,"Texas","Morris County","NHPI_AIC",28,25,-3,-11.32,"undercount"
"10785",48345,"Texas","Motley County","A_A",2,0,-2,-200,"undercount"
"10786",48345,"Texas","Motley County","A_AIC",4,12,8,100,"overcount"
"10787",48345,"Texas","Motley County","NHPI_A",2,0,-2,-200,"undercount"
"10788",48345,"Texas","Motley County","NHPI_AIC",2,8,6,120,"overcount"
"10789",48347,"Texas","Nacogdoches County","A_A",856,764,-92,-11.36,"undercount"
"10790",48347,"Texas","Nacogdoches County","A_AIC",1100,1034,-66,-6.19,"undercount"
"10791",48347,"Texas","Nacogdoches County","NHPI_A",38,10,-28,-116.67,"undercount"
"10792",48347,"Texas","Nacogdoches County","NHPI_AIC",92,47,-45,-64.75,"undercount"
"10793",48349,"Texas","Navarro County","A_A",432,394,-38,-9.2,"undercount"
"10794",48349,"Texas","Navarro County","A_AIC",620,527,-93,-16.22,"undercount"
"10795",48349,"Texas","Navarro County","NHPI_A",927,735,-192,-23.1,"undercount"
"10796",48349,"Texas","Navarro County","NHPI_AIC",993,793,-200,-22.4,"undercount"
"10797",48351,"Texas","Newton County","A_A",74,31,-43,-81.9,"undercount"
"10798",48351,"Texas","Newton County","A_AIC",114,48,-66,-81.48,"undercount"
"10799",48351,"Texas","Newton County","NHPI_A",3,0,-3,-200,"undercount"
"10800",48351,"Texas","Newton County","NHPI_AIC",19,13,-6,-37.5,"undercount"
"10801",48353,"Texas","Nolan County","A_A",146,103,-43,-34.54,"undercount"
"10802",48353,"Texas","Nolan County","A_AIC",179,116,-63,-42.71,"undercount"
"10803",48353,"Texas","Nolan County","NHPI_A",21,2,-19,-165.22,"undercount"
"10804",48353,"Texas","Nolan County","NHPI_AIC",27,10,-17,-91.89,"undercount"
"10805",48355,"Texas","Nueces County","A_A",8263,7778,-485,-6.05,"undercount"
"10806",48355,"Texas","Nueces County","A_AIC",10274,9471,-803,-8.13,"undercount"
"10807",48355,"Texas","Nueces County","NHPI_A",585,281,-304,-70.21,"undercount"
"10808",48355,"Texas","Nueces County","NHPI_AIC",998,548,-450,-58.21,"undercount"
"10809",48357,"Texas","Ochiltree County","A_A",63,30,-33,-70.97,"undercount"
"10810",48357,"Texas","Ochiltree County","A_AIC",86,42,-44,-68.75,"undercount"
"10811",48357,"Texas","Ochiltree County","NHPI_A",8,3,-5,-90.91,"undercount"
"10812",48357,"Texas","Ochiltree County","NHPI_AIC",13,12,-1,-8,"undercount"
"10813",48359,"Texas","Oldham County","A_A",34,10,-24,-109.09,"undercount"
"10814",48359,"Texas","Oldham County","A_AIC",48,29,-19,-49.35,"undercount"
"10815",48359,"Texas","Oldham County","NHPI_A",1,0,-1,-200,"undercount"
"10816",48359,"Texas","Oldham County","NHPI_AIC",2,11,9,138.46,"overcount"
"10817",48361,"Texas","Orange County","A_A",1019,1111,92,8.64,"overcount"
"10818",48361,"Texas","Orange County","A_AIC",1354,1403,49,3.55,"overcount"
"10819",48361,"Texas","Orange County","NHPI_A",87,13,-74,-148,"undercount"
"10820",48361,"Texas","Orange County","NHPI_AIC",127,54,-73,-80.66,"undercount"
"10821",48363,"Texas","Palo Pinto County","A_A",302,212,-90,-35.02,"undercount"
"10822",48363,"Texas","Palo Pinto County","A_AIC",384,317,-67,-19.12,"undercount"
"10823",48363,"Texas","Palo Pinto County","NHPI_A",28,14,-14,-66.67,"undercount"
"10824",48363,"Texas","Palo Pinto County","NHPI_AIC",51,43,-8,-17.02,"undercount"
"10825",48365,"Texas","Panola County","A_A",144,99,-45,-37.04,"undercount"
"10826",48365,"Texas","Panola County","A_AIC",209,143,-66,-37.5,"undercount"
"10827",48365,"Texas","Panola County","NHPI_A",15,7,-8,-72.73,"undercount"
"10828",48365,"Texas","Panola County","NHPI_AIC",39,24,-15,-47.62,"undercount"
"10829",48367,"Texas","Parker County","A_A",1082,990,-92,-8.88,"undercount"
"10830",48367,"Texas","Parker County","A_AIC",1742,1810,68,3.83,"overcount"
"10831",48367,"Texas","Parker County","NHPI_A",132,97,-35,-30.57,"undercount"
"10832",48367,"Texas","Parker County","NHPI_AIC",254,253,-1,-0.39,"undercount"
"10833",48369,"Texas","Parmer County","A_A",99,14,-85,-150.44,"undercount"
"10834",48369,"Texas","Parmer County","A_AIC",117,21,-96,-139.13,"undercount"
"10835",48369,"Texas","Parmer County","NHPI_A",35,0,-35,-200,"undercount"
"10836",48369,"Texas","Parmer County","NHPI_AIC",38,3,-35,-170.73,"undercount"
"10837",48371,"Texas","Pecos County","A_A",213,143,-70,-39.33,"undercount"
"10838",48371,"Texas","Pecos County","A_AIC",257,171,-86,-40.19,"undercount"
"10839",48371,"Texas","Pecos County","NHPI_A",25,0,-25,-200,"undercount"
"10840",48371,"Texas","Pecos County","NHPI_AIC",38,4,-34,-161.9,"undercount"
"10841",48373,"Texas","Polk County","A_A",444,342,-102,-25.95,"undercount"
"10842",48373,"Texas","Polk County","A_AIC",580,453,-127,-24.59,"undercount"
"10843",48373,"Texas","Polk County","NHPI_A",62,1,-61,-193.65,"undercount"
"10844",48373,"Texas","Polk County","NHPI_AIC",112,46,-66,-83.54,"undercount"
"10845",48375,"Texas","Potter County","A_A",6137,6079,-58,-0.95,"undercount"
"10846",48375,"Texas","Potter County","A_AIC",6703,6482,-221,-3.35,"undercount"
"10847",48375,"Texas","Potter County","NHPI_A",170,20,-150,-157.89,"undercount"
"10848",48375,"Texas","Potter County","NHPI_AIC",322,83,-239,-118.02,"undercount"
"10849",48377,"Texas","Presidio County","A_A",145,85,-60,-52.17,"undercount"
"10850",48377,"Texas","Presidio County","A_AIC",160,99,-61,-47.1,"undercount"
"10851",48377,"Texas","Presidio County","NHPI_A",2,0,-2,-200,"undercount"
"10852",48377,"Texas","Presidio County","NHPI_AIC",7,11,4,44.44,"overcount"
"10853",48379,"Texas","Rains County","A_A",110,58,-52,-61.9,"undercount"
"10854",48379,"Texas","Rains County","A_AIC",166,105,-61,-45.02,"undercount"
"10855",48379,"Texas","Rains County","NHPI_A",6,1,-5,-142.86,"undercount"
"10856",48379,"Texas","Rains County","NHPI_AIC",17,10,-7,-51.85,"undercount"
"10857",48381,"Texas","Randall County","A_A",2724,2649,-75,-2.79,"undercount"
"10858",48381,"Texas","Randall County","A_AIC",3432,3289,-143,-4.26,"undercount"
"10859",48381,"Texas","Randall County","NHPI_A",131,60,-71,-74.35,"undercount"
"10860",48381,"Texas","Randall County","NHPI_AIC",227,162,-65,-33.42,"undercount"
"10861",48383,"Texas","Reagan County","A_A",25,22,-3,-12.77,"undercount"
"10862",48383,"Texas","Reagan County","A_AIC",50,31,-19,-46.91,"undercount"
"10863",48383,"Texas","Reagan County","NHPI_A",1,2,1,66.67,"overcount"
"10864",48383,"Texas","Reagan County","NHPI_AIC",7,11,4,44.44,"overcount"
"10865",48385,"Texas","Real County","A_A",18,12,-6,-40,"undercount"
"10866",48385,"Texas","Real County","A_AIC",28,20,-8,-33.33,"undercount"
"10867",48385,"Texas","Real County","NHPI_A",12,3,-9,-120,"undercount"
"10868",48385,"Texas","Real County","NHPI_AIC",15,6,-9,-85.71,"undercount"
"10869",48387,"Texas","Red River County","A_A",48,53,5,9.9,"overcount"
"10870",48387,"Texas","Red River County","A_AIC",77,85,8,9.88,"overcount"
"10871",48387,"Texas","Red River County","NHPI_A",4,0,-4,-200,"undercount"
"10872",48387,"Texas","Red River County","NHPI_AIC",16,15,-1,-6.45,"undercount"
"10873",48389,"Texas","Reeves County","A_A",253,165,-88,-42.11,"undercount"
"10874",48389,"Texas","Reeves County","A_AIC",283,186,-97,-41.36,"undercount"
"10875",48389,"Texas","Reeves County","NHPI_A",12,3,-9,-120,"undercount"
"10876",48389,"Texas","Reeves County","NHPI_AIC",22,8,-14,-93.33,"undercount"
"10877",48391,"Texas","Refugio County","A_A",62,30,-32,-69.57,"undercount"
"10878",48391,"Texas","Refugio County","A_AIC",83,47,-36,-55.38,"undercount"
"10879",48391,"Texas","Refugio County","NHPI_A",3,1,-2,-100,"undercount"
"10880",48391,"Texas","Refugio County","NHPI_AIC",8,13,5,47.62,"overcount"
"10881",48393,"Texas","Roberts County","A_A",2,0,-2,-200,"undercount"
"10882",48393,"Texas","Roberts County","A_AIC",6,7,1,15.38,"overcount"
"10883",48393,"Texas","Roberts County","NHPI_A",0,0,0,0,"equal"
"10884",48393,"Texas","Roberts County","NHPI_AIC",2,5,3,85.71,"overcount"
"10885",48395,"Texas","Robertson County","A_A",150,104,-46,-36.22,"undercount"
"10886",48395,"Texas","Robertson County","A_AIC",201,128,-73,-44.38,"undercount"
"10887",48395,"Texas","Robertson County","NHPI_A",13,21,8,47.06,"overcount"
"10888",48395,"Texas","Robertson County","NHPI_AIC",25,24,-1,-4.08,"undercount"
"10889",48397,"Texas","Rockwall County","A_A",3664,3335,-329,-9.4,"undercount"
"10890",48397,"Texas","Rockwall County","A_AIC",4591,4313,-278,-6.24,"undercount"
"10891",48397,"Texas","Rockwall County","NHPI_A",133,75,-58,-55.77,"undercount"
"10892",48397,"Texas","Rockwall County","NHPI_AIC",269,171,-98,-44.55,"undercount"
"10893",48399,"Texas","Runnels County","A_A",112,29,-83,-117.73,"undercount"
"10894",48399,"Texas","Runnels County","A_AIC",141,61,-80,-79.21,"undercount"
"10895",48399,"Texas","Runnels County","NHPI_A",4,6,2,40,"overcount"
"10896",48399,"Texas","Runnels County","NHPI_AIC",10,38,28,116.67,"overcount"
"10897",48401,"Texas","Rusk County","A_A",385,254,-131,-41,"undercount"
"10898",48401,"Texas","Rusk County","A_AIC",544,358,-186,-41.24,"undercount"
"10899",48401,"Texas","Rusk County","NHPI_A",52,18,-34,-97.14,"undercount"
"10900",48401,"Texas","Rusk County","NHPI_AIC",90,42,-48,-72.73,"undercount"
"10901",48403,"Texas","Sabine County","A_A",46,52,6,12.24,"overcount"
"10902",48403,"Texas","Sabine County","A_AIC",83,75,-8,-10.13,"undercount"
"10903",48403,"Texas","Sabine County","NHPI_A",7,0,-7,-200,"undercount"
"10904",48403,"Texas","Sabine County","NHPI_AIC",16,14,-2,-13.33,"undercount"
"10905",48405,"Texas","San Augustine County","A_A",34,36,2,5.71,"overcount"
"10906",48405,"Texas","San Augustine County","A_AIC",58,49,-9,-16.82,"undercount"
"10907",48405,"Texas","San Augustine County","NHPI_A",1,0,-1,-200,"undercount"
"10908",48405,"Texas","San Augustine County","NHPI_AIC",6,6,0,0,"equal"
"10909",48407,"Texas","San Jacinto County","A_A",155,100,-55,-43.14,"undercount"
"10910",48407,"Texas","San Jacinto County","A_AIC",266,165,-101,-46.87,"undercount"
"10911",48407,"Texas","San Jacinto County","NHPI_A",32,15,-17,-72.34,"undercount"
"10912",48407,"Texas","San Jacinto County","NHPI_AIC",72,34,-38,-71.7,"undercount"
"10913",48409,"Texas","San Patricio County","A_A",853,855,2,0.23,"overcount"
"10914",48409,"Texas","San Patricio County","A_AIC",1123,1124,1,0.09,"overcount"
"10915",48409,"Texas","San Patricio County","NHPI_A",109,66,-43,-49.14,"undercount"
"10916",48409,"Texas","San Patricio County","NHPI_AIC",177,138,-39,-24.76,"undercount"
"10917",48411,"Texas","San Saba County","A_A",38,16,-22,-81.48,"undercount"
"10918",48411,"Texas","San Saba County","A_AIC",60,46,-14,-26.42,"undercount"
"10919",48411,"Texas","San Saba County","NHPI_A",0,3,3,200,"overcount"
"10920",48411,"Texas","San Saba County","NHPI_AIC",5,7,2,33.33,"overcount"
"10921",48413,"Texas","Schleicher County","A_A",17,11,-6,-42.86,"undercount"
"10922",48413,"Texas","Schleicher County","A_AIC",26,19,-7,-31.11,"undercount"
"10923",48413,"Texas","Schleicher County","NHPI_A",0,3,3,200,"overcount"
"10924",48413,"Texas","Schleicher County","NHPI_AIC",1,4,3,120,"overcount"
"10925",48415,"Texas","Scurry County","A_A",139,85,-54,-48.21,"undercount"
"10926",48415,"Texas","Scurry County","A_AIC",204,122,-82,-50.31,"undercount"
"10927",48415,"Texas","Scurry County","NHPI_A",10,5,-5,-66.67,"undercount"
"10928",48415,"Texas","Scurry County","NHPI_AIC",30,10,-20,-100,"undercount"
"10929",48417,"Texas","Shackelford County","A_A",19,14,-5,-30.3,"undercount"
"10930",48417,"Texas","Shackelford County","A_AIC",25,25,0,0,"equal"
"10931",48417,"Texas","Shackelford County","NHPI_A",2,0,-2,-200,"undercount"
"10932",48417,"Texas","Shackelford County","NHPI_AIC",4,7,3,54.55,"overcount"
"10933",48419,"Texas","Shelby County","A_A",375,364,-11,-2.98,"undercount"
"10934",48419,"Texas","Shelby County","A_AIC",451,426,-25,-5.7,"undercount"
"10935",48419,"Texas","Shelby County","NHPI_A",28,14,-14,-66.67,"undercount"
"10936",48419,"Texas","Shelby County","NHPI_AIC",47,34,-13,-32.1,"undercount"
"10937",48421,"Texas","Sherman County","A_A",28,2,-26,-173.33,"undercount"
"10938",48421,"Texas","Sherman County","A_AIC",36,9,-27,-120,"undercount"
"10939",48421,"Texas","Sherman County","NHPI_A",0,0,0,0,"equal"
"10940",48421,"Texas","Sherman County","NHPI_AIC",1,5,4,133.33,"overcount"
"10941",48423,"Texas","Smith County","A_A",3958,4153,195,4.81,"overcount"
"10942",48423,"Texas","Smith County","A_AIC",4911,5192,281,5.56,"overcount"
"10943",48423,"Texas","Smith County","NHPI_A",243,77,-166,-103.75,"undercount"
"10944",48423,"Texas","Smith County","NHPI_AIC",467,239,-228,-64.59,"undercount"
"10945",48425,"Texas","Somervell County","A_A",101,55,-46,-58.97,"undercount"
"10946",48425,"Texas","Somervell County","A_AIC",138,75,-63,-59.15,"undercount"
"10947",48425,"Texas","Somervell County","NHPI_A",4,0,-4,-200,"undercount"
"10948",48425,"Texas","Somervell County","NHPI_AIC",12,12,0,0,"equal"
"10949",48427,"Texas","Starr County","A_A",170,164,-6,-3.59,"undercount"
"10950",48427,"Texas","Starr County","A_AIC",207,175,-32,-16.75,"undercount"
"10951",48427,"Texas","Starr County","NHPI_A",17,0,-17,-200,"undercount"
"10952",48427,"Texas","Starr County","NHPI_AIC",34,14,-20,-83.33,"undercount"
"10953",48429,"Texas","Stephens County","A_A",80,67,-13,-17.69,"undercount"
"10954",48429,"Texas","Stephens County","A_AIC",114,86,-28,-28,"undercount"
"10955",48429,"Texas","Stephens County","NHPI_A",7,1,-6,-150,"undercount"
"10956",48429,"Texas","Stephens County","NHPI_AIC",18,23,5,24.39,"overcount"
"10957",48431,"Texas","Sterling County","A_A",6,3,-3,-66.67,"undercount"
"10958",48431,"Texas","Sterling County","A_AIC",11,17,6,42.86,"overcount"
"10959",48431,"Texas","Sterling County","NHPI_A",1,2,1,66.67,"overcount"
"10960",48431,"Texas","Sterling County","NHPI_AIC",1,6,5,142.86,"overcount"
"10961",48433,"Texas","Stonewall County","A_A",17,5,-12,-109.09,"undercount"
"10962",48433,"Texas","Stonewall County","A_AIC",21,7,-14,-100,"undercount"
"10963",48433,"Texas","Stonewall County","NHPI_A",0,0,0,0,"equal"
"10964",48433,"Texas","Stonewall County","NHPI_AIC",0,3,3,200,"overcount"
"10965",48435,"Texas","Sutton County","A_A",29,6,-23,-131.43,"undercount"
"10966",48435,"Texas","Sutton County","A_AIC",35,17,-18,-69.23,"undercount"
"10967",48435,"Texas","Sutton County","NHPI_A",1,0,-1,-200,"undercount"
"10968",48435,"Texas","Sutton County","NHPI_AIC",2,8,6,120,"overcount"
"10969",48437,"Texas","Swisher County","A_A",50,13,-37,-117.46,"undercount"
"10970",48437,"Texas","Swisher County","A_AIC",76,24,-52,-104,"undercount"
"10971",48437,"Texas","Swisher County","NHPI_A",6,0,-6,-200,"undercount"
"10972",48437,"Texas","Swisher County","NHPI_AIC",11,7,-4,-44.44,"undercount"
"10973",48439,"Texas","Tarrant County","A_A",127054,128780,1726,1.35,"overcount"
"10974",48439,"Texas","Tarrant County","A_AIC",146624,147369,745,0.51,"overcount"
"10975",48439,"Texas","Tarrant County","NHPI_A",5362,4293,-1069,-22.14,"undercount"
"10976",48439,"Texas","Tarrant County","NHPI_AIC",8450,7029,-1421,-18.36,"undercount"
"10977",48441,"Texas","Taylor County","A_A",3139,2839,-300,-10.04,"undercount"
"10978",48441,"Texas","Taylor County","A_AIC",4372,3950,-422,-10.14,"undercount"
"10979",48441,"Texas","Taylor County","NHPI_A",230,165,-65,-32.91,"undercount"
"10980",48441,"Texas","Taylor County","NHPI_AIC",441,350,-91,-23.01,"undercount"
"10981",48443,"Texas","Terrell County","A_A",9,5,-4,-57.14,"undercount"
"10982",48443,"Texas","Terrell County","A_AIC",13,10,-3,-26.09,"undercount"
"10983",48443,"Texas","Terrell County","NHPI_A",0,0,0,0,"equal"
"10984",48443,"Texas","Terrell County","NHPI_AIC",0,7,7,200,"overcount"
"10985",48445,"Texas","Terry County","A_A",80,41,-39,-64.46,"undercount"
"10986",48445,"Texas","Terry County","A_AIC",112,58,-54,-63.53,"undercount"
"10987",48445,"Texas","Terry County","NHPI_A",9,0,-9,-200,"undercount"
"10988",48445,"Texas","Terry County","NHPI_AIC",17,30,13,55.32,"overcount"
"10989",48447,"Texas","Throckmorton County","A_A",8,3,-5,-90.91,"undercount"
"10990",48447,"Texas","Throckmorton County","A_AIC",12,5,-7,-82.35,"undercount"
"10991",48447,"Texas","Throckmorton County","NHPI_A",0,0,0,0,"equal"
"10992",48447,"Texas","Throckmorton County","NHPI_AIC",0,4,4,200,"overcount"
"10993",48449,"Texas","Titus County","A_A",396,262,-134,-40.73,"undercount"
"10994",48449,"Texas","Titus County","A_AIC",493,303,-190,-47.74,"undercount"
"10995",48449,"Texas","Titus County","NHPI_A",59,5,-54,-168.75,"undercount"
"10996",48449,"Texas","Titus County","NHPI_AIC",77,13,-64,-142.22,"undercount"
"10997",48451,"Texas","Tom Green County","A_A",1752,1738,-14,-0.8,"undercount"
"10998",48451,"Texas","Tom Green County","A_AIC",2597,2446,-151,-5.99,"undercount"
"10999",48451,"Texas","Tom Green County","NHPI_A",229,143,-86,-46.24,"undercount"
"11000",48451,"Texas","Tom Green County","NHPI_AIC",418,265,-153,-44.8,"undercount"
"11001",48453,"Texas","Travis County","A_A",100067,100492,425,0.42,"overcount"
"11002",48453,"Texas","Travis County","A_AIC",115922,118616,2694,2.3,"overcount"
"11003",48453,"Texas","Travis County","NHPI_A",1666,801,-865,-70.13,"undercount"
"11004",48453,"Texas","Travis County","NHPI_AIC",3455,2578,-877,-29.07,"undercount"
"11005",48455,"Texas","Trinity County","A_A",80,34,-46,-80.7,"undercount"
"11006",48455,"Texas","Trinity County","A_AIC",114,87,-27,-26.87,"undercount"
"11007",48455,"Texas","Trinity County","NHPI_A",13,4,-9,-105.88,"undercount"
"11008",48455,"Texas","Trinity County","NHPI_AIC",26,24,-2,-8,"undercount"
"11009",48457,"Texas","Tyler County","A_A",132,104,-28,-23.73,"undercount"
"11010",48457,"Texas","Tyler County","A_AIC",172,124,-48,-32.43,"undercount"
"11011",48457,"Texas","Tyler County","NHPI_A",16,3,-13,-136.84,"undercount"
"11012",48457,"Texas","Tyler County","NHPI_AIC",29,12,-17,-82.93,"undercount"
"11013",48459,"Texas","Upshur County","A_A",304,177,-127,-52.81,"undercount"
"11014",48459,"Texas","Upshur County","A_AIC",404,302,-102,-28.9,"undercount"
"11015",48459,"Texas","Upshur County","NHPI_A",33,9,-24,-114.29,"undercount"
"11016",48459,"Texas","Upshur County","NHPI_AIC",67,69,2,2.94,"overcount"
"11017",48461,"Texas","Upton County","A_A",24,4,-20,-142.86,"undercount"
"11018",48461,"Texas","Upton County","A_AIC",30,21,-9,-35.29,"undercount"
"11019",48461,"Texas","Upton County","NHPI_A",1,0,-1,-200,"undercount"
"11020",48461,"Texas","Upton County","NHPI_AIC",5,8,3,46.15,"overcount"
"11021",48463,"Texas","Uvalde County","A_A",327,159,-168,-69.14,"undercount"
"11022",48463,"Texas","Uvalde County","A_AIC",386,181,-205,-72.31,"undercount"
"11023",48463,"Texas","Uvalde County","NHPI_A",22,6,-16,-114.29,"undercount"
"11024",48463,"Texas","Uvalde County","NHPI_AIC",34,25,-9,-30.51,"undercount"
"11025",48465,"Texas","Val Verde County","A_A",439,351,-88,-22.28,"undercount"
"11026",48465,"Texas","Val Verde County","A_AIC",601,466,-135,-25.3,"undercount"
"11027",48465,"Texas","Val Verde County","NHPI_A",90,40,-50,-76.92,"undercount"
"11028",48465,"Texas","Val Verde County","NHPI_AIC",141,67,-74,-71.15,"undercount"
"11029",48467,"Texas","Van Zandt County","A_A",315,273,-42,-14.29,"undercount"
"11030",48467,"Texas","Van Zandt County","A_AIC",421,445,24,5.54,"overcount"
"11031",48467,"Texas","Van Zandt County","NHPI_A",87,30,-57,-97.44,"undercount"
"11032",48467,"Texas","Van Zandt County","NHPI_AIC",121,57,-64,-71.91,"undercount"
"11033",48469,"Texas","Victoria County","A_A",1315,1395,80,5.9,"overcount"
"11034",48469,"Texas","Victoria County","A_AIC",1601,1606,5,0.31,"overcount"
"11035",48469,"Texas","Victoria County","NHPI_A",80,35,-45,-78.26,"undercount"
"11036",48469,"Texas","Victoria County","NHPI_AIC",161,63,-98,-87.5,"undercount"
"11037",48471,"Texas","Walker County","A_A",868,1126,258,25.88,"overcount"
"11038",48471,"Texas","Walker County","A_AIC",1143,1294,151,12.39,"overcount"
"11039",48471,"Texas","Walker County","NHPI_A",90,39,-51,-79.07,"undercount"
"11040",48471,"Texas","Walker County","NHPI_AIC",163,98,-65,-49.81,"undercount"
"11041",48473,"Texas","Waller County","A_A",945,787,-158,-18.24,"undercount"
"11042",48473,"Texas","Waller County","A_AIC",1094,986,-108,-10.38,"undercount"
"11043",48473,"Texas","Waller County","NHPI_A",70,13,-57,-137.35,"undercount"
"11044",48473,"Texas","Waller County","NHPI_AIC",130,48,-82,-92.13,"undercount"
"11045",48475,"Texas","Ward County","A_A",79,69,-10,-13.51,"undercount"
"11046",48475,"Texas","Ward County","A_AIC",110,105,-5,-4.65,"undercount"
"11047",48475,"Texas","Ward County","NHPI_A",12,3,-9,-120,"undercount"
"11048",48475,"Texas","Ward County","NHPI_AIC",31,28,-3,-10.17,"undercount"
"11049",48477,"Texas","Washington County","A_A",594,547,-47,-8.24,"undercount"
"11050",48477,"Texas","Washington County","A_AIC",688,641,-47,-7.07,"undercount"
"11051",48477,"Texas","Washington County","NHPI_A",20,14,-6,-35.29,"undercount"
"11052",48477,"Texas","Washington County","NHPI_AIC",51,31,-20,-48.78,"undercount"
"11053",48479,"Texas","Webb County","A_A",1663,1359,-304,-20.12,"undercount"
"11054",48479,"Texas","Webb County","A_AIC",2016,1461,-555,-31.92,"undercount"
"11055",48479,"Texas","Webb County","NHPI_A",150,44,-106,-109.28,"undercount"
"11056",48479,"Texas","Webb County","NHPI_AIC",239,77,-162,-102.53,"undercount"
"11057",48481,"Texas","Wharton County","A_A",245,164,-81,-39.61,"undercount"
"11058",48481,"Texas","Wharton County","A_AIC",299,211,-88,-34.51,"undercount"
"11059",48481,"Texas","Wharton County","NHPI_A",34,0,-34,-200,"undercount"
"11060",48481,"Texas","Wharton County","NHPI_AIC",57,16,-41,-112.33,"undercount"
"11061",48483,"Texas","Wheeler County","A_A",43,24,-19,-56.72,"undercount"
"11062",48483,"Texas","Wheeler County","A_AIC",52,38,-14,-31.11,"undercount"
"11063",48483,"Texas","Wheeler County","NHPI_A",0,2,2,200,"overcount"
"11064",48483,"Texas","Wheeler County","NHPI_AIC",3,6,3,66.67,"overcount"
"11065",48485,"Texas","Wichita County","A_A",2922,2665,-257,-9.2,"undercount"
"11066",48485,"Texas","Wichita County","A_AIC",4140,3656,-484,-12.42,"undercount"
"11067",48485,"Texas","Wichita County","NHPI_A",207,140,-67,-38.62,"undercount"
"11068",48485,"Texas","Wichita County","NHPI_AIC",471,337,-134,-33.17,"undercount"
"11069",48487,"Texas","Wilbarger County","A_A",468,578,110,21.03,"overcount"
"11070",48487,"Texas","Wilbarger County","A_AIC",519,605,86,15.3,"overcount"
"11071",48487,"Texas","Wilbarger County","NHPI_A",10,0,-10,-200,"undercount"
"11072",48487,"Texas","Wilbarger County","NHPI_AIC",23,9,-14,-87.5,"undercount"
"11073",48489,"Texas","Willacy County","A_A",200,160,-40,-22.22,"undercount"
"11074",48489,"Texas","Willacy County","A_AIC",219,182,-37,-18.45,"undercount"
"11075",48489,"Texas","Willacy County","NHPI_A",15,2,-13,-152.94,"undercount"
"11076",48489,"Texas","Willacy County","NHPI_AIC",20,9,-11,-75.86,"undercount"
"11077",48491,"Texas","Williamson County","A_A",53419,54263,844,1.57,"overcount"
"11078",48491,"Texas","Williamson County","A_AIC",61198,62534,1336,2.16,"overcount"
"11079",48491,"Texas","Williamson County","NHPI_A",1028,599,-429,-52.74,"undercount"
"11080",48491,"Texas","Williamson County","NHPI_AIC",2243,1659,-584,-29.93,"undercount"
"11081",48493,"Texas","Wilson County","A_A",347,236,-111,-38.08,"undercount"
"11082",48493,"Texas","Wilson County","A_AIC",513,452,-61,-12.64,"undercount"
"11083",48493,"Texas","Wilson County","NHPI_A",59,24,-35,-84.34,"undercount"
"11084",48493,"Texas","Wilson County","NHPI_AIC",90,61,-29,-38.41,"undercount"
"11085",48495,"Texas","Winkler County","A_A",66,80,14,19.18,"overcount"
"11086",48495,"Texas","Winkler County","A_AIC",78,93,15,17.54,"overcount"
"11087",48495,"Texas","Winkler County","NHPI_A",4,0,-4,-200,"undercount"
"11088",48495,"Texas","Winkler County","NHPI_AIC",9,8,-1,-11.76,"undercount"
"11089",48497,"Texas","Wise County","A_A",446,372,-74,-18.09,"undercount"
"11090",48497,"Texas","Wise County","A_AIC",730,585,-145,-22.05,"undercount"
"11091",48497,"Texas","Wise County","NHPI_A",56,12,-44,-129.41,"undercount"
"11092",48497,"Texas","Wise County","NHPI_AIC",92,52,-40,-55.56,"undercount"
"11093",48499,"Texas","Wood County","A_A",295,231,-64,-24.33,"undercount"
"11094",48499,"Texas","Wood County","A_AIC",390,344,-46,-12.53,"undercount"
"11095",48499,"Texas","Wood County","NHPI_A",38,1,-37,-189.74,"undercount"
"11096",48499,"Texas","Wood County","NHPI_AIC",65,16,-49,-120.99,"undercount"
"11097",48501,"Texas","Yoakum County","A_A",57,49,-8,-15.09,"undercount"
"11098",48501,"Texas","Yoakum County","A_AIC",72,61,-11,-16.54,"undercount"
"11099",48501,"Texas","Yoakum County","NHPI_A",3,0,-3,-200,"undercount"
"11100",48501,"Texas","Yoakum County","NHPI_AIC",6,0,-6,-200,"undercount"
"11101",48503,"Texas","Young County","A_A",148,86,-62,-52.99,"undercount"
"11102",48503,"Texas","Young County","A_AIC",200,120,-80,-50,"undercount"
"11103",48503,"Texas","Young County","NHPI_A",10,1,-9,-163.64,"undercount"
"11104",48503,"Texas","Young County","NHPI_AIC",29,13,-16,-76.19,"undercount"
"11105",48505,"Texas","Zapata County","A_A",34,16,-18,-72,"undercount"
"11106",48505,"Texas","Zapata County","A_AIC",40,26,-14,-42.42,"undercount"
"11107",48505,"Texas","Zapata County","NHPI_A",2,0,-2,-200,"undercount"
"11108",48505,"Texas","Zapata County","NHPI_AIC",7,7,0,0,"equal"
"11109",48507,"Texas","Zavala County","A_A",33,19,-14,-53.85,"undercount"
"11110",48507,"Texas","Zavala County","A_AIC",42,27,-15,-43.48,"undercount"
"11111",48507,"Texas","Zavala County","NHPI_A",19,1,-18,-180,"undercount"
"11112",48507,"Texas","Zavala County","NHPI_AIC",22,12,-10,-58.82,"undercount"
"11113",49001,"Utah","Beaver County","A_A",66,33,-33,-66.67,"undercount"
"11114",49001,"Utah","Beaver County","A_AIC",109,60,-49,-57.99,"undercount"
"11115",49001,"Utah","Beaver County","NHPI_A",26,21,-5,-21.28,"undercount"
"11116",49001,"Utah","Beaver County","NHPI_AIC",38,50,12,27.27,"overcount"
"11117",49003,"Utah","Box Elder County","A_A",484,445,-39,-8.4,"undercount"
"11118",49003,"Utah","Box Elder County","A_AIC",947,868,-79,-8.71,"undercount"
"11119",49003,"Utah","Box Elder County","NHPI_A",133,98,-35,-30.3,"undercount"
"11120",49003,"Utah","Box Elder County","NHPI_AIC",216,207,-9,-4.26,"undercount"
"11121",49005,"Utah","Cache County","A_A",2992,2332,-660,-24.79,"undercount"
"11122",49005,"Utah","Cache County","A_AIC",4081,3461,-620,-16.44,"undercount"
"11123",49005,"Utah","Cache County","NHPI_A",733,660,-73,-10.48,"undercount"
"11124",49005,"Utah","Cache County","NHPI_AIC",1154,1123,-31,-2.72,"undercount"
"11125",49007,"Utah","Carbon County","A_A",156,71,-85,-74.89,"undercount"
"11126",49007,"Utah","Carbon County","A_AIC",241,175,-66,-31.73,"undercount"
"11127",49007,"Utah","Carbon County","NHPI_A",51,29,-22,-55,"undercount"
"11128",49007,"Utah","Carbon County","NHPI_AIC",99,46,-53,-73.1,"undercount"
"11129",49009,"Utah","Daggett County","A_A",6,1,-5,-142.86,"undercount"
"11130",49009,"Utah","Daggett County","A_AIC",13,5,-8,-88.89,"undercount"
"11131",49009,"Utah","Daggett County","NHPI_A",1,3,2,100,"overcount"
"11132",49009,"Utah","Daggett County","NHPI_AIC",4,4,0,0,"equal"
"11133",49011,"Utah","Davis County","A_A",7703,7013,-690,-9.38,"undercount"
"11134",49011,"Utah","Davis County","A_AIC",12844,12393,-451,-3.57,"undercount"
"11135",49011,"Utah","Davis County","NHPI_A",3041,3241,200,6.37,"overcount"
"11136",49011,"Utah","Davis County","NHPI_AIC",4753,5354,601,11.89,"overcount"
"11137",49013,"Utah","Duchesne County","A_A",96,68,-28,-34.15,"undercount"
"11138",49013,"Utah","Duchesne County","A_AIC",188,142,-46,-27.88,"undercount"
"11139",49013,"Utah","Duchesne County","NHPI_A",71,39,-32,-58.18,"undercount"
"11140",49013,"Utah","Duchesne County","NHPI_AIC",143,75,-68,-62.39,"undercount"
"11141",49015,"Utah","Emery County","A_A",51,36,-15,-34.48,"undercount"
"11142",49015,"Utah","Emery County","A_AIC",83,75,-8,-10.13,"undercount"
"11143",49015,"Utah","Emery County","NHPI_A",12,7,-5,-52.63,"undercount"
"11144",49015,"Utah","Emery County","NHPI_AIC",39,16,-23,-83.64,"undercount"
"11145",49017,"Utah","Garfield County","A_A",53,30,-23,-55.42,"undercount"
"11146",49017,"Utah","Garfield County","A_AIC",72,56,-16,-25,"undercount"
"11147",49017,"Utah","Garfield County","NHPI_A",17,7,-10,-83.33,"undercount"
"11148",49017,"Utah","Garfield County","NHPI_AIC",40,26,-14,-42.42,"undercount"
"11149",49019,"Utah","Grand County","A_A",216,81,-135,-90.91,"undercount"
"11150",49019,"Utah","Grand County","A_AIC",263,166,-97,-45.22,"undercount"
"11151",49019,"Utah","Grand County","NHPI_A",11,12,1,8.7,"overcount"
"11152",49019,"Utah","Grand County","NHPI_AIC",41,16,-25,-87.72,"undercount"
"11153",49021,"Utah","Iron County","A_A",543,621,78,13.4,"overcount"
"11154",49021,"Utah","Iron County","A_AIC",965,1087,122,11.89,"overcount"
"11155",49021,"Utah","Iron County","NHPI_A",194,237,43,19.95,"overcount"
"11156",49021,"Utah","Iron County","NHPI_AIC",424,454,30,6.83,"overcount"
"11157",49023,"Utah","Juab County","A_A",56,34,-22,-48.89,"undercount"
"11158",49023,"Utah","Juab County","A_AIC",82,99,17,18.78,"overcount"
"11159",49023,"Utah","Juab County","NHPI_A",37,41,4,10.26,"overcount"
"11160",49023,"Utah","Juab County","NHPI_AIC",65,94,29,36.48,"overcount"
"11161",49025,"Utah","Kane County","A_A",63,59,-4,-6.56,"undercount"
"11162",49025,"Utah","Kane County","A_AIC",93,111,18,17.65,"overcount"
"11163",49025,"Utah","Kane County","NHPI_A",6,1,-5,-142.86,"undercount"
"11164",49025,"Utah","Kane County","NHPI_AIC",21,23,2,9.09,"overcount"
"11165",49027,"Utah","Millard County","A_A",213,145,-68,-37.99,"undercount"
"11166",49027,"Utah","Millard County","A_AIC",272,193,-79,-33.98,"undercount"
"11167",49027,"Utah","Millard County","NHPI_A",24,14,-10,-52.63,"undercount"
"11168",49027,"Utah","Millard County","NHPI_AIC",44,34,-10,-25.64,"undercount"
"11169",49029,"Utah","Morgan County","A_A",79,57,-22,-32.35,"undercount"
"11170",49029,"Utah","Morgan County","A_AIC",115,144,29,22.39,"overcount"
"11171",49029,"Utah","Morgan County","NHPI_A",25,0,-25,-200,"undercount"
"11172",49029,"Utah","Morgan County","NHPI_AIC",43,20,-23,-73.02,"undercount"
"11173",49031,"Utah","Piute County","A_A",8,0,-8,-200,"undercount"
"11174",49031,"Utah","Piute County","A_AIC",11,5,-6,-75,"undercount"
"11175",49031,"Utah","Piute County","NHPI_A",3,0,-3,-200,"undercount"
"11176",49031,"Utah","Piute County","NHPI_AIC",4,5,1,22.22,"overcount"
"11177",49033,"Utah","Rich County","A_A",7,2,-5,-111.11,"undercount"
"11178",49033,"Utah","Rich County","A_AIC",12,12,0,0,"equal"
"11179",49033,"Utah","Rich County","NHPI_A",3,4,1,28.57,"overcount"
"11180",49033,"Utah","Rich County","NHPI_AIC",4,22,18,138.46,"overcount"
"11181",49035,"Utah","Salt Lake County","A_A",53236,50763,-2473,-4.76,"undercount"
"11182",49035,"Utah","Salt Lake County","A_AIC",67503,66719,-784,-1.17,"undercount"
"11183",49035,"Utah","Salt Lake County","NHPI_A",21751,21314,-437,-2.03,"undercount"
"11184",49035,"Utah","Salt Lake County","NHPI_AIC",28472,28610,138,0.48,"overcount"
"11185",49037,"Utah","San Juan County","A_A",90,38,-52,-81.25,"undercount"
"11186",49037,"Utah","San Juan County","A_AIC",140,101,-39,-32.37,"undercount"
"11187",49037,"Utah","San Juan County","NHPI_A",11,51,40,129.03,"overcount"
"11188",49037,"Utah","San Juan County","NHPI_AIC",44,75,31,52.1,"overcount"
"11189",49039,"Utah","Sanpete County","A_A",260,171,-89,-41.3,"undercount"
"11190",49039,"Utah","Sanpete County","A_AIC",426,357,-69,-17.62,"undercount"
"11191",49039,"Utah","Sanpete County","NHPI_A",202,247,45,20.04,"overcount"
"11192",49039,"Utah","Sanpete County","NHPI_AIC",331,367,36,10.32,"overcount"
"11193",49041,"Utah","Sevier County","A_A",82,40,-42,-68.85,"undercount"
"11194",49041,"Utah","Sevier County","A_AIC",152,120,-32,-23.53,"undercount"
"11195",49041,"Utah","Sevier County","NHPI_A",47,49,2,4.17,"overcount"
"11196",49041,"Utah","Sevier County","NHPI_AIC",74,123,49,49.75,"overcount"
"11197",49043,"Utah","Summit County","A_A",845,726,-119,-15.15,"undercount"
"11198",49043,"Utah","Summit County","A_AIC",1193,1173,-20,-1.69,"undercount"
"11199",49043,"Utah","Summit County","NHPI_A",68,45,-23,-40.71,"undercount"
"11200",49043,"Utah","Summit County","NHPI_AIC",124,128,4,3.17,"overcount"
"11201",49045,"Utah","Tooele County","A_A",615,523,-92,-16.17,"undercount"
"11202",49045,"Utah","Tooele County","A_AIC",1163,1102,-61,-5.39,"undercount"
"11203",49045,"Utah","Tooele County","NHPI_A",595,639,44,7.13,"overcount"
"11204",49045,"Utah","Tooele County","NHPI_AIC",821,944,123,13.94,"overcount"
"11205",49047,"Utah","Uintah County","A_A",238,157,-81,-41.01,"undercount"
"11206",49047,"Utah","Uintah County","A_AIC",455,347,-108,-26.93,"undercount"
"11207",49047,"Utah","Uintah County","NHPI_A",148,97,-51,-41.63,"undercount"
"11208",49047,"Utah","Uintah County","NHPI_AIC",231,194,-37,-17.41,"undercount"
"11209",49049,"Utah","Utah County","A_A",12198,10235,-1963,-17.5,"undercount"
"11210",49049,"Utah","Utah County","A_AIC",20776,19871,-905,-4.45,"undercount"
"11211",49049,"Utah","Utah County","NHPI_A",6494,6652,158,2.4,"overcount"
"11212",49049,"Utah","Utah County","NHPI_AIC",12119,13138,1019,8.07,"overcount"
"11213",49051,"Utah","Wasatch County","A_A",400,354,-46,-12.2,"undercount"
"11214",49051,"Utah","Wasatch County","A_AIC",590,566,-24,-4.15,"undercount"
"11215",49051,"Utah","Wasatch County","NHPI_A",89,42,-47,-71.76,"undercount"
"11216",49051,"Utah","Wasatch County","NHPI_AIC",161,129,-32,-22.07,"undercount"
"11217",49053,"Utah","Washington County","A_A",2018,1832,-186,-9.66,"undercount"
"11218",49053,"Utah","Washington County","A_AIC",3450,3287,-163,-4.84,"undercount"
"11219",49053,"Utah","Washington County","NHPI_A",1728,1613,-115,-6.88,"undercount"
"11220",49053,"Utah","Washington County","NHPI_AIC",2754,2802,48,1.73,"overcount"
"11221",49055,"Utah","Wayne County","A_A",25,18,-7,-32.56,"undercount"
"11222",49055,"Utah","Wayne County","A_AIC",37,33,-4,-11.43,"undercount"
"11223",49055,"Utah","Wayne County","NHPI_A",5,3,-2,-50,"undercount"
"11224",49055,"Utah","Wayne County","NHPI_AIC",9,15,6,50,"overcount"
"11225",49057,"Utah","Weber County","A_A",4369,3675,-694,-17.26,"undercount"
"11226",49057,"Utah","Weber County","A_AIC",7314,6482,-832,-12.06,"undercount"
"11227",49057,"Utah","Weber County","NHPI_A",1045,953,-92,-9.21,"undercount"
"11228",49057,"Utah","Weber County","NHPI_AIC",1982,1951,-31,-1.58,"undercount"
"11229",50001,"Vermont","Addison County","A_A",658,600,-58,-9.22,"undercount"
"11230",50001,"Vermont","Addison County","A_AIC",950,893,-57,-6.19,"undercount"
"11231",50001,"Vermont","Addison County","NHPI_A",14,10,-4,-33.33,"undercount"
"11232",50001,"Vermont","Addison County","NHPI_AIC",55,36,-19,-41.76,"undercount"
"11233",50003,"Vermont","Bennington County","A_A",462,415,-47,-10.72,"undercount"
"11234",50003,"Vermont","Bennington County","A_AIC",589,610,21,3.5,"overcount"
"11235",50003,"Vermont","Bennington County","NHPI_A",20,5,-15,-120,"undercount"
"11236",50003,"Vermont","Bennington County","NHPI_AIC",33,25,-8,-27.59,"undercount"
"11237",50005,"Vermont","Caledonia County","A_A",272,365,93,29.2,"overcount"
"11238",50005,"Vermont","Caledonia County","A_AIC",357,503,146,33.95,"overcount"
"11239",50005,"Vermont","Caledonia County","NHPI_A",6,17,11,95.65,"overcount"
"11240",50005,"Vermont","Caledonia County","NHPI_AIC",17,31,14,58.33,"overcount"
"11241",50007,"Vermont","Chittenden County","A_A",7957,7256,-701,-9.22,"undercount"
"11242",50007,"Vermont","Chittenden County","A_AIC",9452,9096,-356,-3.84,"undercount"
"11243",50007,"Vermont","Chittenden County","NHPI_A",58,54,-4,-7.14,"undercount"
"11244",50007,"Vermont","Chittenden County","NHPI_AIC",182,162,-20,-11.63,"undercount"
"11245",50009,"Vermont","Essex County","A_A",43,18,-25,-81.97,"undercount"
"11246",50009,"Vermont","Essex County","A_AIC",61,38,-23,-46.46,"undercount"
"11247",50009,"Vermont","Essex County","NHPI_A",0,5,5,200,"overcount"
"11248",50009,"Vermont","Essex County","NHPI_AIC",4,12,8,100,"overcount"
"11249",50011,"Vermont","Franklin County","A_A",458,324,-134,-34.27,"undercount"
"11250",50011,"Vermont","Franklin County","A_AIC",622,543,-79,-13.56,"undercount"
"11251",50011,"Vermont","Franklin County","NHPI_A",16,16,0,0,"equal"
"11252",50011,"Vermont","Franklin County","NHPI_AIC",44,57,13,25.74,"overcount"
"11253",50013,"Vermont","Grand Isle County","A_A",51,31,-20,-48.78,"undercount"
"11254",50013,"Vermont","Grand Isle County","A_AIC",79,65,-14,-19.44,"undercount"
"11255",50013,"Vermont","Grand Isle County","NHPI_A",4,0,-4,-200,"undercount"
"11256",50013,"Vermont","Grand Isle County","NHPI_AIC",12,19,7,45.16,"overcount"
"11257",50015,"Vermont","Lamoille County","A_A",171,162,-9,-5.41,"undercount"
"11258",50015,"Vermont","Lamoille County","A_AIC",249,288,39,14.53,"overcount"
"11259",50015,"Vermont","Lamoille County","NHPI_A",18,1,-17,-178.95,"undercount"
"11260",50015,"Vermont","Lamoille County","NHPI_AIC",34,43,9,23.38,"overcount"
"11261",50017,"Vermont","Orange County","A_A",164,160,-4,-2.47,"undercount"
"11262",50017,"Vermont","Orange County","A_AIC",236,325,89,31.73,"overcount"
"11263",50017,"Vermont","Orange County","NHPI_A",5,5,0,0,"equal"
"11264",50017,"Vermont","Orange County","NHPI_AIC",17,24,7,34.15,"overcount"
"11265",50019,"Vermont","Orleans County","A_A",139,119,-20,-15.5,"undercount"
"11266",50019,"Vermont","Orleans County","A_AIC",242,233,-9,-3.79,"undercount"
"11267",50019,"Vermont","Orleans County","NHPI_A",9,1,-8,-160,"undercount"
"11268",50019,"Vermont","Orleans County","NHPI_AIC",28,27,-1,-3.64,"undercount"
"11269",50021,"Vermont","Rutland County","A_A",509,465,-44,-9.03,"undercount"
"11270",50021,"Vermont","Rutland County","A_AIC",697,733,36,5.03,"overcount"
"11271",50021,"Vermont","Rutland County","NHPI_A",15,14,-1,-6.9,"undercount"
"11272",50021,"Vermont","Rutland County","NHPI_AIC",45,52,7,14.43,"overcount"
"11273",50023,"Vermont","Washington County","A_A",555,644,89,14.85,"overcount"
"11274",50023,"Vermont","Washington County","A_AIC",860,989,129,13.95,"overcount"
"11275",50023,"Vermont","Washington County","NHPI_A",23,23,0,0,"equal"
"11276",50023,"Vermont","Washington County","NHPI_AIC",68,62,-6,-9.23,"undercount"
"11277",50025,"Vermont","Windham County","A_A",530,499,-31,-6.03,"undercount"
"11278",50025,"Vermont","Windham County","A_AIC",716,764,48,6.49,"overcount"
"11279",50025,"Vermont","Windham County","NHPI_A",23,12,-11,-62.86,"undercount"
"11280",50025,"Vermont","Windham County","NHPI_AIC",51,53,2,3.85,"overcount"
"11281",50027,"Vermont","Windsor County","A_A",559,555,-4,-0.72,"undercount"
"11282",50027,"Vermont","Windsor County","A_AIC",808,922,114,13.18,"overcount"
"11283",50027,"Vermont","Windsor County","NHPI_A",21,16,-5,-27.03,"undercount"
"11284",50027,"Vermont","Windsor County","NHPI_AIC",51,58,7,12.84,"overcount"
"11285",51001,"Virginia","Accomack County","A_A",264,249,-15,-5.85,"undercount"
"11286",51001,"Virginia","Accomack County","A_AIC",352,362,10,2.8,"overcount"
"11287",51001,"Virginia","Accomack County","NHPI_A",53,11,-42,-131.25,"undercount"
"11288",51001,"Virginia","Accomack County","NHPI_AIC",75,34,-41,-75.23,"undercount"
"11289",51003,"Virginia","Albemarle County","A_A",6308,8277,1969,27,"overcount"
"11290",51003,"Virginia","Albemarle County","A_AIC",7553,9786,2233,25.76,"overcount"
"11291",51003,"Virginia","Albemarle County","NHPI_A",107,44,-63,-83.44,"undercount"
"11292",51003,"Virginia","Albemarle County","NHPI_AIC",227,171,-56,-28.14,"undercount"
"11293",51005,"Virginia","Alleghany County","A_A",56,63,7,11.76,"overcount"
"11294",51005,"Virginia","Alleghany County","A_AIC",83,95,12,13.48,"overcount"
"11295",51005,"Virginia","Alleghany County","NHPI_A",13,7,-6,-60,"undercount"
"11296",51005,"Virginia","Alleghany County","NHPI_AIC",17,17,0,0,"equal"
"11297",51007,"Virginia","Amelia County","A_A",82,63,-19,-26.21,"undercount"
"11298",51007,"Virginia","Amelia County","A_AIC",122,116,-6,-5.04,"undercount"
"11299",51007,"Virginia","Amelia County","NHPI_A",6,0,-6,-200,"undercount"
"11300",51007,"Virginia","Amelia County","NHPI_AIC",13,4,-9,-105.88,"undercount"
"11301",51009,"Virginia","Amherst County","A_A",161,185,24,13.87,"overcount"
"11302",51009,"Virginia","Amherst County","A_AIC",312,259,-53,-18.56,"undercount"
"11303",51009,"Virginia","Amherst County","NHPI_A",15,26,11,53.66,"overcount"
"11304",51009,"Virginia","Amherst County","NHPI_AIC",38,34,-4,-11.11,"undercount"
"11305",51011,"Virginia","Appomattox County","A_A",67,45,-22,-39.29,"undercount"
"11306",51011,"Virginia","Appomattox County","A_AIC",111,82,-29,-30.05,"undercount"
"11307",51011,"Virginia","Appomattox County","NHPI_A",8,3,-5,-90.91,"undercount"
"11308",51011,"Virginia","Appomattox County","NHPI_AIC",13,9,-4,-36.36,"undercount"
"11309",51013,"Virginia","Arlington County","A_A",26823,27517,694,2.55,"overcount"
"11310",51013,"Virginia","Arlington County","A_AIC",32198,33720,1522,4.62,"overcount"
"11311",51013,"Virginia","Arlington County","NHPI_A",296,118,-178,-85.99,"undercount"
"11312",51013,"Virginia","Arlington County","NHPI_AIC",754,472,-282,-46,"undercount"
"11313",51015,"Virginia","Augusta County","A_A",526,495,-31,-6.07,"undercount"
"11314",51015,"Virginia","Augusta County","A_AIC",774,768,-6,-0.78,"undercount"
"11315",51015,"Virginia","Augusta County","NHPI_A",31,29,-2,-6.67,"undercount"
"11316",51015,"Virginia","Augusta County","NHPI_AIC",52,71,19,30.89,"overcount"
"11317",51017,"Virginia","Bath County","A_A",18,17,-1,-5.71,"undercount"
"11318",51017,"Virginia","Bath County","A_AIC",30,37,7,20.9,"overcount"
"11319",51017,"Virginia","Bath County","NHPI_A",0,1,1,200,"overcount"
"11320",51017,"Virginia","Bath County","NHPI_AIC",0,6,6,200,"overcount"
"11321",51019,"Virginia","Bedford County","A_A",1051,967,-84,-8.33,"undercount"
"11322",51019,"Virginia","Bedford County","A_AIC",1376,1373,-3,-0.22,"undercount"
"11323",51019,"Virginia","Bedford County","NHPI_A",25,33,8,27.59,"overcount"
"11324",51019,"Virginia","Bedford County","NHPI_AIC",63,74,11,16.06,"overcount"
"11325",51021,"Virginia","Bland County","A_A",32,5,-27,-145.95,"undercount"
"11326",51021,"Virginia","Bland County","A_AIC",42,42,0,0,"equal"
"11327",51021,"Virginia","Bland County","NHPI_A",1,0,-1,-200,"undercount"
"11328",51021,"Virginia","Bland County","NHPI_AIC",1,14,13,173.33,"overcount"
"11329",51023,"Virginia","Botetourt County","A_A",277,234,-43,-16.83,"undercount"
"11330",51023,"Virginia","Botetourt County","A_AIC",398,413,15,3.7,"overcount"
"11331",51023,"Virginia","Botetourt County","NHPI_A",9,3,-6,-100,"undercount"
"11332",51023,"Virginia","Botetourt County","NHPI_AIC",17,10,-7,-51.85,"undercount"
"11333",51025,"Virginia","Brunswick County","A_A",167,42,-125,-119.62,"undercount"
"11334",51025,"Virginia","Brunswick County","A_AIC",203,76,-127,-91.04,"undercount"
"11335",51025,"Virginia","Brunswick County","NHPI_A",10,5,-5,-66.67,"undercount"
"11336",51025,"Virginia","Brunswick County","NHPI_AIC",18,23,5,24.39,"overcount"
"11337",51027,"Virginia","Buchanan County","A_A",93,51,-42,-58.33,"undercount"
"11338",51027,"Virginia","Buchanan County","A_AIC",119,69,-50,-53.19,"undercount"
"11339",51027,"Virginia","Buchanan County","NHPI_A",3,1,-2,-100,"undercount"
"11340",51027,"Virginia","Buchanan County","NHPI_AIC",5,11,6,75,"overcount"
"11341",51029,"Virginia","Buckingham County","A_A",79,59,-20,-28.99,"undercount"
"11342",51029,"Virginia","Buckingham County","A_AIC",119,87,-32,-31.07,"undercount"
"11343",51029,"Virginia","Buckingham County","NHPI_A",5,0,-5,-200,"undercount"
"11344",51029,"Virginia","Buckingham County","NHPI_AIC",9,13,4,36.36,"overcount"
"11345",51031,"Virginia","Campbell County","A_A",617,608,-9,-1.47,"undercount"
"11346",51031,"Virginia","Campbell County","A_AIC",827,838,11,1.32,"overcount"
"11347",51031,"Virginia","Campbell County","NHPI_A",34,8,-26,-123.81,"undercount"
"11348",51031,"Virginia","Campbell County","NHPI_AIC",82,39,-43,-71.07,"undercount"
"11349",51033,"Virginia","Caroline County","A_A",294,304,10,3.34,"overcount"
"11350",51033,"Virginia","Caroline County","A_AIC",510,544,34,6.45,"overcount"
"11351",51033,"Virginia","Caroline County","NHPI_A",33,18,-15,-58.82,"undercount"
"11352",51033,"Virginia","Caroline County","NHPI_AIC",97,81,-16,-17.98,"undercount"
"11353",51035,"Virginia","Carroll County","A_A",72,81,9,11.76,"overcount"
"11354",51035,"Virginia","Carroll County","A_AIC",138,129,-9,-6.74,"undercount"
"11355",51035,"Virginia","Carroll County","NHPI_A",11,4,-7,-93.33,"undercount"
"11356",51035,"Virginia","Carroll County","NHPI_AIC",16,24,8,40,"overcount"
"11357",51036,"Virginia","Charles City County","A_A",37,34,-3,-8.45,"undercount"
"11358",51036,"Virginia","Charles City County","A_AIC",84,70,-14,-18.18,"undercount"
"11359",51036,"Virginia","Charles City County","NHPI_A",6,6,0,0,"equal"
"11360",51036,"Virginia","Charles City County","NHPI_AIC",16,19,3,17.14,"overcount"
"11361",51037,"Virginia","Charlotte County","A_A",33,23,-10,-35.71,"undercount"
"11362",51037,"Virginia","Charlotte County","A_AIC",66,56,-10,-16.39,"undercount"
"11363",51037,"Virginia","Charlotte County","NHPI_A",2,6,4,100,"overcount"
"11364",51037,"Virginia","Charlotte County","NHPI_AIC",8,11,3,31.58,"overcount"
"11365",51041,"Virginia","Chesterfield County","A_A",13367,13268,-99,-0.74,"undercount"
"11366",51041,"Virginia","Chesterfield County","A_AIC",16803,17104,301,1.78,"overcount"
"11367",51041,"Virginia","Chesterfield County","NHPI_A",515,194,-321,-90.55,"undercount"
"11368",51041,"Virginia","Chesterfield County","NHPI_AIC",906,567,-339,-46.03,"undercount"
"11369",51043,"Virginia","Clarke County","A_A",204,211,7,3.37,"overcount"
"11370",51043,"Virginia","Clarke County","A_AIC",294,312,18,5.94,"overcount"
"11371",51043,"Virginia","Clarke County","NHPI_A",11,15,4,30.77,"overcount"
"11372",51043,"Virginia","Clarke County","NHPI_AIC",25,23,-2,-8.33,"undercount"
"11373",51045,"Virginia","Craig County","A_A",14,11,-3,-24,"undercount"
"11374",51045,"Virginia","Craig County","A_AIC",24,29,5,18.87,"overcount"
"11375",51045,"Virginia","Craig County","NHPI_A",0,3,3,200,"overcount"
"11376",51045,"Virginia","Craig County","NHPI_AIC",0,5,5,200,"overcount"
"11377",51047,"Virginia","Culpeper County","A_A",990,767,-223,-25.38,"undercount"
"11378",51047,"Virginia","Culpeper County","A_AIC",1395,1186,-209,-16.2,"undercount"
"11379",51047,"Virginia","Culpeper County","NHPI_A",90,22,-68,-121.43,"undercount"
"11380",51047,"Virginia","Culpeper County","NHPI_AIC",147,97,-50,-40.98,"undercount"
"11381",51049,"Virginia","Cumberland County","A_A",43,36,-7,-17.72,"undercount"
"11382",51049,"Virginia","Cumberland County","A_AIC",83,73,-10,-12.82,"undercount"
"11383",51049,"Virginia","Cumberland County","NHPI_A",2,8,6,120,"overcount"
"11384",51049,"Virginia","Cumberland County","NHPI_AIC",13,12,-1,-8,"undercount"
"11385",51051,"Virginia","Dickenson County","A_A",30,14,-16,-72.73,"undercount"
"11386",51051,"Virginia","Dickenson County","A_AIC",50,26,-24,-63.16,"undercount"
"11387",51051,"Virginia","Dickenson County","NHPI_A",0,2,2,200,"overcount"
"11388",51051,"Virginia","Dickenson County","NHPI_AIC",2,16,14,155.56,"overcount"
"11389",51053,"Virginia","Dinwiddie County","A_A",256,119,-137,-73.07,"undercount"
"11390",51053,"Virginia","Dinwiddie County","A_AIC",371,233,-138,-45.7,"undercount"
"11391",51053,"Virginia","Dinwiddie County","NHPI_A",21,9,-12,-80,"undercount"
"11392",51053,"Virginia","Dinwiddie County","NHPI_AIC",53,39,-14,-30.43,"undercount"
"11393",51057,"Virginia","Essex County","A_A",126,65,-61,-63.87,"undercount"
"11394",51057,"Virginia","Essex County","A_AIC",184,118,-66,-43.71,"undercount"
"11395",51057,"Virginia","Essex County","NHPI_A",22,3,-19,-152,"undercount"
"11396",51057,"Virginia","Essex County","NHPI_AIC",35,20,-15,-54.55,"undercount"
"11397",51059,"Virginia","Fairfax County","A_A",236522,235984,-538,-0.23,"undercount"
"11398",51059,"Virginia","Fairfax County","A_AIC",266233,267098,865,0.32,"overcount"
"11399",51059,"Virginia","Fairfax County","NHPI_A",1045,808,-237,-25.58,"undercount"
"11400",51059,"Virginia","Fairfax County","NHPI_AIC",3065,2629,-436,-15.31,"undercount"
"11401",51061,"Virginia","Fauquier County","A_A",1260,1219,-41,-3.31,"undercount"
"11402",51061,"Virginia","Fauquier County","A_AIC",1832,1993,161,8.42,"overcount"
"11403",51061,"Virginia","Fauquier County","NHPI_A",73,54,-19,-29.92,"undercount"
"11404",51061,"Virginia","Fauquier County","NHPI_AIC",165,154,-11,-6.9,"undercount"
"11405",51063,"Virginia","Floyd County","A_A",77,51,-26,-40.62,"undercount"
"11406",51063,"Virginia","Floyd County","A_AIC",133,118,-15,-11.95,"undercount"
"11407",51063,"Virginia","Floyd County","NHPI_A",4,0,-4,-200,"undercount"
"11408",51063,"Virginia","Floyd County","NHPI_AIC",18,19,1,5.41,"overcount"
"11409",51065,"Virginia","Fluvanna County","A_A",246,220,-26,-11.16,"undercount"
"11410",51065,"Virginia","Fluvanna County","A_AIC",402,414,12,2.94,"overcount"
"11411",51065,"Virginia","Fluvanna County","NHPI_A",24,7,-17,-109.68,"undercount"
"11412",51065,"Virginia","Fluvanna County","NHPI_AIC",57,47,-10,-19.23,"undercount"
"11413",51067,"Virginia","Franklin County","A_A",286,311,25,8.38,"overcount"
"11414",51067,"Virginia","Franklin County","A_AIC",418,466,48,10.86,"overcount"
"11415",51067,"Virginia","Franklin County","NHPI_A",32,20,-12,-46.15,"undercount"
"11416",51067,"Virginia","Franklin County","NHPI_AIC",55,44,-11,-22.22,"undercount"
"11417",51069,"Virginia","Frederick County","A_A",1733,1673,-60,-3.52,"undercount"
"11418",51069,"Virginia","Frederick County","A_AIC",2261,2357,96,4.16,"overcount"
"11419",51069,"Virginia","Frederick County","NHPI_A",77,39,-38,-65.52,"undercount"
"11420",51069,"Virginia","Frederick County","NHPI_AIC",182,128,-54,-34.84,"undercount"
"11421",51071,"Virginia","Giles County","A_A",96,69,-27,-32.73,"undercount"
"11422",51071,"Virginia","Giles County","A_AIC",126,99,-27,-24,"undercount"
"11423",51071,"Virginia","Giles County","NHPI_A",4,0,-4,-200,"undercount"
"11424",51071,"Virginia","Giles County","NHPI_AIC",13,12,-1,-8,"undercount"
"11425",51073,"Virginia","Gloucester County","A_A",335,312,-23,-7.11,"undercount"
"11426",51073,"Virginia","Gloucester County","A_AIC",597,695,98,15.17,"overcount"
"11427",51073,"Virginia","Gloucester County","NHPI_A",24,21,-3,-13.33,"undercount"
"11428",51073,"Virginia","Gloucester County","NHPI_AIC",77,86,9,11.04,"overcount"
"11429",51075,"Virginia","Goochland County","A_A",488,522,34,6.73,"overcount"
"11430",51075,"Virginia","Goochland County","A_AIC",624,701,77,11.62,"overcount"
"11431",51075,"Virginia","Goochland County","NHPI_A",14,3,-11,-129.41,"undercount"
"11432",51075,"Virginia","Goochland County","NHPI_AIC",37,23,-14,-46.67,"undercount"
"11433",51077,"Virginia","Grayson County","A_A",29,26,-3,-10.91,"undercount"
"11434",51077,"Virginia","Grayson County","A_AIC",50,56,6,11.32,"overcount"
"11435",51077,"Virginia","Grayson County","NHPI_A",5,2,-3,-85.71,"undercount"
"11436",51077,"Virginia","Grayson County","NHPI_AIC",9,8,-1,-11.76,"undercount"
"11437",51079,"Virginia","Greene County","A_A",479,457,-22,-4.7,"undercount"
"11438",51079,"Virginia","Greene County","A_AIC",585,620,35,5.81,"overcount"
"11439",51079,"Virginia","Greene County","NHPI_A",13,4,-9,-105.88,"undercount"
"11440",51079,"Virginia","Greene County","NHPI_AIC",34,32,-2,-6.06,"undercount"
"11441",51081,"Virginia","Greensville County","A_A",80,32,-48,-85.71,"undercount"
"11442",51081,"Virginia","Greensville County","A_AIC",103,104,1,0.97,"overcount"
"11443",51081,"Virginia","Greensville County","NHPI_A",7,0,-7,-200,"undercount"
"11444",51081,"Virginia","Greensville County","NHPI_AIC",18,30,12,50,"overcount"
"11445",51083,"Virginia","Halifax County","A_A",228,225,-3,-1.32,"undercount"
"11446",51083,"Virginia","Halifax County","A_AIC",309,251,-58,-20.71,"undercount"
"11447",51083,"Virginia","Halifax County","NHPI_A",7,3,-4,-80,"undercount"
"11448",51083,"Virginia","Halifax County","NHPI_AIC",40,24,-16,-50,"undercount"
"11449",51085,"Virginia","Hanover County","A_A",2181,2077,-104,-4.88,"undercount"
"11450",51085,"Virginia","Hanover County","A_AIC",2933,3074,141,4.69,"overcount"
"11451",51085,"Virginia","Hanover County","NHPI_A",107,36,-71,-99.3,"undercount"
"11452",51085,"Virginia","Hanover County","NHPI_AIC",210,115,-95,-58.46,"undercount"
"11453",51087,"Virginia","Henrico County","A_A",32023,32459,436,1.35,"overcount"
"11454",51087,"Virginia","Henrico County","A_AIC",35148,36199,1051,2.95,"overcount"
"11455",51087,"Virginia","Henrico County","NHPI_A",235,132,-103,-56.13,"undercount"
"11456",51087,"Virginia","Henrico County","NHPI_AIC",555,391,-164,-34.67,"undercount"
"11457",51089,"Virginia","Henry County","A_A",257,294,37,13.43,"overcount"
"11458",51089,"Virginia","Henry County","A_AIC",367,399,32,8.36,"overcount"
"11459",51089,"Virginia","Henry County","NHPI_A",40,6,-34,-147.83,"undercount"
"11460",51089,"Virginia","Henry County","NHPI_AIC",71,20,-51,-112.09,"undercount"
"11461",51091,"Virginia","Highland County","A_A",17,7,-10,-83.33,"undercount"
"11462",51091,"Virginia","Highland County","A_AIC",19,12,-7,-45.16,"undercount"
"11463",51091,"Virginia","Highland County","NHPI_A",0,1,1,200,"overcount"
"11464",51091,"Virginia","Highland County","NHPI_AIC",1,11,10,166.67,"overcount"
"11465",51093,"Virginia","Isle of Wight County","A_A",385,391,6,1.55,"overcount"
"11466",51093,"Virginia","Isle of Wight County","A_AIC",712,717,5,0.7,"overcount"
"11467",51093,"Virginia","Isle of Wight County","NHPI_A",24,31,7,25.45,"overcount"
"11468",51093,"Virginia","Isle of Wight County","NHPI_AIC",87,60,-27,-36.73,"undercount"
"11469",51095,"Virginia","James City County","A_A",2162,2263,101,4.56,"overcount"
"11470",51095,"Virginia","James City County","A_AIC",3055,3329,274,8.58,"overcount"
"11471",51095,"Virginia","James City County","NHPI_A",76,48,-28,-45.16,"undercount"
"11472",51095,"Virginia","James City County","NHPI_AIC",215,177,-38,-19.39,"undercount"
"11473",51097,"Virginia","King and Queen County","A_A",35,23,-12,-41.38,"undercount"
"11474",51097,"Virginia","King and Queen County","A_AIC",70,50,-20,-33.33,"undercount"
"11475",51097,"Virginia","King and Queen County","NHPI_A",2,3,1,40,"overcount"
"11476",51097,"Virginia","King and Queen County","NHPI_AIC",9,8,-1,-11.76,"undercount"
"11477",51099,"Virginia","King George County","A_A",452,406,-46,-10.72,"undercount"
"11478",51099,"Virginia","King George County","A_AIC",752,782,30,3.91,"overcount"
"11479",51099,"Virginia","King George County","NHPI_A",33,17,-16,-64,"undercount"
"11480",51099,"Virginia","King George County","NHPI_AIC",91,60,-31,-41.06,"undercount"
"11481",51101,"Virginia","King William County","A_A",228,135,-93,-51.24,"undercount"
"11482",51101,"Virginia","King William County","A_AIC",320,254,-66,-23,"undercount"
"11483",51101,"Virginia","King William County","NHPI_A",4,9,5,76.92,"overcount"
"11484",51101,"Virginia","King William County","NHPI_AIC",25,35,10,33.33,"overcount"
"11485",51103,"Virginia","Lancaster County","A_A",92,77,-15,-17.75,"undercount"
"11486",51103,"Virginia","Lancaster County","A_AIC",106,122,16,14.04,"overcount"
"11487",51103,"Virginia","Lancaster County","NHPI_A",0,1,1,200,"overcount"
"11488",51103,"Virginia","Lancaster County","NHPI_AIC",0,21,21,200,"overcount"
"11489",51105,"Virginia","Lee County","A_A",67,42,-25,-45.87,"undercount"
"11490",51105,"Virginia","Lee County","A_AIC",124,73,-51,-51.78,"undercount"
"11491",51105,"Virginia","Lee County","NHPI_A",10,0,-10,-200,"undercount"
"11492",51105,"Virginia","Lee County","NHPI_AIC",26,9,-17,-97.14,"undercount"
"11493",51107,"Virginia","Loudoun County","A_A",89115,89933,818,0.91,"overcount"
"11494",51107,"Virginia","Loudoun County","A_AIC",99402,101139,1737,1.73,"overcount"
"11495",51107,"Virginia","Loudoun County","NHPI_A",439,238,-201,-59.38,"undercount"
"11496",51107,"Virginia","Loudoun County","NHPI_AIC",1143,878,-265,-26.22,"undercount"
"11497",51109,"Virginia","Louisa County","A_A",255,253,-2,-0.79,"undercount"
"11498",51109,"Virginia","Louisa County","A_AIC",407,445,38,8.92,"overcount"
"11499",51109,"Virginia","Louisa County","NHPI_A",29,18,-11,-46.81,"undercount"
"11500",51109,"Virginia","Louisa County","NHPI_AIC",60,53,-7,-12.39,"undercount"
"11501",51111,"Virginia","Lunenburg County","A_A",62,25,-37,-85.06,"undercount"
"11502",51111,"Virginia","Lunenburg County","A_AIC",106,74,-32,-35.56,"undercount"
"11503",51111,"Virginia","Lunenburg County","NHPI_A",28,5,-23,-139.39,"undercount"
"11504",51111,"Virginia","Lunenburg County","NHPI_AIC",37,32,-5,-14.49,"undercount"
"11505",51113,"Virginia","Madison County","A_A",96,86,-10,-10.99,"undercount"
"11506",51113,"Virginia","Madison County","A_AIC",142,144,2,1.4,"overcount"
"11507",51113,"Virginia","Madison County","NHPI_A",4,1,-3,-120,"undercount"
"11508",51113,"Virginia","Madison County","NHPI_AIC",13,20,7,42.42,"overcount"
"11509",51115,"Virginia","Mathews County","A_A",77,49,-28,-44.44,"undercount"
"11510",51115,"Virginia","Mathews County","A_AIC",113,95,-18,-17.31,"undercount"
"11511",51115,"Virginia","Mathews County","NHPI_A",12,15,3,22.22,"overcount"
"11512",51115,"Virginia","Mathews County","NHPI_AIC",19,15,-4,-23.53,"undercount"
"11513",51117,"Virginia","Mecklenburg County","A_A",255,211,-44,-18.88,"undercount"
"11514",51117,"Virginia","Mecklenburg County","A_AIC",343,281,-62,-19.87,"undercount"
"11515",51117,"Virginia","Mecklenburg County","NHPI_A",26,0,-26,-200,"undercount"
"11516",51117,"Virginia","Mecklenburg County","NHPI_AIC",51,12,-39,-123.81,"undercount"
"11517",51119,"Virginia","Middlesex County","A_A",51,30,-21,-51.85,"undercount"
"11518",51119,"Virginia","Middlesex County","A_AIC",87,73,-14,-17.5,"undercount"
"11519",51119,"Virginia","Middlesex County","NHPI_A",6,3,-3,-66.67,"undercount"
"11520",51119,"Virginia","Middlesex County","NHPI_AIC",14,14,0,0,"equal"
"11521",51121,"Virginia","Montgomery County","A_A",6074,8346,2272,31.51,"overcount"
"11522",51121,"Virginia","Montgomery County","A_AIC",7335,9777,2442,28.54,"overcount"
"11523",51121,"Virginia","Montgomery County","NHPI_A",59,45,-14,-26.92,"undercount"
"11524",51121,"Virginia","Montgomery County","NHPI_AIC",170,99,-71,-52.79,"undercount"
"11525",51125,"Virginia","Nelson County","A_A",119,67,-52,-55.91,"undercount"
"11526",51125,"Virginia","Nelson County","A_AIC",165,121,-44,-30.77,"undercount"
"11527",51125,"Virginia","Nelson County","NHPI_A",8,2,-6,-120,"undercount"
"11528",51125,"Virginia","Nelson County","NHPI_AIC",18,18,0,0,"equal"
"11529",51127,"Virginia","New Kent County","A_A",276,227,-49,-19.48,"undercount"
"11530",51127,"Virginia","New Kent County","A_AIC",495,416,-79,-17.34,"undercount"
"11531",51127,"Virginia","New Kent County","NHPI_A",13,9,-4,-36.36,"undercount"
"11532",51127,"Virginia","New Kent County","NHPI_AIC",48,55,7,13.59,"overcount"
"11533",51131,"Virginia","Northampton County","A_A",123,80,-43,-42.36,"undercount"
"11534",51131,"Virginia","Northampton County","A_AIC",161,136,-25,-16.84,"undercount"
"11535",51131,"Virginia","Northampton County","NHPI_A",24,8,-16,-100,"undercount"
"11536",51131,"Virginia","Northampton County","NHPI_AIC",34,19,-15,-56.6,"undercount"
"11537",51133,"Virginia","Northumberland County","A_A",67,67,0,0,"equal"
"11538",51133,"Virginia","Northumberland County","A_AIC",99,103,4,3.96,"overcount"
"11539",51133,"Virginia","Northumberland County","NHPI_A",13,2,-11,-146.67,"undercount"
"11540",51133,"Virginia","Northumberland County","NHPI_AIC",16,21,5,27.03,"overcount"
"11541",51135,"Virginia","Nottoway County","A_A",82,64,-18,-24.66,"undercount"
"11542",51135,"Virginia","Nottoway County","A_AIC",139,121,-18,-13.85,"undercount"
"11543",51135,"Virginia","Nottoway County","NHPI_A",20,3,-17,-147.83,"undercount"
"11544",51135,"Virginia","Nottoway County","NHPI_AIC",32,18,-14,-56,"undercount"
"11545",51137,"Virginia","Orange County","A_A",455,315,-140,-36.36,"undercount"
"11546",51137,"Virginia","Orange County","A_AIC",693,585,-108,-16.9,"undercount"
"11547",51137,"Virginia","Orange County","NHPI_A",42,18,-24,-80,"undercount"
"11548",51137,"Virginia","Orange County","NHPI_AIC",86,76,-10,-12.35,"undercount"
"11549",51139,"Virginia","Page County","A_A",118,138,20,15.62,"overcount"
"11550",51139,"Virginia","Page County","A_AIC",190,241,51,23.67,"overcount"
"11551",51139,"Virginia","Page County","NHPI_A",11,8,-3,-31.58,"undercount"
"11552",51139,"Virginia","Page County","NHPI_AIC",23,31,8,29.63,"overcount"
"11553",51141,"Virginia","Patrick County","A_A",58,52,-6,-10.91,"undercount"
"11554",51141,"Virginia","Patrick County","A_AIC",90,81,-9,-10.53,"undercount"
"11555",51141,"Virginia","Patrick County","NHPI_A",13,3,-10,-125,"undercount"
"11556",51141,"Virginia","Patrick County","NHPI_AIC",15,13,-2,-14.29,"undercount"
"11557",51143,"Virginia","Pittsylvania County","A_A",297,298,1,0.34,"overcount"
"11558",51143,"Virginia","Pittsylvania County","A_AIC",447,407,-40,-9.37,"undercount"
"11559",51143,"Virginia","Pittsylvania County","NHPI_A",28,19,-9,-38.3,"undercount"
"11560",51143,"Virginia","Pittsylvania County","NHPI_AIC",67,36,-31,-60.19,"undercount"
"11561",51145,"Virginia","Powhatan County","A_A",191,167,-24,-13.41,"undercount"
"11562",51145,"Virginia","Powhatan County","A_AIC",286,353,67,20.97,"overcount"
"11563",51145,"Virginia","Powhatan County","NHPI_A",29,18,-11,-46.81,"undercount"
"11564",51145,"Virginia","Powhatan County","NHPI_AIC",61,49,-12,-21.82,"undercount"
"11565",51147,"Virginia","Prince Edward County","A_A",298,202,-96,-38.4,"undercount"
"11566",51147,"Virginia","Prince Edward County","A_AIC",369,266,-103,-32.44,"undercount"
"11567",51147,"Virginia","Prince Edward County","NHPI_A",23,0,-23,-200,"undercount"
"11568",51147,"Virginia","Prince Edward County","NHPI_AIC",46,27,-19,-52.05,"undercount"
"11569",51149,"Virginia","Prince George County","A_A",802,834,32,3.91,"overcount"
"11570",51149,"Virginia","Prince George County","A_AIC",1162,1283,121,9.9,"overcount"
"11571",51149,"Virginia","Prince George County","NHPI_A",142,150,8,5.48,"overcount"
"11572",51149,"Virginia","Prince George County","NHPI_AIC",270,253,-17,-6.5,"undercount"
"11573",51153,"Virginia","Prince William County","A_A",46665,50368,3703,7.63,"overcount"
"11574",51153,"Virginia","Prince William County","A_AIC",56460,61408,4948,8.4,"overcount"
"11575",51153,"Virginia","Prince William County","NHPI_A",980,536,-444,-58.58,"undercount"
"11576",51153,"Virginia","Prince William County","NHPI_AIC",2042,1408,-634,-36.75,"undercount"
"11577",51155,"Virginia","Pulaski County","A_A",243,180,-63,-29.79,"undercount"
"11578",51155,"Virginia","Pulaski County","A_AIC",323,293,-30,-9.74,"undercount"
"11579",51155,"Virginia","Pulaski County","NHPI_A",6,3,-3,-66.67,"undercount"
"11580",51155,"Virginia","Pulaski County","NHPI_AIC",31,31,0,0,"equal"
"11581",51157,"Virginia","Rappahannock County","A_A",94,63,-31,-39.49,"undercount"
"11582",51157,"Virginia","Rappahannock County","A_AIC",123,107,-16,-13.91,"undercount"
"11583",51157,"Virginia","Rappahannock County","NHPI_A",7,0,-7,-200,"undercount"
"11584",51157,"Virginia","Rappahannock County","NHPI_AIC",17,14,-3,-19.35,"undercount"
"11585",51159,"Virginia","Richmond County","A_A",63,42,-21,-40,"undercount"
"11586",51159,"Virginia","Richmond County","A_AIC",101,100,-1,-1,"undercount"
"11587",51159,"Virginia","Richmond County","NHPI_A",5,0,-5,-200,"undercount"
"11588",51159,"Virginia","Richmond County","NHPI_AIC",16,22,6,31.58,"overcount"
"11589",51161,"Virginia","Roanoke County","A_A",3426,3494,68,1.97,"overcount"
"11590",51161,"Virginia","Roanoke County","A_AIC",3946,4177,231,5.69,"overcount"
"11591",51161,"Virginia","Roanoke County","NHPI_A",42,24,-18,-54.55,"undercount"
"11592",51161,"Virginia","Roanoke County","NHPI_AIC",136,104,-32,-26.67,"undercount"
"11593",51163,"Virginia","Rockbridge County","A_A",175,183,8,4.47,"overcount"
"11594",51163,"Virginia","Rockbridge County","A_AIC",246,260,14,5.53,"overcount"
"11595",51163,"Virginia","Rockbridge County","NHPI_A",4,6,2,40,"overcount"
"11596",51163,"Virginia","Rockbridge County","NHPI_AIC",23,22,-1,-4.44,"undercount"
"11597",51165,"Virginia","Rockingham County","A_A",867,926,59,6.58,"overcount"
"11598",51165,"Virginia","Rockingham County","A_AIC",1128,1323,195,15.91,"overcount"
"11599",51165,"Virginia","Rockingham County","NHPI_A",59,13,-46,-127.78,"undercount"
"11600",51165,"Virginia","Rockingham County","NHPI_AIC",101,65,-36,-43.37,"undercount"
"11601",51167,"Virginia","Russell County","A_A",69,42,-27,-48.65,"undercount"
"11602",51167,"Virginia","Russell County","A_AIC",122,77,-45,-45.23,"undercount"
"11603",51167,"Virginia","Russell County","NHPI_A",4,1,-3,-120,"undercount"
"11604",51167,"Virginia","Russell County","NHPI_AIC",12,15,3,22.22,"overcount"
"11605",51169,"Virginia","Scott County","A_A",46,20,-26,-78.79,"undercount"
"11606",51169,"Virginia","Scott County","A_AIC",86,50,-36,-52.94,"undercount"
"11607",51169,"Virginia","Scott County","NHPI_A",19,2,-17,-161.9,"undercount"
"11608",51169,"Virginia","Scott County","NHPI_AIC",29,18,-11,-46.81,"undercount"
"11609",51171,"Virginia","Shenandoah County","A_A",511,352,-159,-36.85,"undercount"
"11610",51171,"Virginia","Shenandoah County","A_AIC",646,549,-97,-16.23,"undercount"
"11611",51171,"Virginia","Shenandoah County","NHPI_A",24,8,-16,-100,"undercount"
"11612",51171,"Virginia","Shenandoah County","NHPI_AIC",52,29,-23,-56.79,"undercount"
"11613",51173,"Virginia","Smyth County","A_A",150,114,-36,-27.27,"undercount"
"11614",51173,"Virginia","Smyth County","A_AIC",203,189,-14,-7.14,"undercount"
"11615",51173,"Virginia","Smyth County","NHPI_A",8,1,-7,-155.56,"undercount"
"11616",51173,"Virginia","Smyth County","NHPI_AIC",25,34,9,30.51,"overcount"
"11617",51175,"Virginia","Southampton County","A_A",109,67,-42,-47.73,"undercount"
"11618",51175,"Virginia","Southampton County","A_AIC",178,99,-79,-57.04,"undercount"
"11619",51175,"Virginia","Southampton County","NHPI_A",15,21,6,33.33,"overcount"
"11620",51175,"Virginia","Southampton County","NHPI_AIC",31,50,19,46.91,"overcount"
"11621",51177,"Virginia","Spotsylvania County","A_A",4086,3983,-103,-2.55,"undercount"
"11622",51177,"Virginia","Spotsylvania County","A_AIC",5709,5861,152,2.63,"overcount"
"11623",51177,"Virginia","Spotsylvania County","NHPI_A",238,124,-114,-62.98,"undercount"
"11624",51177,"Virginia","Spotsylvania County","NHPI_AIC",446,354,-92,-23,"undercount"
"11625",51179,"Virginia","Stafford County","A_A",5984,6211,227,3.72,"overcount"
"11626",51179,"Virginia","Stafford County","A_AIC",8766,9468,702,7.7,"overcount"
"11627",51179,"Virginia","Stafford County","NHPI_A",285,243,-42,-15.91,"undercount"
"11628",51179,"Virginia","Stafford County","NHPI_AIC",589,642,53,8.61,"overcount"
"11629",51181,"Virginia","Surry County","A_A",40,14,-26,-96.3,"undercount"
"11630",51181,"Virginia","Surry County","A_AIC",69,31,-38,-76,"undercount"
"11631",51181,"Virginia","Surry County","NHPI_A",3,10,7,107.69,"overcount"
"11632",51181,"Virginia","Surry County","NHPI_AIC",7,19,12,92.31,"overcount"
"11633",51183,"Virginia","Sussex County","A_A",48,11,-37,-125.42,"undercount"
"11634",51183,"Virginia","Sussex County","A_AIC",80,39,-41,-68.91,"undercount"
"11635",51183,"Virginia","Sussex County","NHPI_A",1,8,7,155.56,"overcount"
"11636",51183,"Virginia","Sussex County","NHPI_AIC",10,18,8,57.14,"overcount"
"11637",51185,"Virginia","Tazewell County","A_A",335,213,-122,-44.53,"undercount"
"11638",51185,"Virginia","Tazewell County","A_AIC",409,301,-108,-30.42,"undercount"
"11639",51185,"Virginia","Tazewell County","NHPI_A",10,15,5,40,"overcount"
"11640",51185,"Virginia","Tazewell County","NHPI_AIC",29,30,1,3.39,"overcount"
"11641",51187,"Virginia","Warren County","A_A",567,469,-98,-18.92,"undercount"
"11642",51187,"Virginia","Warren County","A_AIC",831,783,-48,-5.95,"undercount"
"11643",51187,"Virginia","Warren County","NHPI_A",25,13,-12,-63.16,"undercount"
"11644",51187,"Virginia","Warren County","NHPI_AIC",61,52,-9,-15.93,"undercount"
"11645",51191,"Virginia","Washington County","A_A",297,334,37,11.73,"overcount"
"11646",51191,"Virginia","Washington County","A_AIC",399,469,70,16.13,"overcount"
"11647",51191,"Virginia","Washington County","NHPI_A",27,0,-27,-200,"undercount"
"11648",51191,"Virginia","Washington County","NHPI_AIC",45,29,-16,-43.24,"undercount"
"11649",51193,"Virginia","Westmoreland County","A_A",158,146,-12,-7.89,"undercount"
"11650",51193,"Virginia","Westmoreland County","A_AIC",268,240,-28,-11.02,"undercount"
"11651",51193,"Virginia","Westmoreland County","NHPI_A",20,11,-9,-58.06,"undercount"
"11652",51193,"Virginia","Westmoreland County","NHPI_AIC",42,30,-12,-33.33,"undercount"
"11653",51195,"Virginia","Wise County","A_A",167,150,-17,-10.73,"undercount"
"11654",51195,"Virginia","Wise County","A_AIC",239,215,-24,-10.57,"undercount"
"11655",51195,"Virginia","Wise County","NHPI_A",3,11,8,114.29,"overcount"
"11656",51195,"Virginia","Wise County","NHPI_AIC",14,29,15,69.77,"overcount"
"11657",51197,"Virginia","Wythe County","A_A",169,124,-45,-30.72,"undercount"
"11658",51197,"Virginia","Wythe County","A_AIC",228,189,-39,-18.71,"undercount"
"11659",51197,"Virginia","Wythe County","NHPI_A",7,2,-5,-111.11,"undercount"
"11660",51197,"Virginia","Wythe County","NHPI_AIC",23,26,3,12.24,"overcount"
"11661",51199,"Virginia","York County","A_A",4306,4272,-34,-0.79,"undercount"
"11662",51199,"Virginia","York County","A_AIC",5630,5873,243,4.22,"overcount"
"11663",51199,"Virginia","York County","NHPI_A",173,127,-46,-30.67,"undercount"
"11664",51199,"Virginia","York County","NHPI_AIC",330,305,-25,-7.87,"undercount"
"11665",51510,"Virginia","Alexandria city","A_A",10348,11349,1001,9.23,"overcount"
"11666",51510,"Virginia","Alexandria city","A_AIC",12938,14935,1997,14.33,"overcount"
"11667",51510,"Virginia","Alexandria city","NHPI_A",248,77,-171,-105.23,"undercount"
"11668",51510,"Virginia","Alexandria city","NHPI_AIC",523,366,-157,-35.32,"undercount"
"11669",51520,"Virginia","Bristol city","A_A",168,161,-7,-4.26,"undercount"
"11670",51520,"Virginia","Bristol city","A_AIC",234,192,-42,-19.72,"undercount"
"11671",51520,"Virginia","Bristol city","NHPI_A",12,4,-8,-100,"undercount"
"11672",51520,"Virginia","Bristol city","NHPI_AIC",28,16,-12,-54.55,"undercount"
"11673",51530,"Virginia","Buena Vista city","A_A",42,29,-13,-36.62,"undercount"
"11674",51530,"Virginia","Buena Vista city","A_AIC",72,56,-16,-25,"undercount"
"11675",51530,"Virginia","Buena Vista city","NHPI_A",29,24,-5,-18.87,"undercount"
"11676",51530,"Virginia","Buena Vista city","NHPI_AIC",35,29,-6,-18.75,"undercount"
"11677",51540,"Virginia","Charlottesville city","A_A",3355,4099,744,19.96,"overcount"
"11678",51540,"Virginia","Charlottesville city","A_AIC",4053,5039,986,21.69,"overcount"
"11679",51540,"Virginia","Charlottesville city","NHPI_A",34,25,-9,-30.51,"undercount"
"11680",51540,"Virginia","Charlottesville city","NHPI_AIC",103,73,-30,-34.09,"undercount"
"11681",51550,"Virginia","Chesapeake city","A_A",9020,8954,-66,-0.73,"undercount"
"11682",51550,"Virginia","Chesapeake city","A_AIC",13068,13321,253,1.92,"overcount"
"11683",51550,"Virginia","Chesapeake city","NHPI_A",365,317,-48,-14.08,"undercount"
"11684",51550,"Virginia","Chesapeake city","NHPI_AIC",786,894,108,12.86,"overcount"
"11685",51570,"Virginia","Colonial Heights city","A_A",635,569,-66,-10.96,"undercount"
"11686",51570,"Virginia","Colonial Heights city","A_AIC",817,759,-58,-7.36,"undercount"
"11687",51570,"Virginia","Colonial Heights city","NHPI_A",39,13,-26,-100,"undercount"
"11688",51570,"Virginia","Colonial Heights city","NHPI_AIC",76,44,-32,-53.33,"undercount"
"11689",51580,"Virginia","Covington city","A_A",50,38,-12,-27.27,"undercount"
"11690",51580,"Virginia","Covington city","A_AIC",76,49,-27,-43.2,"undercount"
"11691",51580,"Virginia","Covington city","NHPI_A",4,5,1,22.22,"overcount"
"11692",51580,"Virginia","Covington city","NHPI_AIC",6,23,17,117.24,"overcount"
"11693",51590,"Virginia","Danville city","A_A",562,516,-46,-8.53,"undercount"
"11694",51590,"Virginia","Danville city","A_AIC",710,588,-122,-18.8,"undercount"
"11695",51590,"Virginia","Danville city","NHPI_A",26,1,-25,-185.19,"undercount"
"11696",51590,"Virginia","Danville city","NHPI_AIC",63,16,-47,-118.99,"undercount"
"11697",51595,"Virginia","Emporia city","A_A",52,51,-1,-1.94,"undercount"
"11698",51595,"Virginia","Emporia city","A_AIC",62,73,11,16.3,"overcount"
"11699",51595,"Virginia","Emporia city","NHPI_A",7,4,-3,-54.55,"undercount"
"11700",51595,"Virginia","Emporia city","NHPI_AIC",9,30,21,107.69,"overcount"
"11701",51600,"Virginia","Fairfax city","A_A",4575,4536,-39,-0.86,"undercount"
"11702",51600,"Virginia","Fairfax city","A_AIC",5014,5075,61,1.21,"overcount"
"11703",51600,"Virginia","Fairfax city","NHPI_A",37,12,-25,-102.04,"undercount"
"11704",51600,"Virginia","Fairfax city","NHPI_AIC",81,37,-44,-74.58,"undercount"
"11705",51610,"Virginia","Falls Church city","A_A",1477,1512,35,2.34,"overcount"
"11706",51610,"Virginia","Falls Church city","A_AIC",1871,2070,199,10.1,"overcount"
"11707",51610,"Virginia","Falls Church city","NHPI_A",9,10,1,10.53,"overcount"
"11708",51610,"Virginia","Falls Church city","NHPI_AIC",29,42,13,36.62,"overcount"
"11709",51620,"Virginia","Franklin city","A_A",75,81,6,7.69,"overcount"
"11710",51620,"Virginia","Franklin city","A_AIC",113,124,11,9.28,"overcount"
"11711",51620,"Virginia","Franklin city","NHPI_A",4,2,-2,-66.67,"undercount"
"11712",51620,"Virginia","Franklin city","NHPI_AIC",16,15,-1,-6.45,"undercount"
"11713",51630,"Virginia","Fredericksburg city","A_A",922,1330,408,36.23,"overcount"
"11714",51630,"Virginia","Fredericksburg city","A_AIC",1381,1840,459,28.5,"overcount"
"11715",51630,"Virginia","Fredericksburg city","NHPI_A",47,24,-23,-64.79,"undercount"
"11716",51630,"Virginia","Fredericksburg city","NHPI_AIC",122,70,-52,-54.17,"undercount"
"11717",51640,"Virginia","Galax city","A_A",64,52,-12,-20.69,"undercount"
"11718",51640,"Virginia","Galax city","A_AIC",86,83,-3,-3.55,"undercount"
"11719",51640,"Virginia","Galax city","NHPI_A",18,3,-15,-142.86,"undercount"
"11720",51640,"Virginia","Galax city","NHPI_AIC",24,9,-15,-90.91,"undercount"
"11721",51650,"Virginia","Hampton city","A_A",3537,3532,-5,-0.14,"undercount"
"11722",51650,"Virginia","Hampton city","A_AIC",5295,5235,-60,-1.14,"undercount"
"11723",51650,"Virginia","Hampton city","NHPI_A",249,233,-16,-6.64,"undercount"
"11724",51650,"Virginia","Hampton city","NHPI_AIC",539,556,17,3.11,"overcount"
"11725",51660,"Virginia","Harrisonburg city","A_A",2432,2117,-315,-13.85,"undercount"
"11726",51660,"Virginia","Harrisonburg city","A_AIC",3120,2839,-281,-9.43,"undercount"
"11727",51660,"Virginia","Harrisonburg city","NHPI_A",133,20,-113,-147.71,"undercount"
"11728",51660,"Virginia","Harrisonburg city","NHPI_AIC",192,74,-118,-88.72,"undercount"
"11729",51670,"Virginia","Hopewell city","A_A",394,256,-138,-42.46,"undercount"
"11730",51670,"Virginia","Hopewell city","A_AIC",567,429,-138,-27.71,"undercount"
"11731",51670,"Virginia","Hopewell city","NHPI_A",52,15,-37,-110.45,"undercount"
"11732",51670,"Virginia","Hopewell city","NHPI_AIC",96,47,-49,-68.53,"undercount"
"11733",51678,"Virginia","Lexington city","A_A",215,284,69,27.66,"overcount"
"11734",51678,"Virginia","Lexington city","A_AIC",306,370,64,18.93,"overcount"
"11735",51678,"Virginia","Lexington city","NHPI_A",6,0,-6,-200,"undercount"
"11736",51678,"Virginia","Lexington city","NHPI_AIC",13,11,-2,-16.67,"undercount"
"11737",51680,"Virginia","Lynchburg city","A_A",2261,1782,-479,-23.7,"undercount"
"11738",51680,"Virginia","Lynchburg city","A_AIC",2710,2360,-350,-13.81,"undercount"
"11739",51680,"Virginia","Lynchburg city","NHPI_A",67,34,-33,-65.35,"undercount"
"11740",51680,"Virginia","Lynchburg city","NHPI_AIC",162,130,-32,-21.92,"undercount"
"11741",51683,"Virginia","Manassas city","A_A",2693,2721,28,1.03,"overcount"
"11742",51683,"Virginia","Manassas city","A_AIC",3115,3235,120,3.78,"overcount"
"11743",51683,"Virginia","Manassas city","NHPI_A",103,19,-84,-137.7,"undercount"
"11744",51683,"Virginia","Manassas city","NHPI_AIC",183,58,-125,-103.73,"undercount"
"11745",51685,"Virginia","Manassas Park city","A_A",2133,1858,-275,-13.78,"undercount"
"11746",51685,"Virginia","Manassas Park city","A_AIC",2335,2035,-300,-13.73,"undercount"
"11747",51685,"Virginia","Manassas Park city","NHPI_A",67,13,-54,-135,"undercount"
"11748",51685,"Virginia","Manassas Park city","NHPI_AIC",92,41,-51,-76.69,"undercount"
"11749",51690,"Virginia","Martinsville city","A_A",153,121,-32,-23.36,"undercount"
"11750",51690,"Virginia","Martinsville city","A_AIC",191,179,-12,-6.49,"undercount"
"11751",51690,"Virginia","Martinsville city","NHPI_A",12,4,-8,-100,"undercount"
"11752",51690,"Virginia","Martinsville city","NHPI_AIC",18,35,17,64.15,"overcount"
"11753",51700,"Virginia","Newport News city","A_A",6030,6315,285,4.62,"overcount"
"11754",51700,"Virginia","Newport News city","A_AIC",8810,9128,318,3.55,"overcount"
"11755",51700,"Virginia","Newport News city","NHPI_A",457,424,-33,-7.49,"undercount"
"11756",51700,"Virginia","Newport News city","NHPI_AIC",832,849,17,2.02,"overcount"
"11757",51710,"Virginia","Norfolk city","A_A",9528,8967,-561,-6.07,"undercount"
"11758",51710,"Virginia","Norfolk city","A_AIC",12981,12409,-572,-4.51,"undercount"
"11759",51710,"Virginia","Norfolk city","NHPI_A",579,478,-101,-19.11,"undercount"
"11760",51710,"Virginia","Norfolk city","NHPI_AIC",1208,1085,-123,-10.73,"undercount"
"11761",51720,"Virginia","Norton city","A_A",77,30,-47,-87.85,"undercount"
"11762",51720,"Virginia","Norton city","A_AIC",81,43,-38,-61.29,"undercount"
"11763",51720,"Virginia","Norton city","NHPI_A",2,0,-2,-200,"undercount"
"11764",51720,"Virginia","Norton city","NHPI_AIC",4,5,1,22.22,"overcount"
"11765",51730,"Virginia","Petersburg city","A_A",355,337,-18,-5.2,"undercount"
"11766",51730,"Virginia","Petersburg city","A_AIC",541,495,-46,-8.88,"undercount"
"11767",51730,"Virginia","Petersburg city","NHPI_A",60,30,-30,-66.67,"undercount"
"11768",51730,"Virginia","Petersburg city","NHPI_AIC",112,56,-56,-66.67,"undercount"
"11769",51735,"Virginia","Poquoson city","A_A",291,288,-3,-1.04,"undercount"
"11770",51735,"Virginia","Poquoson city","A_AIC",446,483,37,7.97,"overcount"
"11771",51735,"Virginia","Poquoson city","NHPI_A",9,2,-7,-127.27,"undercount"
"11772",51735,"Virginia","Poquoson city","NHPI_AIC",23,38,15,49.18,"overcount"
"11773",51740,"Virginia","Portsmouth city","A_A",1383,1275,-108,-8.13,"undercount"
"11774",51740,"Virginia","Portsmouth city","A_AIC",2256,2166,-90,-4.07,"undercount"
"11775",51740,"Virginia","Portsmouth city","NHPI_A",149,135,-14,-9.86,"undercount"
"11776",51740,"Virginia","Portsmouth city","NHPI_AIC",284,329,45,14.68,"overcount"
"11777",51750,"Virginia","Radford city","A_A",389,257,-132,-40.87,"undercount"
"11778",51750,"Virginia","Radford city","A_AIC",488,352,-136,-32.38,"undercount"
"11779",51750,"Virginia","Radford city","NHPI_A",5,0,-5,-200,"undercount"
"11780",51750,"Virginia","Radford city","NHPI_AIC",25,4,-21,-144.83,"undercount"
"11781",51760,"Virginia","Richmond city","A_A",5442,6304,862,14.68,"overcount"
"11782",51760,"Virginia","Richmond city","A_AIC",7418,8889,1471,18.04,"overcount"
"11783",51760,"Virginia","Richmond city","NHPI_A",339,79,-260,-124.4,"undercount"
"11784",51760,"Virginia","Richmond city","NHPI_AIC",599,278,-321,-73.2,"undercount"
"11785",51770,"Virginia","Roanoke city","A_A",3359,2493,-866,-29.6,"undercount"
"11786",51770,"Virginia","Roanoke city","A_AIC",3926,3159,-767,-21.65,"undercount"
"11787",51770,"Virginia","Roanoke city","NHPI_A",97,45,-52,-73.24,"undercount"
"11788",51770,"Virginia","Roanoke city","NHPI_AIC",189,94,-95,-67.14,"undercount"
"11789",51775,"Virginia","Salem city","A_A",483,541,58,11.33,"overcount"
"11790",51775,"Virginia","Salem city","A_AIC",573,680,107,17.08,"overcount"
"11791",51775,"Virginia","Salem city","NHPI_A",13,8,-5,-47.62,"undercount"
"11792",51775,"Virginia","Salem city","NHPI_AIC",28,46,18,48.65,"overcount"
"11793",51790,"Virginia","Staunton city","A_A",366,325,-41,-11.87,"undercount"
"11794",51790,"Virginia","Staunton city","A_AIC",520,461,-59,-12.03,"undercount"
"11795",51790,"Virginia","Staunton city","NHPI_A",11,11,0,0,"equal"
"11796",51790,"Virginia","Staunton city","NHPI_AIC",41,23,-18,-56.25,"undercount"
"11797",51800,"Virginia","Suffolk city","A_A",1968,1693,-275,-15.02,"undercount"
"11798",51800,"Virginia","Suffolk city","A_AIC",2913,2692,-221,-7.89,"undercount"
"11799",51800,"Virginia","Suffolk city","NHPI_A",100,72,-28,-32.56,"undercount"
"11800",51800,"Virginia","Suffolk city","NHPI_AIC",221,228,7,3.12,"overcount"
"11801",51810,"Virginia","Virginia Beach city","A_A",34213,34136,-77,-0.23,"undercount"
"11802",51810,"Virginia","Virginia Beach city","A_AIC",43451,44312,861,1.96,"overcount"
"11803",51810,"Virginia","Virginia Beach city","NHPI_A",869,684,-185,-23.82,"undercount"
"11804",51810,"Virginia","Virginia Beach city","NHPI_AIC",1912,2121,209,10.36,"overcount"
"11805",51820,"Virginia","Waynesboro city","A_A",398,260,-138,-41.95,"undercount"
"11806",51820,"Virginia","Waynesboro city","A_AIC",514,398,-116,-25.44,"undercount"
"11807",51820,"Virginia","Waynesboro city","NHPI_A",12,21,9,54.55,"overcount"
"11808",51820,"Virginia","Waynesboro city","NHPI_AIC",39,48,9,20.69,"overcount"
"11809",51830,"Virginia","Williamsburg city","A_A",896,500,-396,-56.73,"undercount"
"11810",51830,"Virginia","Williamsburg city","A_AIC",1154,653,-501,-55.45,"undercount"
"11811",51830,"Virginia","Williamsburg city","NHPI_A",18,25,7,32.56,"overcount"
"11812",51830,"Virginia","Williamsburg city","NHPI_AIC",34,44,10,25.64,"overcount"
"11813",51840,"Virginia","Winchester city","A_A",741,720,-21,-2.87,"undercount"
"11814",51840,"Virginia","Winchester city","A_AIC",920,888,-32,-3.54,"undercount"
"11815",51840,"Virginia","Winchester city","NHPI_A",28,14,-14,-66.67,"undercount"
"11816",51840,"Virginia","Winchester city","NHPI_AIC",57,33,-24,-53.33,"undercount"
"11817",53001,"Washington","Adams County","A_A",259,129,-130,-67.01,"undercount"
"11818",53001,"Washington","Adams County","A_AIC",353,223,-130,-45.14,"undercount"
"11819",53001,"Washington","Adams County","NHPI_A",41,8,-33,-134.69,"undercount"
"11820",53001,"Washington","Adams County","NHPI_AIC",88,50,-38,-55.07,"undercount"
"11821",53003,"Washington","Asotin County","A_A",237,206,-31,-14,"undercount"
"11822",53003,"Washington","Asotin County","A_AIC",401,387,-14,-3.55,"undercount"
"11823",53003,"Washington","Asotin County","NHPI_A",96,34,-62,-95.38,"undercount"
"11824",53003,"Washington","Asotin County","NHPI_AIC",152,101,-51,-40.32,"undercount"
"11825",53005,"Washington","Benton County","A_A",7001,6346,-655,-9.81,"undercount"
"11826",53005,"Washington","Benton County","A_AIC",9395,8927,-468,-5.11,"undercount"
"11827",53005,"Washington","Benton County","NHPI_A",562,543,-19,-3.44,"undercount"
"11828",53005,"Washington","Benton County","NHPI_AIC",1059,1096,37,3.43,"overcount"
"11829",53007,"Washington","Chelan County","A_A",972,815,-157,-17.57,"undercount"
"11830",53007,"Washington","Chelan County","A_AIC",1434,1415,-19,-1.33,"undercount"
"11831",53007,"Washington","Chelan County","NHPI_A",255,109,-146,-80.22,"undercount"
"11832",53007,"Washington","Chelan County","NHPI_AIC",392,294,-98,-28.57,"undercount"
"11833",53009,"Washington","Clallam County","A_A",1551,1250,-301,-21.49,"undercount"
"11834",53009,"Washington","Clallam County","A_AIC",2519,2211,-308,-13.02,"undercount"
"11835",53009,"Washington","Clallam County","NHPI_A",153,114,-39,-29.21,"undercount"
"11836",53009,"Washington","Clallam County","NHPI_AIC",481,434,-47,-10.27,"undercount"
"11837",53011,"Washington","Clark County","A_A",25623,24105,-1518,-6.11,"undercount"
"11838",53011,"Washington","Clark County","A_AIC",35050,34338,-712,-2.05,"undercount"
"11839",53011,"Washington","Clark County","NHPI_A",4718,5223,505,10.16,"overcount"
"11840",53011,"Washington","Clark County","NHPI_AIC",7507,8101,594,7.61,"overcount"
"11841",53013,"Washington","Columbia County","A_A",57,21,-36,-92.31,"undercount"
"11842",53013,"Washington","Columbia County","A_AIC",80,48,-32,-50,"undercount"
"11843",53013,"Washington","Columbia County","NHPI_A",87,0,-87,-200,"undercount"
"11844",53013,"Washington","Columbia County","NHPI_AIC",99,24,-75,-121.95,"undercount"
"11845",53015,"Washington","Cowlitz County","A_A",1819,1781,-38,-2.11,"undercount"
"11846",53015,"Washington","Cowlitz County","A_AIC",2932,2857,-75,-2.59,"undercount"
"11847",53015,"Washington","Cowlitz County","NHPI_A",489,643,154,27.21,"overcount"
"11848",53015,"Washington","Cowlitz County","NHPI_AIC",829,1033,204,21.91,"overcount"
"11849",53017,"Washington","Douglas County","A_A",551,407,-144,-30.06,"undercount"
"11850",53017,"Washington","Douglas County","A_AIC",940,779,-161,-18.73,"undercount"
"11851",53017,"Washington","Douglas County","NHPI_A",138,57,-81,-83.08,"undercount"
"11852",53017,"Washington","Douglas County","NHPI_AIC",256,140,-116,-58.59,"undercount"
"11853",53019,"Washington","Ferry County","A_A",93,43,-50,-73.53,"undercount"
"11854",53019,"Washington","Ferry County","A_AIC",141,102,-39,-32.1,"undercount"
"11855",53019,"Washington","Ferry County","NHPI_A",23,11,-12,-70.59,"undercount"
"11856",53019,"Washington","Ferry County","NHPI_AIC",49,34,-15,-36.14,"undercount"
"11857",53021,"Washington","Franklin County","A_A",2404,1806,-598,-28.41,"undercount"
"11858",53021,"Washington","Franklin County","A_AIC",3238,2535,-703,-24.35,"undercount"
"11859",53021,"Washington","Franklin County","NHPI_A",450,199,-251,-77.35,"undercount"
"11860",53021,"Washington","Franklin County","NHPI_AIC",717,504,-213,-34.89,"undercount"
"11861",53023,"Washington","Garfield County","A_A",89,9,-80,-163.27,"undercount"
"11862",53023,"Washington","Garfield County","A_AIC",103,28,-75,-114.5,"undercount"
"11863",53023,"Washington","Garfield County","NHPI_A",0,0,0,0,"equal"
"11864",53023,"Washington","Garfield County","NHPI_AIC",9,10,1,10.53,"overcount"
"11865",53025,"Washington","Grant County","A_A",1172,1161,-11,-0.94,"undercount"
"11866",53025,"Washington","Grant County","A_AIC",1780,1823,43,2.39,"overcount"
"11867",53025,"Washington","Grant County","NHPI_A",266,99,-167,-91.51,"undercount"
"11868",53025,"Washington","Grant County","NHPI_AIC",431,273,-158,-44.89,"undercount"
"11869",53027,"Washington","Grays Harbor County","A_A",1169,1024,-145,-13.22,"undercount"
"11870",53027,"Washington","Grays Harbor County","A_AIC",2046,2004,-42,-2.07,"undercount"
"11871",53027,"Washington","Grays Harbor County","NHPI_A",286,128,-158,-76.33,"undercount"
"11872",53027,"Washington","Grays Harbor County","NHPI_AIC",547,461,-86,-17.06,"undercount"
"11873",53029,"Washington","Island County","A_A",4337,4013,-324,-7.76,"undercount"
"11874",53029,"Washington","Island County","A_AIC",6347,6084,-263,-4.23,"undercount"
"11875",53029,"Washington","Island County","NHPI_A",434,416,-18,-4.24,"undercount"
"11876",53029,"Washington","Island County","NHPI_AIC",886,923,37,4.09,"overcount"
"11877",53031,"Washington","Jefferson County","A_A",668,487,-181,-31.34,"undercount"
"11878",53031,"Washington","Jefferson County","A_AIC",976,912,-64,-6.78,"undercount"
"11879",53031,"Washington","Jefferson County","NHPI_A",78,52,-26,-40,"undercount"
"11880",53031,"Washington","Jefferson County","NHPI_AIC",156,194,38,21.71,"overcount"
"11881",53033,"Washington","King County","A_A",464002,453230,-10772,-2.35,"undercount"
"11882",53033,"Washington","King County","A_AIC",532415,527853,-4562,-0.86,"undercount"
"11883",53033,"Washington","King County","NHPI_A",18900,19685,785,4.07,"overcount"
"11884",53033,"Washington","King County","NHPI_AIC",31393,31509,116,0.37,"overcount"
"11885",53035,"Washington","Kitsap County","A_A",14844,14203,-641,-4.41,"undercount"
"11886",53035,"Washington","Kitsap County","A_AIC",23674,23249,-425,-1.81,"undercount"
"11887",53035,"Washington","Kitsap County","NHPI_A",2721,2870,149,5.33,"overcount"
"11888",53035,"Washington","Kitsap County","NHPI_AIC",5202,5485,283,5.3,"overcount"
"11889",53037,"Washington","Kittitas County","A_A",1050,909,-141,-14.4,"undercount"
"11890",53037,"Washington","Kittitas County","A_AIC",1745,1544,-201,-12.22,"undercount"
"11891",53037,"Washington","Kittitas County","NHPI_A",107,87,-20,-20.62,"undercount"
"11892",53037,"Washington","Kittitas County","NHPI_AIC",245,246,1,0.41,"overcount"
"11893",53039,"Washington","Klickitat County","A_A",196,148,-48,-27.91,"undercount"
"11894",53039,"Washington","Klickitat County","A_AIC",360,346,-14,-3.97,"undercount"
"11895",53039,"Washington","Klickitat County","NHPI_A",56,36,-20,-43.48,"undercount"
"11896",53039,"Washington","Klickitat County","NHPI_AIC",93,102,9,9.23,"overcount"
"11897",53041,"Washington","Lewis County","A_A",949,805,-144,-16.42,"undercount"
"11898",53041,"Washington","Lewis County","A_AIC",1686,1604,-82,-4.98,"undercount"
"11899",53041,"Washington","Lewis County","NHPI_A",227,162,-65,-33.42,"undercount"
"11900",53041,"Washington","Lewis County","NHPI_AIC",468,475,7,1.48,"overcount"
"11901",53043,"Washington","Lincoln County","A_A",70,70,0,0,"equal"
"11902",53043,"Washington","Lincoln County","A_AIC",147,163,16,10.32,"overcount"
"11903",53043,"Washington","Lincoln County","NHPI_A",16,14,-2,-13.33,"undercount"
"11904",53043,"Washington","Lincoln County","NHPI_AIC",45,46,1,2.2,"overcount"
"11905",53045,"Washington","Mason County","A_A",973,784,-189,-21.51,"undercount"
"11906",53045,"Washington","Mason County","A_AIC",1890,1760,-130,-7.12,"undercount"
"11907",53045,"Washington","Mason County","NHPI_A",373,221,-152,-51.18,"undercount"
"11908",53045,"Washington","Mason County","NHPI_AIC",689,630,-59,-8.95,"undercount"
"11909",53047,"Washington","Okanogan County","A_A",455,268,-187,-51.73,"undercount"
"11910",53047,"Washington","Okanogan County","A_AIC",661,515,-146,-24.83,"undercount"
"11911",53047,"Washington","Okanogan County","NHPI_A",129,41,-88,-103.53,"undercount"
"11912",53047,"Washington","Okanogan County","NHPI_AIC",198,93,-105,-72.16,"undercount"
"11913",53049,"Washington","Pacific County","A_A",480,495,15,3.08,"overcount"
"11914",53049,"Washington","Pacific County","A_AIC",680,698,18,2.61,"overcount"
"11915",53049,"Washington","Pacific County","NHPI_A",48,42,-6,-13.33,"undercount"
"11916",53049,"Washington","Pacific County","NHPI_AIC",93,103,10,10.2,"overcount"
"11917",53051,"Washington","Pend Oreille County","A_A",153,70,-83,-74.44,"undercount"
"11918",53051,"Washington","Pend Oreille County","A_AIC",248,154,-94,-46.77,"undercount"
"11919",53051,"Washington","Pend Oreille County","NHPI_A",24,9,-15,-90.91,"undercount"
"11920",53051,"Washington","Pend Oreille County","NHPI_AIC",53,32,-21,-49.41,"undercount"
"11921",53053,"Washington","Pierce County","A_A",65861,62945,-2916,-4.53,"undercount"
"11922",53053,"Washington","Pierce County","A_AIC",97299,93268,-4031,-4.23,"undercount"
"11923",53053,"Washington","Pierce County","NHPI_A",16321,18262,1941,11.23,"overcount"
"11924",53053,"Washington","Pierce County","NHPI_AIC",24716,27426,2710,10.39,"overcount"
"11925",53055,"Washington","San Juan County","A_A",294,239,-55,-20.64,"undercount"
"11926",53055,"Washington","San Juan County","A_AIC",410,450,40,9.3,"overcount"
"11927",53055,"Washington","San Juan County","NHPI_A",26,23,-3,-12.24,"undercount"
"11928",53055,"Washington","San Juan County","NHPI_AIC",47,67,20,35.09,"overcount"
"11929",53057,"Washington","Skagit County","A_A",3141,2826,-315,-10.56,"undercount"
"11930",53057,"Washington","Skagit County","A_AIC",4494,4474,-20,-0.45,"undercount"
"11931",53057,"Washington","Skagit County","NHPI_A",487,396,-91,-20.61,"undercount"
"11932",53057,"Washington","Skagit County","NHPI_AIC",852,778,-74,-9.08,"undercount"
"11933",53059,"Washington","Skamania County","A_A",130,122,-8,-6.35,"undercount"
"11934",53059,"Washington","Skamania County","A_AIC",238,260,22,8.84,"overcount"
"11935",53059,"Washington","Skamania County","NHPI_A",30,30,0,0,"equal"
"11936",53059,"Washington","Skamania County","NHPI_AIC",70,80,10,13.33,"overcount"
"11937",53061,"Washington","Snohomish County","A_A",104563,101516,-3047,-2.96,"undercount"
"11938",53061,"Washington","Snohomish County","A_AIC",126441,123824,-2617,-2.09,"undercount"
"11939",53061,"Washington","Snohomish County","NHPI_A",5561,5002,-559,-10.58,"undercount"
"11940",53061,"Washington","Snohomish County","NHPI_AIC",10407,9800,-607,-6.01,"undercount"
"11941",53063,"Washington","Spokane County","A_A",12802,12582,-220,-1.73,"undercount"
"11942",53063,"Washington","Spokane County","A_AIC",21109,21194,85,0.4,"overcount"
"11943",53063,"Washington","Spokane County","NHPI_A",3393,4264,871,22.75,"overcount"
"11944",53063,"Washington","Spokane County","NHPI_AIC",5378,6483,1105,18.63,"overcount"
"11945",53065,"Washington","Stevens County","A_A",367,281,-86,-26.54,"undercount"
"11946",53065,"Washington","Stevens County","A_AIC",714,639,-75,-11.09,"undercount"
"11947",53065,"Washington","Stevens County","NHPI_A",91,84,-7,-8,"undercount"
"11948",53065,"Washington","Stevens County","NHPI_AIC",215,214,-1,-0.47,"undercount"
"11949",53067,"Washington","Thurston County","A_A",18326,17076,-1250,-7.06,"undercount"
"11950",53067,"Washington","Thurston County","A_AIC",26428,25151,-1277,-4.95,"undercount"
"11951",53067,"Washington","Thurston County","NHPI_A",3039,3254,215,6.83,"overcount"
"11952",53067,"Washington","Thurston County","NHPI_AIC",5213,5583,370,6.85,"overcount"
"11953",53069,"Washington","Wahkiakum County","A_A",70,43,-27,-47.79,"undercount"
"11954",53069,"Washington","Wahkiakum County","A_AIC",98,95,-3,-3.11,"undercount"
"11955",53069,"Washington","Wahkiakum County","NHPI_A",17,3,-14,-140,"undercount"
"11956",53069,"Washington","Wahkiakum County","NHPI_AIC",28,30,2,6.9,"overcount"
"11957",53071,"Washington","Walla Walla County","A_A",1181,944,-237,-22.31,"undercount"
"11958",53071,"Washington","Walla Walla County","A_AIC",1852,1758,-94,-5.21,"undercount"
"11959",53071,"Washington","Walla Walla County","NHPI_A",238,134,-104,-55.91,"undercount"
"11960",53071,"Washington","Walla Walla County","NHPI_AIC",435,438,3,0.69,"overcount"
"11961",53073,"Washington","Whatcom County","A_A",11064,10115,-949,-8.96,"undercount"
"11962",53073,"Washington","Whatcom County","A_AIC",15631,14570,-1061,-7.03,"undercount"
"11963",53073,"Washington","Whatcom County","NHPI_A",726,684,-42,-5.96,"undercount"
"11964",53073,"Washington","Whatcom County","NHPI_AIC",1645,1612,-33,-2.03,"undercount"
"11965",53075,"Washington","Whitman County","A_A",4072,3634,-438,-11.37,"undercount"
"11966",53075,"Washington","Whitman County","A_AIC",5166,4876,-290,-5.78,"undercount"
"11967",53075,"Washington","Whitman County","NHPI_A",133,145,12,8.63,"overcount"
"11968",53075,"Washington","Whitman County","NHPI_AIC",330,353,23,6.73,"overcount"
"11969",53077,"Washington","Yakima County","A_A",3988,2794,-1194,-35.21,"undercount"
"11970",53077,"Washington","Yakima County","A_AIC",6238,4343,-1895,-35.82,"undercount"
"11971",53077,"Washington","Yakima County","NHPI_A",802,224,-578,-112.67,"undercount"
"11972",53077,"Washington","Yakima County","NHPI_AIC",1411,625,-786,-77.21,"undercount"
"11973",54001,"West Virginia","Barbour County","A_A",50,32,-18,-43.9,"undercount"
"11974",54001,"West Virginia","Barbour County","A_AIC",88,57,-31,-42.76,"undercount"
"11975",54001,"West Virginia","Barbour County","NHPI_A",4,0,-4,-200,"undercount"
"11976",54001,"West Virginia","Barbour County","NHPI_AIC",16,3,-13,-136.84,"undercount"
"11977",54003,"West Virginia","Berkeley County","A_A",1415,1475,60,4.15,"overcount"
"11978",54003,"West Virginia","Berkeley County","A_AIC",2151,2351,200,8.88,"overcount"
"11979",54003,"West Virginia","Berkeley County","NHPI_A",51,43,-8,-17.02,"undercount"
"11980",54003,"West Virginia","Berkeley County","NHPI_AIC",182,146,-36,-21.95,"undercount"
"11981",54005,"West Virginia","Boone County","A_A",30,36,6,18.18,"overcount"
"11982",54005,"West Virginia","Boone County","A_AIC",47,94,47,66.67,"overcount"
"11983",54005,"West Virginia","Boone County","NHPI_A",1,2,1,66.67,"overcount"
"11984",54005,"West Virginia","Boone County","NHPI_AIC",3,12,9,120,"overcount"
"11985",54007,"West Virginia","Braxton County","A_A",33,23,-10,-35.71,"undercount"
"11986",54007,"West Virginia","Braxton County","A_AIC",57,49,-8,-15.09,"undercount"
"11987",54007,"West Virginia","Braxton County","NHPI_A",3,11,8,114.29,"overcount"
"11988",54007,"West Virginia","Braxton County","NHPI_AIC",8,17,9,72,"overcount"
"11989",54009,"West Virginia","Brooke County","A_A",90,55,-35,-48.28,"undercount"
"11990",54009,"West Virginia","Brooke County","A_AIC",140,123,-17,-12.93,"undercount"
"11991",54009,"West Virginia","Brooke County","NHPI_A",5,0,-5,-200,"undercount"
"11992",54009,"West Virginia","Brooke County","NHPI_AIC",17,12,-5,-34.48,"undercount"
"11993",54011,"West Virginia","Cabell County","A_A",1185,1353,168,13.24,"overcount"
"11994",54011,"West Virginia","Cabell County","A_AIC",1568,1755,187,11.25,"overcount"
"11995",54011,"West Virginia","Cabell County","NHPI_A",25,20,-5,-22.22,"undercount"
"11996",54011,"West Virginia","Cabell County","NHPI_AIC",103,79,-24,-26.37,"undercount"
"11997",54013,"West Virginia","Calhoun County","A_A",12,14,2,15.38,"overcount"
"11998",54013,"West Virginia","Calhoun County","A_AIC",18,22,4,20,"overcount"
"11999",54013,"West Virginia","Calhoun County","NHPI_A",3,2,-1,-40,"undercount"
"12000",54013,"West Virginia","Calhoun County","NHPI_AIC",4,4,0,0,"equal"
"12001",54015,"West Virginia","Clay County","A_A",10,17,7,51.85,"overcount"
"12002",54015,"West Virginia","Clay County","A_AIC",33,32,-1,-3.08,"undercount"
"12003",54015,"West Virginia","Clay County","NHPI_A",3,0,-3,-200,"undercount"
"12004",54015,"West Virginia","Clay County","NHPI_AIC",6,14,8,80,"overcount"
"12005",54017,"West Virginia","Doddridge County","A_A",40,16,-24,-85.71,"undercount"
"12006",54017,"West Virginia","Doddridge County","A_AIC",53,25,-28,-71.79,"undercount"
"12007",54017,"West Virginia","Doddridge County","NHPI_A",2,0,-2,-200,"undercount"
"12008",54017,"West Virginia","Doddridge County","NHPI_AIC",7,2,-5,-111.11,"undercount"
"12009",54019,"West Virginia","Fayette County","A_A",126,107,-19,-16.31,"undercount"
"12010",54019,"West Virginia","Fayette County","A_AIC",184,180,-4,-2.2,"undercount"
"12011",54019,"West Virginia","Fayette County","NHPI_A",6,3,-3,-66.67,"undercount"
"12012",54019,"West Virginia","Fayette County","NHPI_AIC",21,28,7,28.57,"overcount"
"12013",54021,"West Virginia","Gilmer County","A_A",60,32,-28,-60.87,"undercount"
"12014",54021,"West Virginia","Gilmer County","A_AIC",82,47,-35,-54.26,"undercount"
"12015",54021,"West Virginia","Gilmer County","NHPI_A",9,0,-9,-200,"undercount"
"12016",54021,"West Virginia","Gilmer County","NHPI_AIC",16,8,-8,-66.67,"undercount"
"12017",54023,"West Virginia","Grant County","A_A",26,24,-2,-8,"undercount"
"12018",54023,"West Virginia","Grant County","A_AIC",43,49,6,13.04,"overcount"
"12019",54023,"West Virginia","Grant County","NHPI_A",2,0,-2,-200,"undercount"
"12020",54023,"West Virginia","Grant County","NHPI_AIC",4,2,-2,-66.67,"undercount"
"12021",54025,"West Virginia","Greenbrier County","A_A",250,204,-46,-20.26,"undercount"
"12022",54025,"West Virginia","Greenbrier County","A_AIC",328,293,-35,-11.27,"undercount"
"12023",54025,"West Virginia","Greenbrier County","NHPI_A",7,14,7,66.67,"overcount"
"12024",54025,"West Virginia","Greenbrier County","NHPI_AIC",25,30,5,18.18,"overcount"
"12025",54027,"West Virginia","Hampshire County","A_A",77,61,-16,-23.19,"undercount"
"12026",54027,"West Virginia","Hampshire County","A_AIC",129,128,-1,-0.78,"undercount"
"12027",54027,"West Virginia","Hampshire County","NHPI_A",13,4,-9,-105.88,"undercount"
"12028",54027,"West Virginia","Hampshire County","NHPI_AIC",23,18,-5,-24.39,"undercount"
"12029",54029,"West Virginia","Hancock County","A_A",137,111,-26,-20.97,"undercount"
"12030",54029,"West Virginia","Hancock County","A_AIC",195,198,3,1.53,"overcount"
"12031",54029,"West Virginia","Hancock County","NHPI_A",5,8,3,46.15,"overcount"
"12032",54029,"West Virginia","Hancock County","NHPI_AIC",16,26,10,47.62,"overcount"
"12033",54031,"West Virginia","Hardy County","A_A",121,53,-68,-78.16,"undercount"
"12034",54031,"West Virginia","Hardy County","A_AIC",146,87,-59,-50.64,"undercount"
"12035",54031,"West Virginia","Hardy County","NHPI_A",9,0,-9,-200,"undercount"
"12036",54031,"West Virginia","Hardy County","NHPI_AIC",12,13,1,8,"overcount"
"12037",54033,"West Virginia","Harrison County","A_A",433,491,58,12.55,"overcount"
"12038",54033,"West Virginia","Harrison County","A_AIC",592,688,96,15,"overcount"
"12039",54033,"West Virginia","Harrison County","NHPI_A",16,28,12,54.55,"overcount"
"12040",54033,"West Virginia","Harrison County","NHPI_AIC",45,74,29,48.74,"overcount"
"12041",54035,"West Virginia","Jackson County","A_A",98,91,-7,-7.41,"undercount"
"12042",54035,"West Virginia","Jackson County","A_AIC",139,145,6,4.23,"overcount"
"12043",54035,"West Virginia","Jackson County","NHPI_A",10,2,-8,-133.33,"undercount"
"12044",54035,"West Virginia","Jackson County","NHPI_AIC",19,3,-16,-145.45,"undercount"
"12045",54037,"West Virginia","Jefferson County","A_A",961,842,-119,-13.2,"undercount"
"12046",54037,"West Virginia","Jefferson County","A_AIC",1335,1359,24,1.78,"overcount"
"12047",54037,"West Virginia","Jefferson County","NHPI_A",47,17,-30,-93.75,"undercount"
"12048",54037,"West Virginia","Jefferson County","NHPI_AIC",122,93,-29,-26.98,"undercount"
"12049",54039,"West Virginia","Kanawha County","A_A",1912,2173,261,12.78,"overcount"
"12050",54039,"West Virginia","Kanawha County","A_AIC",2653,2956,303,10.8,"overcount"
"12051",54039,"West Virginia","Kanawha County","NHPI_A",51,47,-4,-8.16,"undercount"
"12052",54039,"West Virginia","Kanawha County","NHPI_AIC",162,173,11,6.57,"overcount"
"12053",54041,"West Virginia","Lewis County","A_A",80,58,-22,-31.88,"undercount"
"12054",54041,"West Virginia","Lewis County","A_AIC",108,107,-1,-0.93,"undercount"
"12055",54041,"West Virginia","Lewis County","NHPI_A",1,7,6,150,"overcount"
"12056",54041,"West Virginia","Lewis County","NHPI_AIC",4,20,16,133.33,"overcount"
"12057",54043,"West Virginia","Lincoln County","A_A",56,26,-30,-73.17,"undercount"
"12058",54043,"West Virginia","Lincoln County","A_AIC",89,45,-44,-65.67,"undercount"
"12059",54043,"West Virginia","Lincoln County","NHPI_A",1,0,-1,-200,"undercount"
"12060",54043,"West Virginia","Lincoln County","NHPI_AIC",4,8,4,66.67,"overcount"
"12061",54045,"West Virginia","Logan County","A_A",83,63,-20,-27.4,"undercount"
"12062",54045,"West Virginia","Logan County","A_AIC",125,85,-40,-38.1,"undercount"
"12063",54045,"West Virginia","Logan County","NHPI_A",2,1,-1,-66.67,"undercount"
"12064",54045,"West Virginia","Logan County","NHPI_AIC",8,11,3,31.58,"overcount"
"12065",54047,"West Virginia","McDowell County","A_A",32,20,-12,-46.15,"undercount"
"12066",54047,"West Virginia","McDowell County","A_AIC",52,35,-17,-39.08,"undercount"
"12067",54047,"West Virginia","McDowell County","NHPI_A",1,4,3,120,"overcount"
"12068",54047,"West Virginia","McDowell County","NHPI_AIC",7,13,6,60,"overcount"
"12069",54049,"West Virginia","Marion County","A_A",374,266,-108,-33.75,"undercount"
"12070",54049,"West Virginia","Marion County","A_AIC",519,475,-44,-8.85,"undercount"
"12071",54049,"West Virginia","Marion County","NHPI_A",12,43,31,112.73,"overcount"
"12072",54049,"West Virginia","Marion County","NHPI_AIC",49,79,30,46.88,"overcount"
"12073",54051,"West Virginia","Marshall County","A_A",140,108,-32,-25.81,"undercount"
"12074",54051,"West Virginia","Marshall County","A_AIC",184,179,-5,-2.75,"undercount"
"12075",54051,"West Virginia","Marshall County","NHPI_A",4,7,3,54.55,"overcount"
"12076",54051,"West Virginia","Marshall County","NHPI_AIC",17,27,10,45.45,"overcount"
"12077",54053,"West Virginia","Mason County","A_A",81,74,-7,-9.03,"undercount"
"12078",54053,"West Virginia","Mason County","A_AIC",123,116,-7,-5.86,"undercount"
"12079",54053,"West Virginia","Mason County","NHPI_A",16,5,-11,-104.76,"undercount"
"12080",54053,"West Virginia","Mason County","NHPI_AIC",24,14,-10,-52.63,"undercount"
"12081",54055,"West Virginia","Mercer County","A_A",356,292,-64,-19.75,"undercount"
"12082",54055,"West Virginia","Mercer County","A_AIC",474,416,-58,-13.03,"undercount"
"12083",54055,"West Virginia","Mercer County","NHPI_A",7,6,-1,-15.38,"undercount"
"12084",54055,"West Virginia","Mercer County","NHPI_AIC",36,32,-4,-11.76,"undercount"
"12085",54057,"West Virginia","Mineral County","A_A",158,114,-44,-32.35,"undercount"
"12086",54057,"West Virginia","Mineral County","A_AIC",205,174,-31,-16.36,"undercount"
"12087",54057,"West Virginia","Mineral County","NHPI_A",2,5,3,85.71,"overcount"
"12088",54057,"West Virginia","Mineral County","NHPI_AIC",19,8,-11,-81.48,"undercount"
"12089",54059,"West Virginia","Mingo County","A_A",70,33,-37,-71.84,"undercount"
"12090",54059,"West Virginia","Mingo County","A_AIC",96,61,-35,-44.59,"undercount"
"12091",54059,"West Virginia","Mingo County","NHPI_A",3,0,-3,-200,"undercount"
"12092",54059,"West Virginia","Mingo County","NHPI_AIC",10,13,3,26.09,"overcount"
"12093",54061,"West Virginia","Monongalia County","A_A",3781,3769,-12,-0.32,"undercount"
"12094",54061,"West Virginia","Monongalia County","A_AIC",4542,4809,267,5.71,"overcount"
"12095",54061,"West Virginia","Monongalia County","NHPI_A",67,64,-3,-4.58,"undercount"
"12096",54061,"West Virginia","Monongalia County","NHPI_AIC",156,157,1,0.64,"overcount"
"12097",54063,"West Virginia","Monroe County","A_A",25,11,-14,-77.78,"undercount"
"12098",54063,"West Virginia","Monroe County","A_AIC",63,27,-36,-80,"undercount"
"12099",54063,"West Virginia","Monroe County","NHPI_A",3,0,-3,-200,"undercount"
"12100",54063,"West Virginia","Monroe County","NHPI_AIC",10,0,-10,-200,"undercount"
"12101",54065,"West Virginia","Morgan County","A_A",78,89,11,13.17,"overcount"
"12102",54065,"West Virginia","Morgan County","A_AIC",143,160,17,11.22,"overcount"
"12103",54065,"West Virginia","Morgan County","NHPI_A",6,0,-6,-200,"undercount"
"12104",54065,"West Virginia","Morgan County","NHPI_AIC",22,10,-12,-75,"undercount"
"12105",54067,"West Virginia","Nicholas County","A_A",102,72,-30,-34.48,"undercount"
"12106",54067,"West Virginia","Nicholas County","A_AIC",141,126,-15,-11.24,"undercount"
"12107",54067,"West Virginia","Nicholas County","NHPI_A",4,7,3,54.55,"overcount"
"12108",54067,"West Virginia","Nicholas County","NHPI_AIC",14,13,-1,-7.41,"undercount"
"12109",54069,"West Virginia","Ohio County","A_A",338,387,49,13.52,"overcount"
"12110",54069,"West Virginia","Ohio County","A_AIC",481,543,62,12.11,"overcount"
"12111",54069,"West Virginia","Ohio County","NHPI_A",11,20,9,58.06,"overcount"
"12112",54069,"West Virginia","Ohio County","NHPI_AIC",49,46,-3,-6.32,"undercount"
"12113",54071,"West Virginia","Pendleton County","A_A",14,0,-14,-200,"undercount"
"12114",54071,"West Virginia","Pendleton County","A_AIC",33,1,-32,-188.24,"undercount"
"12115",54071,"West Virginia","Pendleton County","NHPI_A",5,2,-3,-85.71,"undercount"
"12116",54071,"West Virginia","Pendleton County","NHPI_AIC",11,6,-5,-58.82,"undercount"
"12117",54073,"West Virginia","Pleasants County","A_A",16,17,1,6.06,"overcount"
"12118",54073,"West Virginia","Pleasants County","A_AIC",38,27,-11,-33.85,"undercount"
"12119",54073,"West Virginia","Pleasants County","NHPI_A",0,0,0,0,"equal"
"12120",54073,"West Virginia","Pleasants County","NHPI_AIC",3,2,-1,-40,"undercount"
"12121",54075,"West Virginia","Pocahontas County","A_A",17,9,-8,-61.54,"undercount"
"12122",54075,"West Virginia","Pocahontas County","A_AIC",43,22,-21,-64.62,"undercount"
"12123",54075,"West Virginia","Pocahontas County","NHPI_A",0,0,0,0,"equal"
"12124",54075,"West Virginia","Pocahontas County","NHPI_AIC",4,0,-4,-200,"undercount"
"12125",54077,"West Virginia","Preston County","A_A",110,53,-57,-69.94,"undercount"
"12126",54077,"West Virginia","Preston County","A_AIC",156,98,-58,-45.67,"undercount"
"12127",54077,"West Virginia","Preston County","NHPI_A",9,5,-4,-57.14,"undercount"
"12128",54077,"West Virginia","Preston County","NHPI_AIC",25,19,-6,-27.27,"undercount"
"12129",54079,"West Virginia","Putnam County","A_A",520,599,79,14.12,"overcount"
"12130",54079,"West Virginia","Putnam County","A_AIC",672,837,165,21.87,"overcount"
"12131",54079,"West Virginia","Putnam County","NHPI_A",25,8,-17,-103.03,"undercount"
"12132",54079,"West Virginia","Putnam County","NHPI_AIC",53,40,-13,-27.96,"undercount"
"12133",54081,"West Virginia","Raleigh County","A_A",672,831,159,21.16,"overcount"
"12134",54081,"West Virginia","Raleigh County","A_AIC",939,1054,115,11.54,"overcount"
"12135",54081,"West Virginia","Raleigh County","NHPI_A",30,16,-14,-60.87,"undercount"
"12136",54081,"West Virginia","Raleigh County","NHPI_AIC",100,58,-42,-53.16,"undercount"
"12137",54083,"West Virginia","Randolph County","A_A",133,96,-37,-32.31,"undercount"
"12138",54083,"West Virginia","Randolph County","A_AIC",199,165,-34,-18.68,"undercount"
"12139",54083,"West Virginia","Randolph County","NHPI_A",1,1,0,0,"equal"
"12140",54083,"West Virginia","Randolph County","NHPI_AIC",18,7,-11,-88,"undercount"
"12141",54085,"West Virginia","Ritchie County","A_A",24,19,-5,-23.26,"undercount"
"12142",54085,"West Virginia","Ritchie County","A_AIC",42,29,-13,-36.62,"undercount"
"12143",54085,"West Virginia","Ritchie County","NHPI_A",0,7,7,200,"overcount"
"12144",54085,"West Virginia","Ritchie County","NHPI_AIC",2,7,5,111.11,"overcount"
"12145",54087,"West Virginia","Roane County","A_A",51,38,-13,-29.21,"undercount"
"12146",54087,"West Virginia","Roane County","A_AIC",89,103,14,14.58,"overcount"
"12147",54087,"West Virginia","Roane County","NHPI_A",5,0,-5,-200,"undercount"
"12148",54087,"West Virginia","Roane County","NHPI_AIC",13,9,-4,-36.36,"undercount"
"12149",54089,"West Virginia","Summers County","A_A",40,33,-7,-19.18,"undercount"
"12150",54089,"West Virginia","Summers County","A_AIC",76,50,-26,-41.27,"undercount"
"12151",54089,"West Virginia","Summers County","NHPI_A",5,0,-5,-200,"undercount"
"12152",54089,"West Virginia","Summers County","NHPI_AIC",11,16,5,37.04,"overcount"
"12153",54091,"West Virginia","Taylor County","A_A",81,41,-40,-65.57,"undercount"
"12154",54091,"West Virginia","Taylor County","A_AIC",111,83,-28,-28.87,"undercount"
"12155",54091,"West Virginia","Taylor County","NHPI_A",1,0,-1,-200,"undercount"
"12156",54091,"West Virginia","Taylor County","NHPI_AIC",7,4,-3,-54.55,"undercount"
"12157",54093,"West Virginia","Tucker County","A_A",23,6,-17,-117.24,"undercount"
"12158",54093,"West Virginia","Tucker County","A_AIC",30,22,-8,-30.77,"undercount"
"12159",54093,"West Virginia","Tucker County","NHPI_A",1,1,0,0,"equal"
"12160",54093,"West Virginia","Tucker County","NHPI_AIC",2,3,1,40,"overcount"
"12161",54095,"West Virginia","Tyler County","A_A",63,3,-60,-181.82,"undercount"
"12162",54095,"West Virginia","Tyler County","A_AIC",79,18,-61,-125.77,"undercount"
"12163",54095,"West Virginia","Tyler County","NHPI_A",2,0,-2,-200,"undercount"
"12164",54095,"West Virginia","Tyler County","NHPI_AIC",5,2,-3,-85.71,"undercount"
"12165",54097,"West Virginia","Upshur County","A_A",131,87,-44,-40.37,"undercount"
"12166",54097,"West Virginia","Upshur County","A_AIC",170,129,-41,-27.42,"undercount"
"12167",54097,"West Virginia","Upshur County","NHPI_A",3,5,2,50,"overcount"
"12168",54097,"West Virginia","Upshur County","NHPI_AIC",15,15,0,0,"equal"
"12169",54099,"West Virginia","Wayne County","A_A",118,85,-33,-32.51,"undercount"
"12170",54099,"West Virginia","Wayne County","A_AIC",197,160,-37,-20.73,"undercount"
"12171",54099,"West Virginia","Wayne County","NHPI_A",7,10,3,35.29,"overcount"
"12172",54099,"West Virginia","Wayne County","NHPI_AIC",18,29,11,46.81,"overcount"
"12173",54101,"West Virginia","Webster County","A_A",16,4,-12,-120,"undercount"
"12174",54101,"West Virginia","Webster County","A_AIC",25,16,-9,-43.9,"undercount"
"12175",54101,"West Virginia","Webster County","NHPI_A",1,2,1,66.67,"overcount"
"12176",54101,"West Virginia","Webster County","NHPI_AIC",5,11,6,75,"overcount"
"12177",54103,"West Virginia","Wetzel County","A_A",54,50,-4,-7.69,"undercount"
"12178",54103,"West Virginia","Wetzel County","A_AIC",74,81,7,9.03,"overcount"
"12179",54103,"West Virginia","Wetzel County","NHPI_A",0,0,0,0,"equal"
"12180",54103,"West Virginia","Wetzel County","NHPI_AIC",3,8,5,90.91,"overcount"
"12181",54105,"West Virginia","Wirt County","A_A",16,0,-16,-200,"undercount"
"12182",54105,"West Virginia","Wirt County","A_AIC",26,6,-20,-125,"undercount"
"12183",54105,"West Virginia","Wirt County","NHPI_A",1,4,3,120,"overcount"
"12184",54105,"West Virginia","Wirt County","NHPI_AIC",3,10,7,107.69,"overcount"
"12185",54107,"West Virginia","Wood County","A_A",467,570,103,19.86,"overcount"
"12186",54107,"West Virginia","Wood County","A_AIC",701,871,170,21.63,"overcount"
"12187",54107,"West Virginia","Wood County","NHPI_A",29,17,-12,-52.17,"undercount"
"12188",54107,"West Virginia","Wood County","NHPI_AIC",78,74,-4,-5.26,"undercount"
"12189",54109,"West Virginia","Wyoming County","A_A",40,13,-27,-101.89,"undercount"
"12190",54109,"West Virginia","Wyoming County","A_AIC",59,39,-20,-40.82,"undercount"
"12191",54109,"West Virginia","Wyoming County","NHPI_A",1,1,0,0,"equal"
"12192",54109,"West Virginia","Wyoming County","NHPI_AIC",5,5,0,0,"equal"
"12193",55001,"Wisconsin","Adams County","A_A",143,84,-59,-51.98,"undercount"
"12194",55001,"Wisconsin","Adams County","A_AIC",206,138,-68,-39.53,"undercount"
"12195",55001,"Wisconsin","Adams County","NHPI_A",12,8,-4,-40,"undercount"
"12196",55001,"Wisconsin","Adams County","NHPI_AIC",24,24,0,0,"equal"
"12197",55003,"Wisconsin","Ashland County","A_A",96,85,-11,-12.15,"undercount"
"12198",55003,"Wisconsin","Ashland County","A_AIC",154,175,21,12.77,"overcount"
"12199",55003,"Wisconsin","Ashland County","NHPI_A",5,9,4,57.14,"overcount"
"12200",55003,"Wisconsin","Ashland County","NHPI_AIC",11,34,23,102.22,"overcount"
"12201",55005,"Wisconsin","Barron County","A_A",309,358,49,14.69,"overcount"
"12202",55005,"Wisconsin","Barron County","A_AIC",456,517,61,12.54,"overcount"
"12203",55005,"Wisconsin","Barron County","NHPI_A",10,5,-5,-66.67,"undercount"
"12204",55005,"Wisconsin","Barron County","NHPI_AIC",30,39,9,26.09,"overcount"
"12205",55007,"Wisconsin","Bayfield County","A_A",88,36,-52,-83.87,"undercount"
"12206",55007,"Wisconsin","Bayfield County","A_AIC",149,97,-52,-42.28,"undercount"
"12207",55007,"Wisconsin","Bayfield County","NHPI_A",6,2,-4,-100,"undercount"
"12208",55007,"Wisconsin","Bayfield County","NHPI_AIC",15,17,2,12.5,"overcount"
"12209",55009,"Wisconsin","Brown County","A_A",9419,8536,-883,-9.84,"undercount"
"12210",55009,"Wisconsin","Brown County","A_AIC",10789,9980,-809,-7.79,"undercount"
"12211",55009,"Wisconsin","Brown County","NHPI_A",223,114,-109,-64.69,"undercount"
"12212",55009,"Wisconsin","Brown County","NHPI_AIC",475,280,-195,-51.66,"undercount"
"12213",55011,"Wisconsin","Buffalo County","A_A",57,22,-35,-88.61,"undercount"
"12214",55011,"Wisconsin","Buffalo County","A_AIC",95,55,-40,-53.33,"undercount"
"12215",55011,"Wisconsin","Buffalo County","NHPI_A",3,12,9,120,"overcount"
"12216",55011,"Wisconsin","Buffalo County","NHPI_AIC",11,24,13,74.29,"overcount"
"12217",55013,"Wisconsin","Burnett County","A_A",79,53,-26,-39.39,"undercount"
"12218",55013,"Wisconsin","Burnett County","A_AIC",130,133,3,2.28,"overcount"
"12219",55013,"Wisconsin","Burnett County","NHPI_A",10,10,0,0,"equal"
"12220",55013,"Wisconsin","Burnett County","NHPI_AIC",20,17,-3,-16.22,"undercount"
"12221",55015,"Wisconsin","Calumet County","A_A",1237,1269,32,2.55,"overcount"
"12222",55015,"Wisconsin","Calumet County","A_AIC",1438,1556,118,7.88,"overcount"
"12223",55015,"Wisconsin","Calumet County","NHPI_A",37,42,5,12.66,"overcount"
"12224",55015,"Wisconsin","Calumet County","NHPI_AIC",59,56,-3,-5.22,"undercount"
"12225",55017,"Wisconsin","Chippewa County","A_A",957,984,27,2.78,"overcount"
"12226",55017,"Wisconsin","Chippewa County","A_AIC",1175,1292,117,9.49,"overcount"
"12227",55017,"Wisconsin","Chippewa County","NHPI_A",43,24,-19,-56.72,"undercount"
"12228",55017,"Wisconsin","Chippewa County","NHPI_AIC",73,57,-16,-24.62,"undercount"
"12229",55019,"Wisconsin","Clark County","A_A",172,106,-66,-47.48,"undercount"
"12230",55019,"Wisconsin","Clark County","A_AIC",237,177,-60,-28.99,"undercount"
"12231",55019,"Wisconsin","Clark County","NHPI_A",16,4,-12,-120,"undercount"
"12232",55019,"Wisconsin","Clark County","NHPI_AIC",29,10,-19,-97.44,"undercount"
"12233",55021,"Wisconsin","Columbia County","A_A",480,384,-96,-22.22,"undercount"
"12234",55021,"Wisconsin","Columbia County","A_AIC",705,589,-116,-17.93,"undercount"
"12235",55021,"Wisconsin","Columbia County","NHPI_A",52,11,-41,-130.16,"undercount"
"12236",55021,"Wisconsin","Columbia County","NHPI_AIC",87,53,-34,-48.57,"undercount"
"12237",55023,"Wisconsin","Crawford County","A_A",108,68,-40,-45.45,"undercount"
"12238",55023,"Wisconsin","Crawford County","A_AIC",153,126,-27,-19.35,"undercount"
"12239",55023,"Wisconsin","Crawford County","NHPI_A",8,1,-7,-155.56,"undercount"
"12240",55023,"Wisconsin","Crawford County","NHPI_AIC",20,26,6,26.09,"overcount"
"12241",55025,"Wisconsin","Dane County","A_A",35594,35820,226,0.63,"overcount"
"12242",55025,"Wisconsin","Dane County","A_AIC",40832,42686,1854,4.44,"overcount"
"12243",55025,"Wisconsin","Dane County","NHPI_A",307,214,-93,-35.7,"undercount"
"12244",55025,"Wisconsin","Dane County","NHPI_AIC",829,740,-89,-11.34,"undercount"
"12245",55027,"Wisconsin","Dodge County","A_A",567,531,-36,-6.56,"undercount"
"12246",55027,"Wisconsin","Dodge County","A_AIC",823,794,-29,-3.59,"undercount"
"12247",55027,"Wisconsin","Dodge County","NHPI_A",59,11,-48,-137.14,"undercount"
"12248",55027,"Wisconsin","Dodge County","NHPI_AIC",102,28,-74,-113.85,"undercount"
"12249",55029,"Wisconsin","Door County","A_A",160,136,-24,-16.22,"undercount"
"12250",55029,"Wisconsin","Door County","A_AIC",223,236,13,5.66,"overcount"
"12251",55029,"Wisconsin","Door County","NHPI_A",11,2,-9,-138.46,"undercount"
"12252",55029,"Wisconsin","Door County","NHPI_AIC",24,22,-2,-8.7,"undercount"
"12253",55031,"Wisconsin","Douglas County","A_A",469,317,-152,-38.68,"undercount"
"12254",55031,"Wisconsin","Douglas County","A_AIC",698,546,-152,-24.44,"undercount"
"12255",55031,"Wisconsin","Douglas County","NHPI_A",19,18,-1,-5.41,"undercount"
"12256",55031,"Wisconsin","Douglas County","NHPI_AIC",66,52,-14,-23.73,"undercount"
"12257",55033,"Wisconsin","Dunn County","A_A",1428,1455,27,1.87,"overcount"
"12258",55033,"Wisconsin","Dunn County","A_AIC",1607,1653,46,2.82,"overcount"
"12259",55033,"Wisconsin","Dunn County","NHPI_A",23,13,-10,-55.56,"undercount"
"12260",55033,"Wisconsin","Dunn County","NHPI_AIC",60,57,-3,-5.13,"undercount"
"12261",55035,"Wisconsin","Eau Claire County","A_A",4605,4388,-217,-4.83,"undercount"
"12262",55035,"Wisconsin","Eau Claire County","A_AIC",5249,5228,-21,-0.4,"undercount"
"12263",55035,"Wisconsin","Eau Claire County","NHPI_A",211,83,-128,-87.07,"undercount"
"12264",55035,"Wisconsin","Eau Claire County","NHPI_AIC",312,190,-122,-48.61,"undercount"
"12265",55037,"Wisconsin","Florence County","A_A",21,6,-15,-111.11,"undercount"
"12266",55037,"Wisconsin","Florence County","A_AIC",35,26,-9,-29.51,"undercount"
"12267",55037,"Wisconsin","Florence County","NHPI_A",1,4,3,120,"overcount"
"12268",55037,"Wisconsin","Florence County","NHPI_AIC",4,10,6,85.71,"overcount"
"12269",55039,"Wisconsin","Fond du Lac County","A_A",1829,1246,-583,-37.92,"undercount"
"12270",55039,"Wisconsin","Fond du Lac County","A_AIC",2213,1638,-575,-29.86,"undercount"
"12271",55039,"Wisconsin","Fond du Lac County","NHPI_A",84,31,-53,-92.17,"undercount"
"12272",55039,"Wisconsin","Fond du Lac County","NHPI_AIC",155,128,-27,-19.08,"undercount"
"12273",55041,"Wisconsin","Forest County","A_A",31,26,-5,-17.54,"undercount"
"12274",55041,"Wisconsin","Forest County","A_AIC",66,45,-21,-37.84,"undercount"
"12275",55041,"Wisconsin","Forest County","NHPI_A",12,7,-5,-52.63,"undercount"
"12276",55041,"Wisconsin","Forest County","NHPI_AIC",25,44,19,55.07,"overcount"
"12277",55043,"Wisconsin","Grant County","A_A",471,417,-54,-12.16,"undercount"
"12278",55043,"Wisconsin","Grant County","A_AIC",597,563,-34,-5.86,"undercount"
"12279",55043,"Wisconsin","Grant County","NHPI_A",12,8,-4,-40,"undercount"
"12280",55043,"Wisconsin","Grant County","NHPI_AIC",40,35,-5,-13.33,"undercount"
"12281",55045,"Wisconsin","Green County","A_A",237,180,-57,-27.34,"undercount"
"12282",55045,"Wisconsin","Green County","A_AIC",348,334,-14,-4.11,"undercount"
"12283",55045,"Wisconsin","Green County","NHPI_A",25,3,-22,-157.14,"undercount"
"12284",55045,"Wisconsin","Green County","NHPI_AIC",47,34,-13,-32.1,"undercount"
"12285",55047,"Wisconsin","Green Lake County","A_A",132,102,-30,-25.64,"undercount"
"12286",55047,"Wisconsin","Green Lake County","A_AIC",175,157,-18,-10.84,"undercount"
"12287",55047,"Wisconsin","Green Lake County","NHPI_A",11,0,-11,-200,"undercount"
"12288",55047,"Wisconsin","Green Lake County","NHPI_AIC",19,8,-11,-81.48,"undercount"
"12289",55049,"Wisconsin","Iowa County","A_A",193,184,-9,-4.77,"undercount"
"12290",55049,"Wisconsin","Iowa County","A_AIC",266,254,-12,-4.62,"undercount"
"12291",55049,"Wisconsin","Iowa County","NHPI_A",14,12,-2,-15.38,"undercount"
"12292",55049,"Wisconsin","Iowa County","NHPI_AIC",27,43,16,45.71,"overcount"
"12293",55051,"Wisconsin","Iron County","A_A",17,14,-3,-19.35,"undercount"
"12294",55051,"Wisconsin","Iron County","A_AIC",25,24,-1,-4.08,"undercount"
"12295",55051,"Wisconsin","Iron County","NHPI_A",0,0,0,0,"equal"
"12296",55051,"Wisconsin","Iron County","NHPI_AIC",4,9,5,76.92,"overcount"
"12297",55053,"Wisconsin","Jackson County","A_A",97,76,-21,-24.28,"undercount"
"12298",55053,"Wisconsin","Jackson County","A_AIC",169,143,-26,-16.67,"undercount"
"12299",55053,"Wisconsin","Jackson County","NHPI_A",22,0,-22,-200,"undercount"
"12300",55053,"Wisconsin","Jackson County","NHPI_AIC",41,8,-33,-134.69,"undercount"
"12301",55055,"Wisconsin","Jefferson County","A_A",832,668,-164,-21.87,"undercount"
"12302",55055,"Wisconsin","Jefferson County","A_AIC",1134,1070,-64,-5.81,"undercount"
"12303",55055,"Wisconsin","Jefferson County","NHPI_A",35,19,-16,-59.26,"undercount"
"12304",55055,"Wisconsin","Jefferson County","NHPI_AIC",73,92,19,23.03,"overcount"
"12305",55057,"Wisconsin","Juneau County","A_A",165,150,-15,-9.52,"undercount"
"12306",55057,"Wisconsin","Juneau County","A_AIC",240,233,-7,-2.96,"undercount"
"12307",55057,"Wisconsin","Juneau County","NHPI_A",17,1,-16,-177.78,"undercount"
"12308",55057,"Wisconsin","Juneau County","NHPI_AIC",32,16,-16,-66.67,"undercount"
"12309",55059,"Wisconsin","Kenosha County","A_A",3133,2808,-325,-10.94,"undercount"
"12310",55059,"Wisconsin","Kenosha County","A_AIC",4271,4049,-222,-5.34,"undercount"
"12311",55059,"Wisconsin","Kenosha County","NHPI_A",162,67,-95,-82.97,"undercount"
"12312",55059,"Wisconsin","Kenosha County","NHPI_AIC",380,189,-191,-67.14,"undercount"
"12313",55061,"Wisconsin","Kewaunee County","A_A",102,70,-32,-37.21,"undercount"
"12314",55061,"Wisconsin","Kewaunee County","A_AIC",150,119,-31,-23.05,"undercount"
"12315",55061,"Wisconsin","Kewaunee County","NHPI_A",11,7,-4,-44.44,"undercount"
"12316",55061,"Wisconsin","Kewaunee County","NHPI_AIC",23,21,-2,-9.09,"undercount"
"12317",55063,"Wisconsin","La Crosse County","A_A",5697,5631,-66,-1.17,"undercount"
"12318",55063,"Wisconsin","La Crosse County","A_AIC",6408,6405,-3,-0.05,"undercount"
"12319",55063,"Wisconsin","La Crosse County","NHPI_A",46,16,-30,-96.77,"undercount"
"12320",55063,"Wisconsin","La Crosse County","NHPI_AIC",130,108,-22,-18.49,"undercount"
"12321",55065,"Wisconsin","Lafayette County","A_A",83,37,-46,-76.67,"undercount"
"12322",55065,"Wisconsin","Lafayette County","A_AIC",120,81,-39,-38.81,"undercount"
"12323",55065,"Wisconsin","Lafayette County","NHPI_A",1,4,3,120,"overcount"
"12324",55065,"Wisconsin","Lafayette County","NHPI_AIC",7,16,9,78.26,"overcount"
"12325",55067,"Wisconsin","Langlade County","A_A",96,74,-22,-25.88,"undercount"
"12326",55067,"Wisconsin","Langlade County","A_AIC",144,147,3,2.06,"overcount"
"12327",55067,"Wisconsin","Langlade County","NHPI_A",4,4,0,0,"equal"
"12328",55067,"Wisconsin","Langlade County","NHPI_AIC",14,9,-5,-43.48,"undercount"
"12329",55069,"Wisconsin","Lincoln County","A_A",168,117,-51,-35.79,"undercount"
"12330",55069,"Wisconsin","Lincoln County","A_AIC",258,221,-37,-15.45,"undercount"
"12331",55069,"Wisconsin","Lincoln County","NHPI_A",11,2,-9,-138.46,"undercount"
"12332",55069,"Wisconsin","Lincoln County","NHPI_AIC",25,22,-3,-12.77,"undercount"
"12333",55071,"Wisconsin","Manitowoc County","A_A",2330,2260,-70,-3.05,"undercount"
"12334",55071,"Wisconsin","Manitowoc County","A_AIC",2697,2687,-10,-0.37,"undercount"
"12335",55071,"Wisconsin","Manitowoc County","NHPI_A",45,15,-30,-100,"undercount"
"12336",55071,"Wisconsin","Manitowoc County","NHPI_AIC",90,71,-19,-23.6,"undercount"
"12337",55073,"Wisconsin","Marathon County","A_A",8546,8462,-84,-0.99,"undercount"
"12338",55073,"Wisconsin","Marathon County","A_AIC",9351,9334,-17,-0.18,"undercount"
"12339",55073,"Wisconsin","Marathon County","NHPI_A",67,29,-38,-79.17,"undercount"
"12340",55073,"Wisconsin","Marathon County","NHPI_AIC",185,136,-49,-30.53,"undercount"
"12341",55075,"Wisconsin","Marinette County","A_A",238,185,-53,-25.06,"undercount"
"12342",55075,"Wisconsin","Marinette County","A_AIC",380,356,-24,-6.52,"undercount"
"12343",55075,"Wisconsin","Marinette County","NHPI_A",14,8,-6,-54.55,"undercount"
"12344",55075,"Wisconsin","Marinette County","NHPI_AIC",41,29,-12,-34.29,"undercount"
"12345",55077,"Wisconsin","Marquette County","A_A",113,52,-61,-73.94,"undercount"
"12346",55077,"Wisconsin","Marquette County","A_AIC",151,110,-41,-31.42,"undercount"
"12347",55077,"Wisconsin","Marquette County","NHPI_A",5,6,1,18.18,"overcount"
"12348",55077,"Wisconsin","Marquette County","NHPI_AIC",8,25,17,103.03,"overcount"
"12349",55078,"Wisconsin","Menominee County","A_A",80,2,-78,-190.24,"undercount"
"12350",55078,"Wisconsin","Menominee County","A_AIC",98,8,-90,-169.81,"undercount"
"12351",55078,"Wisconsin","Menominee County","NHPI_A",0,2,2,200,"overcount"
"12352",55078,"Wisconsin","Menominee County","NHPI_AIC",1,4,3,120,"overcount"
"12353",55079,"Wisconsin","Milwaukee County","A_A",47011,46321,-690,-1.48,"undercount"
"12354",55079,"Wisconsin","Milwaukee County","A_AIC",53100,53503,403,0.76,"overcount"
"12355",55079,"Wisconsin","Milwaukee County","NHPI_A",438,278,-160,-44.69,"undercount"
"12356",55079,"Wisconsin","Milwaukee County","NHPI_AIC",1330,1017,-313,-26.67,"undercount"
"12357",55081,"Wisconsin","Monroe County","A_A",457,359,-98,-24.02,"undercount"
"12358",55081,"Wisconsin","Monroe County","A_AIC",667,645,-22,-3.35,"undercount"
"12359",55081,"Wisconsin","Monroe County","NHPI_A",54,63,9,15.38,"overcount"
"12360",55081,"Wisconsin","Monroe County","NHPI_AIC",96,95,-1,-1.05,"undercount"
"12361",55083,"Wisconsin","Oconto County","A_A",189,110,-79,-52.84,"undercount"
"12362",55083,"Wisconsin","Oconto County","A_AIC",274,209,-65,-26.92,"undercount"
"12363",55083,"Wisconsin","Oconto County","NHPI_A",10,0,-10,-200,"undercount"
"12364",55083,"Wisconsin","Oconto County","NHPI_AIC",20,11,-9,-58.06,"undercount"
"12365",55085,"Wisconsin","Oneida County","A_A",201,195,-6,-3.03,"undercount"
"12366",55085,"Wisconsin","Oneida County","A_AIC",304,331,27,8.5,"overcount"
"12367",55085,"Wisconsin","Oneida County","NHPI_A",11,18,7,48.28,"overcount"
"12368",55085,"Wisconsin","Oneida County","NHPI_AIC",30,35,5,15.38,"overcount"
"12369",55087,"Wisconsin","Outagamie County","A_A",7294,6628,-666,-9.57,"undercount"
"12370",55087,"Wisconsin","Outagamie County","A_AIC",8287,7802,-485,-6.03,"undercount"
"12371",55087,"Wisconsin","Outagamie County","NHPI_A",142,112,-30,-23.62,"undercount"
"12372",55087,"Wisconsin","Outagamie County","NHPI_AIC",280,251,-29,-10.92,"undercount"
"12373",55089,"Wisconsin","Ozaukee County","A_A",2346,2328,-18,-0.77,"undercount"
"12374",55089,"Wisconsin","Ozaukee County","A_AIC",2931,3049,118,3.95,"overcount"
"12375",55089,"Wisconsin","Ozaukee County","NHPI_A",29,14,-15,-69.77,"undercount"
"12376",55089,"Wisconsin","Ozaukee County","NHPI_AIC",88,91,3,3.35,"overcount"
"12377",55091,"Wisconsin","Pepin County","A_A",34,24,-10,-34.48,"undercount"
"12378",55091,"Wisconsin","Pepin County","A_AIC",51,55,4,7.55,"overcount"
"12379",55091,"Wisconsin","Pepin County","NHPI_A",1,0,-1,-200,"undercount"
"12380",55091,"Wisconsin","Pepin County","NHPI_AIC",2,3,1,40,"overcount"
"12381",55093,"Wisconsin","Pierce County","A_A",550,289,-261,-62.22,"undercount"
"12382",55093,"Wisconsin","Pierce County","A_AIC",760,525,-235,-36.58,"undercount"
"12383",55093,"Wisconsin","Pierce County","NHPI_A",20,10,-10,-66.67,"undercount"
"12384",55093,"Wisconsin","Pierce County","NHPI_AIC",54,59,5,8.85,"overcount"
"12385",55095,"Wisconsin","Polk County","A_A",284,206,-78,-31.84,"undercount"
"12386",55095,"Wisconsin","Polk County","A_AIC",425,349,-76,-19.64,"undercount"
"12387",55095,"Wisconsin","Polk County","NHPI_A",11,7,-4,-44.44,"undercount"
"12388",55095,"Wisconsin","Polk County","NHPI_AIC",34,33,-1,-2.99,"undercount"
"12389",55097,"Wisconsin","Portage County","A_A",2394,2260,-134,-5.76,"undercount"
"12390",55097,"Wisconsin","Portage County","A_AIC",2723,2685,-38,-1.41,"undercount"
"12391",55097,"Wisconsin","Portage County","NHPI_A",33,16,-17,-69.39,"undercount"
"12392",55097,"Wisconsin","Portage County","NHPI_AIC",81,90,9,10.53,"overcount"
"12393",55099,"Wisconsin","Price County","A_A",99,67,-32,-38.55,"undercount"
"12394",55099,"Wisconsin","Price County","A_AIC",138,104,-34,-28.1,"undercount"
"12395",55099,"Wisconsin","Price County","NHPI_A",129,124,-5,-3.95,"undercount"
"12396",55099,"Wisconsin","Price County","NHPI_AIC",133,139,6,4.41,"overcount"
"12397",55101,"Wisconsin","Racine County","A_A",2684,2289,-395,-15.89,"undercount"
"12398",55101,"Wisconsin","Racine County","A_AIC",3560,3377,-183,-5.28,"undercount"
"12399",55101,"Wisconsin","Racine County","NHPI_A",159,47,-112,-108.74,"undercount"
"12400",55101,"Wisconsin","Racine County","NHPI_AIC",354,198,-156,-56.52,"undercount"
"12401",55103,"Wisconsin","Richland County","A_A",145,109,-36,-28.35,"undercount"
"12402",55103,"Wisconsin","Richland County","A_AIC",190,168,-22,-12.29,"undercount"
"12403",55103,"Wisconsin","Richland County","NHPI_A",11,0,-11,-200,"undercount"
"12404",55103,"Wisconsin","Richland County","NHPI_AIC",20,15,-5,-28.57,"undercount"
"12405",55105,"Wisconsin","Rock County","A_A",2169,2061,-108,-5.11,"undercount"
"12406",55105,"Wisconsin","Rock County","A_AIC",3046,2964,-82,-2.73,"undercount"
"12407",55105,"Wisconsin","Rock County","NHPI_A",105,51,-54,-69.23,"undercount"
"12408",55105,"Wisconsin","Rock County","NHPI_AIC",240,172,-68,-33.01,"undercount"
"12409",55107,"Wisconsin","Rusk County","A_A",46,60,14,26.42,"overcount"
"12410",55107,"Wisconsin","Rusk County","A_AIC",93,113,20,19.42,"overcount"
"12411",55107,"Wisconsin","Rusk County","NHPI_A",4,5,1,22.22,"overcount"
"12412",55107,"Wisconsin","Rusk County","NHPI_AIC",13,10,-3,-26.09,"undercount"
"12413",55109,"Wisconsin","St. Croix County","A_A",1056,1007,-49,-4.75,"undercount"
"12414",55109,"Wisconsin","St. Croix County","A_AIC",1667,1565,-102,-6.31,"undercount"
"12415",55109,"Wisconsin","St. Croix County","NHPI_A",39,33,-6,-16.67,"undercount"
"12416",55109,"Wisconsin","St. Croix County","NHPI_AIC",92,105,13,13.2,"overcount"
"12417",55111,"Wisconsin","Sauk County","A_A",477,397,-80,-18.31,"undercount"
"12418",55111,"Wisconsin","Sauk County","A_AIC",692,598,-94,-14.57,"undercount"
"12419",55111,"Wisconsin","Sauk County","NHPI_A",23,15,-8,-42.11,"undercount"
"12420",55111,"Wisconsin","Sauk County","NHPI_AIC",58,66,8,12.9,"overcount"
"12421",55113,"Wisconsin","Sawyer County","A_A",69,64,-5,-7.52,"undercount"
"12422",55113,"Wisconsin","Sawyer County","A_AIC",122,127,5,4.02,"overcount"
"12423",55113,"Wisconsin","Sawyer County","NHPI_A",0,2,2,200,"overcount"
"12424",55113,"Wisconsin","Sawyer County","NHPI_AIC",8,15,7,60.87,"overcount"
"12425",55115,"Wisconsin","Shawano County","A_A",203,165,-38,-20.65,"undercount"
"12426",55115,"Wisconsin","Shawano County","A_AIC",323,253,-70,-24.31,"undercount"
"12427",55115,"Wisconsin","Shawano County","NHPI_A",24,6,-18,-120,"undercount"
"12428",55115,"Wisconsin","Shawano County","NHPI_AIC",52,18,-34,-97.14,"undercount"
"12429",55117,"Wisconsin","Sheboygan County","A_A",6931,6900,-31,-0.45,"undercount"
"12430",55117,"Wisconsin","Sheboygan County","A_AIC",7525,7603,78,1.03,"overcount"
"12431",55117,"Wisconsin","Sheboygan County","NHPI_A",71,21,-50,-108.7,"undercount"
"12432",55117,"Wisconsin","Sheboygan County","NHPI_AIC",152,112,-40,-30.3,"undercount"
"12433",55119,"Wisconsin","Taylor County","A_A",106,62,-44,-52.38,"undercount"
"12434",55119,"Wisconsin","Taylor County","A_AIC",155,105,-50,-38.46,"undercount"
"12435",55119,"Wisconsin","Taylor County","NHPI_A",19,5,-14,-116.67,"undercount"
"12436",55119,"Wisconsin","Taylor County","NHPI_AIC",29,31,2,6.67,"overcount"
"12437",55121,"Wisconsin","Trempealeau County","A_A",206,119,-87,-53.54,"undercount"
"12438",55121,"Wisconsin","Trempealeau County","A_AIC",281,228,-53,-20.83,"undercount"
"12439",55121,"Wisconsin","Trempealeau County","NHPI_A",23,0,-23,-200,"undercount"
"12440",55121,"Wisconsin","Trempealeau County","NHPI_AIC",39,12,-27,-105.88,"undercount"
"12441",55123,"Wisconsin","Vernon County","A_A",147,91,-56,-47.06,"undercount"
"12442",55123,"Wisconsin","Vernon County","A_AIC",233,191,-42,-19.81,"undercount"
"12443",55123,"Wisconsin","Vernon County","NHPI_A",11,9,-2,-20,"undercount"
"12444",55123,"Wisconsin","Vernon County","NHPI_AIC",27,27,0,0,"equal"
"12445",55125,"Wisconsin","Vilas County","A_A",126,57,-69,-75.41,"undercount"
"12446",55125,"Wisconsin","Vilas County","A_AIC",192,130,-62,-38.51,"undercount"
"12447",55125,"Wisconsin","Vilas County","NHPI_A",4,0,-4,-200,"undercount"
"12448",55125,"Wisconsin","Vilas County","NHPI_AIC",15,24,9,46.15,"overcount"
"12449",55127,"Wisconsin","Walworth County","A_A",1126,1005,-121,-11.36,"undercount"
"12450",55127,"Wisconsin","Walworth County","A_AIC",1495,1485,-10,-0.67,"undercount"
"12451",55127,"Wisconsin","Walworth County","NHPI_A",64,10,-54,-145.95,"undercount"
"12452",55127,"Wisconsin","Walworth County","NHPI_AIC",118,63,-55,-60.77,"undercount"
"12453",55129,"Wisconsin","Washburn County","A_A",112,59,-53,-61.99,"undercount"
"12454",55129,"Wisconsin","Washburn County","A_AIC",141,111,-30,-23.81,"undercount"
"12455",55129,"Wisconsin","Washburn County","NHPI_A",8,4,-4,-66.67,"undercount"
"12456",55129,"Wisconsin","Washburn County","NHPI_AIC",12,18,6,40,"overcount"
"12457",55131,"Wisconsin","Washington County","A_A",2092,1963,-129,-6.36,"undercount"
"12458",55131,"Wisconsin","Washington County","A_AIC",2654,2718,64,2.38,"overcount"
"12459",55131,"Wisconsin","Washington County","NHPI_A",54,28,-26,-63.41,"undercount"
"12460",55131,"Wisconsin","Washington County","NHPI_AIC",109,131,22,18.33,"overcount"
"12461",55133,"Wisconsin","Waukesha County","A_A",16445,15751,-694,-4.31,"undercount"
"12462",55133,"Wisconsin","Waukesha County","A_AIC",19189,19029,-160,-0.84,"undercount"
"12463",55133,"Wisconsin","Waukesha County","NHPI_A",227,121,-106,-60.92,"undercount"
"12464",55133,"Wisconsin","Waukesha County","NHPI_AIC",454,412,-42,-9.7,"undercount"
"12465",55135,"Wisconsin","Waupaca County","A_A",313,254,-59,-20.81,"undercount"
"12466",55135,"Wisconsin","Waupaca County","A_AIC",445,378,-67,-16.28,"undercount"
"12467",55135,"Wisconsin","Waupaca County","NHPI_A",13,4,-9,-105.88,"undercount"
"12468",55135,"Wisconsin","Waupaca County","NHPI_AIC",32,32,0,0,"equal"
"12469",55137,"Wisconsin","Waushara County","A_A",134,98,-36,-31.03,"undercount"
"12470",55137,"Wisconsin","Waushara County","A_AIC",181,175,-6,-3.37,"undercount"
"12471",55137,"Wisconsin","Waushara County","NHPI_A",19,14,-5,-30.3,"undercount"
"12472",55137,"Wisconsin","Waushara County","NHPI_AIC",30,17,-13,-55.32,"undercount"
"12473",55139,"Wisconsin","Winnebago County","A_A",5565,5592,27,0.48,"overcount"
"12474",55139,"Wisconsin","Winnebago County","A_AIC",6547,6568,21,0.32,"overcount"
"12475",55139,"Wisconsin","Winnebago County","NHPI_A",95,53,-42,-56.76,"undercount"
"12476",55139,"Wisconsin","Winnebago County","NHPI_AIC",213,199,-14,-6.8,"undercount"
"12477",55141,"Wisconsin","Wood County","A_A",1497,1387,-110,-7.63,"undercount"
"12478",55141,"Wisconsin","Wood County","A_AIC",1703,1659,-44,-2.62,"undercount"
"12479",55141,"Wisconsin","Wood County","NHPI_A",24,29,5,18.87,"overcount"
"12480",55141,"Wisconsin","Wood County","NHPI_AIC",49,86,37,54.81,"overcount"
"12481",56001,"Wyoming","Albany County","A_A",1395,1040,-355,-29.16,"undercount"
"12482",56001,"Wyoming","Albany County","A_AIC",1810,1450,-360,-22.09,"undercount"
"12483",56001,"Wyoming","Albany County","NHPI_A",45,30,-15,-40,"undercount"
"12484",56001,"Wyoming","Albany County","NHPI_AIC",125,81,-44,-42.72,"undercount"
"12485",56003,"Wyoming","Big Horn County","A_A",61,45,-16,-30.19,"undercount"
"12486",56003,"Wyoming","Big Horn County","A_AIC",109,96,-13,-12.68,"undercount"
"12487",56003,"Wyoming","Big Horn County","NHPI_A",5,6,1,18.18,"overcount"
"12488",56003,"Wyoming","Big Horn County","NHPI_AIC",21,23,2,9.09,"overcount"
"12489",56005,"Wyoming","Campbell County","A_A",354,320,-34,-10.09,"undercount"
"12490",56005,"Wyoming","Campbell County","A_AIC",606,548,-58,-10.05,"undercount"
"12491",56005,"Wyoming","Campbell County","NHPI_A",37,25,-12,-38.71,"undercount"
"12492",56005,"Wyoming","Campbell County","NHPI_AIC",89,56,-33,-45.52,"undercount"
"12493",56007,"Wyoming","Carbon County","A_A",140,99,-41,-34.31,"undercount"
"12494",56007,"Wyoming","Carbon County","A_AIC",182,161,-21,-12.24,"undercount"
"12495",56007,"Wyoming","Carbon County","NHPI_A",16,15,-1,-6.45,"undercount"
"12496",56007,"Wyoming","Carbon County","NHPI_AIC",34,24,-10,-34.48,"undercount"
"12497",56009,"Wyoming","Converse County","A_A",98,56,-42,-54.55,"undercount"
"12498",56009,"Wyoming","Converse County","A_AIC",144,112,-32,-25,"undercount"
"12499",56009,"Wyoming","Converse County","NHPI_A",8,0,-8,-200,"undercount"
"12500",56009,"Wyoming","Converse County","NHPI_AIC",22,15,-7,-37.84,"undercount"
"12501",56011,"Wyoming","Crook County","A_A",18,9,-9,-66.67,"undercount"
"12502",56011,"Wyoming","Crook County","A_AIC",33,23,-10,-35.71,"undercount"
"12503",56011,"Wyoming","Crook County","NHPI_A",1,7,6,150,"overcount"
"12504",56011,"Wyoming","Crook County","NHPI_AIC",5,20,15,120,"overcount"
"12505",56013,"Wyoming","Fremont County","A_A",198,216,18,8.7,"overcount"
"12506",56013,"Wyoming","Fremont County","A_AIC",379,399,20,5.14,"overcount"
"12507",56013,"Wyoming","Fremont County","NHPI_A",22,11,-11,-66.67,"undercount"
"12508",56013,"Wyoming","Fremont County","NHPI_AIC",75,99,24,27.59,"overcount"
"12509",56015,"Wyoming","Goshen County","A_A",116,46,-70,-86.42,"undercount"
"12510",56015,"Wyoming","Goshen County","A_AIC",160,83,-77,-63.37,"undercount"
"12511",56015,"Wyoming","Goshen County","NHPI_A",11,0,-11,-200,"undercount"
"12512",56015,"Wyoming","Goshen County","NHPI_AIC",39,2,-37,-180.49,"undercount"
"12513",56017,"Wyoming","Hot Springs County","A_A",28,20,-8,-33.33,"undercount"
"12514",56017,"Wyoming","Hot Springs County","A_AIC",35,45,10,25,"overcount"
"12515",56017,"Wyoming","Hot Springs County","NHPI_A",4,5,1,22.22,"overcount"
"12516",56017,"Wyoming","Hot Springs County","NHPI_AIC",8,17,9,72,"overcount"
"12517",56019,"Wyoming","Johnson County","A_A",64,17,-47,-116.05,"undercount"
"12518",56019,"Wyoming","Johnson County","A_AIC",81,51,-30,-45.45,"undercount"
"12519",56019,"Wyoming","Johnson County","NHPI_A",2,7,5,111.11,"overcount"
"12520",56019,"Wyoming","Johnson County","NHPI_AIC",13,11,-2,-16.67,"undercount"
"12521",56021,"Wyoming","Laramie County","A_A",1382,1266,-116,-8.76,"undercount"
"12522",56021,"Wyoming","Laramie County","A_AIC",2325,2258,-67,-2.92,"undercount"
"12523",56021,"Wyoming","Laramie County","NHPI_A",166,136,-30,-19.87,"undercount"
"12524",56021,"Wyoming","Laramie County","NHPI_AIC",345,362,17,4.81,"overcount"
"12525",56023,"Wyoming","Lincoln County","A_A",119,97,-22,-20.37,"undercount"
"12526",56023,"Wyoming","Lincoln County","A_AIC",193,176,-17,-9.21,"undercount"
"12527",56023,"Wyoming","Lincoln County","NHPI_A",16,21,5,27.03,"overcount"
"12528",56023,"Wyoming","Lincoln County","NHPI_AIC",40,58,18,36.73,"overcount"
"12529",56025,"Wyoming","Natrona County","A_A",721,635,-86,-12.68,"undercount"
"12530",56025,"Wyoming","Natrona County","A_AIC",1176,1120,-56,-4.88,"undercount"
"12531",56025,"Wyoming","Natrona County","NHPI_A",60,78,18,26.09,"overcount"
"12532",56025,"Wyoming","Natrona County","NHPI_AIC",199,214,15,7.26,"overcount"
"12533",56027,"Wyoming","Niobrara County","A_A",13,12,-1,-8,"undercount"
"12534",56027,"Wyoming","Niobrara County","A_AIC",27,33,6,20,"overcount"
"12535",56027,"Wyoming","Niobrara County","NHPI_A",0,5,5,200,"overcount"
"12536",56027,"Wyoming","Niobrara County","NHPI_AIC",4,12,8,100,"overcount"
"12537",56029,"Wyoming","Park County","A_A",227,218,-9,-4.04,"undercount"
"12538",56029,"Wyoming","Park County","A_AIC",349,357,8,2.27,"overcount"
"12539",56029,"Wyoming","Park County","NHPI_A",20,17,-3,-16.22,"undercount"
"12540",56029,"Wyoming","Park County","NHPI_AIC",50,67,17,29.06,"overcount"
"12541",56031,"Wyoming","Platte County","A_A",63,44,-19,-35.51,"undercount"
"12542",56031,"Wyoming","Platte County","A_AIC",105,66,-39,-45.61,"undercount"
"12543",56031,"Wyoming","Platte County","NHPI_A",9,4,-5,-76.92,"undercount"
"12544",56031,"Wyoming","Platte County","NHPI_AIC",19,9,-10,-71.43,"undercount"
"12545",56033,"Wyoming","Sheridan County","A_A",256,182,-74,-33.79,"undercount"
"12546",56033,"Wyoming","Sheridan County","A_AIC",407,343,-64,-17.07,"undercount"
"12547",56033,"Wyoming","Sheridan County","NHPI_A",30,17,-13,-55.32,"undercount"
"12548",56033,"Wyoming","Sheridan County","NHPI_AIC",65,58,-7,-11.38,"undercount"
"12549",56035,"Wyoming","Sublette County","A_A",75,49,-26,-41.94,"undercount"
"12550",56035,"Wyoming","Sublette County","A_AIC",120,77,-43,-43.65,"undercount"
"12551",56035,"Wyoming","Sublette County","NHPI_A",7,10,3,35.29,"overcount"
"12552",56035,"Wyoming","Sublette County","NHPI_AIC",22,22,0,0,"equal"
"12553",56037,"Wyoming","Sweetwater County","A_A",430,285,-145,-40.56,"undercount"
"12554",56037,"Wyoming","Sweetwater County","A_AIC",666,543,-123,-20.35,"undercount"
"12555",56037,"Wyoming","Sweetwater County","NHPI_A",76,61,-15,-21.9,"undercount"
"12556",56037,"Wyoming","Sweetwater County","NHPI_AIC",136,146,10,7.09,"overcount"
"12557",56039,"Wyoming","Teton County","A_A",364,321,-43,-12.55,"undercount"
"12558",56039,"Wyoming","Teton County","A_AIC",532,570,38,6.9,"overcount"
"12559",56039,"Wyoming","Teton County","NHPI_A",42,3,-39,-173.33,"undercount"
"12560",56039,"Wyoming","Teton County","NHPI_AIC",85,34,-51,-85.71,"undercount"
"12561",56041,"Wyoming","Uinta County","A_A",107,108,1,0.93,"overcount"
"12562",56041,"Wyoming","Uinta County","A_AIC",203,184,-19,-9.82,"undercount"
"12563",56041,"Wyoming","Uinta County","NHPI_A",32,27,-5,-16.95,"undercount"
"12564",56041,"Wyoming","Uinta County","NHPI_AIC",69,77,8,10.96,"overcount"
"12565",56043,"Wyoming","Washakie County","A_A",67,35,-32,-62.75,"undercount"
"12566",56043,"Wyoming","Washakie County","A_AIC",89,66,-23,-29.68,"undercount"
"12567",56043,"Wyoming","Washakie County","NHPI_A",6,1,-5,-142.86,"undercount"
"12568",56043,"Wyoming","Washakie County","NHPI_AIC",11,7,-4,-44.44,"undercount"
"12569",56045,"Wyoming","Weston County","A_A",98,28,-70,-111.11,"undercount"
"12570",56045,"Wyoming","Weston County","A_AIC",122,61,-61,-66.67,"undercount"
"12571",56045,"Wyoming","Weston County","NHPI_A",2,9,7,127.27,"overcount"
"12572",56045,"Wyoming","Weston County","NHPI_AIC",9,17,8,61.54,"overcount"
