"","FIPS","STNAME","CTYNAME","RACE","ESTIM","MR","NUM_DIFF","PERC_DIFF","COVERAGE"
"1",1001,"Alabama","Autauga County","A_A",638,878,240,31.66,"overcount"
"2",1001,"Alabama","Autauga County","A_AIC",926,1317,391,34.86,"overcount"
"3",1001,"Alabama","Autauga County","NHPI_A",40,25,-15,-46.15,"undercount"
"4",1001,"Alabama","Autauga County","NHPI_AIC",75,96,21,24.56,"overcount"
"5",1003,"Alabama","Baldwin County","A_A",2492,2042,-450,-19.85,"undercount"
"6",1003,"Alabama","Baldwin County","A_AIC",3431,3376,-55,-1.62,"undercount"
"7",1003,"Alabama","Baldwin County","NHPI_A",110,125,15,12.77,"overcount"
"8",1003,"Alabama","Baldwin County","NHPI_AIC",266,333,67,22.37,"overcount"
"9",1005,"Alabama","Barbour County","A_A",111,104,-7,-6.51,"undercount"
"10",1005,"Alabama","Barbour County","A_AIC",148,136,-12,-8.45,"undercount"
"11",1005,"Alabama","Barbour County","NHPI_A",27,0,-27,-200,"undercount"
"12",1005,"Alabama","Barbour County","NHPI_AIC",40,11,-29,-113.73,"undercount"
"13",1007,"Alabama","Bibb County","A_A",47,26,-21,-57.53,"undercount"
"14",1007,"Alabama","Bibb County","A_AIC",93,45,-48,-69.57,"undercount"
"15",1007,"Alabama","Bibb County","NHPI_A",6,9,3,40,"overcount"
"16",1007,"Alabama","Bibb County","NHPI_AIC",20,14,-6,-35.29,"undercount"
"17",1009,"Alabama","Blount County","A_A",203,174,-29,-15.38,"undercount"
"18",1009,"Alabama","Blount County","A_AIC",326,344,18,5.37,"overcount"
"19",1009,"Alabama","Blount County","NHPI_A",21,11,-10,-62.5,"undercount"
"20",1009,"Alabama","Blount County","NHPI_AIC",39,43,4,9.76,"overcount"
"21",1011,"Alabama","Bullock County","A_A",15,12,-3,-22.22,"undercount"
"22",1011,"Alabama","Bullock County","A_AIC",31,24,-7,-25.45,"undercount"
"23",1011,"Alabama","Bullock County","NHPI_A",5,7,2,33.33,"overcount"
"24",1011,"Alabama","Bullock County","NHPI_AIC",6,14,8,80,"overcount"
"25",1013,"Alabama","Butler County","A_A",257,143,-114,-57,"undercount"
"26",1013,"Alabama","Butler County","A_AIC",284,194,-90,-37.66,"undercount"
"27",1013,"Alabama","Butler County","NHPI_A",7,5,-2,-33.33,"undercount"
"28",1013,"Alabama","Butler County","NHPI_AIC",19,24,5,23.26,"overcount"
"29",1015,"Alabama","Calhoun County","A_A",943,1164,221,20.98,"overcount"
"30",1015,"Alabama","Calhoun County","A_AIC",1440,1687,247,15.8,"overcount"
"31",1015,"Alabama","Calhoun County","NHPI_A",99,118,19,17.51,"overcount"
"32",1015,"Alabama","Calhoun County","NHPI_AIC",220,222,2,0.9,"overcount"
"33",1017,"Alabama","Chambers County","A_A",358,385,27,7.27,"overcount"
"34",1017,"Alabama","Chambers County","A_AIC",405,465,60,13.79,"overcount"
"35",1017,"Alabama","Chambers County","NHPI_A",12,11,-1,-8.7,"undercount"
"36",1017,"Alabama","Chambers County","NHPI_AIC",17,33,16,64,"overcount"
"37",1019,"Alabama","Cherokee County","A_A",117,57,-60,-68.97,"undercount"
"38",1019,"Alabama","Cherokee County","A_AIC",157,83,-74,-61.67,"undercount"
"39",1019,"Alabama","Cherokee County","NHPI_A",1,1,0,0,"equal"
"40",1019,"Alabama","Cherokee County","NHPI_AIC",11,24,13,74.29,"overcount"
"41",1021,"Alabama","Chilton County","A_A",191,176,-15,-8.17,"undercount"
"42",1021,"Alabama","Chilton County","A_AIC",266,249,-17,-6.6,"undercount"
"43",1021,"Alabama","Chilton County","NHPI_A",14,5,-9,-94.74,"undercount"
"44",1021,"Alabama","Chilton County","NHPI_AIC",31,20,-11,-43.14,"undercount"
"45",1023,"Alabama","Choctaw County","A_A",25,19,-6,-27.27,"undercount"
"46",1023,"Alabama","Choctaw County","A_AIC",43,43,0,0,"equal"
"47",1023,"Alabama","Choctaw County","NHPI_A",0,0,0,0,"equal"
"48",1023,"Alabama","Choctaw County","NHPI_AIC",5,4,-1,-22.22,"undercount"
"49",1025,"Alabama","Clarke County","A_A",98,91,-7,-7.41,"undercount"
"50",1025,"Alabama","Clarke County","A_AIC",141,132,-9,-6.59,"undercount"
"51",1025,"Alabama","Clarke County","NHPI_A",5,1,-4,-133.33,"undercount"
"52",1025,"Alabama","Clarke County","NHPI_AIC",15,8,-7,-60.87,"undercount"
"53",1027,"Alabama","Clay County","A_A",33,46,13,32.91,"overcount"
"54",1027,"Alabama","Clay County","A_AIC",59,73,14,21.21,"overcount"
"55",1027,"Alabama","Clay County","NHPI_A",0,4,4,200,"overcount"
"56",1027,"Alabama","Clay County","NHPI_AIC",11,16,5,37.04,"overcount"
"57",1029,"Alabama","Cleburne County","A_A",25,22,-3,-12.77,"undercount"
"58",1029,"Alabama","Cleburne County","A_AIC",46,48,2,4.26,"overcount"
"59",1029,"Alabama","Cleburne County","NHPI_A",1,2,1,66.67,"overcount"
"60",1029,"Alabama","Cleburne County","NHPI_AIC",13,14,1,7.41,"overcount"
"61",1031,"Alabama","Coffee County","A_A",840,922,82,9.31,"overcount"
"62",1031,"Alabama","Coffee County","A_AIC",1259,1423,164,12.23,"overcount"
"63",1031,"Alabama","Coffee County","NHPI_A",80,57,-23,-33.58,"undercount"
"64",1031,"Alabama","Coffee County","NHPI_AIC",174,168,-6,-3.51,"undercount"
"65",1033,"Alabama","Colbert County","A_A",370,432,62,15.46,"overcount"
"66",1033,"Alabama","Colbert County","A_AIC",474,563,89,17.16,"overcount"
"67",1033,"Alabama","Colbert County","NHPI_A",29,9,-20,-105.26,"undercount"
"68",1033,"Alabama","Colbert County","NHPI_AIC",59,28,-31,-71.26,"undercount"
"69",1035,"Alabama","Conecuh County","A_A",29,37,8,24.24,"overcount"
"70",1035,"Alabama","Conecuh County","A_AIC",51,59,8,14.55,"overcount"
"71",1035,"Alabama","Conecuh County","NHPI_A",3,5,2,50,"overcount"
"72",1035,"Alabama","Conecuh County","NHPI_AIC",15,19,4,23.53,"overcount"
"73",1037,"Alabama","Coosa County","A_A",19,8,-11,-81.48,"undercount"
"74",1037,"Alabama","Coosa County","A_AIC",38,22,-16,-53.33,"undercount"
"75",1037,"Alabama","Coosa County","NHPI_A",1,0,-1,-200,"undercount"
"76",1037,"Alabama","Coosa County","NHPI_AIC",11,8,-3,-31.58,"undercount"
"77",1039,"Alabama","Covington County","A_A",176,246,70,33.18,"overcount"
"78",1039,"Alabama","Covington County","A_AIC",225,322,97,35.47,"overcount"
"79",1039,"Alabama","Covington County","NHPI_A",2,1,-1,-66.67,"undercount"
"80",1039,"Alabama","Covington County","NHPI_AIC",19,18,-1,-5.41,"undercount"
"81",1041,"Alabama","Crenshaw County","A_A",163,87,-76,-60.8,"undercount"
"82",1041,"Alabama","Crenshaw County","A_AIC",184,110,-74,-50.34,"undercount"
"83",1041,"Alabama","Crenshaw County","NHPI_A",2,2,0,0,"equal"
"84",1041,"Alabama","Crenshaw County","NHPI_AIC",6,13,7,73.68,"overcount"
"85",1043,"Alabama","Cullman County","A_A",531,524,-7,-1.33,"undercount"
"86",1043,"Alabama","Cullman County","A_AIC",668,739,71,10.09,"overcount"
"87",1043,"Alabama","Cullman County","NHPI_A",51,64,13,22.61,"overcount"
"88",1043,"Alabama","Cullman County","NHPI_AIC",85,136,51,46.15,"overcount"
"89",1045,"Alabama","Dale County","A_A",697,659,-38,-5.6,"undercount"
"90",1045,"Alabama","Dale County","A_AIC",1004,1011,7,0.69,"overcount"
"91",1045,"Alabama","Dale County","NHPI_A",64,42,-22,-41.51,"undercount"
"92",1045,"Alabama","Dale County","NHPI_AIC",129,142,13,9.59,"overcount"
"93",1047,"Alabama","Dallas County","A_A",182,148,-34,-20.61,"undercount"
"94",1047,"Alabama","Dallas County","A_AIC",235,167,-68,-33.83,"undercount"
"95",1047,"Alabama","Dallas County","NHPI_A",11,12,1,8.7,"overcount"
"96",1047,"Alabama","Dallas County","NHPI_AIC",29,35,6,18.75,"overcount"
"97",1049,"Alabama","DeKalb County","A_A",259,237,-22,-8.87,"undercount"
"98",1049,"Alabama","DeKalb County","A_AIC",372,376,4,1.07,"overcount"
"99",1049,"Alabama","DeKalb County","NHPI_A",43,16,-27,-91.53,"undercount"
"100",1049,"Alabama","DeKalb County","NHPI_AIC",75,41,-34,-58.62,"undercount"
"101",1051,"Alabama","Elmore County","A_A",626,681,55,8.42,"overcount"
"102",1051,"Alabama","Elmore County","A_AIC",971,1084,113,11,"overcount"
"103",1051,"Alabama","Elmore County","NHPI_A",69,28,-41,-84.54,"undercount"
"104",1051,"Alabama","Elmore County","NHPI_AIC",127,84,-43,-40.76,"undercount"
"105",1053,"Alabama","Escambia County","A_A",100,108,8,7.69,"overcount"
"106",1053,"Alabama","Escambia County","A_AIC",197,193,-4,-2.05,"undercount"
"107",1053,"Alabama","Escambia County","NHPI_A",19,22,3,14.63,"overcount"
"108",1053,"Alabama","Escambia County","NHPI_AIC",44,44,0,0,"equal"
"109",1055,"Alabama","Etowah County","A_A",800,924,124,14.39,"overcount"
"110",1055,"Alabama","Etowah County","A_AIC",1010,1191,181,16.45,"overcount"
"111",1055,"Alabama","Etowah County","NHPI_A",50,39,-11,-24.72,"undercount"
"112",1055,"Alabama","Etowah County","NHPI_AIC",96,65,-31,-38.51,"undercount"
"113",1057,"Alabama","Fayette County","A_A",77,49,-28,-44.44,"undercount"
"114",1057,"Alabama","Fayette County","A_AIC",97,82,-15,-16.76,"undercount"
"115",1057,"Alabama","Fayette County","NHPI_A",0,1,1,200,"overcount"
"116",1057,"Alabama","Fayette County","NHPI_AIC",5,3,-2,-50,"undercount"
"117",1059,"Alabama","Franklin County","A_A",82,68,-14,-18.67,"undercount"
"118",1059,"Alabama","Franklin County","A_AIC",113,106,-7,-6.39,"undercount"
"119",1059,"Alabama","Franklin County","NHPI_A",38,5,-33,-153.49,"undercount"
"120",1059,"Alabama","Franklin County","NHPI_AIC",48,34,-14,-34.15,"undercount"
"121",1061,"Alabama","Geneva County","A_A",89,91,2,2.22,"overcount"
"122",1061,"Alabama","Geneva County","A_AIC",150,152,2,1.32,"overcount"
"123",1061,"Alabama","Geneva County","NHPI_A",11,7,-4,-44.44,"undercount"
"124",1061,"Alabama","Geneva County","NHPI_AIC",26,32,6,20.69,"overcount"
"125",1063,"Alabama","Greene County","A_A",18,7,-11,-88,"undercount"
"126",1063,"Alabama","Greene County","A_AIC",27,22,-5,-20.41,"undercount"
"127",1063,"Alabama","Greene County","NHPI_A",0,0,0,0,"equal"
"128",1063,"Alabama","Greene County","NHPI_AIC",0,4,4,200,"overcount"
"129",1065,"Alabama","Hale County","A_A",47,18,-29,-89.23,"undercount"
"130",1065,"Alabama","Hale County","A_AIC",73,58,-15,-22.9,"undercount"
"131",1065,"Alabama","Hale County","NHPI_A",4,5,1,22.22,"overcount"
"132",1065,"Alabama","Hale County","NHPI_AIC",8,21,13,89.66,"overcount"
"133",1067,"Alabama","Henry County","A_A",74,73,-1,-1.36,"undercount"
"134",1067,"Alabama","Henry County","A_AIC",106,143,37,29.72,"overcount"
"135",1067,"Alabama","Henry County","NHPI_A",2,0,-2,-200,"undercount"
"136",1067,"Alabama","Henry County","NHPI_AIC",12,13,1,8,"overcount"
"137",1069,"Alabama","Houston County","A_A",1152,1264,112,9.27,"overcount"
"138",1069,"Alabama","Houston County","A_AIC",1581,1875,294,17.01,"overcount"
"139",1069,"Alabama","Houston County","NHPI_A",60,59,-1,-1.68,"undercount"
"140",1069,"Alabama","Houston County","NHPI_AIC",176,159,-17,-10.15,"undercount"
"141",1071,"Alabama","Jackson County","A_A",243,217,-26,-11.3,"undercount"
"142",1071,"Alabama","Jackson County","A_AIC",334,334,0,0,"equal"
"143",1071,"Alabama","Jackson County","NHPI_A",33,2,-31,-177.14,"undercount"
"144",1071,"Alabama","Jackson County","NHPI_AIC",56,30,-26,-60.47,"undercount"
"145",1073,"Alabama","Jefferson County","A_A",11898,13194,1296,10.33,"overcount"
"146",1073,"Alabama","Jefferson County","A_AIC",14258,16205,1947,12.78,"overcount"
"147",1073,"Alabama","Jefferson County","NHPI_A",183,335,152,58.69,"overcount"
"148",1073,"Alabama","Jefferson County","NHPI_AIC",444,732,288,48.98,"overcount"
"149",1075,"Alabama","Lamar County","A_A",14,6,-8,-80,"undercount"
"150",1075,"Alabama","Lamar County","A_AIC",49,29,-20,-51.28,"undercount"
"151",1075,"Alabama","Lamar County","NHPI_A",1,3,2,100,"overcount"
"152",1075,"Alabama","Lamar County","NHPI_AIC",6,4,-2,-40,"undercount"
"153",1077,"Alabama","Lauderdale County","A_A",789,749,-40,-5.2,"undercount"
"154",1077,"Alabama","Lauderdale County","A_AIC",1002,1076,74,7.12,"overcount"
"155",1077,"Alabama","Lauderdale County","NHPI_A",39,31,-8,-22.86,"undercount"
"156",1077,"Alabama","Lauderdale County","NHPI_AIC",85,103,18,19.15,"overcount"
"157",1079,"Alabama","Lawrence County","A_A",82,84,2,2.41,"overcount"
"158",1079,"Alabama","Lawrence County","A_AIC",169,180,11,6.3,"overcount"
"159",1079,"Alabama","Lawrence County","NHPI_A",6,9,3,40,"overcount"
"160",1079,"Alabama","Lawrence County","NHPI_AIC",40,33,-7,-19.18,"undercount"
"161",1081,"Alabama","Lee County","A_A",6877,8580,1703,22.04,"overcount"
"162",1081,"Alabama","Lee County","A_AIC",7782,9958,2176,24.53,"overcount"
"163",1081,"Alabama","Lee County","NHPI_A",89,111,22,22,"overcount"
"164",1081,"Alabama","Lee County","NHPI_AIC",211,287,76,30.52,"overcount"
"165",1083,"Alabama","Limestone County","A_A",1782,1861,79,4.34,"overcount"
"166",1083,"Alabama","Limestone County","A_AIC",2223,2613,390,16.13,"overcount"
"167",1083,"Alabama","Limestone County","NHPI_A",83,70,-13,-16.99,"undercount"
"168",1083,"Alabama","Limestone County","NHPI_AIC",144,189,45,27.03,"overcount"
"169",1085,"Alabama","Lowndes County","A_A",33,19,-14,-53.85,"undercount"
"170",1085,"Alabama","Lowndes County","A_AIC",38,38,0,0,"equal"
"171",1085,"Alabama","Lowndes County","NHPI_A",4,0,-4,-200,"undercount"
"172",1085,"Alabama","Lowndes County","NHPI_AIC",5,4,-1,-22.22,"undercount"
"173",1087,"Alabama","Macon County","A_A",86,74,-12,-15,"undercount"
"174",1087,"Alabama","Macon County","A_AIC",138,93,-45,-38.96,"undercount"
"175",1087,"Alabama","Macon County","NHPI_A",2,5,3,85.71,"overcount"
"176",1087,"Alabama","Macon County","NHPI_AIC",16,20,4,22.22,"overcount"
"177",1089,"Alabama","Madison County","A_A",10025,10298,273,2.69,"overcount"
"178",1089,"Alabama","Madison County","A_AIC",13192,14671,1479,10.62,"overcount"
"179",1089,"Alabama","Madison County","NHPI_A",317,461,144,37.02,"overcount"
"180",1089,"Alabama","Madison County","NHPI_AIC",657,998,341,41.21,"overcount"
"181",1091,"Alabama","Marengo County","A_A",56,54,-2,-3.64,"undercount"
"182",1091,"Alabama","Marengo County","A_AIC",81,77,-4,-5.06,"undercount"
"183",1091,"Alabama","Marengo County","NHPI_A",8,1,-7,-155.56,"undercount"
"184",1091,"Alabama","Marengo County","NHPI_AIC",14,7,-7,-66.67,"undercount"
"185",1093,"Alabama","Marion County","A_A",89,75,-14,-17.07,"undercount"
"186",1093,"Alabama","Marion County","A_AIC",128,153,25,17.79,"overcount"
"187",1093,"Alabama","Marion County","NHPI_A",9,14,5,43.48,"overcount"
"188",1093,"Alabama","Marion County","NHPI_AIC",18,19,1,5.41,"overcount"
"189",1095,"Alabama","Marshall County","A_A",637,587,-50,-8.17,"undercount"
"190",1095,"Alabama","Marshall County","A_AIC",808,879,71,8.42,"overcount"
"191",1095,"Alabama","Marshall County","NHPI_A",109,128,19,16.03,"overcount"
"192",1095,"Alabama","Marshall County","NHPI_AIC",143,185,42,25.61,"overcount"
"193",1097,"Alabama","Mobile County","A_A",8609,8636,27,0.31,"overcount"
"194",1097,"Alabama","Mobile County","A_AIC",10262,10505,243,2.34,"overcount"
"195",1097,"Alabama","Mobile County","NHPI_A",118,220,102,60.36,"overcount"
"196",1097,"Alabama","Mobile County","NHPI_AIC",339,537,198,45.21,"overcount"
"197",1099,"Alabama","Monroe County","A_A",87,88,1,1.14,"overcount"
"198",1099,"Alabama","Monroe County","A_AIC",136,125,-11,-8.43,"undercount"
"199",1099,"Alabama","Monroe County","NHPI_A",4,0,-4,-200,"undercount"
"200",1099,"Alabama","Monroe County","NHPI_AIC",15,15,0,0,"equal"
"201",1101,"Alabama","Montgomery County","A_A",7478,7979,501,6.48,"overcount"
"202",1101,"Alabama","Montgomery County","A_AIC",8450,9175,725,8.23,"overcount"
"203",1101,"Alabama","Montgomery County","NHPI_A",99,123,24,21.62,"overcount"
"204",1101,"Alabama","Montgomery County","NHPI_AIC",229,271,42,16.8,"overcount"
"205",1103,"Alabama","Morgan County","A_A",750,848,98,12.27,"overcount"
"206",1103,"Alabama","Morgan County","A_AIC",1111,1389,278,22.24,"overcount"
"207",1103,"Alabama","Morgan County","NHPI_A",82,84,2,2.41,"overcount"
"208",1103,"Alabama","Morgan County","NHPI_AIC",130,147,17,12.27,"overcount"
"209",1105,"Alabama","Perry County","A_A",54,10,-44,-137.5,"undercount"
"210",1105,"Alabama","Perry County","A_AIC",69,32,-37,-73.27,"undercount"
"211",1105,"Alabama","Perry County","NHPI_A",6,1,-5,-142.86,"undercount"
"212",1105,"Alabama","Perry County","NHPI_AIC",9,3,-6,-100,"undercount"
"213",1107,"Alabama","Pickens County","A_A",57,78,21,31.11,"overcount"
"214",1107,"Alabama","Pickens County","A_AIC",86,109,23,23.59,"overcount"
"215",1107,"Alabama","Pickens County","NHPI_A",1,0,-1,-200,"undercount"
"216",1107,"Alabama","Pickens County","NHPI_AIC",7,2,-5,-111.11,"undercount"
"217",1109,"Alabama","Pike County","A_A",600,588,-12,-2.02,"undercount"
"218",1109,"Alabama","Pike County","A_AIC",734,735,1,0.14,"overcount"
"219",1109,"Alabama","Pike County","NHPI_A",6,9,3,40,"overcount"
"220",1109,"Alabama","Pike County","NHPI_AIC",40,35,-5,-13.33,"undercount"
"221",1111,"Alabama","Randolph County","A_A",95,87,-8,-8.79,"undercount"
"222",1111,"Alabama","Randolph County","A_AIC",135,132,-3,-2.25,"undercount"
"223",1111,"Alabama","Randolph County","NHPI_A",20,1,-19,-180.95,"undercount"
"224",1111,"Alabama","Randolph County","NHPI_AIC",35,11,-24,-104.35,"undercount"
"225",1113,"Alabama","Russell County","A_A",469,412,-57,-12.94,"undercount"
"226",1113,"Alabama","Russell County","A_AIC",835,781,-54,-6.68,"undercount"
"227",1113,"Alabama","Russell County","NHPI_A",146,135,-11,-7.83,"undercount"
"228",1113,"Alabama","Russell County","NHPI_AIC",224,226,2,0.89,"overcount"
"229",1115,"Alabama","St. Clair County","A_A",835,659,-176,-23.56,"undercount"
"230",1115,"Alabama","St. Clair County","A_AIC",1074,985,-89,-8.64,"undercount"
"231",1115,"Alabama","St. Clair County","NHPI_A",51,20,-31,-87.32,"undercount"
"232",1115,"Alabama","St. Clair County","NHPI_AIC",84,56,-28,-40,"undercount"
"233",1117,"Alabama","Shelby County","A_A",5131,5184,53,1.03,"overcount"
"234",1117,"Alabama","Shelby County","A_AIC",6131,6608,477,7.49,"overcount"
"235",1117,"Alabama","Shelby County","NHPI_A",81,91,10,11.63,"overcount"
"236",1117,"Alabama","Shelby County","NHPI_AIC",203,231,28,12.9,"overcount"
"237",1119,"Alabama","Sumter County","A_A",212,102,-110,-70.06,"undercount"
"238",1119,"Alabama","Sumter County","A_AIC",223,133,-90,-50.56,"undercount"
"239",1119,"Alabama","Sumter County","NHPI_A",1,3,2,100,"overcount"
"240",1119,"Alabama","Sumter County","NHPI_AIC",9,29,20,105.26,"overcount"
"241",1121,"Alabama","Talladega County","A_A",459,397,-62,-14.49,"undercount"
"242",1121,"Alabama","Talladega County","A_AIC",677,581,-96,-15.26,"undercount"
"243",1121,"Alabama","Talladega County","NHPI_A",13,27,14,70,"overcount"
"244",1121,"Alabama","Talladega County","NHPI_AIC",81,79,-2,-2.5,"undercount"
"245",1123,"Alabama","Tallapoosa County","A_A",232,223,-9,-3.96,"undercount"
"246",1123,"Alabama","Tallapoosa County","A_AIC",306,291,-15,-5.03,"undercount"
"247",1123,"Alabama","Tallapoosa County","NHPI_A",8,0,-8,-200,"undercount"
"248",1123,"Alabama","Tallapoosa County","NHPI_AIC",33,14,-19,-80.85,"undercount"
"249",1125,"Alabama","Tuscaloosa County","A_A",3472,3264,-208,-6.18,"undercount"
"250",1125,"Alabama","Tuscaloosa County","A_AIC",4263,4296,33,0.77,"overcount"
"251",1125,"Alabama","Tuscaloosa County","NHPI_A",87,94,7,7.73,"overcount"
"252",1125,"Alabama","Tuscaloosa County","NHPI_AIC",204,221,17,8,"overcount"
"253",1127,"Alabama","Walker County","A_A",291,283,-8,-2.79,"undercount"
"254",1127,"Alabama","Walker County","A_AIC",383,400,17,4.34,"overcount"
"255",1127,"Alabama","Walker County","NHPI_A",28,3,-25,-161.29,"undercount"
"256",1127,"Alabama","Walker County","NHPI_AIC",54,32,-22,-51.16,"undercount"
"257",1129,"Alabama","Washington County","A_A",125,16,-109,-154.61,"undercount"
"258",1129,"Alabama","Washington County","A_AIC",173,43,-130,-120.37,"undercount"
"259",1129,"Alabama","Washington County","NHPI_A",13,3,-10,-125,"undercount"
"260",1129,"Alabama","Washington County","NHPI_AIC",26,17,-9,-41.86,"undercount"
"261",1131,"Alabama","Wilcox County","A_A",19,9,-10,-71.43,"undercount"
"262",1131,"Alabama","Wilcox County","A_AIC",43,16,-27,-91.53,"undercount"
"263",1131,"Alabama","Wilcox County","NHPI_A",1,5,4,133.33,"overcount"
"264",1131,"Alabama","Wilcox County","NHPI_AIC",4,5,1,22.22,"overcount"
"265",1133,"Alabama","Winston County","A_A",68,58,-10,-15.87,"undercount"
"266",1133,"Alabama","Winston County","A_AIC",121,91,-30,-28.3,"undercount"
"267",1133,"Alabama","Winston County","NHPI_A",8,9,1,11.76,"overcount"
"268",1133,"Alabama","Winston County","NHPI_AIC",17,13,-4,-26.67,"undercount"
"269",2013,"Alaska","Aleutians East Borough","A_A",1473,773,-700,-62.33,"undercount"
"270",2013,"Alaska","Aleutians East Borough","A_AIC",1522,807,-715,-61.4,"undercount"
"271",2013,"Alaska","Aleutians East Borough","NHPI_A",34,32,-2,-6.06,"undercount"
"272",2013,"Alaska","Aleutians East Borough","NHPI_AIC",47,45,-2,-4.35,"undercount"
"273",2016,"Alaska","Aleutians West Census Area","A_A",2213,1506,-707,-38.02,"undercount"
"274",2016,"Alaska","Aleutians West Census Area","A_AIC",2299,1603,-696,-35.67,"undercount"
"275",2016,"Alaska","Aleutians West Census Area","NHPI_A",169,238,69,33.91,"overcount"
"276",2016,"Alaska","Aleutians West Census Area","NHPI_AIC",219,272,53,21.59,"overcount"
"277",2020,"Alaska","Anchorage Municipality","A_A",28106,27548,-558,-2.01,"undercount"
"278",2020,"Alaska","Anchorage Municipality","A_AIC",35584,35806,222,0.62,"overcount"
"279",2020,"Alaska","Anchorage Municipality","NHPI_A",8845,9912,1067,11.38,"overcount"
"280",2020,"Alaska","Anchorage Municipality","NHPI_AIC",11076,12898,1822,15.2,"overcount"
"281",2050,"Alaska","Bethel Census Area","A_A",207,201,-6,-2.94,"undercount"
"282",2050,"Alaska","Bethel Census Area","A_AIC",311,295,-16,-5.28,"undercount"
"283",2050,"Alaska","Bethel Census Area","NHPI_A",29,2,-27,-174.19,"undercount"
"284",2050,"Alaska","Bethel Census Area","NHPI_AIC",71,39,-32,-58.18,"undercount"
"285",2060,"Alaska","Bristol Bay Borough","A_A",20,5,-15,-120,"undercount"
"286",2060,"Alaska","Bristol Bay Borough","A_AIC",52,24,-28,-73.68,"undercount"
"287",2060,"Alaska","Bristol Bay Borough","NHPI_A",2,3,1,40,"overcount"
"288",2060,"Alaska","Bristol Bay Borough","NHPI_AIC",9,20,11,75.86,"overcount"
"289",2063,"Alaska","Chugach Census Area","A_A",425,527,102,21.43,"overcount"
"290",2063,"Alaska","Chugach Census Area","A_AIC",506,662,156,26.71,"overcount"
"291",2063,"Alaska","Chugach Census Area","NHPI_A",45,61,16,30.19,"overcount"
"292",2063,"Alaska","Chugach Census Area","NHPI_AIC",64,75,11,15.83,"overcount"
"293",2066,"Alaska","Copper River Census Area","A_A",71,17,-54,-122.73,"undercount"
"294",2066,"Alaska","Copper River Census Area","A_AIC",96,45,-51,-72.34,"undercount"
"295",2066,"Alaska","Copper River Census Area","NHPI_A",10,10,0,0,"equal"
"296",2066,"Alaska","Copper River Census Area","NHPI_AIC",19,29,10,41.67,"overcount"
"297",2068,"Alaska","Denali Borough","A_A",117,13,-104,-160,"undercount"
"298",2068,"Alaska","Denali Borough","A_AIC",133,47,-86,-95.56,"undercount"
"299",2068,"Alaska","Denali Borough","NHPI_A",1,3,2,100,"overcount"
"300",2068,"Alaska","Denali Borough","NHPI_AIC",4,13,9,105.88,"overcount"
"301",2070,"Alaska","Dillingham Census Area","A_A",47,45,-2,-4.35,"undercount"
"302",2070,"Alaska","Dillingham Census Area","A_AIC",106,99,-7,-6.83,"undercount"
"303",2070,"Alaska","Dillingham Census Area","NHPI_A",10,9,-1,-10.53,"undercount"
"304",2070,"Alaska","Dillingham Census Area","NHPI_AIC",28,23,-5,-19.61,"undercount"
"305",2090,"Alaska","Fairbanks North Star Borough","A_A",3155,3097,-58,-1.86,"undercount"
"306",2090,"Alaska","Fairbanks North Star Borough","A_AIC",5028,4998,-30,-0.6,"undercount"
"307",2090,"Alaska","Fairbanks North Star Borough","NHPI_A",495,584,89,16.5,"overcount"
"308",2090,"Alaska","Fairbanks North Star Borough","NHPI_AIC",893,999,106,11.21,"overcount"
"309",2100,"Alaska","Haines Borough","A_A",24,16,-8,-40,"undercount"
"310",2100,"Alaska","Haines Borough","A_AIC",52,45,-7,-14.43,"undercount"
"311",2100,"Alaska","Haines Borough","NHPI_A",0,2,2,200,"overcount"
"312",2100,"Alaska","Haines Borough","NHPI_AIC",4,15,11,115.79,"overcount"
"313",2105,"Alaska","Hoonah-Angoon Census Area","A_A",18,16,-2,-11.76,"undercount"
"314",2105,"Alaska","Hoonah-Angoon Census Area","A_AIC",44,56,12,24,"overcount"
"315",2105,"Alaska","Hoonah-Angoon Census Area","NHPI_A",2,4,2,66.67,"overcount"
"316",2105,"Alaska","Hoonah-Angoon Census Area","NHPI_AIC",9,9,0,0,"equal"
"317",2110,"Alaska","Juneau City and Borough","A_A",2206,2111,-95,-4.4,"undercount"
"318",2110,"Alaska","Juneau City and Borough","A_AIC",3251,3241,-10,-0.31,"undercount"
"319",2110,"Alaska","Juneau City and Borough","NHPI_A",389,469,80,18.65,"overcount"
"320",2110,"Alaska","Juneau City and Borough","NHPI_AIC",589,704,115,17.79,"overcount"
"321",2122,"Alaska","Kenai Peninsula Borough","A_A",1073,813,-260,-27.57,"undercount"
"322",2122,"Alaska","Kenai Peninsula Borough","A_AIC",1801,1520,-281,-16.92,"undercount"
"323",2122,"Alaska","Kenai Peninsula Borough","NHPI_A",156,173,17,10.33,"overcount"
"324",2122,"Alaska","Kenai Peninsula Borough","NHPI_AIC",351,405,54,14.29,"overcount"
"325",2130,"Alaska","Ketchikan Gateway Borough","A_A",1125,1125,0,0,"equal"
"326",2130,"Alaska","Ketchikan Gateway Borough","A_AIC",1406,1423,17,1.2,"overcount"
"327",2130,"Alaska","Ketchikan Gateway Borough","NHPI_A",40,26,-14,-42.42,"undercount"
"328",2130,"Alaska","Ketchikan Gateway Borough","NHPI_AIC",99,99,0,0,"equal"
"329",2150,"Alaska","Kodiak Island Borough","A_A",2988,2796,-192,-6.64,"undercount"
"330",2150,"Alaska","Kodiak Island Borough","A_AIC",3267,3060,-207,-6.54,"undercount"
"331",2150,"Alaska","Kodiak Island Borough","NHPI_A",97,107,10,9.8,"overcount"
"332",2150,"Alaska","Kodiak Island Borough","NHPI_AIC",181,189,8,4.32,"overcount"
"333",2158,"Alaska","Kusilvak Census Area","A_A",35,23,-12,-41.38,"undercount"
"334",2158,"Alaska","Kusilvak Census Area","A_AIC",81,44,-37,-59.2,"undercount"
"335",2158,"Alaska","Kusilvak Census Area","NHPI_A",2,0,-2,-200,"undercount"
"336",2158,"Alaska","Kusilvak Census Area","NHPI_AIC",15,24,9,46.15,"overcount"
"337",2164,"Alaska","Lake and Peninsula Borough","A_A",42,7,-35,-142.86,"undercount"
"338",2164,"Alaska","Lake and Peninsula Borough","A_AIC",81,22,-59,-114.56,"undercount"
"339",2164,"Alaska","Lake and Peninsula Borough","NHPI_A",5,0,-5,-200,"undercount"
"340",2164,"Alaska","Lake and Peninsula Borough","NHPI_AIC",12,13,1,8,"overcount"
"341",2170,"Alaska","Matanuska-Susitna Borough","A_A",1775,1571,-204,-12.19,"undercount"
"342",2170,"Alaska","Matanuska-Susitna Borough","A_AIC",3625,3329,-296,-8.51,"undercount"
"343",2170,"Alaska","Matanuska-Susitna Borough","NHPI_A",457,477,20,4.28,"overcount"
"344",2170,"Alaska","Matanuska-Susitna Borough","NHPI_AIC",1017,1117,100,9.37,"overcount"
"345",2180,"Alaska","Nome Census Area","A_A",157,109,-48,-36.09,"undercount"
"346",2180,"Alaska","Nome Census Area","A_AIC",236,214,-22,-9.78,"undercount"
"347",2180,"Alaska","Nome Census Area","NHPI_A",17,5,-12,-109.09,"undercount"
"348",2180,"Alaska","Nome Census Area","NHPI_AIC",45,34,-11,-27.85,"undercount"
"349",2185,"Alaska","North Slope Borough","A_A",532,641,109,18.58,"overcount"
"350",2185,"Alaska","North Slope Borough","A_AIC",656,766,110,15.47,"overcount"
"351",2185,"Alaska","North Slope Borough","NHPI_A",173,321,148,59.92,"overcount"
"352",2185,"Alaska","North Slope Borough","NHPI_AIC",233,439,206,61.31,"overcount"
"353",2188,"Alaska","Northwest Arctic Borough","A_A",88,53,-35,-49.65,"undercount"
"354",2188,"Alaska","Northwest Arctic Borough","A_AIC",151,100,-51,-40.64,"undercount"
"355",2188,"Alaska","Northwest Arctic Borough","NHPI_A",17,11,-6,-42.86,"undercount"
"356",2188,"Alaska","Northwest Arctic Borough","NHPI_AIC",36,32,-4,-11.76,"undercount"
"357",2195,"Alaska","Petersburg Borough","A_A",175,117,-58,-39.73,"undercount"
"358",2195,"Alaska","Petersburg Borough","A_AIC",239,193,-46,-21.3,"undercount"
"359",2195,"Alaska","Petersburg Borough","NHPI_A",25,12,-13,-70.27,"undercount"
"360",2195,"Alaska","Petersburg Borough","NHPI_AIC",37,47,10,23.81,"overcount"
"361",2198,"Alaska","Prince of Wales-Hyder Census Area","A_A",91,29,-62,-103.33,"undercount"
"362",2198,"Alaska","Prince of Wales-Hyder Census Area","A_AIC",197,94,-103,-70.79,"undercount"
"363",2198,"Alaska","Prince of Wales-Hyder Census Area","NHPI_A",31,30,-1,-3.28,"undercount"
"364",2198,"Alaska","Prince of Wales-Hyder Census Area","NHPI_AIC",71,60,-11,-16.79,"undercount"
"365",2220,"Alaska","Sitka City and Borough","A_A",622,584,-38,-6.3,"undercount"
"366",2220,"Alaska","Sitka City and Borough","A_AIC",810,774,-36,-4.55,"undercount"
"367",2220,"Alaska","Sitka City and Borough","NHPI_A",32,14,-18,-78.26,"undercount"
"368",2220,"Alaska","Sitka City and Borough","NHPI_AIC",94,60,-34,-44.16,"undercount"
"369",2230,"Alaska","Skagway Municipality","A_A",32,40,8,22.22,"overcount"
"370",2230,"Alaska","Skagway Municipality","A_AIC",55,61,6,10.34,"overcount"
"371",2230,"Alaska","Skagway Municipality","NHPI_A",3,0,-3,-200,"undercount"
"372",2230,"Alaska","Skagway Municipality","NHPI_AIC",6,10,4,50,"overcount"
"373",2240,"Alaska","Southeast Fairbanks Census Area","A_A",172,87,-85,-65.64,"undercount"
"374",2240,"Alaska","Southeast Fairbanks Census Area","A_AIC",229,172,-57,-28.43,"undercount"
"375",2240,"Alaska","Southeast Fairbanks Census Area","NHPI_A",29,13,-16,-76.19,"undercount"
"376",2240,"Alaska","Southeast Fairbanks Census Area","NHPI_AIC",49,58,9,16.82,"overcount"
"377",2275,"Alaska","Wrangell City and Borough","A_A",81,25,-56,-105.66,"undercount"
"378",2275,"Alaska","Wrangell City and Borough","A_AIC",118,61,-57,-63.69,"undercount"
"379",2275,"Alaska","Wrangell City and Borough","NHPI_A",1,2,1,66.67,"overcount"
"380",2275,"Alaska","Wrangell City and Borough","NHPI_AIC",15,25,10,50,"overcount"
"381",2282,"Alaska","Yakutat City and Borough","A_A",43,32,-11,-29.33,"undercount"
"382",2282,"Alaska","Yakutat City and Borough","A_AIC",63,54,-9,-15.38,"undercount"
"383",2282,"Alaska","Yakutat City and Borough","NHPI_A",7,1,-6,-150,"undercount"
"384",2282,"Alaska","Yakutat City and Borough","NHPI_AIC",8,11,3,31.58,"overcount"
"385",2290,"Alaska","Yukon-Koyukuk Census Area","A_A",32,8,-24,-120,"undercount"
"386",2290,"Alaska","Yukon-Koyukuk Census Area","A_AIC",71,33,-38,-73.08,"undercount"
"387",2290,"Alaska","Yukon-Koyukuk Census Area","NHPI_A",9,3,-6,-100,"undercount"
"388",2290,"Alaska","Yukon-Koyukuk Census Area","NHPI_AIC",16,16,0,0,"equal"
"389",4001,"Arizona","Apache County","A_A",267,309,42,14.58,"overcount"
"390",4001,"Arizona","Apache County","A_AIC",433,441,8,1.83,"overcount"
"391",4001,"Arizona","Apache County","NHPI_A",39,18,-21,-73.68,"undercount"
"392",4001,"Arizona","Apache County","NHPI_AIC",118,95,-23,-21.6,"undercount"
"393",4003,"Arizona","Cochise County","A_A",2615,2614,-1,-0.04,"undercount"
"394",4003,"Arizona","Cochise County","A_AIC",3987,3974,-13,-0.33,"undercount"
"395",4003,"Arizona","Cochise County","NHPI_A",372,425,53,13.3,"overcount"
"396",4003,"Arizona","Cochise County","NHPI_AIC",715,798,83,10.97,"overcount"
"397",4005,"Arizona","Coconino County","A_A",2800,2606,-194,-7.18,"undercount"
"398",4005,"Arizona","Coconino County","A_AIC",4097,4156,59,1.43,"overcount"
"399",4005,"Arizona","Coconino County","NHPI_A",167,256,89,42.08,"overcount"
"400",4005,"Arizona","Coconino County","NHPI_AIC",532,607,75,13.17,"overcount"
"401",4007,"Arizona","Gila County","A_A",426,443,17,3.91,"overcount"
"402",4007,"Arizona","Gila County","A_AIC",531,651,120,20.3,"overcount"
"403",4007,"Arizona","Gila County","NHPI_A",58,46,-12,-23.08,"undercount"
"404",4007,"Arizona","Gila County","NHPI_AIC",99,147,48,39.02,"overcount"
"405",4009,"Arizona","Graham County","A_A",257,172,-85,-39.63,"undercount"
"406",4009,"Arizona","Graham County","A_AIC",379,295,-84,-24.93,"undercount"
"407",4009,"Arizona","Graham County","NHPI_A",54,16,-38,-108.57,"undercount"
"408",4009,"Arizona","Graham County","NHPI_AIC",116,87,-29,-28.57,"undercount"
"409",4011,"Arizona","Greenlee County","A_A",75,68,-7,-9.79,"undercount"
"410",4011,"Arizona","Greenlee County","A_AIC",96,105,9,8.96,"overcount"
"411",4011,"Arizona","Greenlee County","NHPI_A",8,1,-7,-155.56,"undercount"
"412",4011,"Arizona","Greenlee County","NHPI_AIC",15,31,16,69.57,"overcount"
"413",4012,"Arizona","La Paz County","A_A",144,115,-29,-22.39,"undercount"
"414",4012,"Arizona","La Paz County","A_AIC",214,187,-27,-13.47,"undercount"
"415",4012,"Arizona","La Paz County","NHPI_A",21,41,20,64.52,"overcount"
"416",4012,"Arizona","La Paz County","NHPI_AIC",49,78,29,45.67,"overcount"
"417",4013,"Arizona","Maricopa County","A_A",204375,200031,-4344,-2.15,"undercount"
"418",4013,"Arizona","Maricopa County","A_AIC",249340,251338,1998,0.8,"overcount"
"419",4013,"Arizona","Maricopa County","NHPI_A",9090,9874,784,8.27,"overcount"
"420",4013,"Arizona","Maricopa County","NHPI_AIC",17844,20128,2284,12.03,"overcount"
"421",4015,"Arizona","Mohave County","A_A",2605,2643,38,1.45,"overcount"
"422",4015,"Arizona","Mohave County","A_AIC",3883,4178,295,7.32,"overcount"
"423",4015,"Arizona","Mohave County","NHPI_A",428,382,-46,-11.36,"undercount"
"424",4015,"Arizona","Mohave County","NHPI_AIC",849,911,62,7.05,"overcount"
"425",4017,"Arizona","Navajo County","A_A",623,548,-75,-12.81,"undercount"
"426",4017,"Arizona","Navajo County","A_AIC",984,880,-104,-11.16,"undercount"
"427",4017,"Arizona","Navajo County","NHPI_A",162,69,-93,-80.52,"undercount"
"428",4017,"Arizona","Navajo County","NHPI_AIC",289,223,-66,-25.78,"undercount"
"429",4019,"Arizona","Pima County","A_A",32326,30209,-2117,-6.77,"undercount"
"430",4019,"Arizona","Pima County","A_AIC",41245,41404,159,0.38,"overcount"
"431",4019,"Arizona","Pima County","NHPI_A",1555,2004,449,25.23,"overcount"
"432",4019,"Arizona","Pima County","NHPI_AIC",2973,3737,764,22.77,"overcount"
"433",4021,"Arizona","Pinal County","A_A",7952,6417,-1535,-21.37,"undercount"
"434",4021,"Arizona","Pinal County","A_AIC",11288,10281,-1007,-9.34,"undercount"
"435",4021,"Arizona","Pinal County","NHPI_A",1580,1090,-490,-36.7,"undercount"
"436",4021,"Arizona","Pinal County","NHPI_AIC",2508,2756,248,9.42,"overcount"
"437",4023,"Arizona","Santa Cruz County","A_A",265,274,9,3.34,"overcount"
"438",4023,"Arizona","Santa Cruz County","A_AIC",309,326,17,5.35,"overcount"
"439",4023,"Arizona","Santa Cruz County","NHPI_A",16,13,-3,-20.69,"undercount"
"440",4023,"Arizona","Santa Cruz County","NHPI_AIC",25,43,18,52.94,"overcount"
"441",4025,"Arizona","Yavapai County","A_A",2688,2832,144,5.22,"overcount"
"442",4025,"Arizona","Yavapai County","A_AIC",3975,4387,412,9.85,"overcount"
"443",4025,"Arizona","Yavapai County","NHPI_A",284,270,-14,-5.05,"undercount"
"444",4025,"Arizona","Yavapai County","NHPI_AIC",684,740,56,7.87,"overcount"
"445",4027,"Arizona","Yuma County","A_A",2479,2364,-115,-4.75,"undercount"
"446",4027,"Arizona","Yuma County","A_AIC",3525,3322,-203,-5.93,"undercount"
"447",4027,"Arizona","Yuma County","NHPI_A",254,221,-33,-13.89,"undercount"
"448",4027,"Arizona","Yuma County","NHPI_AIC",505,493,-12,-2.4,"undercount"
"449",5001,"Arkansas","Arkansas County","A_A",122,94,-28,-25.93,"undercount"
"450",5001,"Arkansas","Arkansas County","A_AIC",152,140,-12,-8.22,"undercount"
"451",5001,"Arkansas","Arkansas County","NHPI_A",8,9,1,11.76,"overcount"
"452",5001,"Arkansas","Arkansas County","NHPI_AIC",11,20,9,58.06,"overcount"
"453",5003,"Arkansas","Ashley County","A_A",43,41,-2,-4.76,"undercount"
"454",5003,"Arkansas","Ashley County","A_AIC",74,57,-17,-25.95,"undercount"
"455",5003,"Arkansas","Ashley County","NHPI_A",2,8,6,120,"overcount"
"456",5003,"Arkansas","Ashley County","NHPI_AIC",5,14,9,94.74,"overcount"
"457",5005,"Arkansas","Baxter County","A_A",216,239,23,10.11,"overcount"
"458",5005,"Arkansas","Baxter County","A_AIC",314,365,51,15.02,"overcount"
"459",5005,"Arkansas","Baxter County","NHPI_A",26,9,-17,-97.14,"undercount"
"460",5005,"Arkansas","Baxter County","NHPI_AIC",42,47,5,11.24,"overcount"
"461",5007,"Arkansas","Benton County","A_A",13057,13667,610,4.57,"overcount"
"462",5007,"Arkansas","Benton County","A_AIC",14920,16013,1093,7.07,"overcount"
"463",5007,"Arkansas","Benton County","NHPI_A",1994,2601,607,26.42,"overcount"
"464",5007,"Arkansas","Benton County","NHPI_AIC",2287,3075,788,29.39,"overcount"
"465",5009,"Arkansas","Boone County","A_A",238,233,-5,-2.12,"undercount"
"466",5009,"Arkansas","Boone County","A_AIC",323,365,42,12.21,"overcount"
"467",5009,"Arkansas","Boone County","NHPI_A",27,27,0,0,"equal"
"468",5009,"Arkansas","Boone County","NHPI_AIC",38,36,-2,-5.41,"undercount"
"469",5011,"Arkansas","Bradley County","A_A",27,27,0,0,"equal"
"470",5011,"Arkansas","Bradley County","A_AIC",45,42,-3,-6.9,"undercount"
"471",5011,"Arkansas","Bradley County","NHPI_A",5,1,-4,-133.33,"undercount"
"472",5011,"Arkansas","Bradley County","NHPI_AIC",10,8,-2,-22.22,"undercount"
"473",5013,"Arkansas","Calhoun County","A_A",12,6,-6,-66.67,"undercount"
"474",5013,"Arkansas","Calhoun County","A_AIC",30,20,-10,-40,"undercount"
"475",5013,"Arkansas","Calhoun County","NHPI_A",0,9,9,200,"overcount"
"476",5013,"Arkansas","Calhoun County","NHPI_AIC",4,9,5,76.92,"overcount"
"477",5015,"Arkansas","Carroll County","A_A",584,571,-13,-2.25,"undercount"
"478",5015,"Arkansas","Carroll County","A_AIC",656,667,11,1.66,"overcount"
"479",5015,"Arkansas","Carroll County","NHPI_A",323,432,109,28.87,"overcount"
"480",5015,"Arkansas","Carroll County","NHPI_AIC",331,463,132,33.25,"overcount"
"481",5017,"Arkansas","Chicot County","A_A",66,45,-21,-37.84,"undercount"
"482",5017,"Arkansas","Chicot County","A_AIC",85,55,-30,-42.86,"undercount"
"483",5017,"Arkansas","Chicot County","NHPI_A",3,9,6,100,"overcount"
"484",5017,"Arkansas","Chicot County","NHPI_AIC",5,19,14,116.67,"overcount"
"485",5019,"Arkansas","Clark County","A_A",141,155,14,9.46,"overcount"
"486",5019,"Arkansas","Clark County","A_AIC",190,210,20,10,"overcount"
"487",5019,"Arkansas","Clark County","NHPI_A",91,17,-74,-137.04,"undercount"
"488",5019,"Arkansas","Clark County","NHPI_AIC",103,29,-74,-112.12,"undercount"
"489",5021,"Arkansas","Clay County","A_A",29,14,-15,-69.77,"undercount"
"490",5021,"Arkansas","Clay County","A_AIC",61,47,-14,-25.93,"undercount"
"491",5021,"Arkansas","Clay County","NHPI_A",4,5,1,22.22,"overcount"
"492",5021,"Arkansas","Clay County","NHPI_AIC",9,11,2,20,"overcount"
"493",5023,"Arkansas","Cleburne County","A_A",106,96,-10,-9.9,"undercount"
"494",5023,"Arkansas","Cleburne County","A_AIC",143,148,5,3.44,"overcount"
"495",5023,"Arkansas","Cleburne County","NHPI_A",8,12,4,40,"overcount"
"496",5023,"Arkansas","Cleburne County","NHPI_AIC",11,20,9,58.06,"overcount"
"497",5025,"Arkansas","Cleveland County","A_A",12,7,-5,-52.63,"undercount"
"498",5025,"Arkansas","Cleveland County","A_AIC",29,34,5,15.87,"overcount"
"499",5025,"Arkansas","Cleveland County","NHPI_A",1,1,0,0,"equal"
"500",5025,"Arkansas","Cleveland County","NHPI_AIC",4,6,2,40,"overcount"
"501",5027,"Arkansas","Columbia County","A_A",199,172,-27,-14.56,"undercount"
"502",5027,"Arkansas","Columbia County","A_AIC",256,226,-30,-12.45,"undercount"
"503",5027,"Arkansas","Columbia County","NHPI_A",9,0,-9,-200,"undercount"
"504",5027,"Arkansas","Columbia County","NHPI_AIC",23,10,-13,-78.79,"undercount"
"505",5029,"Arkansas","Conway County","A_A",90,89,-1,-1.12,"undercount"
"506",5029,"Arkansas","Conway County","A_AIC",153,138,-15,-10.31,"undercount"
"507",5029,"Arkansas","Conway County","NHPI_A",6,8,2,28.57,"overcount"
"508",5029,"Arkansas","Conway County","NHPI_AIC",20,42,22,70.97,"overcount"
"509",5031,"Arkansas","Craighead County","A_A",1483,1692,209,13.17,"overcount"
"510",5031,"Arkansas","Craighead County","A_AIC",1824,2134,310,15.66,"overcount"
"511",5031,"Arkansas","Craighead County","NHPI_A",49,55,6,11.54,"overcount"
"512",5031,"Arkansas","Craighead County","NHPI_AIC",109,135,26,21.31,"overcount"
"513",5033,"Arkansas","Crawford County","A_A",951,950,-1,-0.11,"undercount"
"514",5033,"Arkansas","Crawford County","A_AIC",1258,1308,50,3.9,"overcount"
"515",5033,"Arkansas","Crawford County","NHPI_A",25,30,5,18.18,"overcount"
"516",5033,"Arkansas","Crawford County","NHPI_AIC",71,85,14,17.95,"overcount"
"517",5035,"Arkansas","Crittenden County","A_A",315,324,9,2.82,"overcount"
"518",5035,"Arkansas","Crittenden County","A_AIC",434,439,5,1.15,"overcount"
"519",5035,"Arkansas","Crittenden County","NHPI_A",13,18,5,32.26,"overcount"
"520",5035,"Arkansas","Crittenden County","NHPI_AIC",47,34,-13,-32.1,"undercount"
"521",5037,"Arkansas","Cross County","A_A",122,103,-19,-16.89,"undercount"
"522",5037,"Arkansas","Cross County","A_AIC",162,135,-27,-18.18,"undercount"
"523",5037,"Arkansas","Cross County","NHPI_A",9,5,-4,-57.14,"undercount"
"524",5037,"Arkansas","Cross County","NHPI_AIC",21,18,-3,-15.38,"undercount"
"525",5039,"Arkansas","Dallas County","A_A",22,7,-15,-103.45,"undercount"
"526",5039,"Arkansas","Dallas County","A_AIC",40,31,-9,-25.35,"undercount"
"527",5039,"Arkansas","Dallas County","NHPI_A",1,0,-1,-200,"undercount"
"528",5039,"Arkansas","Dallas County","NHPI_AIC",4,14,10,111.11,"overcount"
"529",5041,"Arkansas","Desha County","A_A",96,61,-35,-44.59,"undercount"
"530",5041,"Arkansas","Desha County","A_AIC",113,87,-26,-26,"undercount"
"531",5041,"Arkansas","Desha County","NHPI_A",4,0,-4,-200,"undercount"
"532",5041,"Arkansas","Desha County","NHPI_AIC",7,6,-1,-15.38,"undercount"
"533",5043,"Arkansas","Drew County","A_A",117,122,5,4.18,"overcount"
"534",5043,"Arkansas","Drew County","A_AIC",145,157,12,7.95,"overcount"
"535",5043,"Arkansas","Drew County","NHPI_A",3,16,13,136.84,"overcount"
"536",5043,"Arkansas","Drew County","NHPI_AIC",8,32,24,120,"overcount"
"537",5045,"Arkansas","Faulkner County","A_A",1577,1484,-93,-6.08,"undercount"
"538",5045,"Arkansas","Faulkner County","A_AIC",2192,2248,56,2.52,"overcount"
"539",5045,"Arkansas","Faulkner County","NHPI_A",68,65,-3,-4.51,"undercount"
"540",5045,"Arkansas","Faulkner County","NHPI_AIC",323,177,-146,-58.4,"undercount"
"541",5047,"Arkansas","Franklin County","A_A",180,162,-18,-10.53,"undercount"
"542",5047,"Arkansas","Franklin County","A_AIC",209,217,8,3.76,"overcount"
"543",5047,"Arkansas","Franklin County","NHPI_A",37,10,-27,-114.89,"undercount"
"544",5047,"Arkansas","Franklin County","NHPI_AIC",44,27,-17,-47.89,"undercount"
"545",5049,"Arkansas","Fulton County","A_A",35,38,3,8.22,"overcount"
"546",5049,"Arkansas","Fulton County","A_AIC",59,84,25,34.97,"overcount"
"547",5049,"Arkansas","Fulton County","NHPI_A",3,0,-3,-200,"undercount"
"548",5049,"Arkansas","Fulton County","NHPI_AIC",13,4,-9,-105.88,"undercount"
"549",5051,"Arkansas","Garland County","A_A",817,976,159,17.74,"overcount"
"550",5051,"Arkansas","Garland County","A_AIC",1193,1468,275,20.67,"overcount"
"551",5051,"Arkansas","Garland County","NHPI_A",60,73,13,19.55,"overcount"
"552",5051,"Arkansas","Garland County","NHPI_AIC",149,169,20,12.58,"overcount"
"553",5053,"Arkansas","Grant County","A_A",77,76,-1,-1.31,"undercount"
"554",5053,"Arkansas","Grant County","A_AIC",110,125,15,12.77,"overcount"
"555",5053,"Arkansas","Grant County","NHPI_A",1,1,0,0,"equal"
"556",5053,"Arkansas","Grant County","NHPI_AIC",9,15,6,50,"overcount"
"557",5055,"Arkansas","Greene County","A_A",180,211,31,15.86,"overcount"
"558",5055,"Arkansas","Greene County","A_AIC",257,330,73,24.87,"overcount"
"559",5055,"Arkansas","Greene County","NHPI_A",188,289,101,42.35,"overcount"
"560",5055,"Arkansas","Greene County","NHPI_AIC",204,309,105,40.94,"overcount"
"561",5057,"Arkansas","Hempstead County","A_A",108,95,-13,-12.81,"undercount"
"562",5057,"Arkansas","Hempstead County","A_AIC",156,146,-10,-6.62,"undercount"
"563",5057,"Arkansas","Hempstead County","NHPI_A",18,5,-13,-113.04,"undercount"
"564",5057,"Arkansas","Hempstead County","NHPI_AIC",33,16,-17,-69.39,"undercount"
"565",5059,"Arkansas","Hot Spring County","A_A",124,118,-6,-4.96,"undercount"
"566",5059,"Arkansas","Hot Spring County","A_AIC",224,216,-8,-3.64,"undercount"
"567",5059,"Arkansas","Hot Spring County","NHPI_A",18,11,-7,-48.28,"undercount"
"568",5059,"Arkansas","Hot Spring County","NHPI_AIC",40,51,11,24.18,"overcount"
"569",5061,"Arkansas","Howard County","A_A",77,62,-15,-21.58,"undercount"
"570",5061,"Arkansas","Howard County","A_AIC",99,95,-4,-4.12,"undercount"
"571",5061,"Arkansas","Howard County","NHPI_A",8,5,-3,-46.15,"undercount"
"572",5061,"Arkansas","Howard County","NHPI_AIC",15,12,-3,-22.22,"undercount"
"573",5063,"Arkansas","Independence County","A_A",297,366,69,20.81,"overcount"
"574",5063,"Arkansas","Independence County","A_AIC",395,513,118,25.99,"overcount"
"575",5063,"Arkansas","Independence County","NHPI_A",31,30,-1,-3.28,"undercount"
"576",5063,"Arkansas","Independence County","NHPI_AIC",62,50,-12,-21.43,"undercount"
"577",5065,"Arkansas","Izard County","A_A",63,27,-36,-80,"undercount"
"578",5065,"Arkansas","Izard County","A_AIC",87,65,-22,-28.95,"undercount"
"579",5065,"Arkansas","Izard County","NHPI_A",2,9,7,127.27,"overcount"
"580",5065,"Arkansas","Izard County","NHPI_AIC",5,15,10,100,"overcount"
"581",5067,"Arkansas","Jackson County","A_A",78,65,-13,-18.18,"undercount"
"582",5067,"Arkansas","Jackson County","A_AIC",108,96,-12,-11.76,"undercount"
"583",5067,"Arkansas","Jackson County","NHPI_A",38,5,-33,-153.49,"undercount"
"584",5067,"Arkansas","Jackson County","NHPI_AIC",46,15,-31,-101.64,"undercount"
"585",5069,"Arkansas","Jefferson County","A_A",601,677,76,11.89,"overcount"
"586",5069,"Arkansas","Jefferson County","A_AIC",716,831,115,14.87,"overcount"
"587",5069,"Arkansas","Jefferson County","NHPI_A",72,93,21,25.45,"overcount"
"588",5069,"Arkansas","Jefferson County","NHPI_AIC",125,121,-4,-3.25,"undercount"
"589",5071,"Arkansas","Johnson County","A_A",776,918,142,16.77,"overcount"
"590",5071,"Arkansas","Johnson County","A_AIC",847,979,132,14.46,"overcount"
"591",5071,"Arkansas","Johnson County","NHPI_A",29,30,1,3.39,"overcount"
"592",5071,"Arkansas","Johnson County","NHPI_AIC",39,49,10,22.73,"overcount"
"593",5073,"Arkansas","Lafayette County","A_A",43,32,-11,-29.33,"undercount"
"594",5073,"Arkansas","Lafayette County","A_AIC",53,50,-3,-5.83,"undercount"
"595",5073,"Arkansas","Lafayette County","NHPI_A",1,8,7,155.56,"overcount"
"596",5073,"Arkansas","Lafayette County","NHPI_AIC",4,14,10,111.11,"overcount"
"597",5075,"Arkansas","Lawrence County","A_A",46,39,-7,-16.47,"undercount"
"598",5075,"Arkansas","Lawrence County","A_AIC",89,54,-35,-48.95,"undercount"
"599",5075,"Arkansas","Lawrence County","NHPI_A",7,10,3,35.29,"overcount"
"600",5075,"Arkansas","Lawrence County","NHPI_AIC",17,20,3,16.22,"overcount"
"601",5077,"Arkansas","Lee County","A_A",50,14,-36,-112.5,"undercount"
"602",5077,"Arkansas","Lee County","A_AIC",63,25,-38,-86.36,"undercount"
"603",5077,"Arkansas","Lee County","NHPI_A",2,1,-1,-66.67,"undercount"
"604",5077,"Arkansas","Lee County","NHPI_AIC",7,19,12,92.31,"overcount"
"605",5079,"Arkansas","Lincoln County","A_A",31,23,-8,-29.63,"undercount"
"606",5079,"Arkansas","Lincoln County","A_AIC",52,58,6,10.91,"overcount"
"607",5079,"Arkansas","Lincoln County","NHPI_A",1,9,8,160,"overcount"
"608",5079,"Arkansas","Lincoln County","NHPI_AIC",4,26,22,146.67,"overcount"
"609",5081,"Arkansas","Little River County","A_A",62,20,-42,-102.44,"undercount"
"610",5081,"Arkansas","Little River County","A_AIC",89,56,-33,-45.52,"undercount"
"611",5081,"Arkansas","Little River County","NHPI_A",7,9,2,25,"overcount"
"612",5081,"Arkansas","Little River County","NHPI_AIC",11,15,4,30.77,"overcount"
"613",5083,"Arkansas","Logan County","A_A",454,329,-125,-31.93,"undercount"
"614",5083,"Arkansas","Logan County","A_AIC",500,399,-101,-22.47,"undercount"
"615",5083,"Arkansas","Logan County","NHPI_A",8,9,1,11.76,"overcount"
"616",5083,"Arkansas","Logan County","NHPI_AIC",21,20,-1,-4.88,"undercount"
"617",5085,"Arkansas","Lonoke County","A_A",628,721,93,13.79,"overcount"
"618",5085,"Arkansas","Lonoke County","A_AIC",1078,1333,255,21.15,"overcount"
"619",5085,"Arkansas","Lonoke County","NHPI_A",35,49,14,33.33,"overcount"
"620",5085,"Arkansas","Lonoke County","NHPI_AIC",98,128,30,26.55,"overcount"
"621",5087,"Arkansas","Madison County","A_A",130,102,-28,-24.14,"undercount"
"622",5087,"Arkansas","Madison County","A_AIC",166,154,-12,-7.5,"undercount"
"623",5087,"Arkansas","Madison County","NHPI_A",116,238,122,68.93,"overcount"
"624",5087,"Arkansas","Madison County","NHPI_AIC",129,246,117,62.4,"overcount"
"625",5089,"Arkansas","Marion County","A_A",102,56,-46,-58.23,"undercount"
"626",5089,"Arkansas","Marion County","A_AIC",150,106,-44,-34.38,"undercount"
"627",5089,"Arkansas","Marion County","NHPI_A",7,0,-7,-200,"undercount"
"628",5089,"Arkansas","Marion County","NHPI_AIC",19,22,3,14.63,"overcount"
"629",5091,"Arkansas","Miller County","A_A",234,205,-29,-13.21,"undercount"
"630",5091,"Arkansas","Miller County","A_AIC",352,321,-31,-9.21,"undercount"
"631",5091,"Arkansas","Miller County","NHPI_A",29,4,-25,-151.52,"undercount"
"632",5091,"Arkansas","Miller County","NHPI_AIC",68,50,-18,-30.51,"undercount"
"633",5093,"Arkansas","Mississippi County","A_A",193,242,49,22.53,"overcount"
"634",5093,"Arkansas","Mississippi County","A_AIC",258,310,52,18.31,"overcount"
"635",5093,"Arkansas","Mississippi County","NHPI_A",5,3,-2,-50,"undercount"
"636",5093,"Arkansas","Mississippi County","NHPI_AIC",30,11,-19,-92.68,"undercount"
"637",5095,"Arkansas","Monroe County","A_A",55,29,-26,-61.9,"undercount"
"638",5095,"Arkansas","Monroe County","A_AIC",76,31,-45,-84.11,"undercount"
"639",5095,"Arkansas","Monroe County","NHPI_A",0,8,8,200,"overcount"
"640",5095,"Arkansas","Monroe County","NHPI_AIC",4,9,5,76.92,"overcount"
"641",5097,"Arkansas","Montgomery County","A_A",112,48,-64,-80,"undercount"
"642",5097,"Arkansas","Montgomery County","A_AIC",137,74,-63,-59.72,"undercount"
"643",5097,"Arkansas","Montgomery County","NHPI_A",3,5,2,50,"overcount"
"644",5097,"Arkansas","Montgomery County","NHPI_AIC",4,16,12,120,"overcount"
"645",5099,"Arkansas","Nevada County","A_A",42,42,0,0,"equal"
"646",5099,"Arkansas","Nevada County","A_AIC",55,56,1,1.8,"overcount"
"647",5099,"Arkansas","Nevada County","NHPI_A",1,0,-1,-200,"undercount"
"648",5099,"Arkansas","Nevada County","NHPI_AIC",4,5,1,22.22,"overcount"
"649",5101,"Arkansas","Newton County","A_A",38,24,-14,-45.16,"undercount"
"650",5101,"Arkansas","Newton County","A_AIC",53,47,-6,-12,"undercount"
"651",5101,"Arkansas","Newton County","NHPI_A",1,1,0,0,"equal"
"652",5101,"Arkansas","Newton County","NHPI_AIC",3,22,19,152,"overcount"
"653",5103,"Arkansas","Ouachita County","A_A",105,123,18,15.79,"overcount"
"654",5103,"Arkansas","Ouachita County","A_AIC",163,203,40,21.86,"overcount"
"655",5103,"Arkansas","Ouachita County","NHPI_A",5,3,-2,-50,"undercount"
"656",5103,"Arkansas","Ouachita County","NHPI_AIC",31,29,-2,-6.67,"undercount"
"657",5105,"Arkansas","Perry County","A_A",32,12,-20,-90.91,"undercount"
"658",5105,"Arkansas","Perry County","A_AIC",63,48,-15,-27.03,"undercount"
"659",5105,"Arkansas","Perry County","NHPI_A",2,0,-2,-200,"undercount"
"660",5105,"Arkansas","Perry County","NHPI_AIC",7,0,-7,-200,"undercount"
"661",5107,"Arkansas","Phillips County","A_A",73,64,-9,-13.14,"undercount"
"662",5107,"Arkansas","Phillips County","A_AIC",99,81,-18,-20,"undercount"
"663",5107,"Arkansas","Phillips County","NHPI_A",2,4,2,66.67,"overcount"
"664",5107,"Arkansas","Phillips County","NHPI_AIC",12,11,-1,-8.7,"undercount"
"665",5109,"Arkansas","Pike County","A_A",59,16,-43,-114.67,"undercount"
"666",5109,"Arkansas","Pike County","A_AIC",89,43,-46,-69.7,"undercount"
"667",5109,"Arkansas","Pike County","NHPI_A",1,0,-1,-200,"undercount"
"668",5109,"Arkansas","Pike County","NHPI_AIC",7,12,5,52.63,"overcount"
"669",5111,"Arkansas","Poinsett County","A_A",87,56,-31,-43.36,"undercount"
"670",5111,"Arkansas","Poinsett County","A_AIC",134,115,-19,-15.26,"undercount"
"671",5111,"Arkansas","Poinsett County","NHPI_A",4,1,-3,-120,"undercount"
"672",5111,"Arkansas","Poinsett County","NHPI_AIC",16,13,-3,-20.69,"undercount"
"673",5113,"Arkansas","Polk County","A_A",172,120,-52,-35.62,"undercount"
"674",5113,"Arkansas","Polk County","A_AIC",212,166,-46,-24.34,"undercount"
"675",5113,"Arkansas","Polk County","NHPI_A",11,9,-2,-20,"undercount"
"676",5113,"Arkansas","Polk County","NHPI_AIC",17,33,16,64,"overcount"
"677",5115,"Arkansas","Pope County","A_A",752,664,-88,-12.43,"undercount"
"678",5115,"Arkansas","Pope County","A_AIC",983,1010,27,2.71,"overcount"
"679",5115,"Arkansas","Pope County","NHPI_A",27,48,21,56,"overcount"
"680",5115,"Arkansas","Pope County","NHPI_AIC",56,86,30,42.25,"overcount"
"681",5117,"Arkansas","Prairie County","A_A",13,21,8,47.06,"overcount"
"682",5117,"Arkansas","Prairie County","A_AIC",28,27,-1,-3.64,"undercount"
"683",5117,"Arkansas","Prairie County","NHPI_A",0,3,3,200,"overcount"
"684",5117,"Arkansas","Prairie County","NHPI_AIC",1,16,15,176.47,"overcount"
"685",5119,"Arkansas","Pulaski County","A_A",9036,10036,1000,10.49,"overcount"
"686",5119,"Arkansas","Pulaski County","A_AIC",11153,12801,1648,13.76,"overcount"
"687",5119,"Arkansas","Pulaski County","NHPI_A",61,208,147,109.29,"overcount"
"688",5119,"Arkansas","Pulaski County","NHPI_AIC",330,513,183,43.42,"overcount"
"689",5121,"Arkansas","Randolph County","A_A",80,73,-7,-9.15,"undercount"
"690",5121,"Arkansas","Randolph County","A_AIC",136,140,4,2.9,"overcount"
"691",5121,"Arkansas","Randolph County","NHPI_A",389,596,207,42.03,"overcount"
"692",5121,"Arkansas","Randolph County","NHPI_AIC",400,614,214,42.21,"overcount"
"693",5123,"Arkansas","St. Francis County","A_A",150,122,-28,-20.59,"undercount"
"694",5123,"Arkansas","St. Francis County","A_AIC",214,145,-69,-38.44,"undercount"
"695",5123,"Arkansas","St. Francis County","NHPI_A",14,0,-14,-200,"undercount"
"696",5123,"Arkansas","St. Francis County","NHPI_AIC",44,16,-28,-93.33,"undercount"
"697",5125,"Arkansas","Saline County","A_A",1639,1454,-185,-11.96,"undercount"
"698",5125,"Arkansas","Saline County","A_AIC",2078,1974,-104,-5.13,"undercount"
"699",5125,"Arkansas","Saline County","NHPI_A",41,70,29,52.25,"overcount"
"700",5125,"Arkansas","Saline County","NHPI_AIC",105,127,22,18.97,"overcount"
"701",5127,"Arkansas","Scott County","A_A",310,296,-14,-4.62,"undercount"
"702",5127,"Arkansas","Scott County","A_AIC",345,317,-28,-8.46,"undercount"
"703",5127,"Arkansas","Scott County","NHPI_A",3,5,2,50,"overcount"
"704",5127,"Arkansas","Scott County","NHPI_AIC",7,6,-1,-15.38,"undercount"
"705",5129,"Arkansas","Searcy County","A_A",30,20,-10,-40,"undercount"
"706",5129,"Arkansas","Searcy County","A_AIC",49,27,-22,-57.89,"undercount"
"707",5129,"Arkansas","Searcy County","NHPI_A",2,5,3,85.71,"overcount"
"708",5129,"Arkansas","Searcy County","NHPI_AIC",8,6,-2,-28.57,"undercount"
"709",5131,"Arkansas","Sebastian County","A_A",5813,5745,-68,-1.18,"undercount"
"710",5131,"Arkansas","Sebastian County","A_AIC",6669,6750,81,1.21,"overcount"
"711",5131,"Arkansas","Sebastian County","NHPI_A",126,93,-33,-30.14,"undercount"
"712",5131,"Arkansas","Sebastian County","NHPI_AIC",245,211,-34,-14.91,"undercount"
"713",5133,"Arkansas","Sevier County","A_A",85,61,-24,-32.88,"undercount"
"714",5133,"Arkansas","Sevier County","A_AIC",118,102,-16,-14.55,"undercount"
"715",5133,"Arkansas","Sevier County","NHPI_A",166,241,75,36.86,"overcount"
"716",5133,"Arkansas","Sevier County","NHPI_AIC",174,243,69,33.09,"overcount"
"717",5135,"Arkansas","Sharp County","A_A",89,57,-32,-43.84,"undercount"
"718",5135,"Arkansas","Sharp County","A_AIC",119,104,-15,-13.45,"undercount"
"719",5135,"Arkansas","Sharp County","NHPI_A",16,20,4,22.22,"overcount"
"720",5135,"Arkansas","Sharp County","NHPI_AIC",23,27,4,16,"overcount"
"721",5137,"Arkansas","Stone County","A_A",59,25,-34,-80.95,"undercount"
"722",5137,"Arkansas","Stone County","A_AIC",84,44,-40,-62.5,"undercount"
"723",5137,"Arkansas","Stone County","NHPI_A",4,2,-2,-66.67,"undercount"
"724",5137,"Arkansas","Stone County","NHPI_AIC",6,7,1,15.38,"overcount"
"725",5139,"Arkansas","Union County","A_A",277,273,-4,-1.45,"undercount"
"726",5139,"Arkansas","Union County","A_AIC",342,340,-2,-0.59,"undercount"
"727",5139,"Arkansas","Union County","NHPI_A",16,16,0,0,"equal"
"728",5139,"Arkansas","Union County","NHPI_AIC",33,33,0,0,"equal"
"729",5141,"Arkansas","Van Buren County","A_A",67,56,-11,-17.89,"undercount"
"730",5141,"Arkansas","Van Buren County","A_AIC",92,95,3,3.21,"overcount"
"731",5141,"Arkansas","Van Buren County","NHPI_A",3,2,-1,-40,"undercount"
"732",5141,"Arkansas","Van Buren County","NHPI_AIC",7,6,-1,-15.38,"undercount"
"733",5143,"Arkansas","Washington County","A_A",6182,5704,-478,-8.04,"undercount"
"734",5143,"Arkansas","Washington County","A_AIC",7762,7665,-97,-1.26,"undercount"
"735",5143,"Arkansas","Washington County","NHPI_A",7169,8844,1675,20.92,"overcount"
"736",5143,"Arkansas","Washington County","NHPI_AIC",7422,9310,1888,22.57,"overcount"
"737",5145,"Arkansas","White County","A_A",627,629,2,0.32,"overcount"
"738",5145,"Arkansas","White County","A_AIC",840,952,112,12.5,"overcount"
"739",5145,"Arkansas","White County","NHPI_A",54,25,-29,-73.42,"undercount"
"740",5145,"Arkansas","White County","NHPI_AIC",87,98,11,11.89,"overcount"
"741",5147,"Arkansas","Woodruff County","A_A",17,22,5,25.64,"overcount"
"742",5147,"Arkansas","Woodruff County","A_AIC",26,30,4,14.29,"overcount"
"743",5147,"Arkansas","Woodruff County","NHPI_A",5,3,-2,-50,"undercount"
"744",5147,"Arkansas","Woodruff County","NHPI_AIC",7,21,14,100,"overcount"
"745",5149,"Arkansas","Yell County","A_A",268,203,-65,-27.6,"undercount"
"746",5149,"Arkansas","Yell County","A_AIC",315,277,-38,-12.84,"undercount"
"747",5149,"Arkansas","Yell County","NHPI_A",4,11,7,93.33,"overcount"
"748",5149,"Arkansas","Yell County","NHPI_AIC",10,28,18,94.74,"overcount"
"749",6001,"California","Alameda County","A_A",540561,544341,3780,0.7,"overcount"
"750",6001,"California","Alameda County","A_AIC",587857,594258,6401,1.08,"overcount"
"751",6001,"California","Alameda County","NHPI_A",13345,13911,566,4.15,"overcount"
"752",6001,"California","Alameda County","NHPI_AIC",22279,22164,-115,-0.52,"undercount"
"753",6003,"California","Alpine County","A_A",21,13,-8,-47.06,"undercount"
"754",6003,"California","Alpine County","A_AIC",25,31,6,21.43,"overcount"
"755",6003,"California","Alpine County","NHPI_A",0,0,0,0,"equal"
"756",6003,"California","Alpine County","NHPI_AIC",5,12,7,82.35,"overcount"
"757",6005,"California","Amador County","A_A",587,561,-26,-4.53,"undercount"
"758",6005,"California","Amador County","A_AIC",915,975,60,6.35,"overcount"
"759",6005,"California","Amador County","NHPI_A",86,75,-11,-13.66,"undercount"
"760",6005,"California","Amador County","NHPI_AIC",168,237,69,34.07,"overcount"
"761",6007,"California","Butte County","A_A",10645,10414,-231,-2.19,"undercount"
"762",6007,"California","Butte County","A_AIC",13662,13380,-282,-2.09,"undercount"
"763",6007,"California","Butte County","NHPI_A",460,524,64,13.01,"overcount"
"764",6007,"California","Butte County","NHPI_AIC",1180,1367,187,14.68,"overcount"
"765",6009,"California","Calaveras County","A_A",693,733,40,5.61,"overcount"
"766",6009,"California","Calaveras County","A_AIC",1218,1247,29,2.35,"overcount"
"767",6009,"California","Calaveras County","NHPI_A",106,78,-28,-30.43,"undercount"
"768",6009,"California","Calaveras County","NHPI_AIC",214,296,82,32.16,"overcount"
"769",6011,"California","Colusa County","A_A",284,257,-27,-9.98,"undercount"
"770",6011,"California","Colusa County","A_AIC",382,388,6,1.56,"overcount"
"771",6011,"California","Colusa County","NHPI_A",78,76,-2,-2.6,"undercount"
"772",6011,"California","Colusa County","NHPI_AIC",119,133,14,11.11,"overcount"
"773",6013,"California","Contra Costa County","A_A",209784,216685,6901,3.24,"overcount"
"774",6013,"California","Contra Costa County","A_AIC",241509,251208,9699,3.94,"overcount"
"775",6013,"California","Contra Costa County","NHPI_A",5541,6005,464,8.04,"overcount"
"776",6013,"California","Contra Costa County","NHPI_AIC",10630,11578,948,8.54,"overcount"
"777",6015,"California","Del Norte County","A_A",819,833,14,1.69,"overcount"
"778",6015,"California","Del Norte County","A_AIC",1151,1142,-9,-0.78,"undercount"
"779",6015,"California","Del Norte County","NHPI_A",45,29,-16,-43.24,"undercount"
"780",6015,"California","Del Norte County","NHPI_AIC",107,155,48,36.64,"overcount"
"781",6017,"California","El Dorado County","A_A",9354,9161,-193,-2.08,"undercount"
"782",6017,"California","El Dorado County","A_AIC",12700,12776,76,0.6,"overcount"
"783",6017,"California","El Dorado County","NHPI_A",322,279,-43,-14.31,"undercount"
"784",6017,"California","El Dorado County","NHPI_AIC",900,968,68,7.28,"overcount"
"785",6019,"California","Fresno County","A_A",106901,111019,4118,3.78,"overcount"
"786",6019,"California","Fresno County","A_AIC",116589,121270,4681,3.94,"overcount"
"787",6019,"California","Fresno County","NHPI_A",1513,1298,-215,-15.3,"undercount"
"788",6019,"California","Fresno County","NHPI_AIC",3194,3204,10,0.31,"overcount"
"789",6021,"California","Glenn County","A_A",704,626,-78,-11.73,"undercount"
"790",6021,"California","Glenn County","A_AIC",835,802,-33,-4.03,"undercount"
"791",6021,"California","Glenn County","NHPI_A",34,39,5,13.7,"overcount"
"792",6021,"California","Glenn County","NHPI_AIC",80,82,2,2.47,"overcount"
"793",6023,"California","Humboldt County","A_A",3684,3553,-131,-3.62,"undercount"
"794",6023,"California","Humboldt County","A_AIC",5902,5517,-385,-6.74,"undercount"
"795",6023,"California","Humboldt County","NHPI_A",393,444,51,12.19,"overcount"
"796",6023,"California","Humboldt County","NHPI_AIC",933,1083,150,14.88,"overcount"
"797",6025,"California","Imperial County","A_A",2148,2288,140,6.31,"overcount"
"798",6025,"California","Imperial County","A_AIC",2637,2778,141,5.21,"overcount"
"799",6025,"California","Imperial County","NHPI_A",144,92,-52,-44.07,"undercount"
"800",6025,"California","Imperial County","NHPI_AIC",234,262,28,11.29,"overcount"
"801",6027,"California","Inyo County","A_A",258,273,15,5.65,"overcount"
"802",6027,"California","Inyo County","A_AIC",405,411,6,1.47,"overcount"
"803",6027,"California","Inyo County","NHPI_A",20,13,-7,-42.42,"undercount"
"804",6027,"California","Inyo County","NHPI_AIC",53,65,12,20.34,"overcount"
"805",6029,"California","Kern County","A_A",43646,44945,1299,2.93,"overcount"
"806",6029,"California","Kern County","A_AIC",51338,52296,958,1.85,"overcount"
"807",6029,"California","Kern County","NHPI_A",1069,1161,92,8.25,"overcount"
"808",6029,"California","Kern County","NHPI_AIC",2338,2965,627,23.65,"overcount"
"809",6031,"California","Kings County","A_A",5799,5622,-177,-3.1,"undercount"
"810",6031,"California","Kings County","A_AIC",7529,7435,-94,-1.26,"undercount"
"811",6031,"California","Kings County","NHPI_A",312,338,26,8,"overcount"
"812",6031,"California","Kings County","NHPI_AIC",601,842,241,33.4,"overcount"
"813",6033,"California","Lake County","A_A",777,964,187,21.48,"overcount"
"814",6033,"California","Lake County","A_AIC",1413,1643,230,15.05,"overcount"
"815",6033,"California","Lake County","NHPI_A",160,100,-60,-46.15,"undercount"
"816",6033,"California","Lake County","NHPI_AIC",421,350,-71,-18.42,"undercount"
"817",6035,"California","Lassen County","A_A",421,475,54,12.05,"overcount"
"818",6035,"California","Lassen County","A_AIC",671,865,194,25.26,"overcount"
"819",6035,"California","Lassen County","NHPI_A",243,285,42,15.91,"overcount"
"820",6035,"California","Lassen County","NHPI_AIC",313,517,204,49.16,"overcount"
"821",6037,"California","Los Angeles County","A_A",1495320,1489041,-6279,-0.42,"undercount"
"822",6037,"California","Los Angeles County","A_AIC",1630180,1639661,9481,0.58,"overcount"
"823",6037,"California","Los Angeles County","NHPI_A",21923,21327,-596,-2.76,"undercount"
"824",6037,"California","Los Angeles County","NHPI_AIC",44220,44206,-14,-0.03,"undercount"
"825",6039,"California","Madera County","A_A",3306,3615,309,8.93,"overcount"
"826",6039,"California","Madera County","A_AIC",4180,4584,404,9.22,"overcount"
"827",6039,"California","Madera County","NHPI_A",176,125,-51,-33.89,"undercount"
"828",6039,"California","Madera County","NHPI_AIC",394,418,24,5.91,"overcount"
"829",6041,"California","Marin County","A_A",16768,16530,-238,-1.43,"undercount"
"830",6041,"California","Marin County","A_AIC",22415,23442,1027,4.48,"overcount"
"831",6041,"California","Marin County","NHPI_A",449,473,24,5.21,"overcount"
"832",6041,"California","Marin County","NHPI_AIC",1067,1318,251,21.05,"overcount"
"833",6043,"California","Mariposa County","A_A",263,297,34,12.14,"overcount"
"834",6043,"California","Mariposa County","A_AIC",371,454,83,20.12,"overcount"
"835",6043,"California","Mariposa County","NHPI_A",28,15,-13,-60.47,"undercount"
"836",6043,"California","Mariposa County","NHPI_AIC",71,75,4,5.48,"overcount"
"837",6045,"California","Mendocino County","A_A",1783,1779,-4,-0.22,"undercount"
"838",6045,"California","Mendocino County","A_AIC",2467,2659,192,7.49,"overcount"
"839",6045,"California","Mendocino County","NHPI_A",132,116,-16,-12.9,"undercount"
"840",6045,"California","Mendocino County","NHPI_AIC",318,344,26,7.85,"overcount"
"841",6047,"California","Merced County","A_A",20185,20143,-42,-0.21,"undercount"
"842",6047,"California","Merced County","A_AIC",22701,22468,-233,-1.03,"undercount"
"843",6047,"California","Merced County","NHPI_A",607,644,37,5.92,"overcount"
"844",6047,"California","Merced County","NHPI_AIC",1231,1253,22,1.77,"overcount"
"845",6049,"California","Modoc County","A_A",90,74,-16,-19.51,"undercount"
"846",6049,"California","Modoc County","A_AIC",136,120,-16,-12.5,"undercount"
"847",6049,"California","Modoc County","NHPI_A",28,13,-15,-73.17,"undercount"
"848",6049,"California","Modoc County","NHPI_AIC",43,44,1,2.3,"overcount"
"849",6051,"California","Mono County","A_A",340,161,-179,-71.46,"undercount"
"850",6051,"California","Mono County","A_AIC",455,304,-151,-39.79,"undercount"
"851",6051,"California","Mono County","NHPI_A",44,26,-18,-51.43,"undercount"
"852",6051,"California","Mono County","NHPI_AIC",68,72,4,5.71,"overcount"
"853",6053,"California","Monterey County","A_A",24594,25513,919,3.67,"overcount"
"854",6053,"California","Monterey County","A_AIC",30834,32581,1747,5.51,"overcount"
"855",6053,"California","Monterey County","NHPI_A",1902,1940,38,1.98,"overcount"
"856",6053,"California","Monterey County","NHPI_AIC",3205,3596,391,11.5,"overcount"
"857",6055,"California","Napa County","A_A",11658,10622,-1036,-9.3,"undercount"
"858",6055,"California","Napa County","A_AIC",13457,12854,-603,-4.58,"undercount"
"859",6055,"California","Napa County","NHPI_A",372,338,-34,-9.58,"undercount"
"860",6055,"California","Napa County","NHPI_AIC",750,805,55,7.07,"overcount"
"861",6057,"California","Nevada County","A_A",1333,1386,53,3.9,"overcount"
"862",6057,"California","Nevada County","A_AIC",2374,2706,332,13.07,"overcount"
"863",6057,"California","Nevada County","NHPI_A",185,121,-64,-41.83,"undercount"
"864",6057,"California","Nevada County","NHPI_AIC",424,450,26,5.95,"overcount"
"865",6059,"California","Orange County","A_A",695528,703747,8219,1.17,"overcount"
"866",6059,"California","Orange County","A_AIC",759544,773767,14223,1.86,"overcount"
"867",6059,"California","Orange County","NHPI_A",8819,7890,-929,-11.12,"undercount"
"868",6059,"California","Orange County","NHPI_AIC",18510,18243,-267,-1.45,"undercount"
"869",6061,"California","Placer County","A_A",33660,35196,1536,4.46,"overcount"
"870",6061,"California","Placer County","A_AIC",43026,45335,2309,5.23,"overcount"
"871",6061,"California","Placer County","NHPI_A",881,1043,162,16.84,"overcount"
"872",6061,"California","Placer County","NHPI_AIC",2373,2912,539,20.4,"overcount"
"873",6063,"California","Plumas County","A_A",175,147,-28,-17.39,"undercount"
"874",6063,"California","Plumas County","A_AIC",341,327,-14,-4.19,"undercount"
"875",6063,"California","Plumas County","NHPI_A",39,46,7,16.47,"overcount"
"876",6063,"California","Plumas County","NHPI_AIC",80,100,20,22.22,"overcount"
"877",6065,"California","Riverside County","A_A",168103,166841,-1262,-0.75,"undercount"
"878",6065,"California","Riverside County","A_AIC",198826,199081,255,0.13,"overcount"
"879",6065,"California","Riverside County","NHPI_A",7778,7005,-773,-10.46,"undercount"
"880",6065,"California","Riverside County","NHPI_AIC",13884,14670,786,5.51,"overcount"
"881",6067,"California","Sacramento County","A_A",260695,278616,17921,6.65,"overcount"
"882",6067,"California","Sacramento County","A_AIC",303072,322059,18987,6.07,"overcount"
"883",6067,"California","Sacramento County","NHPI_A",17962,19410,1448,7.75,"overcount"
"884",6067,"California","Sacramento County","NHPI_AIC",27490,28994,1504,5.33,"overcount"
"885",6069,"California","San Benito County","A_A",2190,2229,39,1.77,"overcount"
"886",6069,"California","San Benito County","A_AIC",2762,2968,206,7.19,"overcount"
"887",6069,"California","San Benito County","NHPI_A",155,145,-10,-6.67,"undercount"
"888",6069,"California","San Benito County","NHPI_AIC",263,342,79,26.12,"overcount"
"889",6071,"California","San Bernardino County","A_A",168611,178290,9679,5.58,"overcount"
"890",6071,"California","San Bernardino County","A_AIC",190864,201247,10383,5.3,"overcount"
"891",6071,"California","San Bernardino County","NHPI_A",6955,6317,-638,-9.61,"undercount"
"892",6071,"California","San Bernardino County","NHPI_AIC",11742,11925,183,1.55,"overcount"
"893",6073,"California","San Diego County","A_A",404893,404249,-644,-0.16,"undercount"
"894",6073,"California","San Diego County","A_AIC",480731,488904,8173,1.69,"overcount"
"895",6073,"California","San Diego County","NHPI_A",14220,13179,-1041,-7.6,"undercount"
"896",6073,"California","San Diego County","NHPI_AIC",28108,29045,937,3.28,"overcount"
"897",6075,"California","San Francisco County","A_A",310909,296560,-14349,-4.72,"undercount"
"898",6075,"California","San Francisco County","A_AIC",333358,323737,-9621,-2.93,"undercount"
"899",6075,"California","San Francisco County","NHPI_A",3320,3315,-5,-0.15,"undercount"
"900",6075,"California","San Francisco County","NHPI_AIC",6325,6373,48,0.76,"overcount"
"901",6077,"California","San Joaquin County","A_A",126602,135843,9241,7.04,"overcount"
"902",6077,"California","San Joaquin County","A_AIC",143675,150694,7019,4.77,"overcount"
"903",6077,"California","San Joaquin County","NHPI_A",4919,5227,308,6.07,"overcount"
"904",6077,"California","San Joaquin County","NHPI_AIC",8214,8852,638,7.48,"overcount"
"905",6079,"California","San Luis Obispo County","A_A",10309,10086,-223,-2.19,"undercount"
"906",6079,"California","San Luis Obispo County","A_AIC",14283,14831,548,3.76,"overcount"
"907",6079,"California","San Luis Obispo County","NHPI_A",380,342,-38,-10.53,"undercount"
"908",6079,"California","San Luis Obispo County","NHPI_AIC",1034,1252,218,19.07,"overcount"
"909",6081,"California","San Mateo County","A_A",232637,229962,-2675,-1.16,"undercount"
"910",6081,"California","San Mateo County","A_AIC",254735,254287,-448,-0.18,"undercount"
"911",6081,"California","San Mateo County","NHPI_A",9665,9344,-321,-3.38,"undercount"
"912",6081,"California","San Mateo County","NHPI_AIC",13990,13051,-939,-6.95,"undercount"
"913",6083,"California","Santa Barbara County","A_A",24035,25710,1675,6.73,"overcount"
"914",6083,"California","Santa Barbara County","A_AIC",30364,32524,2160,6.87,"overcount"
"915",6083,"California","Santa Barbara County","NHPI_A",796,549,-247,-36.73,"undercount"
"916",6083,"California","Santa Barbara County","NHPI_AIC",1805,1731,-74,-4.19,"undercount"
"917",6085,"California","Santa Clara County","A_A",750900,757909,7009,0.93,"overcount"
"918",6085,"California","Santa Clara County","A_AIC",795849,807249,11400,1.42,"overcount"
"919",6085,"California","Santa Clara County","NHPI_A",7436,6152,-1284,-18.9,"undercount"
"920",6085,"California","Santa Clara County","NHPI_AIC",13932,12655,-1277,-9.61,"undercount"
"921",6087,"California","Santa Cruz County","A_A",12813,12298,-515,-4.1,"undercount"
"922",6087,"California","Santa Cruz County","A_AIC",17601,17589,-12,-0.07,"undercount"
"923",6087,"California","Santa Cruz County","NHPI_A",335,305,-30,-9.38,"undercount"
"924",6087,"California","Santa Cruz County","NHPI_AIC",1156,1235,79,6.61,"overcount"
"925",6089,"California","Shasta County","A_A",5416,5974,558,9.8,"overcount"
"926",6089,"California","Shasta County","A_AIC",7716,8140,424,5.35,"overcount"
"927",6089,"California","Shasta County","NHPI_A",315,328,13,4.04,"overcount"
"928",6089,"California","Shasta County","NHPI_AIC",858,878,20,2.3,"overcount"
"929",6091,"California","Sierra County","A_A",19,7,-12,-92.31,"undercount"
"930",6091,"California","Sierra County","A_AIC",35,37,2,5.56,"overcount"
"931",6091,"California","Sierra County","NHPI_A",4,1,-3,-120,"undercount"
"932",6091,"California","Sierra County","NHPI_AIC",10,19,9,62.07,"overcount"
"933",6093,"California","Siskiyou County","A_A",642,882,240,31.5,"overcount"
"934",6093,"California","Siskiyou County","A_AIC",1159,1284,125,10.23,"overcount"
"935",6093,"California","Siskiyou County","NHPI_A",112,46,-66,-83.54,"undercount"
"936",6093,"California","Siskiyou County","NHPI_AIC",275,204,-71,-29.65,"undercount"
"937",6095,"California","Solano County","A_A",69474,71512,2038,2.89,"overcount"
"938",6095,"California","Solano County","A_AIC",83822,86017,2195,2.58,"overcount"
"939",6095,"California","Solano County","NHPI_A",3882,3918,36,0.92,"overcount"
"940",6095,"California","Solano County","NHPI_AIC",7635,7994,359,4.59,"overcount"
"941",6097,"California","Sonoma County","A_A",21387,22610,1223,5.56,"overcount"
"942",6097,"California","Sonoma County","A_AIC",28664,31027,2363,7.92,"overcount"
"943",6097,"California","Sonoma County","NHPI_A",1579,1750,171,10.27,"overcount"
"944",6097,"California","Sonoma County","NHPI_AIC",3185,3549,364,10.81,"overcount"
"945",6099,"California","Stanislaus County","A_A",30185,33604,3419,10.72,"overcount"
"946",6099,"California","Stanislaus County","A_AIC",38358,41059,2701,6.8,"overcount"
"947",6099,"California","Stanislaus County","NHPI_A",4005,4089,84,2.08,"overcount"
"948",6099,"California","Stanislaus County","NHPI_AIC",6377,6272,-105,-1.66,"undercount"
"949",6101,"California","Sutter County","A_A",16273,18316,2043,11.81,"overcount"
"950",6101,"California","Sutter County","A_AIC",18018,19907,1889,9.96,"overcount"
"951",6101,"California","Sutter County","NHPI_A",292,290,-2,-0.69,"undercount"
"952",6101,"California","Sutter County","NHPI_AIC",644,619,-25,-3.96,"undercount"
"953",6103,"California","Tehama County","A_A",817,999,182,20.04,"overcount"
"954",6103,"California","Tehama County","A_AIC",1299,1463,164,11.88,"overcount"
"955",6103,"California","Tehama County","NHPI_A",111,100,-11,-10.43,"undercount"
"956",6103,"California","Tehama County","NHPI_AIC",240,248,8,3.28,"overcount"
"957",6105,"California","Trinity County","A_A",221,2212,1991,163.67,"overcount"
"958",6105,"California","Trinity County","A_AIC",324,2342,2018,151.39,"overcount"
"959",6105,"California","Trinity County","NHPI_A",29,24,-5,-18.87,"undercount"
"960",6105,"California","Trinity County","NHPI_AIC",67,69,2,2.94,"overcount"
"961",6107,"California","Tulare County","A_A",15759,16322,563,3.51,"overcount"
"962",6107,"California","Tulare County","A_AIC",18921,19203,282,1.48,"overcount"
"963",6107,"California","Tulare County","NHPI_A",474,535,61,12.09,"overcount"
"964",6107,"California","Tulare County","NHPI_AIC",1165,1199,34,2.88,"overcount"
"965",6109,"California","Tuolumne County","A_A",710,779,69,9.27,"overcount"
"966",6109,"California","Tuolumne County","A_AIC",1185,1375,190,14.84,"overcount"
"967",6109,"California","Tuolumne County","NHPI_A",116,115,-1,-0.87,"undercount"
"968",6109,"California","Tuolumne County","NHPI_AIC",234,350,116,39.73,"overcount"
"969",6111,"California","Ventura County","A_A",62823,64109,1286,2.03,"overcount"
"970",6111,"California","Ventura County","A_AIC",75796,78997,3201,4.14,"overcount"
"971",6111,"California","Ventura County","NHPI_A",1561,1493,-68,-4.45,"undercount"
"972",6111,"California","Ventura County","NHPI_AIC",3632,4025,393,10.27,"overcount"
"973",6113,"California","Yolo County","A_A",32242,30182,-2060,-6.6,"undercount"
"974",6113,"California","Yolo County","A_AIC",38533,35999,-2534,-6.8,"undercount"
"975",6113,"California","Yolo County","NHPI_A",890,1147,257,25.23,"overcount"
"976",6113,"California","Yolo County","NHPI_AIC",1925,2023,98,4.96,"overcount"
"977",6115,"California","Yuba County","A_A",5526,5618,92,1.65,"overcount"
"978",6115,"California","Yuba County","A_AIC",7040,7015,-25,-0.36,"undercount"
"979",6115,"California","Yuba County","NHPI_A",371,373,2,0.54,"overcount"
"980",6115,"California","Yuba County","NHPI_AIC",722,745,23,3.14,"overcount"
"981",8001,"Colorado","Adams County","A_A",21808,22771,963,4.32,"overcount"
"982",8001,"Colorado","Adams County","A_AIC",26379,28005,1626,5.98,"overcount"
"983",8001,"Colorado","Adams County","NHPI_A",766,754,-12,-1.58,"undercount"
"984",8001,"Colorado","Adams County","NHPI_AIC",1416,1562,146,9.81,"overcount"
"985",8003,"Colorado","Alamosa County","A_A",159,142,-17,-11.3,"undercount"
"986",8003,"Colorado","Alamosa County","A_AIC",232,211,-21,-9.48,"undercount"
"987",8003,"Colorado","Alamosa County","NHPI_A",11,20,9,58.06,"overcount"
"988",8003,"Colorado","Alamosa County","NHPI_AIC",32,34,2,6.06,"overcount"
"989",8005,"Colorado","Arapahoe County","A_A",42062,42232,170,0.4,"overcount"
"990",8005,"Colorado","Arapahoe County","A_AIC",50595,52743,2148,4.16,"overcount"
"991",8005,"Colorado","Arapahoe County","NHPI_A",1759,1652,-107,-6.27,"undercount"
"992",8005,"Colorado","Arapahoe County","NHPI_AIC",3064,3157,93,2.99,"overcount"
"993",8007,"Colorado","Archuleta County","A_A",119,103,-16,-14.41,"undercount"
"994",8007,"Colorado","Archuleta County","A_AIC",190,208,18,9.05,"overcount"
"995",8007,"Colorado","Archuleta County","NHPI_A",10,6,-4,-50,"undercount"
"996",8007,"Colorado","Archuleta County","NHPI_AIC",28,37,9,27.69,"overcount"
"997",8009,"Colorado","Baca County","A_A",13,8,-5,-47.62,"undercount"
"998",8009,"Colorado","Baca County","A_AIC",26,11,-15,-81.08,"undercount"
"999",8009,"Colorado","Baca County","NHPI_A",0,0,0,0,"equal"
"1000",8009,"Colorado","Baca County","NHPI_AIC",3,2,-1,-40,"undercount"
"1001",8011,"Colorado","Bent County","A_A",69,39,-30,-55.56,"undercount"
"1002",8011,"Colorado","Bent County","A_AIC",81,60,-21,-29.79,"undercount"
"1003",8011,"Colorado","Bent County","NHPI_A",5,0,-5,-200,"undercount"
"1004",8011,"Colorado","Bent County","NHPI_AIC",7,3,-4,-80,"undercount"
"1005",8013,"Colorado","Boulder County","A_A",15841,16470,629,3.89,"overcount"
"1006",8013,"Colorado","Boulder County","A_AIC",20249,21777,1528,7.27,"overcount"
"1007",8013,"Colorado","Boulder County","NHPI_A",174,243,69,33.09,"overcount"
"1008",8013,"Colorado","Boulder County","NHPI_AIC",567,648,81,13.33,"overcount"
"1009",8014,"Colorado","Broomfield County","A_A",4966,5118,152,3.01,"overcount"
"1010",8014,"Colorado","Broomfield County","A_AIC",5985,6482,497,7.97,"overcount"
"1011",8014,"Colorado","Broomfield County","NHPI_A",83,80,-3,-3.68,"undercount"
"1012",8014,"Colorado","Broomfield County","NHPI_AIC",162,210,48,25.81,"overcount"
"1013",8015,"Colorado","Chaffee County","A_A",175,133,-42,-27.27,"undercount"
"1014",8015,"Colorado","Chaffee County","A_AIC",257,258,1,0.39,"overcount"
"1015",8015,"Colorado","Chaffee County","NHPI_A",17,11,-6,-42.86,"undercount"
"1016",8015,"Colorado","Chaffee County","NHPI_AIC",30,35,5,15.38,"overcount"
"1017",8017,"Colorado","Cheyenne County","A_A",36,3,-33,-169.23,"undercount"
"1018",8017,"Colorado","Cheyenne County","A_AIC",41,8,-33,-134.69,"undercount"
"1019",8017,"Colorado","Cheyenne County","NHPI_A",1,0,-1,-200,"undercount"
"1020",8017,"Colorado","Cheyenne County","NHPI_AIC",1,4,3,120,"overcount"
"1021",8019,"Colorado","Clear Creek County","A_A",114,82,-32,-32.65,"undercount"
"1022",8019,"Colorado","Clear Creek County","A_AIC",162,154,-8,-5.06,"undercount"
"1023",8019,"Colorado","Clear Creek County","NHPI_A",4,10,6,85.71,"overcount"
"1024",8019,"Colorado","Clear Creek County","NHPI_AIC",11,17,6,42.86,"overcount"
"1025",8021,"Colorado","Conejos County","A_A",31,21,-10,-38.46,"undercount"
"1026",8021,"Colorado","Conejos County","A_AIC",49,34,-15,-36.14,"undercount"
"1027",8021,"Colorado","Conejos County","NHPI_A",6,2,-4,-100,"undercount"
"1028",8021,"Colorado","Conejos County","NHPI_AIC",7,16,9,78.26,"overcount"
"1029",8023,"Colorado","Costilla County","A_A",50,57,7,13.08,"overcount"
"1030",8023,"Colorado","Costilla County","A_AIC",66,76,10,14.08,"overcount"
"1031",8023,"Colorado","Costilla County","NHPI_A",3,0,-3,-200,"undercount"
"1032",8023,"Colorado","Costilla County","NHPI_AIC",6,4,-2,-40,"undercount"
"1033",8025,"Colorado","Crowley County","A_A",69,69,0,0,"equal"
"1034",8025,"Colorado","Crowley County","A_AIC",82,83,1,1.21,"overcount"
"1035",8025,"Colorado","Crowley County","NHPI_A",1,2,1,66.67,"overcount"
"1036",8025,"Colorado","Crowley County","NHPI_AIC",2,6,4,100,"overcount"
"1037",8027,"Colorado","Custer County","A_A",24,23,-1,-4.26,"undercount"
"1038",8027,"Colorado","Custer County","A_AIC",37,36,-1,-2.74,"undercount"
"1039",8027,"Colorado","Custer County","NHPI_A",1,0,-1,-200,"undercount"
"1040",8027,"Colorado","Custer County","NHPI_AIC",4,12,8,100,"overcount"
"1041",8029,"Colorado","Delta County","A_A",219,237,18,7.89,"overcount"
"1042",8029,"Colorado","Delta County","A_AIC",311,354,43,12.93,"overcount"
"1043",8029,"Colorado","Delta County","NHPI_A",15,9,-6,-50,"undercount"
"1044",8029,"Colorado","Delta County","NHPI_AIC",43,28,-15,-42.25,"undercount"
"1045",8031,"Colorado","Denver County","A_A",28547,27500,-1047,-3.74,"undercount"
"1046",8031,"Colorado","Denver County","A_AIC",35249,37611,2362,6.48,"overcount"
"1047",8031,"Colorado","Denver County","NHPI_A",1188,1412,224,17.23,"overcount"
"1048",8031,"Colorado","Denver County","NHPI_AIC",2156,2528,372,15.88,"overcount"
"1049",8033,"Colorado","Dolores County","A_A",7,6,-1,-15.38,"undercount"
"1050",8033,"Colorado","Dolores County","A_AIC",16,13,-3,-20.69,"undercount"
"1051",8033,"Colorado","Dolores County","NHPI_A",2,5,3,85.71,"overcount"
"1052",8033,"Colorado","Dolores County","NHPI_AIC",5,14,9,94.74,"overcount"
"1053",8035,"Colorado","Douglas County","A_A",19774,19946,172,0.87,"overcount"
"1054",8035,"Colorado","Douglas County","A_AIC",24985,26381,1396,5.44,"overcount"
"1055",8035,"Colorado","Douglas County","NHPI_A",327,295,-32,-10.29,"undercount"
"1056",8035,"Colorado","Douglas County","NHPI_AIC",950,1159,209,19.82,"overcount"
"1057",8037,"Colorado","Eagle County","A_A",696,729,33,4.63,"overcount"
"1058",8037,"Colorado","Eagle County","A_AIC",920,1091,171,17.01,"overcount"
"1059",8037,"Colorado","Eagle County","NHPI_A",22,27,5,20.41,"overcount"
"1060",8037,"Colorado","Eagle County","NHPI_AIC",84,93,9,10.17,"overcount"
"1061",8039,"Colorado","Elbert County","A_A",232,191,-41,-19.39,"undercount"
"1062",8039,"Colorado","Elbert County","A_AIC",388,451,63,15.02,"overcount"
"1063",8039,"Colorado","Elbert County","NHPI_A",37,21,-16,-55.17,"undercount"
"1064",8039,"Colorado","Elbert County","NHPI_AIC",72,62,-10,-14.93,"undercount"
"1065",8041,"Colorado","El Paso County","A_A",21647,21945,298,1.37,"overcount"
"1066",8041,"Colorado","El Paso County","A_AIC",33961,36177,2216,6.32,"overcount"
"1067",8041,"Colorado","El Paso County","NHPI_A",2179,2772,593,23.95,"overcount"
"1068",8041,"Colorado","El Paso County","NHPI_AIC",4558,5761,1203,23.32,"overcount"
"1069",8043,"Colorado","Fremont County","A_A",417,338,-79,-20.93,"undercount"
"1070",8043,"Colorado","Fremont County","A_AIC",565,483,-82,-15.65,"undercount"
"1071",8043,"Colorado","Fremont County","NHPI_A",20,30,10,40,"overcount"
"1072",8043,"Colorado","Fremont County","NHPI_AIC",51,93,42,58.33,"overcount"
"1073",8045,"Colorado","Garfield County","A_A",481,402,-79,-17.89,"undercount"
"1074",8045,"Colorado","Garfield County","A_AIC",710,755,45,6.14,"overcount"
"1075",8045,"Colorado","Garfield County","NHPI_A",50,34,-16,-38.1,"undercount"
"1076",8045,"Colorado","Garfield County","NHPI_AIC",97,107,10,9.8,"overcount"
"1077",8047,"Colorado","Gilpin County","A_A",87,85,-2,-2.33,"undercount"
"1078",8047,"Colorado","Gilpin County","A_AIC",128,146,18,13.14,"overcount"
"1079",8047,"Colorado","Gilpin County","NHPI_A",13,4,-9,-105.88,"undercount"
"1080",8047,"Colorado","Gilpin County","NHPI_AIC",23,36,13,44.07,"overcount"
"1081",8049,"Colorado","Grand County","A_A",129,83,-46,-43.4,"undercount"
"1082",8049,"Colorado","Grand County","A_AIC",186,161,-25,-14.41,"undercount"
"1083",8049,"Colorado","Grand County","NHPI_A",14,17,3,19.35,"overcount"
"1084",8049,"Colorado","Grand County","NHPI_AIC",32,44,12,31.58,"overcount"
"1085",8051,"Colorado","Gunnison County","A_A",138,121,-17,-13.13,"undercount"
"1086",8051,"Colorado","Gunnison County","A_AIC",226,232,6,2.62,"overcount"
"1087",8051,"Colorado","Gunnison County","NHPI_A",4,7,3,54.55,"overcount"
"1088",8051,"Colorado","Gunnison County","NHPI_AIC",23,34,11,38.6,"overcount"
"1089",8053,"Colorado","Hinsdale County","A_A",5,2,-3,-85.71,"undercount"
"1090",8053,"Colorado","Hinsdale County","A_AIC",9,22,13,83.87,"overcount"
"1091",8053,"Colorado","Hinsdale County","NHPI_A",0,1,1,200,"overcount"
"1092",8053,"Colorado","Hinsdale County","NHPI_AIC",0,12,12,200,"overcount"
"1093",8055,"Colorado","Huerfano County","A_A",44,24,-20,-58.82,"undercount"
"1094",8055,"Colorado","Huerfano County","A_AIC",63,60,-3,-4.88,"undercount"
"1095",8055,"Colorado","Huerfano County","NHPI_A",17,0,-17,-200,"undercount"
"1096",8055,"Colorado","Huerfano County","NHPI_AIC",24,4,-20,-142.86,"undercount"
"1097",8057,"Colorado","Jackson County","A_A",9,2,-7,-127.27,"undercount"
"1098",8057,"Colorado","Jackson County","A_AIC",10,9,-1,-10.53,"undercount"
"1099",8057,"Colorado","Jackson County","NHPI_A",0,2,2,200,"overcount"
"1100",8057,"Colorado","Jackson County","NHPI_AIC",1,6,5,142.86,"overcount"
"1101",8059,"Colorado","Jefferson County","A_A",17564,17881,317,1.79,"overcount"
"1102",8059,"Colorado","Jefferson County","A_AIC",22843,24846,2003,8.4,"overcount"
"1103",8059,"Colorado","Jefferson County","NHPI_A",561,479,-82,-15.77,"undercount"
"1104",8059,"Colorado","Jefferson County","NHPI_AIC",1271,1328,57,4.39,"overcount"
"1105",8061,"Colorado","Kiowa County","A_A",7,9,2,25,"overcount"
"1106",8061,"Colorado","Kiowa County","A_AIC",11,21,10,62.5,"overcount"
"1107",8061,"Colorado","Kiowa County","NHPI_A",1,1,0,0,"equal"
"1108",8061,"Colorado","Kiowa County","NHPI_AIC",2,9,7,127.27,"overcount"
"1109",8063,"Colorado","Kit Carson County","A_A",56,30,-26,-60.47,"undercount"
"1110",8063,"Colorado","Kit Carson County","A_AIC",71,65,-6,-8.82,"undercount"
"1111",8063,"Colorado","Kit Carson County","NHPI_A",6,5,-1,-18.18,"undercount"
"1112",8063,"Colorado","Kit Carson County","NHPI_AIC",13,10,-3,-26.09,"undercount"
"1113",8065,"Colorado","Lake County","A_A",67,63,-4,-6.15,"undercount"
"1114",8065,"Colorado","Lake County","A_AIC",88,110,22,22.22,"overcount"
"1115",8065,"Colorado","Lake County","NHPI_A",5,8,3,46.15,"overcount"
"1116",8065,"Colorado","Lake County","NHPI_AIC",12,17,5,34.48,"overcount"
"1117",8067,"Colorado","La Plata County","A_A",362,389,27,7.19,"overcount"
"1118",8067,"Colorado","La Plata County","A_AIC",609,747,138,20.35,"overcount"
"1119",8067,"Colorado","La Plata County","NHPI_A",48,33,-15,-37.04,"undercount"
"1120",8067,"Colorado","La Plata County","NHPI_AIC",102,92,-10,-10.31,"undercount"
"1121",8069,"Colorado","Larimer County","A_A",8132,8575,443,5.3,"overcount"
"1122",8069,"Colorado","Larimer County","A_AIC",11723,12765,1042,8.51,"overcount"
"1123",8069,"Colorado","Larimer County","NHPI_A",263,298,35,12.48,"overcount"
"1124",8069,"Colorado","Larimer County","NHPI_AIC",750,927,177,21.11,"overcount"
"1125",8071,"Colorado","Las Animas County","A_A",191,108,-83,-55.52,"undercount"
"1126",8071,"Colorado","Las Animas County","A_AIC",234,164,-70,-35.18,"undercount"
"1127",8071,"Colorado","Las Animas County","NHPI_A",8,12,4,40,"overcount"
"1128",8071,"Colorado","Las Animas County","NHPI_AIC",22,41,19,60.32,"overcount"
"1129",8073,"Colorado","Lincoln County","A_A",52,40,-12,-26.09,"undercount"
"1130",8073,"Colorado","Lincoln County","A_AIC",73,58,-15,-22.9,"undercount"
"1131",8073,"Colorado","Lincoln County","NHPI_A",10,22,12,75,"overcount"
"1132",8073,"Colorado","Lincoln County","NHPI_AIC",16,36,20,76.92,"overcount"
"1133",8075,"Colorado","Logan County","A_A",175,130,-45,-29.51,"undercount"
"1134",8075,"Colorado","Logan County","A_AIC",220,225,5,2.25,"overcount"
"1135",8075,"Colorado","Logan County","NHPI_A",18,18,0,0,"equal"
"1136",8075,"Colorado","Logan County","NHPI_AIC",30,33,3,9.52,"overcount"
"1137",8077,"Colorado","Mesa County","A_A",1423,1645,222,14.47,"overcount"
"1138",8077,"Colorado","Mesa County","A_AIC",2331,2780,449,17.57,"overcount"
"1139",8077,"Colorado","Mesa County","NHPI_A",164,189,25,14.16,"overcount"
"1140",8077,"Colorado","Mesa County","NHPI_AIC",366,479,113,26.75,"overcount"
"1141",8079,"Colorado","Mineral County","A_A",5,3,-2,-50,"undercount"
"1142",8079,"Colorado","Mineral County","A_AIC",8,7,-1,-13.33,"undercount"
"1143",8079,"Colorado","Mineral County","NHPI_A",0,0,0,0,"equal"
"1144",8079,"Colorado","Mineral County","NHPI_AIC",2,6,4,100,"overcount"
"1145",8081,"Colorado","Moffat County","A_A",94,52,-42,-57.53,"undercount"
"1146",8081,"Colorado","Moffat County","A_AIC",161,113,-48,-35.04,"undercount"
"1147",8081,"Colorado","Moffat County","NHPI_A",11,2,-9,-138.46,"undercount"
"1148",8081,"Colorado","Moffat County","NHPI_AIC",30,13,-17,-79.07,"undercount"
"1149",8083,"Colorado","Montezuma County","A_A",150,128,-22,-15.83,"undercount"
"1150",8083,"Colorado","Montezuma County","A_AIC",264,245,-19,-7.47,"undercount"
"1151",8083,"Colorado","Montezuma County","NHPI_A",18,24,6,28.57,"overcount"
"1152",8083,"Colorado","Montezuma County","NHPI_AIC",43,70,27,47.79,"overcount"
"1153",8085,"Colorado","Montrose County","A_A",297,345,48,14.95,"overcount"
"1154",8085,"Colorado","Montrose County","A_AIC",471,536,65,12.91,"overcount"
"1155",8085,"Colorado","Montrose County","NHPI_A",52,27,-25,-63.29,"undercount"
"1156",8085,"Colorado","Montrose County","NHPI_AIC",85,90,5,5.71,"overcount"
"1157",8087,"Colorado","Morgan County","A_A",180,160,-20,-11.76,"undercount"
"1158",8087,"Colorado","Morgan County","A_AIC",252,248,-4,-1.6,"undercount"
"1159",8087,"Colorado","Morgan County","NHPI_A",51,11,-40,-129.03,"undercount"
"1160",8087,"Colorado","Morgan County","NHPI_AIC",75,16,-59,-129.67,"undercount"
"1161",8089,"Colorado","Otero County","A_A",139,99,-40,-33.61,"undercount"
"1162",8089,"Colorado","Otero County","A_AIC",205,157,-48,-26.52,"undercount"
"1163",8089,"Colorado","Otero County","NHPI_A",14,28,14,66.67,"overcount"
"1164",8089,"Colorado","Otero County","NHPI_AIC",31,42,11,30.14,"overcount"
"1165",8091,"Colorado","Ouray County","A_A",37,28,-9,-27.69,"undercount"
"1166",8091,"Colorado","Ouray County","A_AIC",56,55,-1,-1.8,"undercount"
"1167",8091,"Colorado","Ouray County","NHPI_A",9,2,-7,-127.27,"undercount"
"1168",8091,"Colorado","Ouray County","NHPI_AIC",12,7,-5,-52.63,"undercount"
"1169",8093,"Colorado","Park County","A_A",164,99,-65,-49.43,"undercount"
"1170",8093,"Colorado","Park County","A_AIC",286,229,-57,-22.14,"undercount"
"1171",8093,"Colorado","Park County","NHPI_A",7,9,2,25,"overcount"
"1172",8093,"Colorado","Park County","NHPI_AIC",30,31,1,3.28,"overcount"
"1173",8095,"Colorado","Phillips County","A_A",25,22,-3,-12.77,"undercount"
"1174",8095,"Colorado","Phillips County","A_AIC",34,44,10,25.64,"overcount"
"1175",8095,"Colorado","Phillips County","NHPI_A",4,1,-3,-120,"undercount"
"1176",8095,"Colorado","Phillips County","NHPI_AIC",8,10,2,22.22,"overcount"
"1177",8097,"Colorado","Pitkin County","A_A",343,283,-60,-19.17,"undercount"
"1178",8097,"Colorado","Pitkin County","A_AIC",450,451,1,0.22,"overcount"
"1179",8097,"Colorado","Pitkin County","NHPI_A",16,7,-9,-78.26,"undercount"
"1180",8097,"Colorado","Pitkin County","NHPI_AIC",39,31,-8,-22.86,"undercount"
"1181",8099,"Colorado","Prowers County","A_A",59,35,-24,-51.06,"undercount"
"1182",8099,"Colorado","Prowers County","A_AIC",89,48,-41,-59.85,"undercount"
"1183",8099,"Colorado","Prowers County","NHPI_A",5,6,1,18.18,"overcount"
"1184",8099,"Colorado","Prowers County","NHPI_AIC",18,14,-4,-25,"undercount"
"1185",8101,"Colorado","Pueblo County","A_A",1548,1653,105,6.56,"overcount"
"1186",8101,"Colorado","Pueblo County","A_AIC",2309,2470,161,6.74,"overcount"
"1187",8101,"Colorado","Pueblo County","NHPI_A",144,149,5,3.41,"overcount"
"1188",8101,"Colorado","Pueblo County","NHPI_AIC",330,362,32,9.25,"overcount"
"1189",8103,"Colorado","Rio Blanco County","A_A",47,24,-23,-64.79,"undercount"
"1190",8103,"Colorado","Rio Blanco County","A_AIC",86,57,-29,-40.56,"undercount"
"1191",8103,"Colorado","Rio Blanco County","NHPI_A",10,4,-6,-85.71,"undercount"
"1192",8103,"Colorado","Rio Blanco County","NHPI_AIC",21,12,-9,-54.55,"undercount"
"1193",8105,"Colorado","Rio Grande County","A_A",50,36,-14,-32.56,"undercount"
"1194",8105,"Colorado","Rio Grande County","A_AIC",86,81,-5,-5.99,"undercount"
"1195",8105,"Colorado","Rio Grande County","NHPI_A",9,8,-1,-11.76,"undercount"
"1196",8105,"Colorado","Rio Grande County","NHPI_AIC",20,30,10,40,"overcount"
"1197",8107,"Colorado","Routt County","A_A",219,177,-42,-21.21,"undercount"
"1198",8107,"Colorado","Routt County","A_AIC",344,360,16,4.55,"overcount"
"1199",8107,"Colorado","Routt County","NHPI_A",20,37,17,59.65,"overcount"
"1200",8107,"Colorado","Routt County","NHPI_AIC",52,77,25,38.76,"overcount"
"1201",8109,"Colorado","Saguache County","A_A",55,63,8,13.56,"overcount"
"1202",8109,"Colorado","Saguache County","A_AIC",84,92,8,9.09,"overcount"
"1203",8109,"Colorado","Saguache County","NHPI_A",2,2,0,0,"equal"
"1204",8109,"Colorado","Saguache County","NHPI_AIC",10,17,7,51.85,"overcount"
"1205",8111,"Colorado","San Juan County","A_A",5,2,-3,-85.71,"undercount"
"1206",8111,"Colorado","San Juan County","A_AIC",5,9,4,57.14,"overcount"
"1207",8111,"Colorado","San Juan County","NHPI_A",0,0,0,0,"equal"
"1208",8111,"Colorado","San Juan County","NHPI_AIC",1,5,4,133.33,"overcount"
"1209",8113,"Colorado","San Miguel County","A_A",74,56,-18,-27.69,"undercount"
"1210",8113,"Colorado","San Miguel County","A_AIC",107,94,-13,-12.94,"undercount"
"1211",8113,"Colorado","San Miguel County","NHPI_A",4,0,-4,-200,"undercount"
"1212",8113,"Colorado","San Miguel County","NHPI_AIC",14,10,-4,-33.33,"undercount"
"1213",8115,"Colorado","Sedgwick County","A_A",18,12,-6,-40,"undercount"
"1214",8115,"Colorado","Sedgwick County","A_AIC",25,29,4,14.81,"overcount"
"1215",8115,"Colorado","Sedgwick County","NHPI_A",0,0,0,0,"equal"
"1216",8115,"Colorado","Sedgwick County","NHPI_AIC",1,8,7,155.56,"overcount"
"1217",8117,"Colorado","Summit County","A_A",396,412,16,3.96,"overcount"
"1218",8117,"Colorado","Summit County","A_AIC",546,721,175,27.62,"overcount"
"1219",8117,"Colorado","Summit County","NHPI_A",27,20,-7,-29.79,"undercount"
"1220",8117,"Colorado","Summit County","NHPI_AIC",54,86,32,45.71,"overcount"
"1221",8119,"Colorado","Teller County","A_A",254,202,-52,-22.81,"undercount"
"1222",8119,"Colorado","Teller County","A_AIC",427,389,-38,-9.31,"undercount"
"1223",8119,"Colorado","Teller County","NHPI_A",26,12,-14,-73.68,"undercount"
"1224",8119,"Colorado","Teller County","NHPI_AIC",53,54,1,1.87,"overcount"
"1225",8121,"Colorado","Washington County","A_A",13,15,2,14.29,"overcount"
"1226",8121,"Colorado","Washington County","A_AIC",25,30,5,18.18,"overcount"
"1227",8121,"Colorado","Washington County","NHPI_A",1,10,9,163.64,"overcount"
"1228",8121,"Colorado","Washington County","NHPI_AIC",5,13,8,88.89,"overcount"
"1229",8123,"Colorado","Weld County","A_A",5734,5748,14,0.24,"overcount"
"1230",8123,"Colorado","Weld County","A_AIC",7783,8419,636,7.85,"overcount"
"1231",8123,"Colorado","Weld County","NHPI_A",331,311,-20,-6.23,"undercount"
"1232",8123,"Colorado","Weld County","NHPI_AIC",678,852,174,22.75,"overcount"
"1233",8125,"Colorado","Yuma County","A_A",32,26,-6,-20.69,"undercount"
"1234",8125,"Colorado","Yuma County","A_AIC",45,41,-4,-9.3,"undercount"
"1235",8125,"Colorado","Yuma County","NHPI_A",3,3,0,0,"equal"
"1236",8125,"Colorado","Yuma County","NHPI_AIC",6,11,5,58.82,"overcount"
"1237",9001,"Connecticut","Fairfield County","A_A",54537,51779,-2758,-5.19,"undercount"
"1238",9001,"Connecticut","Fairfield County","A_AIC",60801,60756,-45,-0.07,"undercount"
"1239",9001,"Connecticut","Fairfield County","NHPI_A",345,224,-121,-42.53,"undercount"
"1240",9001,"Connecticut","Fairfield County","NHPI_AIC",1287,771,-516,-50.15,"undercount"
"1241",9003,"Connecticut","Hartford County","A_A",53950,54142,192,0.36,"overcount"
"1242",9003,"Connecticut","Hartford County","A_AIC",58979,60742,1763,2.95,"overcount"
"1243",9003,"Connecticut","Hartford County","NHPI_A",285,247,-38,-14.29,"undercount"
"1244",9003,"Connecticut","Hartford County","NHPI_AIC",931,811,-120,-13.78,"undercount"
"1245",9005,"Connecticut","Litchfield County","A_A",3800,3528,-272,-7.42,"undercount"
"1246",9005,"Connecticut","Litchfield County","A_AIC",4617,4686,69,1.48,"overcount"
"1247",9005,"Connecticut","Litchfield County","NHPI_A",76,64,-12,-17.14,"undercount"
"1248",9005,"Connecticut","Litchfield County","NHPI_AIC",188,170,-18,-10.06,"undercount"
"1249",9007,"Connecticut","Middlesex County","A_A",5276,4982,-294,-5.73,"undercount"
"1250",9007,"Connecticut","Middlesex County","A_AIC",6368,6242,-126,-2,"undercount"
"1251",9007,"Connecticut","Middlesex County","NHPI_A",59,45,-14,-26.92,"undercount"
"1252",9007,"Connecticut","Middlesex County","NHPI_AIC",213,185,-28,-14.07,"undercount"
"1253",9009,"Connecticut","New Haven County","A_A",36284,37746,1462,3.95,"overcount"
"1254",9009,"Connecticut","New Haven County","A_AIC",40972,43583,2611,6.18,"overcount"
"1255",9009,"Connecticut","New Haven County","NHPI_A",285,334,49,15.83,"overcount"
"1256",9009,"Connecticut","New Haven County","NHPI_AIC",820,806,-14,-1.72,"undercount"
"1257",9011,"Connecticut","New London County","A_A",10950,10768,-182,-1.68,"undercount"
"1258",9011,"Connecticut","New London County","A_AIC",13549,13636,87,0.64,"overcount"
"1259",9011,"Connecticut","New London County","NHPI_A",196,232,36,16.82,"overcount"
"1260",9011,"Connecticut","New London County","NHPI_AIC",560,827,267,38.5,"overcount"
"1261",9013,"Connecticut","Tolland County","A_A",7676,8560,884,10.89,"overcount"
"1262",9013,"Connecticut","Tolland County","A_AIC",8815,9782,967,10.4,"overcount"
"1263",9013,"Connecticut","Tolland County","NHPI_A",45,48,3,6.45,"overcount"
"1264",9013,"Connecticut","Tolland County","NHPI_AIC",173,175,2,1.15,"overcount"
"1265",9015,"Connecticut","Windham County","A_A",1588,1983,395,22.12,"overcount"
"1266",9015,"Connecticut","Windham County","A_AIC",2106,2716,610,25.3,"overcount"
"1267",9015,"Connecticut","Windham County","NHPI_A",48,17,-31,-95.38,"undercount"
"1268",9015,"Connecticut","Windham County","NHPI_AIC",152,120,-32,-23.53,"undercount"
"1269",10001,"Delaware","Kent County","A_A",4243,4450,207,4.76,"overcount"
"1270",10001,"Delaware","Kent County","A_AIC",5988,6190,202,3.32,"overcount"
"1271",10001,"Delaware","Kent County","NHPI_A",103,115,12,11.01,"overcount"
"1272",10001,"Delaware","Kent County","NHPI_AIC",480,367,-113,-26.68,"undercount"
"1273",10003,"Delaware","New Castle County","A_A",33349,35302,1953,5.69,"overcount"
"1274",10003,"Delaware","New Castle County","A_AIC",37209,39895,2686,6.97,"overcount"
"1275",10003,"Delaware","New Castle County","NHPI_A",146,144,-2,-1.38,"undercount"
"1276",10003,"Delaware","New Castle County","NHPI_AIC",456,607,151,28.41,"overcount"
"1277",10005,"Delaware","Sussex County","A_A",3181,3090,-91,-2.9,"undercount"
"1278",10005,"Delaware","Sussex County","A_AIC",3990,4160,170,4.17,"overcount"
"1279",10005,"Delaware","Sussex County","NHPI_A",93,100,7,7.25,"overcount"
"1280",10005,"Delaware","Sussex County","NHPI_AIC",260,284,24,8.82,"overcount"
"1281",11001,"District of Columbia","District of Columbia","A_A",31361,33647,2286,7.03,"overcount"
"1282",11001,"District of Columbia","District of Columbia","A_AIC",38932,44516,5584,13.38,"overcount"
"1283",11001,"District of Columbia","District of Columbia","NHPI_A",326,352,26,7.67,"overcount"
"1284",11001,"District of Columbia","District of Columbia","NHPI_AIC",1108,1139,31,2.76,"overcount"
"1285",12001,"Florida","Alachua County","A_A",16350,18138,1788,10.37,"overcount"
"1286",12001,"Florida","Alachua County","A_AIC",19359,21731,2372,11.55,"overcount"
"1287",12001,"Florida","Alachua County","NHPI_A",141,106,-35,-28.34,"undercount"
"1288",12001,"Florida","Alachua County","NHPI_AIC",436,393,-43,-10.37,"undercount"
"1289",12003,"Florida","Baker County","A_A",211,159,-52,-28.11,"undercount"
"1290",12003,"Florida","Baker County","A_AIC",286,258,-28,-10.29,"undercount"
"1291",12003,"Florida","Baker County","NHPI_A",7,14,7,66.67,"overcount"
"1292",12003,"Florida","Baker County","NHPI_AIC",29,41,12,34.29,"overcount"
"1293",12005,"Florida","Bay County","A_A",3937,4113,176,4.37,"overcount"
"1294",12005,"Florida","Bay County","A_AIC",5981,6307,326,5.31,"overcount"
"1295",12005,"Florida","Bay County","NHPI_A",216,194,-22,-10.73,"undercount"
"1296",12005,"Florida","Bay County","NHPI_AIC",509,569,60,11.13,"overcount"
"1297",12007,"Florida","Bradford County","A_A",178,139,-39,-24.61,"undercount"
"1298",12007,"Florida","Bradford County","A_AIC",277,233,-44,-17.25,"undercount"
"1299",12007,"Florida","Bradford County","NHPI_A",6,12,6,66.67,"overcount"
"1300",12007,"Florida","Bradford County","NHPI_AIC",48,30,-18,-46.15,"undercount"
"1301",12009,"Florida","Brevard County","A_A",15653,15839,186,1.18,"overcount"
"1302",12009,"Florida","Brevard County","A_AIC",21417,22549,1132,5.15,"overcount"
"1303",12009,"Florida","Brevard County","NHPI_A",417,498,81,17.7,"overcount"
"1304",12009,"Florida","Brevard County","NHPI_AIC",1300,1455,155,11.25,"overcount"
"1305",12011,"Florida","Broward County","A_A",73280,76607,3327,4.44,"overcount"
"1306",12011,"Florida","Broward County","A_AIC",87458,91468,4010,4.48,"overcount"
"1307",12011,"Florida","Broward County","NHPI_A",1250,984,-266,-23.81,"undercount"
"1308",12011,"Florida","Broward County","NHPI_AIC",5167,3030,-2137,-52.14,"undercount"
"1309",12013,"Florida","Calhoun County","A_A",107,48,-59,-76.13,"undercount"
"1310",12013,"Florida","Calhoun County","A_AIC",152,125,-27,-19.49,"undercount"
"1311",12013,"Florida","Calhoun County","NHPI_A",8,0,-8,-200,"undercount"
"1312",12013,"Florida","Calhoun County","NHPI_AIC",18,57,39,104,"overcount"
"1313",12015,"Florida","Charlotte County","A_A",2714,2617,-97,-3.64,"undercount"
"1314",12015,"Florida","Charlotte County","A_AIC",3497,3532,35,1,"overcount"
"1315",12015,"Florida","Charlotte County","NHPI_A",98,106,8,7.84,"overcount"
"1316",12015,"Florida","Charlotte County","NHPI_AIC",278,261,-17,-6.31,"undercount"
"1317",12017,"Florida","Citrus County","A_A",2542,2466,-76,-3.04,"undercount"
"1318",12017,"Florida","Citrus County","A_AIC",3101,3151,50,1.6,"overcount"
"1319",12017,"Florida","Citrus County","NHPI_A",59,46,-13,-24.76,"undercount"
"1320",12017,"Florida","Citrus County","NHPI_AIC",204,179,-25,-13.05,"undercount"
"1321",12019,"Florida","Clay County","A_A",6666,6704,38,0.57,"overcount"
"1322",12019,"Florida","Clay County","A_AIC",9520,9611,91,0.95,"overcount"
"1323",12019,"Florida","Clay County","NHPI_A",271,367,96,30.09,"overcount"
"1324",12019,"Florida","Clay County","NHPI_AIC",657,858,201,26.53,"overcount"
"1325",12021,"Florida","Collier County","A_A",5885,5503,-382,-6.71,"undercount"
"1326",12021,"Florida","Collier County","A_AIC",7252,7138,-114,-1.58,"undercount"
"1327",12021,"Florida","Collier County","NHPI_A",121,80,-41,-40.8,"undercount"
"1328",12021,"Florida","Collier County","NHPI_AIC",721,308,-413,-80.27,"undercount"
"1329",12023,"Florida","Columbia County","A_A",725,880,155,19.31,"overcount"
"1330",12023,"Florida","Columbia County","A_AIC",954,1122,168,16.18,"overcount"
"1331",12023,"Florida","Columbia County","NHPI_A",48,27,-21,-56,"undercount"
"1332",12023,"Florida","Columbia County","NHPI_AIC",117,65,-52,-57.14,"undercount"
"1333",12027,"Florida","DeSoto County","A_A",199,199,0,0,"equal"
"1334",12027,"Florida","DeSoto County","A_AIC",248,254,6,2.39,"overcount"
"1335",12027,"Florida","DeSoto County","NHPI_A",7,8,1,13.33,"overcount"
"1336",12027,"Florida","DeSoto County","NHPI_AIC",31,37,6,17.65,"overcount"
"1337",12029,"Florida","Dixie County","A_A",71,78,7,9.4,"overcount"
"1338",12029,"Florida","Dixie County","A_AIC",98,114,16,15.09,"overcount"
"1339",12029,"Florida","Dixie County","NHPI_A",5,0,-5,-200,"undercount"
"1340",12029,"Florida","Dixie County","NHPI_AIC",23,18,-5,-24.39,"undercount"
"1341",12031,"Florida","Duval County","A_A",47406,49291,1885,3.9,"overcount"
"1342",12031,"Florida","Duval County","A_AIC",58300,61315,3015,5.04,"overcount"
"1343",12031,"Florida","Duval County","NHPI_A",769,988,219,24.93,"overcount"
"1344",12031,"Florida","Duval County","NHPI_AIC",2407,2660,253,9.99,"overcount"
"1345",12033,"Florida","Escambia County","A_A",10413,9970,-443,-4.35,"undercount"
"1346",12033,"Florida","Escambia County","A_AIC",14852,14401,-451,-3.08,"undercount"
"1347",12033,"Florida","Escambia County","NHPI_A",523,424,-99,-20.91,"undercount"
"1348",12033,"Florida","Escambia County","NHPI_AIC",1272,1137,-135,-11.21,"undercount"
"1349",12035,"Florida","Flagler County","A_A",2848,2489,-359,-13.45,"undercount"
"1350",12035,"Florida","Flagler County","A_AIC",3558,3317,-241,-7.01,"undercount"
"1351",12035,"Florida","Flagler County","NHPI_A",71,64,-7,-10.37,"undercount"
"1352",12035,"Florida","Flagler County","NHPI_AIC",248,175,-73,-34.52,"undercount"
"1353",12037,"Florida","Franklin County","A_A",44,34,-10,-25.64,"undercount"
"1354",12037,"Florida","Franklin County","A_AIC",63,55,-8,-13.56,"undercount"
"1355",12037,"Florida","Franklin County","NHPI_A",3,4,1,28.57,"overcount"
"1356",12037,"Florida","Franklin County","NHPI_AIC",19,11,-8,-53.33,"undercount"
"1357",12039,"Florida","Gadsden County","A_A",275,161,-114,-52.29,"undercount"
"1358",12039,"Florida","Gadsden County","A_AIC",355,260,-95,-30.89,"undercount"
"1359",12039,"Florida","Gadsden County","NHPI_A",14,7,-7,-66.67,"undercount"
"1360",12039,"Florida","Gadsden County","NHPI_AIC",53,33,-20,-46.51,"undercount"
"1361",12041,"Florida","Gilchrist County","A_A",101,64,-37,-44.85,"undercount"
"1362",12041,"Florida","Gilchrist County","A_AIC",130,149,19,13.62,"overcount"
"1363",12041,"Florida","Gilchrist County","NHPI_A",6,4,-2,-40,"undercount"
"1364",12041,"Florida","Gilchrist County","NHPI_AIC",22,21,-1,-4.65,"undercount"
"1365",12043,"Florida","Glades County","A_A",65,34,-31,-62.63,"undercount"
"1366",12043,"Florida","Glades County","A_AIC",86,72,-14,-17.72,"undercount"
"1367",12043,"Florida","Glades County","NHPI_A",14,0,-14,-200,"undercount"
"1368",12043,"Florida","Glades County","NHPI_AIC",22,12,-10,-58.82,"undercount"
"1369",12045,"Florida","Gulf County","A_A",75,59,-16,-23.88,"undercount"
"1370",12045,"Florida","Gulf County","A_AIC",112,100,-12,-11.32,"undercount"
"1371",12045,"Florida","Gulf County","NHPI_A",4,0,-4,-200,"undercount"
"1372",12045,"Florida","Gulf County","NHPI_AIC",17,16,-1,-6.06,"undercount"
"1373",12047,"Florida","Hamilton County","A_A",90,45,-45,-66.67,"undercount"
"1374",12047,"Florida","Hamilton County","A_AIC",127,108,-19,-16.17,"undercount"
"1375",12047,"Florida","Hamilton County","NHPI_A",0,0,0,0,"equal"
"1376",12047,"Florida","Hamilton County","NHPI_AIC",13,16,3,20.69,"overcount"
"1377",12049,"Florida","Hardee County","A_A",246,167,-79,-38.26,"undercount"
"1378",12049,"Florida","Hardee County","A_AIC",301,212,-89,-34.7,"undercount"
"1379",12049,"Florida","Hardee County","NHPI_A",19,3,-16,-145.45,"undercount"
"1380",12049,"Florida","Hardee County","NHPI_AIC",42,12,-30,-111.11,"undercount"
"1381",12051,"Florida","Hendry County","A_A",348,362,14,3.94,"overcount"
"1382",12051,"Florida","Hendry County","A_AIC",417,449,32,7.39,"overcount"
"1383",12051,"Florida","Hendry County","NHPI_A",26,4,-22,-146.67,"undercount"
"1384",12051,"Florida","Hendry County","NHPI_AIC",48,38,-10,-23.26,"undercount"
"1385",12053,"Florida","Hernando County","A_A",2754,2627,-127,-4.72,"undercount"
"1386",12053,"Florida","Hernando County","A_AIC",3654,3723,69,1.87,"overcount"
"1387",12053,"Florida","Hernando County","NHPI_A",123,101,-22,-19.64,"undercount"
"1388",12053,"Florida","Hernando County","NHPI_AIC",323,302,-21,-6.72,"undercount"
"1389",12055,"Florida","Highlands County","A_A",1588,1623,35,2.18,"overcount"
"1390",12055,"Florida","Highlands County","A_AIC",1901,1956,55,2.85,"overcount"
"1391",12055,"Florida","Highlands County","NHPI_A",52,60,8,14.29,"overcount"
"1392",12055,"Florida","Highlands County","NHPI_AIC",157,151,-6,-3.9,"undercount"
"1393",12057,"Florida","Hillsborough County","A_A",66112,71024,4912,7.16,"overcount"
"1394",12057,"Florida","Hillsborough County","A_AIC",78013,85518,7505,9.18,"overcount"
"1395",12057,"Florida","Hillsborough County","NHPI_A",1065,1008,-57,-5.5,"undercount"
"1396",12057,"Florida","Hillsborough County","NHPI_AIC",2951,2722,-229,-8.07,"undercount"
"1397",12059,"Florida","Holmes County","A_A",126,82,-44,-42.31,"undercount"
"1398",12059,"Florida","Holmes County","A_AIC",170,142,-28,-17.95,"undercount"
"1399",12059,"Florida","Holmes County","NHPI_A",27,13,-14,-70,"undercount"
"1400",12059,"Florida","Holmes County","NHPI_AIC",46,36,-10,-24.39,"undercount"
"1401",12061,"Florida","Indian River County","A_A",2598,2365,-233,-9.39,"undercount"
"1402",12061,"Florida","Indian River County","A_AIC",3210,3113,-97,-3.07,"undercount"
"1403",12061,"Florida","Indian River County","NHPI_A",64,52,-12,-20.69,"undercount"
"1404",12061,"Florida","Indian River County","NHPI_AIC",215,157,-58,-31.18,"undercount"
"1405",12063,"Florida","Jackson County","A_A",294,295,1,0.34,"overcount"
"1406",12063,"Florida","Jackson County","A_AIC",421,411,-10,-2.4,"undercount"
"1407",12063,"Florida","Jackson County","NHPI_A",55,18,-37,-101.37,"undercount"
"1408",12063,"Florida","Jackson County","NHPI_AIC",109,62,-47,-54.97,"undercount"
"1409",12065,"Florida","Jefferson County","A_A",96,34,-62,-95.38,"undercount"
"1410",12065,"Florida","Jefferson County","A_AIC",127,111,-16,-13.45,"undercount"
"1411",12065,"Florida","Jefferson County","NHPI_A",4,3,-1,-28.57,"undercount"
"1412",12065,"Florida","Jefferson County","NHPI_AIC",18,23,5,24.39,"overcount"
"1413",12067,"Florida","Lafayette County","A_A",26,10,-16,-88.89,"undercount"
"1414",12067,"Florida","Lafayette County","A_AIC",47,22,-25,-72.46,"undercount"
"1415",12067,"Florida","Lafayette County","NHPI_A",5,1,-4,-133.33,"undercount"
"1416",12067,"Florida","Lafayette County","NHPI_AIC",11,13,2,16.67,"overcount"
"1417",12069,"Florida","Lake County","A_A",8353,9014,661,7.61,"overcount"
"1418",12069,"Florida","Lake County","A_AIC",10239,11451,1212,11.18,"overcount"
"1419",12069,"Florida","Lake County","NHPI_A",419,403,-16,-3.89,"undercount"
"1420",12069,"Florida","Lake County","NHPI_AIC",815,838,23,2.78,"overcount"
"1421",12071,"Florida","Lee County","A_A",13350,13062,-288,-2.18,"undercount"
"1422",12071,"Florida","Lee County","A_AIC",16761,16829,68,0.4,"overcount"
"1423",12071,"Florida","Lee County","NHPI_A",301,251,-50,-18.12,"undercount"
"1424",12071,"Florida","Lee County","NHPI_AIC",1071,719,-352,-39.33,"undercount"
"1425",12073,"Florida","Leon County","A_A",10481,10549,68,0.65,"overcount"
"1426",12073,"Florida","Leon County","A_AIC",12847,13297,450,3.44,"overcount"
"1427",12073,"Florida","Leon County","NHPI_A",135,165,30,20,"overcount"
"1428",12073,"Florida","Leon County","NHPI_AIC",446,454,8,1.78,"overcount"
"1429",12075,"Florida","Levy County","A_A",360,307,-53,-15.89,"undercount"
"1430",12075,"Florida","Levy County","A_AIC",461,461,0,0,"equal"
"1431",12075,"Florida","Levy County","NHPI_A",24,11,-13,-74.29,"undercount"
"1432",12075,"Florida","Levy County","NHPI_AIC",59,45,-14,-26.92,"undercount"
"1433",12077,"Florida","Liberty County","A_A",28,18,-10,-43.48,"undercount"
"1434",12077,"Florida","Liberty County","A_AIC",53,43,-10,-20.83,"undercount"
"1435",12077,"Florida","Liberty County","NHPI_A",2,1,-1,-66.67,"undercount"
"1436",12077,"Florida","Liberty County","NHPI_AIC",3,16,13,136.84,"overcount"
"1437",12079,"Florida","Madison County","A_A",82,46,-36,-56.25,"undercount"
"1438",12079,"Florida","Madison County","A_AIC",117,97,-20,-18.69,"undercount"
"1439",12079,"Florida","Madison County","NHPI_A",4,0,-4,-200,"undercount"
"1440",12079,"Florida","Madison County","NHPI_AIC",21,21,0,0,"equal"
"1441",12081,"Florida","Manatee County","A_A",9264,8501,-763,-8.59,"undercount"
"1442",12081,"Florida","Manatee County","A_AIC",11096,10789,-307,-2.81,"undercount"
"1443",12081,"Florida","Manatee County","NHPI_A",226,255,29,12.06,"overcount"
"1444",12081,"Florida","Manatee County","NHPI_AIC",590,561,-29,-5.04,"undercount"
"1445",12083,"Florida","Marion County","A_A",6499,6175,-324,-5.11,"undercount"
"1446",12083,"Florida","Marion County","A_AIC",8030,8020,-10,-0.12,"undercount"
"1447",12083,"Florida","Marion County","NHPI_A",200,213,13,6.3,"overcount"
"1448",12083,"Florida","Marion County","NHPI_AIC",591,581,-10,-1.71,"undercount"
"1449",12085,"Florida","Martin County","A_A",2399,2296,-103,-4.39,"undercount"
"1450",12085,"Florida","Martin County","A_AIC",3050,3120,70,2.27,"overcount"
"1451",12085,"Florida","Martin County","NHPI_A",93,55,-38,-51.35,"undercount"
"1452",12085,"Florida","Martin County","NHPI_AIC",224,171,-53,-26.84,"undercount"
"1453",12086,"Florida","Miami-Dade County","A_A",41157,43394,2237,5.29,"overcount"
"1454",12086,"Florida","Miami-Dade County","A_AIC",49448,51937,2489,4.91,"overcount"
"1455",12086,"Florida","Miami-Dade County","NHPI_A",593,527,-66,-11.79,"undercount"
"1456",12086,"Florida","Miami-Dade County","NHPI_AIC",3332,1537,-1795,-73.73,"undercount"
"1457",12087,"Florida","Monroe County","A_A",1044,1142,98,8.97,"overcount"
"1458",12087,"Florida","Monroe County","A_AIC",1355,1632,277,18.55,"overcount"
"1459",12087,"Florida","Monroe County","NHPI_A",108,63,-45,-52.63,"undercount"
"1460",12087,"Florida","Monroe County","NHPI_AIC",175,158,-17,-10.21,"undercount"
"1461",12089,"Florida","Nassau County","A_A",928,887,-41,-4.52,"undercount"
"1462",12089,"Florida","Nassau County","A_AIC",1430,1544,114,7.67,"overcount"
"1463",12089,"Florida","Nassau County","NHPI_A",66,52,-14,-23.73,"undercount"
"1464",12089,"Florida","Nassau County","NHPI_AIC",141,173,32,20.38,"overcount"
"1465",12091,"Florida","Okaloosa County","A_A",6556,6704,148,2.23,"overcount"
"1466",12091,"Florida","Okaloosa County","A_AIC",10841,11287,446,4.03,"overcount"
"1467",12091,"Florida","Okaloosa County","NHPI_A",358,453,95,23.43,"overcount"
"1468",12091,"Florida","Okaloosa County","NHPI_AIC",833,1071,238,25,"overcount"
"1469",12093,"Florida","Okeechobee County","A_A",367,332,-35,-10.01,"undercount"
"1470",12093,"Florida","Okeechobee County","A_AIC",459,418,-41,-9.35,"undercount"
"1471",12093,"Florida","Okeechobee County","NHPI_A",42,14,-28,-100,"undercount"
"1472",12093,"Florida","Okeechobee County","NHPI_AIC",75,55,-20,-30.77,"undercount"
"1473",12095,"Florida","Orange County","A_A",77811,79751,1940,2.46,"overcount"
"1474",12095,"Florida","Orange County","A_AIC",89057,94340,5283,5.76,"overcount"
"1475",12095,"Florida","Orange County","NHPI_A",1630,1444,-186,-12.1,"undercount"
"1476",12095,"Florida","Orange County","NHPI_AIC",4020,3351,-669,-18.15,"undercount"
"1477",12097,"Florida","Osceola County","A_A",10613,11989,1376,12.18,"overcount"
"1478",12097,"Florida","Osceola County","A_AIC",12427,14692,2265,16.7,"overcount"
"1479",12097,"Florida","Osceola County","NHPI_A",444,354,-90,-22.56,"undercount"
"1480",12097,"Florida","Osceola County","NHPI_AIC",860,743,-117,-14.6,"undercount"
"1481",12099,"Florida","Palm Beach County","A_A",43598,44327,729,1.66,"overcount"
"1482",12099,"Florida","Palm Beach County","A_AIC",51946,54259,2313,4.36,"overcount"
"1483",12099,"Florida","Palm Beach County","NHPI_A",753,593,-160,-23.77,"undercount"
"1484",12099,"Florida","Palm Beach County","NHPI_AIC",3058,1928,-1130,-45.33,"undercount"
"1485",12101,"Florida","Pasco County","A_A",16426,16760,334,2.01,"overcount"
"1486",12101,"Florida","Pasco County","A_AIC",20638,21373,735,3.5,"overcount"
"1487",12101,"Florida","Pasco County","NHPI_A",339,330,-9,-2.69,"undercount"
"1488",12101,"Florida","Pasco County","NHPI_AIC",832,877,45,5.27,"overcount"
"1489",12103,"Florida","Pinellas County","A_A",34497,34223,-274,-0.8,"undercount"
"1490",12103,"Florida","Pinellas County","A_AIC",41709,42728,1019,2.41,"overcount"
"1491",12103,"Florida","Pinellas County","NHPI_A",850,855,5,0.59,"overcount"
"1492",12103,"Florida","Pinellas County","NHPI_AIC",1805,1799,-6,-0.33,"undercount"
"1493",12105,"Florida","Polk County","A_A",13539,13625,86,0.63,"overcount"
"1494",12105,"Florida","Polk County","A_AIC",16759,17111,352,2.08,"overcount"
"1495",12105,"Florida","Polk County","NHPI_A",390,375,-15,-3.92,"undercount"
"1496",12105,"Florida","Polk County","NHPI_AIC",1189,988,-201,-18.47,"undercount"
"1497",12107,"Florida","Putnam County","A_A",477,471,-6,-1.27,"undercount"
"1498",12107,"Florida","Putnam County","A_AIC",650,706,56,8.26,"overcount"
"1499",12107,"Florida","Putnam County","NHPI_A",70,39,-31,-56.88,"undercount"
"1500",12107,"Florida","Putnam County","NHPI_AIC",121,122,1,0.82,"overcount"
"1501",12109,"Florida","St. Johns County","A_A",9486,9910,424,4.37,"overcount"
"1502",12109,"Florida","St. Johns County","A_AIC",11966,13219,1253,9.95,"overcount"
"1503",12109,"Florida","St. Johns County","NHPI_A",198,156,-42,-23.73,"undercount"
"1504",12109,"Florida","St. Johns County","NHPI_AIC",474,493,19,3.93,"overcount"
"1505",12111,"Florida","St. Lucie County","A_A",6420,5885,-535,-8.7,"undercount"
"1506",12111,"Florida","St. Lucie County","A_AIC",8300,7871,-429,-5.31,"undercount"
"1507",12111,"Florida","St. Lucie County","NHPI_A",219,172,-47,-24.04,"undercount"
"1508",12111,"Florida","St. Lucie County","NHPI_AIC",731,546,-185,-28.97,"undercount"
"1509",12113,"Florida","Santa Rosa County","A_A",4004,3869,-135,-3.43,"undercount"
"1510",12113,"Florida","Santa Rosa County","A_AIC",6736,6887,151,2.22,"overcount"
"1511",12113,"Florida","Santa Rosa County","NHPI_A",294,362,68,20.73,"overcount"
"1512",12113,"Florida","Santa Rosa County","NHPI_AIC",624,809,185,25.82,"overcount"
"1513",12115,"Florida","Sarasota County","A_A",8198,8521,323,3.86,"overcount"
"1514",12115,"Florida","Sarasota County","A_AIC",10275,10954,679,6.4,"overcount"
"1515",12115,"Florida","Sarasota County","NHPI_A",140,175,35,22.22,"overcount"
"1516",12115,"Florida","Sarasota County","NHPI_AIC",436,481,45,9.81,"overcount"
"1517",12117,"Florida","Seminole County","A_A",23495,25557,2062,8.41,"overcount"
"1518",12117,"Florida","Seminole County","A_AIC",27805,31006,3201,10.89,"overcount"
"1519",12117,"Florida","Seminole County","NHPI_A",288,275,-13,-4.62,"undercount"
"1520",12117,"Florida","Seminole County","NHPI_AIC",781,856,75,9.16,"overcount"
"1521",12119,"Florida","Sumter County","A_A",1378,1263,-115,-8.71,"undercount"
"1522",12119,"Florida","Sumter County","A_AIC",1646,1563,-83,-5.17,"undercount"
"1523",12119,"Florida","Sumter County","NHPI_A",97,34,-63,-96.18,"undercount"
"1524",12119,"Florida","Sumter County","NHPI_AIC",183,110,-73,-49.83,"undercount"
"1525",12121,"Florida","Suwannee County","A_A",267,275,8,2.95,"overcount"
"1526",12121,"Florida","Suwannee County","A_AIC",372,401,29,7.5,"overcount"
"1527",12121,"Florida","Suwannee County","NHPI_A",20,16,-4,-22.22,"undercount"
"1528",12121,"Florida","Suwannee County","NHPI_AIC",49,58,9,16.82,"overcount"
"1529",12123,"Florida","Taylor County","A_A",187,228,41,19.76,"overcount"
"1530",12123,"Florida","Taylor County","A_AIC",248,286,38,14.23,"overcount"
"1531",12123,"Florida","Taylor County","NHPI_A",10,0,-10,-200,"undercount"
"1532",12123,"Florida","Taylor County","NHPI_AIC",27,19,-8,-34.78,"undercount"
"1533",12125,"Florida","Union County","A_A",90,36,-54,-85.71,"undercount"
"1534",12125,"Florida","Union County","A_AIC",120,75,-45,-46.15,"undercount"
"1535",12125,"Florida","Union County","NHPI_A",5,0,-5,-200,"undercount"
"1536",12125,"Florida","Union County","NHPI_AIC",15,15,0,0,"equal"
"1537",12127,"Florida","Volusia County","A_A",10445,10729,284,2.68,"overcount"
"1538",12127,"Florida","Volusia County","A_AIC",13414,13978,564,4.12,"overcount"
"1539",12127,"Florida","Volusia County","NHPI_A",273,287,14,5,"overcount"
"1540",12127,"Florida","Volusia County","NHPI_AIC",701,777,76,10.28,"overcount"
"1541",12129,"Florida","Wakulla County","A_A",232,211,-21,-9.48,"undercount"
"1542",12129,"Florida","Wakulla County","A_AIC",355,368,13,3.6,"overcount"
"1543",12129,"Florida","Wakulla County","NHPI_A",25,21,-4,-17.39,"undercount"
"1544",12129,"Florida","Wakulla County","NHPI_AIC",59,53,-6,-10.71,"undercount"
"1545",12131,"Florida","Walton County","A_A",957,912,-45,-4.82,"undercount"
"1546",12131,"Florida","Walton County","A_AIC",1463,1547,84,5.58,"overcount"
"1547",12131,"Florida","Walton County","NHPI_A",70,49,-21,-35.29,"undercount"
"1548",12131,"Florida","Walton County","NHPI_AIC",122,161,39,27.56,"overcount"
"1549",12133,"Florida","Washington County","A_A",171,138,-33,-21.36,"undercount"
"1550",12133,"Florida","Washington County","A_AIC",267,273,6,2.22,"overcount"
"1551",12133,"Florida","Washington County","NHPI_A",86,28,-58,-101.75,"undercount"
"1552",12133,"Florida","Washington County","NHPI_AIC",122,71,-51,-52.85,"undercount"
"1553",13001,"Georgia","Appling County","A_A",130,123,-7,-5.53,"undercount"
"1554",13001,"Georgia","Appling County","A_AIC",153,159,6,3.85,"overcount"
"1555",13001,"Georgia","Appling County","NHPI_A",12,1,-11,-169.23,"undercount"
"1556",13001,"Georgia","Appling County","NHPI_AIC",16,10,-6,-46.15,"undercount"
"1557",13003,"Georgia","Atkinson County","A_A",36,12,-24,-100,"undercount"
"1558",13003,"Georgia","Atkinson County","A_AIC",47,40,-7,-16.09,"undercount"
"1559",13003,"Georgia","Atkinson County","NHPI_A",13,4,-9,-105.88,"undercount"
"1560",13003,"Georgia","Atkinson County","NHPI_AIC",14,17,3,19.35,"overcount"
"1561",13005,"Georgia","Bacon County","A_A",58,40,-18,-36.73,"undercount"
"1562",13005,"Georgia","Bacon County","A_AIC",73,58,-15,-22.9,"undercount"
"1563",13005,"Georgia","Bacon County","NHPI_A",14,4,-10,-111.11,"undercount"
"1564",13005,"Georgia","Bacon County","NHPI_AIC",18,9,-9,-66.67,"undercount"
"1565",13007,"Georgia","Baker County","A_A",34,18,-16,-61.54,"undercount"
"1566",13007,"Georgia","Baker County","A_AIC",39,42,3,7.41,"overcount"
"1567",13007,"Georgia","Baker County","NHPI_A",2,0,-2,-200,"undercount"
"1568",13007,"Georgia","Baker County","NHPI_AIC",2,5,3,85.71,"overcount"
"1569",13009,"Georgia","Baldwin County","A_A",734,606,-128,-19.1,"undercount"
"1570",13009,"Georgia","Baldwin County","A_AIC",864,726,-138,-17.36,"undercount"
"1571",13009,"Georgia","Baldwin County","NHPI_A",30,27,-3,-10.53,"undercount"
"1572",13009,"Georgia","Baldwin County","NHPI_AIC",57,56,-1,-1.77,"undercount"
"1573",13011,"Georgia","Banks County","A_A",194,195,1,0.51,"overcount"
"1574",13011,"Georgia","Banks County","A_AIC",251,242,-9,-3.65,"undercount"
"1575",13011,"Georgia","Banks County","NHPI_A",3,8,5,90.91,"overcount"
"1576",13011,"Georgia","Banks County","NHPI_AIC",16,16,0,0,"equal"
"1577",13013,"Georgia","Barrow County","A_A",3351,3276,-75,-2.26,"undercount"
"1578",13013,"Georgia","Barrow County","A_AIC",3742,3776,34,0.9,"overcount"
"1579",13013,"Georgia","Barrow County","NHPI_A",72,21,-51,-109.68,"undercount"
"1580",13013,"Georgia","Barrow County","NHPI_AIC",138,119,-19,-14.79,"undercount"
"1581",13015,"Georgia","Bartow County","A_A",1116,1193,77,6.67,"overcount"
"1582",13015,"Georgia","Bartow County","A_AIC",1506,1635,129,8.21,"overcount"
"1583",13015,"Georgia","Bartow County","NHPI_A",92,40,-52,-78.79,"undercount"
"1584",13015,"Georgia","Bartow County","NHPI_AIC",162,120,-42,-29.79,"undercount"
"1585",13017,"Georgia","Ben Hill County","A_A",127,116,-11,-9.05,"undercount"
"1586",13017,"Georgia","Ben Hill County","A_AIC",164,149,-15,-9.58,"undercount"
"1587",13017,"Georgia","Ben Hill County","NHPI_A",2,2,0,0,"equal"
"1588",13017,"Georgia","Ben Hill County","NHPI_AIC",4,6,2,40,"overcount"
"1589",13019,"Georgia","Berrien County","A_A",199,82,-117,-83.27,"undercount"
"1590",13019,"Georgia","Berrien County","A_AIC",260,140,-120,-60,"undercount"
"1591",13019,"Georgia","Berrien County","NHPI_A",4,10,6,85.71,"overcount"
"1592",13019,"Georgia","Berrien County","NHPI_AIC",14,28,14,66.67,"overcount"
"1593",13021,"Georgia","Bibb County","A_A",3220,3283,63,1.94,"overcount"
"1594",13021,"Georgia","Bibb County","A_AIC",3842,3971,129,3.3,"overcount"
"1595",13021,"Georgia","Bibb County","NHPI_A",94,48,-46,-64.79,"undercount"
"1596",13021,"Georgia","Bibb County","NHPI_AIC",253,147,-106,-53,"undercount"
"1597",13023,"Georgia","Bleckley County","A_A",142,153,11,7.46,"overcount"
"1598",13023,"Georgia","Bleckley County","A_AIC",167,187,20,11.3,"overcount"
"1599",13023,"Georgia","Bleckley County","NHPI_A",3,9,6,100,"overcount"
"1600",13023,"Georgia","Bleckley County","NHPI_AIC",7,14,7,66.67,"overcount"
"1601",13025,"Georgia","Brantley County","A_A",61,43,-18,-34.62,"undercount"
"1602",13025,"Georgia","Brantley County","A_AIC",100,98,-2,-2.02,"undercount"
"1603",13025,"Georgia","Brantley County","NHPI_A",4,3,-1,-28.57,"undercount"
"1604",13025,"Georgia","Brantley County","NHPI_AIC",10,26,16,88.89,"overcount"
"1605",13027,"Georgia","Brooks County","A_A",205,67,-138,-101.47,"undercount"
"1606",13027,"Georgia","Brooks County","A_AIC",253,112,-141,-77.26,"undercount"
"1607",13027,"Georgia","Brooks County","NHPI_A",8,6,-2,-28.57,"undercount"
"1608",13027,"Georgia","Brooks County","NHPI_AIC",20,17,-3,-16.22,"undercount"
"1609",13029,"Georgia","Bryan County","A_A",904,1043,139,14.28,"overcount"
"1610",13029,"Georgia","Bryan County","A_AIC",1285,1657,372,25.29,"overcount"
"1611",13029,"Georgia","Bryan County","NHPI_A",56,53,-3,-5.5,"undercount"
"1612",13029,"Georgia","Bryan County","NHPI_AIC",124,172,48,32.43,"overcount"
"1613",13031,"Georgia","Bulloch County","A_A",1035,1337,302,25.46,"overcount"
"1614",13031,"Georgia","Bulloch County","A_AIC",1404,1737,333,21.2,"overcount"
"1615",13031,"Georgia","Bulloch County","NHPI_A",82,64,-18,-24.66,"undercount"
"1616",13031,"Georgia","Bulloch County","NHPI_AIC",155,151,-4,-2.61,"undercount"
"1617",13033,"Georgia","Burke County","A_A",118,100,-18,-16.51,"undercount"
"1618",13033,"Georgia","Burke County","A_AIC",166,169,3,1.79,"overcount"
"1619",13033,"Georgia","Burke County","NHPI_A",28,12,-16,-80,"undercount"
"1620",13033,"Georgia","Burke County","NHPI_AIC",41,29,-12,-34.29,"undercount"
"1621",13035,"Georgia","Butts County","A_A",175,103,-72,-51.8,"undercount"
"1622",13035,"Georgia","Butts County","A_AIC",247,190,-57,-26.09,"undercount"
"1623",13035,"Georgia","Butts County","NHPI_A",10,9,-1,-10.53,"undercount"
"1624",13035,"Georgia","Butts County","NHPI_AIC",19,22,3,14.63,"overcount"
"1625",13037,"Georgia","Calhoun County","A_A",55,19,-36,-97.3,"undercount"
"1626",13037,"Georgia","Calhoun County","A_AIC",69,30,-39,-78.79,"undercount"
"1627",13037,"Georgia","Calhoun County","NHPI_A",0,0,0,0,"equal"
"1628",13037,"Georgia","Calhoun County","NHPI_AIC",1,2,1,66.67,"overcount"
"1629",13039,"Georgia","Camden County","A_A",846,864,18,2.11,"overcount"
"1630",13039,"Georgia","Camden County","A_AIC",1391,1448,57,4.02,"overcount"
"1631",13039,"Georgia","Camden County","NHPI_A",95,67,-28,-34.57,"undercount"
"1632",13039,"Georgia","Camden County","NHPI_AIC",189,185,-4,-2.14,"undercount"
"1633",13043,"Georgia","Candler County","A_A",76,65,-11,-15.6,"undercount"
"1634",13043,"Georgia","Candler County","A_AIC",94,77,-17,-19.88,"undercount"
"1635",13043,"Georgia","Candler County","NHPI_A",2,3,1,40,"overcount"
"1636",13043,"Georgia","Candler County","NHPI_AIC",5,10,5,66.67,"overcount"
"1637",13045,"Georgia","Carroll County","A_A",1207,1119,-88,-7.57,"undercount"
"1638",13045,"Georgia","Carroll County","A_AIC",1604,1629,25,1.55,"overcount"
"1639",13045,"Georgia","Carroll County","NHPI_A",60,22,-38,-92.68,"undercount"
"1640",13045,"Georgia","Carroll County","NHPI_AIC",148,99,-49,-39.68,"undercount"
"1641",13047,"Georgia","Catoosa County","A_A",986,1025,39,3.88,"overcount"
"1642",13047,"Georgia","Catoosa County","A_AIC",1236,1282,46,3.65,"overcount"
"1643",13047,"Georgia","Catoosa County","NHPI_A",92,84,-8,-9.09,"undercount"
"1644",13047,"Georgia","Catoosa County","NHPI_AIC",123,160,37,26.15,"overcount"
"1645",13049,"Georgia","Charlton County","A_A",93,109,16,15.84,"overcount"
"1646",13049,"Georgia","Charlton County","A_AIC",134,154,20,13.89,"overcount"
"1647",13049,"Georgia","Charlton County","NHPI_A",6,2,-4,-100,"undercount"
"1648",13049,"Georgia","Charlton County","NHPI_AIC",12,18,6,40,"overcount"
"1649",13051,"Georgia","Chatham County","A_A",8625,10682,2057,21.31,"overcount"
"1650",13051,"Georgia","Chatham County","A_AIC",10692,13129,2437,20.46,"overcount"
"1651",13051,"Georgia","Chatham County","NHPI_A",368,418,50,12.72,"overcount"
"1652",13051,"Georgia","Chatham County","NHPI_AIC",652,776,124,17.37,"overcount"
"1653",13053,"Georgia","Chattahoochee County","A_A",289,305,16,5.39,"overcount"
"1654",13053,"Georgia","Chattahoochee County","A_AIC",456,500,44,9.21,"overcount"
"1655",13053,"Georgia","Chattahoochee County","NHPI_A",63,106,43,50.89,"overcount"
"1656",13053,"Georgia","Chattahoochee County","NHPI_AIC",95,168,73,55.51,"overcount"
"1657",13055,"Georgia","Chattooga County","A_A",136,102,-34,-28.57,"undercount"
"1658",13055,"Georgia","Chattooga County","A_AIC",191,132,-59,-36.53,"undercount"
"1659",13055,"Georgia","Chattooga County","NHPI_A",8,0,-8,-200,"undercount"
"1660",13055,"Georgia","Chattooga County","NHPI_AIC",14,14,0,0,"equal"
"1661",13057,"Georgia","Cherokee County","A_A",5676,5525,-151,-2.7,"undercount"
"1662",13057,"Georgia","Cherokee County","A_AIC",7491,7932,441,5.72,"overcount"
"1663",13057,"Georgia","Cherokee County","NHPI_A",156,107,-49,-37.26,"undercount"
"1664",13057,"Georgia","Cherokee County","NHPI_AIC",365,320,-45,-13.14,"undercount"
"1665",13059,"Georgia","Clarke County","A_A",5027,5035,8,0.16,"overcount"
"1666",13059,"Georgia","Clarke County","A_AIC",6088,6216,128,2.08,"overcount"
"1667",13059,"Georgia","Clarke County","NHPI_A",58,74,16,24.24,"overcount"
"1668",13059,"Georgia","Clarke County","NHPI_AIC",172,185,13,7.28,"overcount"
"1669",13061,"Georgia","Clay County","A_A",35,6,-29,-141.46,"undercount"
"1670",13061,"Georgia","Clay County","A_AIC",41,19,-22,-73.33,"undercount"
"1671",13061,"Georgia","Clay County","NHPI_A",2,1,-1,-66.67,"undercount"
"1672",13061,"Georgia","Clay County","NHPI_AIC",2,6,4,100,"overcount"
"1673",13063,"Georgia","Clayton County","A_A",14381,13594,-787,-5.63,"undercount"
"1674",13063,"Georgia","Clayton County","A_AIC",15561,14716,-845,-5.58,"undercount"
"1675",13063,"Georgia","Clayton County","NHPI_A",181,129,-52,-33.55,"undercount"
"1676",13063,"Georgia","Clayton County","NHPI_AIC",522,331,-191,-44.78,"undercount"
"1677",13065,"Georgia","Clinch County","A_A",23,22,-1,-4.44,"undercount"
"1678",13065,"Georgia","Clinch County","A_AIC",33,29,-4,-12.9,"undercount"
"1679",13065,"Georgia","Clinch County","NHPI_A",4,7,3,54.55,"overcount"
"1680",13065,"Georgia","Clinch County","NHPI_AIC",5,13,8,88.89,"overcount"
"1681",13067,"Georgia","Cobb County","A_A",42890,43211,321,0.75,"overcount"
"1682",13067,"Georgia","Cobb County","A_AIC",49071,50909,1838,3.68,"overcount"
"1683",13067,"Georgia","Cobb County","NHPI_A",313,320,7,2.21,"overcount"
"1684",13067,"Georgia","Cobb County","NHPI_AIC",891,981,90,9.62,"overcount"
"1685",13069,"Georgia","Coffee County","A_A",334,307,-27,-8.42,"undercount"
"1686",13069,"Georgia","Coffee County","A_AIC",407,404,-3,-0.74,"undercount"
"1687",13069,"Georgia","Coffee County","NHPI_A",19,17,-2,-11.11,"undercount"
"1688",13069,"Georgia","Coffee County","NHPI_AIC",38,54,16,34.78,"overcount"
"1689",13071,"Georgia","Colquitt County","A_A",378,389,11,2.87,"overcount"
"1690",13071,"Georgia","Colquitt County","A_AIC",449,486,37,7.91,"overcount"
"1691",13071,"Georgia","Colquitt County","NHPI_A",16,15,-1,-6.45,"undercount"
"1692",13071,"Georgia","Colquitt County","NHPI_AIC",36,32,-4,-11.76,"undercount"
"1693",13073,"Georgia","Columbia County","A_A",6965,7205,240,3.39,"overcount"
"1694",13073,"Georgia","Columbia County","A_AIC",9104,9991,887,9.29,"overcount"
"1695",13073,"Georgia","Columbia County","NHPI_A",240,284,44,16.79,"overcount"
"1696",13073,"Georgia","Columbia County","NHPI_AIC",454,613,159,29.8,"overcount"
"1697",13075,"Georgia","Cook County","A_A",118,100,-18,-16.51,"undercount"
"1698",13075,"Georgia","Cook County","A_AIC",160,171,11,6.65,"overcount"
"1699",13075,"Georgia","Cook County","NHPI_A",4,4,0,0,"equal"
"1700",13075,"Georgia","Cook County","NHPI_AIC",12,17,5,34.48,"overcount"
"1701",13077,"Georgia","Coweta County","A_A",3352,3399,47,1.39,"overcount"
"1702",13077,"Georgia","Coweta County","A_AIC",4232,4514,282,6.45,"overcount"
"1703",13077,"Georgia","Coweta County","NHPI_A",103,69,-34,-39.53,"undercount"
"1704",13077,"Georgia","Coweta County","NHPI_AIC",216,165,-51,-26.77,"undercount"
"1705",13079,"Georgia","Crawford County","A_A",99,31,-68,-104.62,"undercount"
"1706",13079,"Georgia","Crawford County","A_AIC",120,94,-26,-24.3,"undercount"
"1707",13079,"Georgia","Crawford County","NHPI_A",2,3,1,40,"overcount"
"1708",13079,"Georgia","Crawford County","NHPI_AIC",6,21,15,111.11,"overcount"
"1709",13081,"Georgia","Crisp County","A_A",216,180,-36,-18.18,"undercount"
"1710",13081,"Georgia","Crisp County","A_AIC",254,244,-10,-4.02,"undercount"
"1711",13081,"Georgia","Crisp County","NHPI_A",11,4,-7,-93.33,"undercount"
"1712",13081,"Georgia","Crisp County","NHPI_AIC",18,12,-6,-40,"undercount"
"1713",13083,"Georgia","Dade County","A_A",157,140,-17,-11.45,"undercount"
"1714",13083,"Georgia","Dade County","A_AIC",209,193,-16,-7.96,"undercount"
"1715",13083,"Georgia","Dade County","NHPI_A",8,5,-3,-46.15,"undercount"
"1716",13083,"Georgia","Dade County","NHPI_AIC",14,12,-2,-15.38,"undercount"
"1717",13085,"Georgia","Dawson County","A_A",274,239,-35,-13.65,"undercount"
"1718",13085,"Georgia","Dawson County","A_AIC",344,381,37,10.21,"overcount"
"1719",13085,"Georgia","Dawson County","NHPI_A",14,14,0,0,"equal"
"1720",13085,"Georgia","Dawson County","NHPI_AIC",23,37,14,46.67,"overcount"
"1721",13087,"Georgia","Decatur County","A_A",165,194,29,16.16,"overcount"
"1722",13087,"Georgia","Decatur County","A_AIC",212,263,51,21.47,"overcount"
"1723",13087,"Georgia","Decatur County","NHPI_A",10,16,6,46.15,"overcount"
"1724",13087,"Georgia","Decatur County","NHPI_AIC",22,31,9,33.96,"overcount"
"1725",13089,"Georgia","DeKalb County","A_A",49662,50872,1210,2.41,"overcount"
"1726",13089,"Georgia","DeKalb County","A_AIC",55001,58001,3000,5.31,"overcount"
"1727",13089,"Georgia","DeKalb County","NHPI_A",639,238,-401,-91.45,"undercount"
"1728",13089,"Georgia","DeKalb County","NHPI_AIC",1292,843,-449,-42.06,"undercount"
"1729",13091,"Georgia","Dodge County","A_A",111,95,-16,-15.53,"undercount"
"1730",13091,"Georgia","Dodge County","A_AIC",149,133,-16,-11.35,"undercount"
"1731",13091,"Georgia","Dodge County","NHPI_A",5,8,3,46.15,"overcount"
"1732",13091,"Georgia","Dodge County","NHPI_AIC",10,13,3,26.09,"overcount"
"1733",13093,"Georgia","Dooly County","A_A",79,51,-28,-43.08,"undercount"
"1734",13093,"Georgia","Dooly County","A_AIC",105,78,-27,-29.51,"undercount"
"1735",13093,"Georgia","Dooly County","NHPI_A",4,2,-2,-66.67,"undercount"
"1736",13093,"Georgia","Dooly County","NHPI_AIC",9,7,-2,-25,"undercount"
"1737",13095,"Georgia","Dougherty County","A_A",734,654,-80,-11.53,"undercount"
"1738",13095,"Georgia","Dougherty County","A_AIC",975,925,-50,-5.26,"undercount"
"1739",13095,"Georgia","Dougherty County","NHPI_A",58,20,-38,-97.44,"undercount"
"1740",13095,"Georgia","Dougherty County","NHPI_AIC",123,86,-37,-35.41,"undercount"
"1741",13097,"Georgia","Douglas County","A_A",2394,2339,-55,-2.32,"undercount"
"1742",13097,"Georgia","Douglas County","A_AIC",3122,3056,-66,-2.14,"undercount"
"1743",13097,"Georgia","Douglas County","NHPI_A",148,111,-37,-28.57,"undercount"
"1744",13097,"Georgia","Douglas County","NHPI_AIC",302,230,-72,-27.07,"undercount"
"1745",13099,"Georgia","Early County","A_A",78,47,-31,-49.6,"undercount"
"1746",13099,"Georgia","Early County","A_AIC",99,70,-29,-34.32,"undercount"
"1747",13099,"Georgia","Early County","NHPI_A",7,0,-7,-200,"undercount"
"1748",13099,"Georgia","Early County","NHPI_AIC",11,8,-3,-31.58,"undercount"
"1749",13101,"Georgia","Echols County","A_A",27,8,-19,-108.57,"undercount"
"1750",13101,"Georgia","Echols County","A_AIC",42,23,-19,-58.46,"undercount"
"1751",13101,"Georgia","Echols County","NHPI_A",1,2,1,66.67,"overcount"
"1752",13101,"Georgia","Echols County","NHPI_AIC",2,14,12,150,"overcount"
"1753",13103,"Georgia","Effingham County","A_A",730,678,-52,-7.39,"undercount"
"1754",13103,"Georgia","Effingham County","A_AIC",1049,1208,159,14.09,"overcount"
"1755",13103,"Georgia","Effingham County","NHPI_A",56,28,-28,-66.67,"undercount"
"1756",13103,"Georgia","Effingham County","NHPI_AIC",129,82,-47,-44.55,"undercount"
"1757",13105,"Georgia","Elbert County","A_A",186,182,-4,-2.17,"undercount"
"1758",13105,"Georgia","Elbert County","A_AIC",227,233,6,2.61,"overcount"
"1759",13105,"Georgia","Elbert County","NHPI_A",6,3,-3,-66.67,"undercount"
"1760",13105,"Georgia","Elbert County","NHPI_AIC",16,20,4,22.22,"overcount"
"1761",13107,"Georgia","Emanuel County","A_A",175,141,-34,-21.52,"undercount"
"1762",13107,"Georgia","Emanuel County","A_AIC",206,155,-51,-28.25,"undercount"
"1763",13107,"Georgia","Emanuel County","NHPI_A",7,2,-5,-111.11,"undercount"
"1764",13107,"Georgia","Emanuel County","NHPI_AIC",19,9,-10,-71.43,"undercount"
"1765",13109,"Georgia","Evans County","A_A",76,79,3,3.87,"overcount"
"1766",13109,"Georgia","Evans County","A_AIC",106,92,-14,-14.14,"undercount"
"1767",13109,"Georgia","Evans County","NHPI_A",8,11,3,31.58,"overcount"
"1768",13109,"Georgia","Evans County","NHPI_AIC",11,16,5,37.04,"overcount"
"1769",13111,"Georgia","Fannin County","A_A",159,113,-46,-33.82,"undercount"
"1770",13111,"Georgia","Fannin County","A_AIC",217,170,-47,-24.29,"undercount"
"1771",13111,"Georgia","Fannin County","NHPI_A",9,3,-6,-100,"undercount"
"1772",13111,"Georgia","Fannin County","NHPI_AIC",24,7,-17,-109.68,"undercount"
"1773",13113,"Georgia","Fayette County","A_A",5741,6468,727,11.91,"overcount"
"1774",13113,"Georgia","Fayette County","A_AIC",6723,7683,960,13.33,"overcount"
"1775",13113,"Georgia","Fayette County","NHPI_A",110,44,-66,-85.71,"undercount"
"1776",13113,"Georgia","Fayette County","NHPI_AIC",239,162,-77,-38.4,"undercount"
"1777",13115,"Georgia","Floyd County","A_A",1379,1310,-69,-5.13,"undercount"
"1778",13115,"Georgia","Floyd County","A_AIC",1725,1698,-27,-1.58,"undercount"
"1779",13115,"Georgia","Floyd County","NHPI_A",65,24,-41,-92.13,"undercount"
"1780",13115,"Georgia","Floyd County","NHPI_AIC",122,79,-43,-42.79,"undercount"
"1781",13117,"Georgia","Forsyth County","A_A",42072,45357,3285,7.51,"overcount"
"1782",13117,"Georgia","Forsyth County","A_AIC",44189,48065,3876,8.4,"overcount"
"1783",13117,"Georgia","Forsyth County","NHPI_A",113,89,-24,-23.76,"undercount"
"1784",13117,"Georgia","Forsyth County","NHPI_AIC",317,280,-37,-12.4,"undercount"
"1785",13119,"Georgia","Franklin County","A_A",348,302,-46,-14.15,"undercount"
"1786",13119,"Georgia","Franklin County","A_AIC",401,352,-49,-13.01,"undercount"
"1787",13119,"Georgia","Franklin County","NHPI_A",5,3,-2,-50,"undercount"
"1788",13119,"Georgia","Franklin County","NHPI_AIC",16,21,5,27.03,"overcount"
"1789",13121,"Georgia","Fulton County","A_A",83844,81449,-2395,-2.9,"undercount"
"1790",13121,"Georgia","Fulton County","A_AIC",92596,91953,-643,-0.7,"undercount"
"1791",13121,"Georgia","Fulton County","NHPI_A",301,425,124,34.16,"overcount"
"1792",13121,"Georgia","Fulton County","NHPI_AIC",1185,1322,137,10.93,"overcount"
"1793",13123,"Georgia","Gilmer County","A_A",161,141,-20,-13.25,"undercount"
"1794",13123,"Georgia","Gilmer County","A_AIC",216,213,-3,-1.4,"undercount"
"1795",13123,"Georgia","Gilmer County","NHPI_A",19,0,-19,-200,"undercount"
"1796",13123,"Georgia","Gilmer County","NHPI_AIC",30,4,-26,-152.94,"undercount"
"1797",13125,"Georgia","Glascock County","A_A",5,7,2,33.33,"overcount"
"1798",13125,"Georgia","Glascock County","A_AIC",9,18,9,66.67,"overcount"
"1799",13125,"Georgia","Glascock County","NHPI_A",2,2,0,0,"equal"
"1800",13125,"Georgia","Glascock County","NHPI_AIC",4,8,4,66.67,"overcount"
"1801",13127,"Georgia","Glynn County","A_A",1333,1178,-155,-12.35,"undercount"
"1802",13127,"Georgia","Glynn County","A_AIC",1687,1630,-57,-3.44,"undercount"
"1803",13127,"Georgia","Glynn County","NHPI_A",96,97,1,1.04,"overcount"
"1804",13127,"Georgia","Glynn County","NHPI_AIC",165,182,17,9.8,"overcount"
"1805",13129,"Georgia","Gordon County","A_A",683,722,39,5.55,"overcount"
"1806",13129,"Georgia","Gordon County","A_AIC",845,910,65,7.41,"overcount"
"1807",13129,"Georgia","Gordon County","NHPI_A",61,17,-44,-112.82,"undercount"
"1808",13129,"Georgia","Gordon County","NHPI_AIC",85,60,-25,-34.48,"undercount"
"1809",13131,"Georgia","Grady County","A_A",131,111,-20,-16.53,"undercount"
"1810",13131,"Georgia","Grady County","A_AIC",181,168,-13,-7.45,"undercount"
"1811",13131,"Georgia","Grady County","NHPI_A",13,6,-7,-73.68,"undercount"
"1812",13131,"Georgia","Grady County","NHPI_AIC",28,19,-9,-38.3,"undercount"
"1813",13133,"Georgia","Greene County","A_A",199,174,-25,-13.4,"undercount"
"1814",13133,"Georgia","Greene County","A_AIC",236,230,-6,-2.58,"undercount"
"1815",13133,"Georgia","Greene County","NHPI_A",18,2,-16,-160,"undercount"
"1816",13133,"Georgia","Greene County","NHPI_AIC",27,20,-7,-29.79,"undercount"
"1817",13135,"Georgia","Gwinnett County","A_A",120923,127704,6781,5.45,"overcount"
"1818",13135,"Georgia","Gwinnett County","A_AIC",129752,137420,7668,5.74,"overcount"
"1819",13135,"Georgia","Gwinnett County","NHPI_A",439,489,50,10.78,"overcount"
"1820",13135,"Georgia","Gwinnett County","NHPI_AIC",1446,1334,-112,-8.06,"undercount"
"1821",13137,"Georgia","Habersham County","A_A",1014,1014,0,0,"equal"
"1822",13137,"Georgia","Habersham County","A_AIC",1175,1189,14,1.18,"overcount"
"1823",13137,"Georgia","Habersham County","NHPI_A",46,40,-6,-13.95,"undercount"
"1824",13137,"Georgia","Habersham County","NHPI_AIC",61,74,13,19.26,"overcount"
"1825",13139,"Georgia","Hall County","A_A",4312,4230,-82,-1.92,"undercount"
"1826",13139,"Georgia","Hall County","A_AIC",5004,5152,148,2.91,"overcount"
"1827",13139,"Georgia","Hall County","NHPI_A",88,85,-3,-3.47,"undercount"
"1828",13139,"Georgia","Hall County","NHPI_AIC",185,176,-9,-4.99,"undercount"
"1829",13141,"Georgia","Hancock County","A_A",90,38,-52,-81.25,"undercount"
"1830",13141,"Georgia","Hancock County","A_AIC",104,54,-50,-63.29,"undercount"
"1831",13141,"Georgia","Hancock County","NHPI_A",3,1,-2,-100,"undercount"
"1832",13141,"Georgia","Hancock County","NHPI_AIC",5,5,0,0,"equal"
"1833",13143,"Georgia","Haralson County","A_A",232,186,-46,-22.01,"undercount"
"1834",13143,"Georgia","Haralson County","A_AIC",327,263,-64,-21.69,"undercount"
"1835",13143,"Georgia","Haralson County","NHPI_A",14,9,-5,-43.48,"undercount"
"1836",13143,"Georgia","Haralson County","NHPI_AIC",30,22,-8,-30.77,"undercount"
"1837",13145,"Georgia","Harris County","A_A",467,409,-58,-13.24,"undercount"
"1838",13145,"Georgia","Harris County","A_AIC",681,708,27,3.89,"overcount"
"1839",13145,"Georgia","Harris County","NHPI_A",49,21,-28,-80,"undercount"
"1840",13145,"Georgia","Harris County","NHPI_AIC",75,60,-15,-22.22,"undercount"
"1841",13147,"Georgia","Hart County","A_A",318,335,17,5.21,"overcount"
"1842",13147,"Georgia","Hart County","A_AIC",371,424,53,13.33,"overcount"
"1843",13147,"Georgia","Hart County","NHPI_A",5,3,-2,-50,"undercount"
"1844",13147,"Georgia","Hart County","NHPI_AIC",14,23,9,48.65,"overcount"
"1845",13149,"Georgia","Heard County","A_A",62,54,-8,-13.79,"undercount"
"1846",13149,"Georgia","Heard County","A_AIC",95,81,-14,-15.91,"undercount"
"1847",13149,"Georgia","Heard County","NHPI_A",1,4,3,120,"overcount"
"1848",13149,"Georgia","Heard County","NHPI_AIC",10,10,0,0,"equal"
"1849",13151,"Georgia","Henry County","A_A",7860,8084,224,2.81,"overcount"
"1850",13151,"Georgia","Henry County","A_AIC",9540,9676,136,1.42,"overcount"
"1851",13151,"Georgia","Henry County","NHPI_A",164,129,-35,-23.89,"undercount"
"1852",13151,"Georgia","Henry County","NHPI_AIC",454,360,-94,-23.1,"undercount"
"1853",13153,"Georgia","Houston County","A_A",4892,4977,85,1.72,"overcount"
"1854",13153,"Georgia","Houston County","A_AIC",6721,6913,192,2.82,"overcount"
"1855",13153,"Georgia","Houston County","NHPI_A",169,124,-45,-30.72,"undercount"
"1856",13153,"Georgia","Houston County","NHPI_AIC",354,342,-12,-3.45,"undercount"
"1857",13155,"Georgia","Irwin County","A_A",70,119,49,51.85,"overcount"
"1858",13155,"Georgia","Irwin County","A_AIC",88,144,56,48.28,"overcount"
"1859",13155,"Georgia","Irwin County","NHPI_A",0,1,1,200,"overcount"
"1860",13155,"Georgia","Irwin County","NHPI_AIC",4,14,10,111.11,"overcount"
"1861",13157,"Georgia","Jackson County","A_A",1614,1764,150,8.88,"overcount"
"1862",13157,"Georgia","Jackson County","A_AIC",1908,2210,302,14.67,"overcount"
"1863",13157,"Georgia","Jackson County","NHPI_A",36,30,-6,-18.18,"undercount"
"1864",13157,"Georgia","Jackson County","NHPI_AIC",87,64,-23,-30.46,"undercount"
"1865",13159,"Georgia","Jasper County","A_A",47,30,-17,-44.16,"undercount"
"1866",13159,"Georgia","Jasper County","A_AIC",79,68,-11,-14.97,"undercount"
"1867",13159,"Georgia","Jasper County","NHPI_A",2,1,-1,-66.67,"undercount"
"1868",13159,"Georgia","Jasper County","NHPI_AIC",15,25,10,50,"overcount"
"1869",13161,"Georgia","Jeff Davis County","A_A",95,50,-45,-62.07,"undercount"
"1870",13161,"Georgia","Jeff Davis County","A_AIC",118,70,-48,-51.06,"undercount"
"1871",13161,"Georgia","Jeff Davis County","NHPI_A",5,8,3,46.15,"overcount"
"1872",13161,"Georgia","Jeff Davis County","NHPI_AIC",11,18,7,48.28,"overcount"
"1873",13163,"Georgia","Jefferson County","A_A",88,70,-18,-22.78,"undercount"
"1874",13163,"Georgia","Jefferson County","A_AIC",111,109,-2,-1.82,"undercount"
"1875",13163,"Georgia","Jefferson County","NHPI_A",3,0,-3,-200,"undercount"
"1876",13163,"Georgia","Jefferson County","NHPI_AIC",10,24,14,82.35,"overcount"
"1877",13165,"Georgia","Jenkins County","A_A",95,15,-80,-145.45,"undercount"
"1878",13165,"Georgia","Jenkins County","A_AIC",106,25,-81,-123.66,"undercount"
"1879",13165,"Georgia","Jenkins County","NHPI_A",1,5,4,133.33,"overcount"
"1880",13165,"Georgia","Jenkins County","NHPI_AIC",5,7,2,33.33,"overcount"
"1881",13167,"Georgia","Johnson County","A_A",45,33,-12,-30.77,"undercount"
"1882",13167,"Georgia","Johnson County","A_AIC",64,40,-24,-46.15,"undercount"
"1883",13167,"Georgia","Johnson County","NHPI_A",3,15,12,133.33,"overcount"
"1884",13167,"Georgia","Johnson County","NHPI_AIC",6,17,11,95.65,"overcount"
"1885",13169,"Georgia","Jones County","A_A",163,138,-25,-16.61,"undercount"
"1886",13169,"Georgia","Jones County","A_AIC",238,208,-30,-13.45,"undercount"
"1887",13169,"Georgia","Jones County","NHPI_A",3,7,4,80,"overcount"
"1888",13169,"Georgia","Jones County","NHPI_AIC",25,16,-9,-43.9,"undercount"
"1889",13171,"Georgia","Lamar County","A_A",135,102,-33,-27.85,"undercount"
"1890",13171,"Georgia","Lamar County","A_AIC",188,179,-9,-4.9,"undercount"
"1891",13171,"Georgia","Lamar County","NHPI_A",6,4,-2,-40,"undercount"
"1892",13171,"Georgia","Lamar County","NHPI_AIC",26,8,-18,-105.88,"undercount"
"1893",13173,"Georgia","Lanier County","A_A",117,81,-36,-36.36,"undercount"
"1894",13173,"Georgia","Lanier County","A_AIC",191,117,-74,-48.05,"undercount"
"1895",13173,"Georgia","Lanier County","NHPI_A",5,14,9,94.74,"overcount"
"1896",13173,"Georgia","Lanier County","NHPI_AIC",20,37,17,59.65,"overcount"
"1897",13175,"Georgia","Laurens County","A_A",487,512,25,5.01,"overcount"
"1898",13175,"Georgia","Laurens County","A_AIC",586,621,35,5.8,"overcount"
"1899",13175,"Georgia","Laurens County","NHPI_A",11,15,4,30.77,"overcount"
"1900",13175,"Georgia","Laurens County","NHPI_AIC",42,35,-7,-18.18,"undercount"
"1901",13177,"Georgia","Lee County","A_A",752,864,112,13.86,"overcount"
"1902",13177,"Georgia","Lee County","A_AIC",867,1076,209,21.51,"overcount"
"1903",13177,"Georgia","Lee County","NHPI_A",27,12,-15,-76.92,"undercount"
"1904",13177,"Georgia","Lee County","NHPI_AIC",64,42,-22,-41.51,"undercount"
"1905",13179,"Georgia","Liberty County","A_A",1203,1339,136,10.7,"overcount"
"1906",13179,"Georgia","Liberty County","A_AIC",1958,2105,147,7.24,"overcount"
"1907",13179,"Georgia","Liberty County","NHPI_A",281,458,177,47.9,"overcount"
"1908",13179,"Georgia","Liberty County","NHPI_AIC",451,680,229,40.5,"overcount"
"1909",13181,"Georgia","Lincoln County","A_A",36,20,-16,-57.14,"undercount"
"1910",13181,"Georgia","Lincoln County","A_AIC",61,49,-12,-21.82,"undercount"
"1911",13181,"Georgia","Lincoln County","NHPI_A",1,9,8,160,"overcount"
"1912",13181,"Georgia","Lincoln County","NHPI_AIC",9,32,23,112.2,"overcount"
"1913",13183,"Georgia","Long County","A_A",230,164,-66,-33.5,"undercount"
"1914",13183,"Georgia","Long County","A_AIC",436,326,-110,-28.87,"undercount"
"1915",13183,"Georgia","Long County","NHPI_A",94,88,-6,-6.59,"undercount"
"1916",13183,"Georgia","Long County","NHPI_AIC",146,136,-10,-7.09,"undercount"
"1917",13185,"Georgia","Lowndes County","A_A",2232,1932,-300,-14.41,"undercount"
"1918",13185,"Georgia","Lowndes County","A_AIC",3095,2748,-347,-11.88,"undercount"
"1919",13185,"Georgia","Lowndes County","NHPI_A",120,110,-10,-8.7,"undercount"
"1920",13185,"Georgia","Lowndes County","NHPI_AIC",266,280,14,5.13,"overcount"
"1921",13187,"Georgia","Lumpkin County","A_A",246,258,12,4.76,"overcount"
"1922",13187,"Georgia","Lumpkin County","A_AIC",367,448,81,19.88,"overcount"
"1923",13187,"Georgia","Lumpkin County","NHPI_A",38,23,-15,-49.18,"undercount"
"1924",13187,"Georgia","Lumpkin County","NHPI_AIC",68,46,-22,-38.6,"undercount"
"1925",13189,"Georgia","McDuffie County","A_A",111,77,-34,-36.17,"undercount"
"1926",13189,"Georgia","McDuffie County","A_AIC",166,161,-5,-3.06,"undercount"
"1927",13189,"Georgia","McDuffie County","NHPI_A",16,15,-1,-6.45,"undercount"
"1928",13189,"Georgia","McDuffie County","NHPI_AIC",33,34,1,2.99,"overcount"
"1929",13191,"Georgia","McIntosh County","A_A",59,45,-14,-26.92,"undercount"
"1930",13191,"Georgia","McIntosh County","A_AIC",99,95,-4,-4.12,"undercount"
"1931",13191,"Georgia","McIntosh County","NHPI_A",10,0,-10,-200,"undercount"
"1932",13191,"Georgia","McIntosh County","NHPI_AIC",26,9,-17,-97.14,"undercount"
"1933",13193,"Georgia","Macon County","A_A",175,161,-14,-8.33,"undercount"
"1934",13193,"Georgia","Macon County","A_AIC",203,179,-24,-12.57,"undercount"
"1935",13193,"Georgia","Macon County","NHPI_A",16,7,-9,-78.26,"undercount"
"1936",13193,"Georgia","Macon County","NHPI_AIC",28,9,-19,-102.7,"undercount"
"1937",13195,"Georgia","Madison County","A_A",605,531,-74,-13.03,"undercount"
"1938",13195,"Georgia","Madison County","A_AIC",708,647,-61,-9,"undercount"
"1939",13195,"Georgia","Madison County","NHPI_A",5,4,-1,-22.22,"undercount"
"1940",13195,"Georgia","Madison County","NHPI_AIC",26,17,-9,-41.86,"undercount"
"1941",13197,"Georgia","Marion County","A_A",75,55,-20,-30.77,"undercount"
"1942",13197,"Georgia","Marion County","A_AIC",106,84,-22,-23.16,"undercount"
"1943",13197,"Georgia","Marion County","NHPI_A",18,16,-2,-11.76,"undercount"
"1944",13197,"Georgia","Marion County","NHPI_AIC",27,36,9,28.57,"overcount"
"1945",13199,"Georgia","Meriwether County","A_A",137,78,-59,-54.88,"undercount"
"1946",13199,"Georgia","Meriwether County","A_AIC",181,117,-64,-42.95,"undercount"
"1947",13199,"Georgia","Meriwether County","NHPI_A",5,7,2,33.33,"overcount"
"1948",13199,"Georgia","Meriwether County","NHPI_AIC",19,20,1,5.13,"overcount"
"1949",13201,"Georgia","Miller County","A_A",31,26,-5,-17.54,"undercount"
"1950",13201,"Georgia","Miller County","A_AIC",54,41,-13,-27.37,"undercount"
"1951",13201,"Georgia","Miller County","NHPI_A",0,1,1,200,"overcount"
"1952",13201,"Georgia","Miller County","NHPI_AIC",2,3,1,40,"overcount"
"1953",13205,"Georgia","Mitchell County","A_A",178,108,-70,-48.95,"undercount"
"1954",13205,"Georgia","Mitchell County","A_AIC",225,152,-73,-38.73,"undercount"
"1955",13205,"Georgia","Mitchell County","NHPI_A",14,0,-14,-200,"undercount"
"1956",13205,"Georgia","Mitchell County","NHPI_AIC",24,21,-3,-13.33,"undercount"
"1957",13207,"Georgia","Monroe County","A_A",266,240,-26,-10.28,"undercount"
"1958",13207,"Georgia","Monroe County","A_AIC",332,328,-4,-1.21,"undercount"
"1959",13207,"Georgia","Monroe County","NHPI_A",9,0,-9,-200,"undercount"
"1960",13207,"Georgia","Monroe County","NHPI_AIC",26,14,-12,-60,"undercount"
"1961",13209,"Georgia","Montgomery County","A_A",57,34,-23,-50.55,"undercount"
"1962",13209,"Georgia","Montgomery County","A_AIC",75,42,-33,-56.41,"undercount"
"1963",13209,"Georgia","Montgomery County","NHPI_A",1,0,-1,-200,"undercount"
"1964",13209,"Georgia","Montgomery County","NHPI_AIC",2,6,4,100,"overcount"
"1965",13211,"Georgia","Morgan County","A_A",115,125,10,8.33,"overcount"
"1966",13211,"Georgia","Morgan County","A_AIC",170,194,24,13.19,"overcount"
"1967",13211,"Georgia","Morgan County","NHPI_A",2,1,-1,-66.67,"undercount"
"1968",13211,"Georgia","Morgan County","NHPI_AIC",11,8,-3,-31.58,"undercount"
"1969",13213,"Georgia","Murray County","A_A",178,140,-38,-23.9,"undercount"
"1970",13213,"Georgia","Murray County","A_AIC",268,205,-63,-26.64,"undercount"
"1971",13213,"Georgia","Murray County","NHPI_A",7,2,-5,-111.11,"undercount"
"1972",13213,"Georgia","Murray County","NHPI_AIC",24,17,-7,-34.15,"undercount"
"1973",13215,"Georgia","Muscogee County","A_A",5446,5601,155,2.81,"overcount"
"1974",13215,"Georgia","Muscogee County","A_AIC",7218,7814,596,7.93,"overcount"
"1975",13215,"Georgia","Muscogee County","NHPI_A",373,527,154,34.22,"overcount"
"1976",13215,"Georgia","Muscogee County","NHPI_AIC",683,939,256,31.57,"overcount"
"1977",13217,"Georgia","Newton County","A_A",1283,1063,-220,-18.76,"undercount"
"1978",13217,"Georgia","Newton County","A_AIC",1748,1531,-217,-13.24,"undercount"
"1979",13217,"Georgia","Newton County","NHPI_A",114,114,0,0,"equal"
"1980",13217,"Georgia","Newton County","NHPI_AIC",235,231,-4,-1.72,"undercount"
"1981",13219,"Georgia","Oconee County","A_A",1779,2080,301,15.6,"overcount"
"1982",13219,"Georgia","Oconee County","A_AIC",2047,2466,419,18.57,"overcount"
"1983",13219,"Georgia","Oconee County","NHPI_A",15,0,-15,-200,"undercount"
"1984",13219,"Georgia","Oconee County","NHPI_AIC",34,18,-16,-61.54,"undercount"
"1985",13221,"Georgia","Oglethorpe County","A_A",154,134,-20,-13.89,"undercount"
"1986",13221,"Georgia","Oglethorpe County","A_AIC",192,194,2,1.04,"overcount"
"1987",13221,"Georgia","Oglethorpe County","NHPI_A",2,5,3,85.71,"overcount"
"1988",13221,"Georgia","Oglethorpe County","NHPI_AIC",8,20,12,85.71,"overcount"
"1989",13223,"Georgia","Paulding County","A_A",2079,1993,-86,-4.22,"undercount"
"1990",13223,"Georgia","Paulding County","A_AIC",3090,3112,22,0.71,"overcount"
"1991",13223,"Georgia","Paulding County","NHPI_A",109,117,8,7.08,"overcount"
"1992",13223,"Georgia","Paulding County","NHPI_AIC",274,247,-27,-10.36,"undercount"
"1993",13225,"Georgia","Peach County","A_A",284,194,-90,-37.66,"undercount"
"1994",13225,"Georgia","Peach County","A_AIC",393,314,-79,-22.35,"undercount"
"1995",13225,"Georgia","Peach County","NHPI_A",8,6,-2,-28.57,"undercount"
"1996",13225,"Georgia","Peach County","NHPI_AIC",36,35,-1,-2.82,"undercount"
"1997",13227,"Georgia","Pickens County","A_A",261,194,-67,-29.45,"undercount"
"1998",13227,"Georgia","Pickens County","A_AIC",340,264,-76,-25.17,"undercount"
"1999",13227,"Georgia","Pickens County","NHPI_A",11,7,-4,-44.44,"undercount"
"2000",13227,"Georgia","Pickens County","NHPI_AIC",23,16,-7,-35.9,"undercount"
"2001",13229,"Georgia","Pierce County","A_A",120,82,-38,-37.62,"undercount"
"2002",13229,"Georgia","Pierce County","A_AIC",184,144,-40,-24.39,"undercount"
"2003",13229,"Georgia","Pierce County","NHPI_A",15,2,-13,-152.94,"undercount"
"2004",13229,"Georgia","Pierce County","NHPI_AIC",26,14,-12,-60,"undercount"
"2005",13231,"Georgia","Pike County","A_A",92,77,-15,-17.75,"undercount"
"2006",13231,"Georgia","Pike County","A_AIC",153,149,-4,-2.65,"undercount"
"2007",13231,"Georgia","Pike County","NHPI_A",4,0,-4,-200,"undercount"
"2008",13231,"Georgia","Pike County","NHPI_AIC",18,20,2,10.53,"overcount"
"2009",13233,"Georgia","Polk County","A_A",272,239,-33,-12.92,"undercount"
"2010",13233,"Georgia","Polk County","A_AIC",353,325,-28,-8.26,"undercount"
"2011",13233,"Georgia","Polk County","NHPI_A",24,24,0,0,"equal"
"2012",13233,"Georgia","Polk County","NHPI_AIC",43,42,-1,-2.35,"undercount"
"2013",13235,"Georgia","Pulaski County","A_A",130,103,-27,-23.18,"undercount"
"2014",13235,"Georgia","Pulaski County","A_AIC",163,123,-40,-27.97,"undercount"
"2015",13235,"Georgia","Pulaski County","NHPI_A",3,3,0,0,"equal"
"2016",13235,"Georgia","Pulaski County","NHPI_AIC",15,10,-5,-40,"undercount"
"2017",13237,"Georgia","Putnam County","A_A",117,117,0,0,"equal"
"2018",13237,"Georgia","Putnam County","A_AIC",180,175,-5,-2.82,"undercount"
"2019",13237,"Georgia","Putnam County","NHPI_A",10,2,-8,-133.33,"undercount"
"2020",13237,"Georgia","Putnam County","NHPI_AIC",26,17,-9,-41.86,"undercount"
"2021",13239,"Georgia","Quitman County","A_A",14,13,-1,-7.41,"undercount"
"2022",13239,"Georgia","Quitman County","A_AIC",21,17,-4,-21.05,"undercount"
"2023",13239,"Georgia","Quitman County","NHPI_A",0,0,0,0,"equal"
"2024",13239,"Georgia","Quitman County","NHPI_AIC",2,1,-1,-66.67,"undercount"
"2025",13241,"Georgia","Rabun County","A_A",165,60,-105,-93.33,"undercount"
"2026",13241,"Georgia","Rabun County","A_AIC",207,103,-104,-67.1,"undercount"
"2027",13241,"Georgia","Rabun County","NHPI_A",10,1,-9,-163.64,"undercount"
"2028",13241,"Georgia","Rabun County","NHPI_AIC",17,11,-6,-42.86,"undercount"
"2029",13243,"Georgia","Randolph County","A_A",32,21,-11,-41.51,"undercount"
"2030",13243,"Georgia","Randolph County","A_AIC",40,38,-2,-5.13,"undercount"
"2031",13243,"Georgia","Randolph County","NHPI_A",0,3,3,200,"overcount"
"2032",13243,"Georgia","Randolph County","NHPI_AIC",2,5,3,85.71,"overcount"
"2033",13245,"Georgia","Richmond County","A_A",3336,3984,648,17.7,"overcount"
"2034",13245,"Georgia","Richmond County","A_AIC",4924,5489,565,10.85,"overcount"
"2035",13245,"Georgia","Richmond County","NHPI_A",399,427,28,6.78,"overcount"
"2036",13245,"Georgia","Richmond County","NHPI_AIC",672,704,32,4.65,"overcount"
"2037",13247,"Georgia","Rockdale County","A_A",1495,1583,88,5.72,"overcount"
"2038",13247,"Georgia","Rockdale County","A_AIC",1995,1954,-41,-2.08,"undercount"
"2039",13247,"Georgia","Rockdale County","NHPI_A",106,75,-31,-34.25,"undercount"
"2040",13247,"Georgia","Rockdale County","NHPI_AIC",241,154,-87,-44.05,"undercount"
"2041",13249,"Georgia","Schley County","A_A",47,21,-26,-76.47,"undercount"
"2042",13249,"Georgia","Schley County","A_AIC",65,40,-25,-47.62,"undercount"
"2043",13249,"Georgia","Schley County","NHPI_A",0,2,2,200,"overcount"
"2044",13249,"Georgia","Schley County","NHPI_AIC",3,2,-1,-40,"undercount"
"2045",13251,"Georgia","Screven County","A_A",90,61,-29,-38.41,"undercount"
"2046",13251,"Georgia","Screven County","A_AIC",126,86,-40,-37.74,"undercount"
"2047",13251,"Georgia","Screven County","NHPI_A",2,3,1,40,"overcount"
"2048",13251,"Georgia","Screven County","NHPI_AIC",10,14,4,33.33,"overcount"
"2049",13253,"Georgia","Seminole County","A_A",65,61,-4,-6.35,"undercount"
"2050",13253,"Georgia","Seminole County","A_AIC",81,83,2,2.44,"overcount"
"2051",13253,"Georgia","Seminole County","NHPI_A",0,0,0,0,"equal"
"2052",13253,"Georgia","Seminole County","NHPI_AIC",4,3,-1,-28.57,"undercount"
"2053",13255,"Georgia","Spalding County","A_A",601,649,48,7.68,"overcount"
"2054",13255,"Georgia","Spalding County","A_AIC",814,835,21,2.55,"overcount"
"2055",13255,"Georgia","Spalding County","NHPI_A",52,27,-25,-63.29,"undercount"
"2056",13255,"Georgia","Spalding County","NHPI_AIC",114,58,-56,-65.12,"undercount"
"2057",13257,"Georgia","Stephens County","A_A",249,235,-14,-5.79,"undercount"
"2058",13257,"Georgia","Stephens County","A_AIC",334,309,-25,-7.78,"undercount"
"2059",13257,"Georgia","Stephens County","NHPI_A",46,9,-37,-134.55,"undercount"
"2060",13257,"Georgia","Stephens County","NHPI_AIC",65,27,-38,-82.61,"undercount"
"2061",13259,"Georgia","Stewart County","A_A",179,171,-8,-4.57,"undercount"
"2062",13259,"Georgia","Stewart County","A_AIC",198,182,-16,-8.42,"undercount"
"2063",13259,"Georgia","Stewart County","NHPI_A",1,5,4,133.33,"overcount"
"2064",13259,"Georgia","Stewart County","NHPI_AIC",3,15,12,133.33,"overcount"
"2065",13261,"Georgia","Sumter County","A_A",364,504,140,32.26,"overcount"
"2066",13261,"Georgia","Sumter County","A_AIC",424,585,161,31.91,"overcount"
"2067",13261,"Georgia","Sumter County","NHPI_A",9,4,-5,-76.92,"undercount"
"2068",13261,"Georgia","Sumter County","NHPI_AIC",34,37,3,8.45,"overcount"
"2069",13263,"Georgia","Talbot County","A_A",17,17,0,0,"equal"
"2070",13263,"Georgia","Talbot County","A_AIC",29,24,-5,-18.87,"undercount"
"2071",13263,"Georgia","Talbot County","NHPI_A",2,1,-1,-66.67,"undercount"
"2072",13263,"Georgia","Talbot County","NHPI_AIC",5,6,1,18.18,"overcount"
"2073",13265,"Georgia","Taliaferro County","A_A",22,6,-16,-114.29,"undercount"
"2074",13265,"Georgia","Taliaferro County","A_AIC",31,16,-15,-63.83,"undercount"
"2075",13265,"Georgia","Taliaferro County","NHPI_A",0,0,0,0,"equal"
"2076",13265,"Georgia","Taliaferro County","NHPI_AIC",3,4,1,28.57,"overcount"
"2077",13267,"Georgia","Tattnall County","A_A",153,127,-26,-18.57,"undercount"
"2078",13267,"Georgia","Tattnall County","A_AIC",198,189,-9,-4.65,"undercount"
"2079",13267,"Georgia","Tattnall County","NHPI_A",14,7,-7,-66.67,"undercount"
"2080",13267,"Georgia","Tattnall County","NHPI_AIC",22,29,7,27.45,"overcount"
"2081",13269,"Georgia","Taylor County","A_A",72,29,-43,-85.15,"undercount"
"2082",13269,"Georgia","Taylor County","A_AIC",91,39,-52,-80,"undercount"
"2083",13269,"Georgia","Taylor County","NHPI_A",1,2,1,66.67,"overcount"
"2084",13269,"Georgia","Taylor County","NHPI_AIC",6,10,4,50,"overcount"
"2085",13271,"Georgia","Telfair County","A_A",101,30,-71,-108.4,"undercount"
"2086",13271,"Georgia","Telfair County","A_AIC",147,41,-106,-112.77,"undercount"
"2087",13271,"Georgia","Telfair County","NHPI_A",3,0,-3,-200,"undercount"
"2088",13271,"Georgia","Telfair County","NHPI_AIC",16,3,-13,-136.84,"undercount"
"2089",13273,"Georgia","Terrell County","A_A",40,61,21,41.58,"overcount"
"2090",13273,"Georgia","Terrell County","A_AIC",70,85,15,19.35,"overcount"
"2091",13273,"Georgia","Terrell County","NHPI_A",0,1,1,200,"overcount"
"2092",13273,"Georgia","Terrell County","NHPI_AIC",10,15,5,40,"overcount"
"2093",13275,"Georgia","Thomas County","A_A",436,412,-24,-5.66,"undercount"
"2094",13275,"Georgia","Thomas County","A_AIC",549,527,-22,-4.09,"undercount"
"2095",13275,"Georgia","Thomas County","NHPI_A",18,9,-9,-66.67,"undercount"
"2096",13275,"Georgia","Thomas County","NHPI_AIC",45,26,-19,-53.52,"undercount"
"2097",13277,"Georgia","Tift County","A_A",588,653,65,10.48,"overcount"
"2098",13277,"Georgia","Tift County","A_AIC",701,789,88,11.81,"overcount"
"2099",13277,"Georgia","Tift County","NHPI_A",13,2,-11,-146.67,"undercount"
"2100",13277,"Georgia","Tift County","NHPI_AIC",44,7,-37,-145.1,"undercount"
"2101",13279,"Georgia","Toombs County","A_A",217,207,-10,-4.72,"undercount"
"2102",13279,"Georgia","Toombs County","A_AIC",273,264,-9,-3.35,"undercount"
"2103",13279,"Georgia","Toombs County","NHPI_A",23,6,-17,-117.24,"undercount"
"2104",13279,"Georgia","Toombs County","NHPI_AIC",43,9,-34,-130.77,"undercount"
"2105",13281,"Georgia","Towns County","A_A",125,81,-44,-42.72,"undercount"
"2106",13281,"Georgia","Towns County","A_AIC",150,113,-37,-28.14,"undercount"
"2107",13281,"Georgia","Towns County","NHPI_A",3,5,2,50,"overcount"
"2108",13281,"Georgia","Towns County","NHPI_AIC",7,17,10,83.33,"overcount"
"2109",13283,"Georgia","Treutlen County","A_A",24,8,-16,-100,"undercount"
"2110",13283,"Georgia","Treutlen County","A_AIC",35,23,-12,-41.38,"undercount"
"2111",13283,"Georgia","Treutlen County","NHPI_A",0,0,0,0,"equal"
"2112",13283,"Georgia","Treutlen County","NHPI_AIC",1,9,8,160,"overcount"
"2113",13285,"Georgia","Troup County","A_A",1659,1611,-48,-2.94,"undercount"
"2114",13285,"Georgia","Troup County","A_AIC",1859,1826,-33,-1.79,"undercount"
"2115",13285,"Georgia","Troup County","NHPI_A",49,36,-13,-30.59,"undercount"
"2116",13285,"Georgia","Troup County","NHPI_AIC",107,85,-22,-22.92,"undercount"
"2117",13287,"Georgia","Turner County","A_A",81,49,-32,-49.23,"undercount"
"2118",13287,"Georgia","Turner County","A_AIC",92,61,-31,-40.52,"undercount"
"2119",13287,"Georgia","Turner County","NHPI_A",9,0,-9,-200,"undercount"
"2120",13287,"Georgia","Turner County","NHPI_AIC",10,2,-8,-133.33,"undercount"
"2121",13289,"Georgia","Twiggs County","A_A",33,37,4,11.43,"overcount"
"2122",13289,"Georgia","Twiggs County","A_AIC",51,62,11,19.47,"overcount"
"2123",13289,"Georgia","Twiggs County","NHPI_A",3,0,-3,-200,"undercount"
"2124",13289,"Georgia","Twiggs County","NHPI_AIC",6,5,-1,-18.18,"undercount"
"2125",13291,"Georgia","Union County","A_A",114,100,-14,-13.08,"undercount"
"2126",13291,"Georgia","Union County","A_AIC",180,171,-9,-5.13,"undercount"
"2127",13291,"Georgia","Union County","NHPI_A",5,0,-5,-200,"undercount"
"2128",13291,"Georgia","Union County","NHPI_AIC",13,13,0,0,"equal"
"2129",13293,"Georgia","Upson County","A_A",158,157,-1,-0.63,"undercount"
"2130",13293,"Georgia","Upson County","A_AIC",220,232,12,5.31,"overcount"
"2131",13293,"Georgia","Upson County","NHPI_A",37,1,-36,-189.47,"undercount"
"2132",13293,"Georgia","Upson County","NHPI_AIC",53,15,-38,-111.76,"undercount"
"2133",13295,"Georgia","Walker County","A_A",507,301,-206,-50.99,"undercount"
"2134",13295,"Georgia","Walker County","A_AIC",646,494,-152,-26.67,"undercount"
"2135",13295,"Georgia","Walker County","NHPI_A",32,29,-3,-9.84,"undercount"
"2136",13295,"Georgia","Walker County","NHPI_AIC",59,61,2,3.33,"overcount"
"2137",13297,"Georgia","Walton County","A_A",1605,1453,-152,-9.94,"undercount"
"2138",13297,"Georgia","Walton County","A_AIC",2010,1965,-45,-2.26,"undercount"
"2139",13297,"Georgia","Walton County","NHPI_A",78,54,-24,-36.36,"undercount"
"2140",13297,"Georgia","Walton County","NHPI_AIC",162,122,-40,-28.17,"undercount"
"2141",13299,"Georgia","Ware County","A_A",420,337,-83,-21.93,"undercount"
"2142",13299,"Georgia","Ware County","A_AIC",516,405,-111,-24.1,"undercount"
"2143",13299,"Georgia","Ware County","NHPI_A",17,19,2,11.11,"overcount"
"2144",13299,"Georgia","Ware County","NHPI_AIC",41,34,-7,-18.67,"undercount"
"2145",13301,"Georgia","Warren County","A_A",33,15,-18,-75,"undercount"
"2146",13301,"Georgia","Warren County","A_AIC",40,26,-14,-42.42,"undercount"
"2147",13301,"Georgia","Warren County","NHPI_A",0,1,1,200,"overcount"
"2148",13301,"Georgia","Warren County","NHPI_AIC",3,4,1,28.57,"overcount"
"2149",13303,"Georgia","Washington County","A_A",117,76,-41,-42.49,"undercount"
"2150",13303,"Georgia","Washington County","A_AIC",145,99,-46,-37.7,"undercount"
"2151",13303,"Georgia","Washington County","NHPI_A",2,0,-2,-200,"undercount"
"2152",13303,"Georgia","Washington County","NHPI_AIC",11,13,2,16.67,"overcount"
"2153",13305,"Georgia","Wayne County","A_A",218,174,-44,-22.45,"undercount"
"2154",13305,"Georgia","Wayne County","A_AIC",306,275,-31,-10.67,"undercount"
"2155",13305,"Georgia","Wayne County","NHPI_A",15,5,-10,-100,"undercount"
"2156",13305,"Georgia","Wayne County","NHPI_AIC",38,25,-13,-41.27,"undercount"
"2157",13307,"Georgia","Webster County","A_A",14,12,-2,-15.38,"undercount"
"2158",13307,"Georgia","Webster County","A_AIC",17,21,4,21.05,"overcount"
"2159",13307,"Georgia","Webster County","NHPI_A",0,6,6,200,"overcount"
"2160",13307,"Georgia","Webster County","NHPI_AIC",1,17,16,177.78,"overcount"
"2161",13309,"Georgia","Wheeler County","A_A",26,17,-9,-41.86,"undercount"
"2162",13309,"Georgia","Wheeler County","A_AIC",40,28,-12,-35.29,"undercount"
"2163",13309,"Georgia","Wheeler County","NHPI_A",0,0,0,0,"equal"
"2164",13309,"Georgia","Wheeler County","NHPI_AIC",2,8,6,120,"overcount"
"2165",13311,"Georgia","White County","A_A",179,159,-20,-11.83,"undercount"
"2166",13311,"Georgia","White County","A_AIC",218,263,45,18.71,"overcount"
"2167",13311,"Georgia","White County","NHPI_A",21,2,-19,-165.22,"undercount"
"2168",13311,"Georgia","White County","NHPI_AIC",34,8,-26,-123.81,"undercount"
"2169",13313,"Georgia","Whitfield County","A_A",1500,1427,-73,-4.99,"undercount"
"2170",13313,"Georgia","Whitfield County","A_AIC",1739,1686,-53,-3.09,"undercount"
"2171",13313,"Georgia","Whitfield County","NHPI_A",58,19,-39,-101.3,"undercount"
"2172",13313,"Georgia","Whitfield County","NHPI_AIC",99,46,-53,-73.1,"undercount"
"2173",13315,"Georgia","Wilcox County","A_A",81,53,-28,-41.79,"undercount"
"2174",13315,"Georgia","Wilcox County","A_AIC",94,73,-21,-25.15,"undercount"
"2175",13315,"Georgia","Wilcox County","NHPI_A",1,4,3,120,"overcount"
"2176",13315,"Georgia","Wilcox County","NHPI_AIC",6,13,7,73.68,"overcount"
"2177",13317,"Georgia","Wilkes County","A_A",72,59,-13,-19.85,"undercount"
"2178",13317,"Georgia","Wilkes County","A_AIC",86,79,-7,-8.48,"undercount"
"2179",13317,"Georgia","Wilkes County","NHPI_A",2,0,-2,-200,"undercount"
"2180",13317,"Georgia","Wilkes County","NHPI_AIC",4,12,8,100,"overcount"
"2181",13319,"Georgia","Wilkinson County","A_A",37,22,-15,-50.85,"undercount"
"2182",13319,"Georgia","Wilkinson County","A_AIC",57,46,-11,-21.36,"undercount"
"2183",13319,"Georgia","Wilkinson County","NHPI_A",1,3,2,100,"overcount"
"2184",13319,"Georgia","Wilkinson County","NHPI_AIC",5,11,6,75,"overcount"
"2185",13321,"Georgia","Worth County","A_A",161,87,-74,-59.68,"undercount"
"2186",13321,"Georgia","Worth County","A_AIC",200,136,-64,-38.1,"undercount"
"2187",13321,"Georgia","Worth County","NHPI_A",12,10,-2,-18.18,"undercount"
"2188",13321,"Georgia","Worth County","NHPI_AIC",19,15,-4,-23.53,"undercount"
"2189",15001,"Hawaii","Hawaii County","A_A",40086,38632,-1454,-3.69,"undercount"
"2190",15001,"Hawaii","Hawaii County","A_AIC",78597,73414,-5183,-6.82,"undercount"
"2191",15001,"Hawaii","Hawaii County","NHPI_A",24195,26362,2167,8.57,"overcount"
"2192",15001,"Hawaii","Hawaii County","NHPI_AIC",59892,59152,-740,-1.24,"undercount"
"2193",15003,"Hawaii","Honolulu County","A_A",397745,431044,33299,8.04,"overcount"
"2194",15003,"Hawaii","Honolulu County","A_AIC",549077,593111,44034,7.71,"overcount"
"2195",15003,"Hawaii","Honolulu County","NHPI_A",89607,97596,7989,8.54,"overcount"
"2196",15003,"Hawaii","Honolulu County","NHPI_AIC",212713,228009,15296,6.94,"overcount"
"2197",15005,"Hawaii","Kalawao County","A_A",7,10,3,35.29,"overcount"
"2198",15005,"Hawaii","Kalawao County","A_AIC",14,14,0,0,"equal"
"2199",15005,"Hawaii","Kalawao County","NHPI_A",42,15,-27,-94.74,"undercount"
"2200",15005,"Hawaii","Kalawao County","NHPI_AIC",44,18,-26,-83.87,"undercount"
"2201",15007,"Hawaii","Kauai County","A_A",20857,20597,-260,-1.25,"undercount"
"2202",15007,"Hawaii","Kauai County","A_AIC",32960,32995,35,0.11,"overcount"
"2203",15007,"Hawaii","Kauai County","NHPI_A",6109,6884,775,11.93,"overcount"
"2204",15007,"Hawaii","Kauai County","NHPI_AIC",16213,17328,1115,6.65,"overcount"
"2205",15009,"Hawaii","Maui County","A_A",46349,43508,-2841,-6.32,"undercount"
"2206",15009,"Hawaii","Maui County","A_AIC",73237,67377,-5860,-8.33,"undercount"
"2207",15009,"Hawaii","Maui County","NHPI_A",16404,19092,2688,15.15,"overcount"
"2208",15009,"Hawaii","Maui County","NHPI_AIC",40902,40713,-189,-0.46,"undercount"
"2209",16001,"Idaho","Ada County","A_A",13438,13850,412,3.02,"overcount"
"2210",16001,"Idaho","Ada County","A_AIC",20176,21358,1182,5.69,"overcount"
"2211",16001,"Idaho","Ada County","NHPI_A",995,1240,245,21.92,"overcount"
"2212",16001,"Idaho","Ada County","NHPI_AIC",2223,2722,499,20.18,"overcount"
"2213",16003,"Idaho","Adams County","A_A",40,8,-32,-133.33,"undercount"
"2214",16003,"Idaho","Adams County","A_AIC",59,22,-37,-91.36,"undercount"
"2215",16003,"Idaho","Adams County","NHPI_A",19,0,-19,-200,"undercount"
"2216",16003,"Idaho","Adams County","NHPI_AIC",22,2,-20,-166.67,"undercount"
"2217",16005,"Idaho","Bannock County","A_A",1451,1159,-292,-22.38,"undercount"
"2218",16005,"Idaho","Bannock County","A_AIC",2193,1994,-199,-9.51,"undercount"
"2219",16005,"Idaho","Bannock County","NHPI_A",215,249,34,14.66,"overcount"
"2220",16005,"Idaho","Bannock County","NHPI_AIC",421,539,118,24.58,"overcount"
"2221",16007,"Idaho","Bear Lake County","A_A",27,13,-14,-70,"undercount"
"2222",16007,"Idaho","Bear Lake County","A_AIC",47,40,-7,-16.09,"undercount"
"2223",16007,"Idaho","Bear Lake County","NHPI_A",3,2,-1,-40,"undercount"
"2224",16007,"Idaho","Bear Lake County","NHPI_AIC",6,6,0,0,"equal"
"2225",16009,"Idaho","Benewah County","A_A",28,30,2,6.9,"overcount"
"2226",16009,"Idaho","Benewah County","A_AIC",83,58,-25,-35.46,"undercount"
"2227",16009,"Idaho","Benewah County","NHPI_A",7,15,8,72.73,"overcount"
"2228",16009,"Idaho","Benewah County","NHPI_AIC",22,35,13,45.61,"overcount"
"2229",16011,"Idaho","Bingham County","A_A",356,192,-164,-59.85,"undercount"
"2230",16011,"Idaho","Bingham County","A_AIC",580,479,-101,-19.07,"undercount"
"2231",16011,"Idaho","Bingham County","NHPI_A",73,38,-35,-63.06,"undercount"
"2232",16011,"Idaho","Bingham County","NHPI_AIC",123,121,-2,-1.64,"undercount"
"2233",16013,"Idaho","Blaine County","A_A",237,211,-26,-11.61,"undercount"
"2234",16013,"Idaho","Blaine County","A_AIC",322,368,46,13.33,"overcount"
"2235",16013,"Idaho","Blaine County","NHPI_A",20,22,2,9.52,"overcount"
"2236",16013,"Idaho","Blaine County","NHPI_AIC",37,63,26,52,"overcount"
"2237",16015,"Idaho","Boise County","A_A",111,39,-72,-96,"undercount"
"2238",16015,"Idaho","Boise County","A_AIC",142,80,-62,-55.86,"undercount"
"2239",16015,"Idaho","Boise County","NHPI_A",17,4,-13,-123.81,"undercount"
"2240",16015,"Idaho","Boise County","NHPI_AIC",23,20,-3,-13.95,"undercount"
"2241",16017,"Idaho","Bonner County","A_A",307,260,-47,-16.58,"undercount"
"2242",16017,"Idaho","Bonner County","A_AIC",562,550,-12,-2.16,"undercount"
"2243",16017,"Idaho","Bonner County","NHPI_A",57,39,-18,-37.5,"undercount"
"2244",16017,"Idaho","Bonner County","NHPI_AIC",103,127,24,20.87,"overcount"
"2245",16019,"Idaho","Bonneville County","A_A",1348,1409,61,4.43,"overcount"
"2246",16019,"Idaho","Bonneville County","A_AIC",2062,2313,251,11.47,"overcount"
"2247",16019,"Idaho","Bonneville County","NHPI_A",153,151,-2,-1.32,"undercount"
"2248",16019,"Idaho","Bonneville County","NHPI_AIC",320,399,79,21.97,"overcount"
"2249",16021,"Idaho","Boundary County","A_A",142,72,-70,-65.42,"undercount"
"2250",16021,"Idaho","Boundary County","A_AIC",197,158,-39,-21.97,"undercount"
"2251",16021,"Idaho","Boundary County","NHPI_A",13,9,-4,-36.36,"undercount"
"2252",16021,"Idaho","Boundary County","NHPI_AIC",33,34,1,2.99,"overcount"
"2253",16023,"Idaho","Butte County","A_A",9,4,-5,-76.92,"undercount"
"2254",16023,"Idaho","Butte County","A_AIC",18,8,-10,-76.92,"undercount"
"2255",16023,"Idaho","Butte County","NHPI_A",5,2,-3,-85.71,"undercount"
"2256",16023,"Idaho","Butte County","NHPI_AIC",10,4,-6,-85.71,"undercount"
"2257",16025,"Idaho","Camas County","A_A",4,8,4,66.67,"overcount"
"2258",16025,"Idaho","Camas County","A_AIC",11,22,11,66.67,"overcount"
"2259",16025,"Idaho","Camas County","NHPI_A",0,0,0,0,"equal"
"2260",16025,"Idaho","Camas County","NHPI_AIC",2,3,1,40,"overcount"
"2261",16027,"Idaho","Canyon County","A_A",2132,2002,-130,-6.29,"undercount"
"2262",16027,"Idaho","Canyon County","A_AIC",4027,4197,170,4.13,"overcount"
"2263",16027,"Idaho","Canyon County","NHPI_A",575,628,53,8.81,"overcount"
"2264",16027,"Idaho","Canyon County","NHPI_AIC",1037,1249,212,18.55,"overcount"
"2265",16029,"Idaho","Caribou County","A_A",25,10,-15,-85.71,"undercount"
"2266",16029,"Idaho","Caribou County","A_AIC",44,25,-19,-55.07,"undercount"
"2267",16029,"Idaho","Caribou County","NHPI_A",20,15,-5,-28.57,"undercount"
"2268",16029,"Idaho","Caribou County","NHPI_AIC",25,44,19,55.07,"overcount"
"2269",16031,"Idaho","Cassia County","A_A",149,160,11,7.12,"overcount"
"2270",16031,"Idaho","Cassia County","A_AIC",238,275,37,14.42,"overcount"
"2271",16031,"Idaho","Cassia County","NHPI_A",46,29,-17,-45.33,"undercount"
"2272",16031,"Idaho","Cassia County","NHPI_AIC",76,67,-9,-12.59,"undercount"
"2273",16033,"Idaho","Clark County","A_A",4,1,-3,-120,"undercount"
"2274",16033,"Idaho","Clark County","A_AIC",7,11,4,44.44,"overcount"
"2275",16033,"Idaho","Clark County","NHPI_A",2,0,-2,-200,"undercount"
"2276",16033,"Idaho","Clark County","NHPI_AIC",4,5,1,22.22,"overcount"
"2277",16035,"Idaho","Clearwater County","A_A",70,46,-24,-41.38,"undercount"
"2278",16035,"Idaho","Clearwater County","A_AIC",106,81,-25,-26.74,"undercount"
"2279",16035,"Idaho","Clearwater County","NHPI_A",27,5,-22,-137.5,"undercount"
"2280",16035,"Idaho","Clearwater County","NHPI_AIC",38,24,-14,-45.16,"undercount"
"2281",16037,"Idaho","Custer County","A_A",14,16,2,13.33,"overcount"
"2282",16037,"Idaho","Custer County","A_AIC",31,35,4,12.12,"overcount"
"2283",16037,"Idaho","Custer County","NHPI_A",2,3,1,40,"overcount"
"2284",16037,"Idaho","Custer County","NHPI_AIC",6,14,8,80,"overcount"
"2285",16039,"Idaho","Elmore County","A_A",719,776,57,7.63,"overcount"
"2286",16039,"Idaho","Elmore County","A_AIC",1112,1179,67,5.85,"overcount"
"2287",16039,"Idaho","Elmore County","NHPI_A",92,105,13,13.2,"overcount"
"2288",16039,"Idaho","Elmore County","NHPI_AIC",180,219,39,19.55,"overcount"
"2289",16041,"Idaho","Franklin County","A_A",34,29,-5,-15.87,"undercount"
"2290",16041,"Idaho","Franklin County","A_AIC",71,96,25,29.94,"overcount"
"2291",16041,"Idaho","Franklin County","NHPI_A",12,7,-5,-52.63,"undercount"
"2292",16041,"Idaho","Franklin County","NHPI_AIC",34,49,15,36.14,"overcount"
"2293",16043,"Idaho","Fremont County","A_A",45,49,4,8.51,"overcount"
"2294",16043,"Idaho","Fremont County","A_AIC",73,102,29,33.14,"overcount"
"2295",16043,"Idaho","Fremont County","NHPI_A",57,24,-33,-81.48,"undercount"
"2296",16043,"Idaho","Fremont County","NHPI_AIC",64,37,-27,-53.47,"undercount"
"2297",16045,"Idaho","Gem County","A_A",172,99,-73,-53.87,"undercount"
"2298",16045,"Idaho","Gem County","A_AIC",267,243,-24,-9.41,"undercount"
"2299",16045,"Idaho","Gem County","NHPI_A",32,20,-12,-46.15,"undercount"
"2300",16045,"Idaho","Gem County","NHPI_AIC",62,55,-7,-11.97,"undercount"
"2301",16047,"Idaho","Gooding County","A_A",92,45,-47,-68.61,"undercount"
"2302",16047,"Idaho","Gooding County","A_AIC",160,114,-46,-33.58,"undercount"
"2303",16047,"Idaho","Gooding County","NHPI_A",13,7,-6,-60,"undercount"
"2304",16047,"Idaho","Gooding County","NHPI_AIC",25,36,11,36.07,"overcount"
"2305",16049,"Idaho","Idaho County","A_A",88,59,-29,-39.46,"undercount"
"2306",16049,"Idaho","Idaho County","A_AIC",146,154,8,5.33,"overcount"
"2307",16049,"Idaho","Idaho County","NHPI_A",10,5,-5,-66.67,"undercount"
"2308",16049,"Idaho","Idaho County","NHPI_AIC",39,49,10,22.73,"overcount"
"2309",16051,"Idaho","Jefferson County","A_A",165,119,-46,-32.39,"undercount"
"2310",16051,"Idaho","Jefferson County","A_AIC",317,290,-27,-8.9,"undercount"
"2311",16051,"Idaho","Jefferson County","NHPI_A",39,30,-9,-26.09,"undercount"
"2312",16051,"Idaho","Jefferson County","NHPI_AIC",86,97,11,12.02,"overcount"
"2313",16053,"Idaho","Jerome County","A_A",88,80,-8,-9.52,"undercount"
"2314",16053,"Idaho","Jerome County","A_AIC",150,152,2,1.32,"overcount"
"2315",16053,"Idaho","Jerome County","NHPI_A",37,24,-13,-42.62,"undercount"
"2316",16053,"Idaho","Jerome County","NHPI_AIC",55,54,-1,-1.83,"undercount"
"2317",16055,"Idaho","Kootenai County","A_A",1537,1376,-161,-11.05,"undercount"
"2318",16055,"Idaho","Kootenai County","A_AIC",2822,3141,319,10.7,"overcount"
"2319",16055,"Idaho","Kootenai County","NHPI_A",238,195,-43,-19.86,"undercount"
"2320",16055,"Idaho","Kootenai County","NHPI_AIC",564,684,120,19.23,"overcount"
"2321",16057,"Idaho","Latah County","A_A",997,994,-3,-0.3,"undercount"
"2322",16057,"Idaho","Latah County","A_AIC",1460,1526,66,4.42,"overcount"
"2323",16057,"Idaho","Latah County","NHPI_A",53,48,-5,-9.9,"undercount"
"2324",16057,"Idaho","Latah County","NHPI_AIC",126,145,19,14.02,"overcount"
"2325",16059,"Idaho","Lemhi County","A_A",28,28,0,0,"equal"
"2326",16059,"Idaho","Lemhi County","A_AIC",54,41,-13,-27.37,"undercount"
"2327",16059,"Idaho","Lemhi County","NHPI_A",2,6,4,100,"overcount"
"2328",16059,"Idaho","Lemhi County","NHPI_AIC",12,13,1,8,"overcount"
"2329",16061,"Idaho","Lewis County","A_A",52,11,-41,-130.16,"undercount"
"2330",16061,"Idaho","Lewis County","A_AIC",81,30,-51,-91.89,"undercount"
"2331",16061,"Idaho","Lewis County","NHPI_A",10,1,-9,-163.64,"undercount"
"2332",16061,"Idaho","Lewis County","NHPI_AIC",18,11,-7,-48.28,"undercount"
"2333",16063,"Idaho","Lincoln County","A_A",16,10,-6,-46.15,"undercount"
"2334",16063,"Idaho","Lincoln County","A_AIC",38,47,9,21.18,"overcount"
"2335",16063,"Idaho","Lincoln County","NHPI_A",10,5,-5,-66.67,"undercount"
"2336",16063,"Idaho","Lincoln County","NHPI_AIC",20,18,-2,-10.53,"undercount"
"2337",16065,"Idaho","Madison County","A_A",588,937,349,45.77,"overcount"
"2338",16065,"Idaho","Madison County","A_AIC",906,1422,516,44.33,"overcount"
"2339",16065,"Idaho","Madison County","NHPI_A",105,215,110,68.75,"overcount"
"2340",16065,"Idaho","Madison County","NHPI_AIC",210,421,211,66.88,"overcount"
"2341",16067,"Idaho","Minidoka County","A_A",87,53,-34,-48.57,"undercount"
"2342",16067,"Idaho","Minidoka County","A_AIC",156,165,9,5.61,"overcount"
"2343",16067,"Idaho","Minidoka County","NHPI_A",7,12,5,52.63,"overcount"
"2344",16067,"Idaho","Minidoka County","NHPI_AIC",36,37,1,2.74,"overcount"
"2345",16069,"Idaho","Nez Perce County","A_A",356,326,-30,-8.8,"undercount"
"2346",16069,"Idaho","Nez Perce County","A_AIC",611,642,31,4.95,"overcount"
"2347",16069,"Idaho","Nez Perce County","NHPI_A",58,32,-26,-57.78,"undercount"
"2348",16069,"Idaho","Nez Perce County","NHPI_AIC",133,134,1,0.75,"overcount"
"2349",16071,"Idaho","Oneida County","A_A",26,16,-10,-47.62,"undercount"
"2350",16071,"Idaho","Oneida County","A_AIC",39,35,-4,-10.81,"undercount"
"2351",16071,"Idaho","Oneida County","NHPI_A",3,4,1,28.57,"overcount"
"2352",16071,"Idaho","Oneida County","NHPI_AIC",7,11,4,44.44,"overcount"
"2353",16073,"Idaho","Owyhee County","A_A",69,42,-27,-48.65,"undercount"
"2354",16073,"Idaho","Owyhee County","A_AIC",115,89,-26,-25.49,"undercount"
"2355",16073,"Idaho","Owyhee County","NHPI_A",6,8,2,28.57,"overcount"
"2356",16073,"Idaho","Owyhee County","NHPI_AIC",15,22,7,37.84,"overcount"
"2357",16075,"Idaho","Payette County","A_A",222,207,-15,-6.99,"undercount"
"2358",16075,"Idaho","Payette County","A_AIC",404,428,24,5.77,"overcount"
"2359",16075,"Idaho","Payette County","NHPI_A",19,31,12,48,"overcount"
"2360",16075,"Idaho","Payette County","NHPI_AIC",62,67,5,7.75,"overcount"
"2361",16077,"Idaho","Power County","A_A",35,19,-16,-59.26,"undercount"
"2362",16077,"Idaho","Power County","A_AIC",63,46,-17,-31.19,"undercount"
"2363",16077,"Idaho","Power County","NHPI_A",9,8,-1,-11.76,"undercount"
"2364",16077,"Idaho","Power County","NHPI_AIC",21,31,10,38.46,"overcount"
"2365",16079,"Idaho","Shoshone County","A_A",73,53,-20,-31.75,"undercount"
"2366",16079,"Idaho","Shoshone County","A_AIC",119,103,-16,-14.41,"undercount"
"2367",16079,"Idaho","Shoshone County","NHPI_A",7,6,-1,-15.38,"undercount"
"2368",16079,"Idaho","Shoshone County","NHPI_AIC",28,20,-8,-33.33,"undercount"
"2369",16081,"Idaho","Teton County","A_A",78,54,-24,-36.36,"undercount"
"2370",16081,"Idaho","Teton County","A_AIC",104,126,22,19.13,"overcount"
"2371",16081,"Idaho","Teton County","NHPI_A",13,0,-13,-200,"undercount"
"2372",16081,"Idaho","Teton County","NHPI_AIC",20,17,-3,-16.22,"undercount"
"2373",16083,"Idaho","Twin Falls County","A_A",1489,1424,-65,-4.46,"undercount"
"2374",16083,"Idaho","Twin Falls County","A_AIC",1981,2099,118,5.78,"overcount"
"2375",16083,"Idaho","Twin Falls County","NHPI_A",181,201,20,10.47,"overcount"
"2376",16083,"Idaho","Twin Falls County","NHPI_AIC",279,345,66,21.15,"overcount"
"2377",16085,"Idaho","Valley County","A_A",62,55,-7,-11.97,"undercount"
"2378",16085,"Idaho","Valley County","A_AIC",106,106,0,0,"equal"
"2379",16085,"Idaho","Valley County","NHPI_A",9,8,-1,-11.76,"undercount"
"2380",16085,"Idaho","Valley County","NHPI_AIC",18,29,11,46.81,"overcount"
"2381",16087,"Idaho","Washington County","A_A",85,81,-4,-4.82,"undercount"
"2382",16087,"Idaho","Washington County","A_AIC",122,163,41,28.77,"overcount"
"2383",16087,"Idaho","Washington County","NHPI_A",4,7,3,54.55,"overcount"
"2384",16087,"Idaho","Washington County","NHPI_AIC",9,26,17,97.14,"overcount"
"2385",17001,"Illinois","Adams County","A_A",579,500,-79,-14.64,"undercount"
"2386",17001,"Illinois","Adams County","A_AIC",789,743,-46,-6.01,"undercount"
"2387",17001,"Illinois","Adams County","NHPI_A",24,33,9,31.58,"overcount"
"2388",17001,"Illinois","Adams County","NHPI_AIC",56,102,46,58.23,"overcount"
"2389",17003,"Illinois","Alexander County","A_A",16,6,-10,-90.91,"undercount"
"2390",17003,"Illinois","Alexander County","A_AIC",31,17,-14,-58.33,"undercount"
"2391",17003,"Illinois","Alexander County","NHPI_A",10,0,-10,-200,"undercount"
"2392",17003,"Illinois","Alexander County","NHPI_AIC",14,3,-11,-129.41,"undercount"
"2393",17005,"Illinois","Bond County","A_A",129,94,-35,-31.39,"undercount"
"2394",17005,"Illinois","Bond County","A_AIC",186,143,-43,-26.14,"undercount"
"2395",17005,"Illinois","Bond County","NHPI_A",3,11,8,114.29,"overcount"
"2396",17005,"Illinois","Bond County","NHPI_AIC",12,27,15,76.92,"overcount"
"2397",17007,"Illinois","Boone County","A_A",661,644,-17,-2.61,"undercount"
"2398",17007,"Illinois","Boone County","A_AIC",891,938,47,5.14,"overcount"
"2399",17007,"Illinois","Boone County","NHPI_A",15,10,-5,-40,"undercount"
"2400",17007,"Illinois","Boone County","NHPI_AIC",35,37,2,5.56,"overcount"
"2401",17009,"Illinois","Brown County","A_A",15,11,-4,-30.77,"undercount"
"2402",17009,"Illinois","Brown County","A_AIC",21,34,13,47.27,"overcount"
"2403",17009,"Illinois","Brown County","NHPI_A",3,0,-3,-200,"undercount"
"2404",17009,"Illinois","Brown County","NHPI_AIC",5,14,9,94.74,"overcount"
"2405",17011,"Illinois","Bureau County","A_A",326,298,-28,-8.97,"undercount"
"2406",17011,"Illinois","Bureau County","A_AIC",391,399,8,2.03,"overcount"
"2407",17011,"Illinois","Bureau County","NHPI_A",10,21,11,70.97,"overcount"
"2408",17011,"Illinois","Bureau County","NHPI_AIC",18,42,24,80,"overcount"
"2409",17013,"Illinois","Calhoun County","A_A",14,7,-7,-66.67,"undercount"
"2410",17013,"Illinois","Calhoun County","A_AIC",19,20,1,5.13,"overcount"
"2411",17013,"Illinois","Calhoun County","NHPI_A",2,0,-2,-200,"undercount"
"2412",17013,"Illinois","Calhoun County","NHPI_AIC",5,7,2,33.33,"overcount"
"2413",17015,"Illinois","Carroll County","A_A",90,40,-50,-76.92,"undercount"
"2414",17015,"Illinois","Carroll County","A_AIC",144,89,-55,-47.21,"undercount"
"2415",17015,"Illinois","Carroll County","NHPI_A",3,8,5,90.91,"overcount"
"2416",17015,"Illinois","Carroll County","NHPI_AIC",11,26,15,81.08,"overcount"
"2417",17017,"Illinois","Cass County","A_A",81,117,36,36.36,"overcount"
"2418",17017,"Illinois","Cass County","A_AIC",98,135,37,31.76,"overcount"
"2419",17017,"Illinois","Cass County","NHPI_A",11,33,22,100,"overcount"
"2420",17017,"Illinois","Cass County","NHPI_AIC",15,38,23,86.79,"overcount"
"2421",17019,"Illinois","Champaign County","A_A",22325,24569,2244,9.57,"overcount"
"2422",17019,"Illinois","Champaign County","A_AIC",24905,27147,2242,8.61,"overcount"
"2423",17019,"Illinois","Champaign County","NHPI_A",160,69,-91,-79.48,"undercount"
"2424",17019,"Illinois","Champaign County","NHPI_AIC",443,282,-161,-44.41,"undercount"
"2425",17021,"Illinois","Christian County","A_A",238,181,-57,-27.21,"undercount"
"2426",17021,"Illinois","Christian County","A_AIC",298,270,-28,-9.86,"undercount"
"2427",17021,"Illinois","Christian County","NHPI_A",10,1,-9,-163.64,"undercount"
"2428",17021,"Illinois","Christian County","NHPI_AIC",17,14,-3,-19.35,"undercount"
"2429",17023,"Illinois","Clark County","A_A",55,53,-2,-3.7,"undercount"
"2430",17023,"Illinois","Clark County","A_AIC",84,90,6,6.9,"overcount"
"2431",17023,"Illinois","Clark County","NHPI_A",5,0,-5,-200,"undercount"
"2432",17023,"Illinois","Clark County","NHPI_AIC",9,10,1,10.53,"overcount"
"2433",17025,"Illinois","Clay County","A_A",112,80,-32,-33.33,"undercount"
"2434",17025,"Illinois","Clay County","A_AIC",138,108,-30,-24.39,"undercount"
"2435",17025,"Illinois","Clay County","NHPI_A",0,0,0,0,"equal"
"2436",17025,"Illinois","Clay County","NHPI_AIC",3,6,3,66.67,"overcount"
"2437",17027,"Illinois","Clinton County","A_A",220,181,-39,-19.45,"undercount"
"2438",17027,"Illinois","Clinton County","A_AIC",365,352,-13,-3.63,"undercount"
"2439",17027,"Illinois","Clinton County","NHPI_A",13,5,-8,-88.89,"undercount"
"2440",17027,"Illinois","Clinton County","NHPI_AIC",24,33,9,31.58,"overcount"
"2441",17029,"Illinois","Coles County","A_A",481,618,137,24.93,"overcount"
"2442",17029,"Illinois","Coles County","A_AIC",677,852,175,22.89,"overcount"
"2443",17029,"Illinois","Coles County","NHPI_A",15,24,9,46.15,"overcount"
"2444",17029,"Illinois","Coles County","NHPI_AIC",48,63,15,27.03,"overcount"
"2445",17031,"Illinois","Cook County","A_A",403784,411944,8160,2,"overcount"
"2446",17031,"Illinois","Cook County","A_AIC",442453,460698,18245,4.04,"overcount"
"2447",17031,"Illinois","Cook County","NHPI_A",961,1107,146,14.12,"overcount"
"2448",17031,"Illinois","Cook County","NHPI_AIC",4568,4342,-226,-5.07,"undercount"
"2449",17033,"Illinois","Crawford County","A_A",107,76,-31,-33.88,"undercount"
"2450",17033,"Illinois","Crawford County","A_AIC",156,157,1,0.64,"overcount"
"2451",17033,"Illinois","Crawford County","NHPI_A",7,2,-5,-111.11,"undercount"
"2452",17033,"Illinois","Crawford County","NHPI_AIC",14,14,0,0,"equal"
"2453",17035,"Illinois","Cumberland County","A_A",64,21,-43,-101.18,"undercount"
"2454",17035,"Illinois","Cumberland County","A_AIC",88,29,-59,-100.85,"undercount"
"2455",17035,"Illinois","Cumberland County","NHPI_A",8,0,-8,-200,"undercount"
"2456",17035,"Illinois","Cumberland County","NHPI_AIC",8,5,-3,-46.15,"undercount"
"2457",17037,"Illinois","DeKalb County","A_A",2719,2297,-422,-16.83,"undercount"
"2458",17037,"Illinois","DeKalb County","A_AIC",3406,3055,-351,-10.87,"undercount"
"2459",17037,"Illinois","DeKalb County","NHPI_A",51,29,-22,-55,"undercount"
"2460",17037,"Illinois","DeKalb County","NHPI_AIC",117,105,-12,-10.81,"undercount"
"2461",17039,"Illinois","De Witt County","A_A",67,44,-23,-41.44,"undercount"
"2462",17039,"Illinois","De Witt County","A_AIC",112,110,-2,-1.8,"undercount"
"2463",17039,"Illinois","De Witt County","NHPI_A",7,16,9,78.26,"overcount"
"2464",17039,"Illinois","De Witt County","NHPI_AIC",15,42,27,94.74,"overcount"
"2465",17041,"Illinois","Douglas County","A_A",131,103,-28,-23.93,"undercount"
"2466",17041,"Illinois","Douglas County","A_AIC",180,157,-23,-13.65,"undercount"
"2467",17041,"Illinois","Douglas County","NHPI_A",0,6,6,200,"overcount"
"2468",17041,"Illinois","Douglas County","NHPI_AIC",7,25,18,112.5,"overcount"
"2469",17043,"Illinois","DuPage County","A_A",118600,119903,1303,1.09,"overcount"
"2470",17043,"Illinois","DuPage County","A_AIC",127861,131392,3531,2.72,"overcount"
"2471",17043,"Illinois","DuPage County","NHPI_A",231,232,1,0.43,"overcount"
"2472",17043,"Illinois","DuPage County","NHPI_AIC",965,984,19,1.95,"overcount"
"2473",17045,"Illinois","Edgar County","A_A",65,51,-14,-24.14,"undercount"
"2474",17045,"Illinois","Edgar County","A_AIC",84,82,-2,-2.41,"undercount"
"2475",17045,"Illinois","Edgar County","NHPI_A",4,0,-4,-200,"undercount"
"2476",17045,"Illinois","Edgar County","NHPI_AIC",8,14,6,54.55,"overcount"
"2477",17047,"Illinois","Edwards County","A_A",28,25,-3,-11.32,"undercount"
"2478",17047,"Illinois","Edwards County","A_AIC",45,42,-3,-6.9,"undercount"
"2479",17047,"Illinois","Edwards County","NHPI_A",0,4,4,200,"overcount"
"2480",17047,"Illinois","Edwards County","NHPI_AIC",3,7,4,80,"overcount"
"2481",17049,"Illinois","Effingham County","A_A",279,249,-30,-11.36,"undercount"
"2482",17049,"Illinois","Effingham County","A_AIC",336,355,19,5.5,"overcount"
"2483",17049,"Illinois","Effingham County","NHPI_A",8,6,-2,-28.57,"undercount"
"2484",17049,"Illinois","Effingham County","NHPI_AIC",22,33,11,40,"overcount"
"2485",17051,"Illinois","Fayette County","A_A",75,68,-7,-9.79,"undercount"
"2486",17051,"Illinois","Fayette County","A_AIC",126,116,-10,-8.26,"undercount"
"2487",17051,"Illinois","Fayette County","NHPI_A",4,1,-3,-120,"undercount"
"2488",17051,"Illinois","Fayette County","NHPI_AIC",13,17,4,26.67,"overcount"
"2489",17053,"Illinois","Ford County","A_A",64,57,-7,-11.57,"undercount"
"2490",17053,"Illinois","Ford County","A_AIC",128,114,-14,-11.57,"undercount"
"2491",17053,"Illinois","Ford County","NHPI_A",8,0,-8,-200,"undercount"
"2492",17053,"Illinois","Ford County","NHPI_AIC",18,9,-9,-66.67,"undercount"
"2493",17055,"Illinois","Franklin County","A_A",147,121,-26,-19.4,"undercount"
"2494",17055,"Illinois","Franklin County","A_AIC",240,252,12,4.88,"overcount"
"2495",17055,"Illinois","Franklin County","NHPI_A",6,4,-2,-40,"undercount"
"2496",17055,"Illinois","Franklin County","NHPI_AIC",16,48,32,100,"overcount"
"2497",17057,"Illinois","Fulton County","A_A",102,72,-30,-34.48,"undercount"
"2498",17057,"Illinois","Fulton County","A_AIC",167,147,-20,-12.74,"undercount"
"2499",17057,"Illinois","Fulton County","NHPI_A",6,6,0,0,"equal"
"2500",17057,"Illinois","Fulton County","NHPI_AIC",20,17,-3,-16.22,"undercount"
"2501",17059,"Illinois","Gallatin County","A_A",14,23,9,48.65,"overcount"
"2502",17059,"Illinois","Gallatin County","A_AIC",30,58,28,63.64,"overcount"
"2503",17059,"Illinois","Gallatin County","NHPI_A",0,0,0,0,"equal"
"2504",17059,"Illinois","Gallatin County","NHPI_AIC",3,8,5,90.91,"overcount"
"2505",17061,"Illinois","Greene County","A_A",33,21,-12,-44.44,"undercount"
"2506",17061,"Illinois","Greene County","A_AIC",46,43,-3,-6.74,"undercount"
"2507",17061,"Illinois","Greene County","NHPI_A",2,4,2,66.67,"overcount"
"2508",17061,"Illinois","Greene County","NHPI_AIC",6,10,4,50,"overcount"
"2509",17063,"Illinois","Grundy County","A_A",440,466,26,5.74,"overcount"
"2510",17063,"Illinois","Grundy County","A_AIC",648,711,63,9.27,"overcount"
"2511",17063,"Illinois","Grundy County","NHPI_A",40,16,-24,-85.71,"undercount"
"2512",17063,"Illinois","Grundy County","NHPI_AIC",64,50,-14,-24.56,"undercount"
"2513",17065,"Illinois","Hamilton County","A_A",59,14,-45,-123.29,"undercount"
"2514",17065,"Illinois","Hamilton County","A_AIC",80,50,-30,-46.15,"undercount"
"2515",17065,"Illinois","Hamilton County","NHPI_A",0,0,0,0,"equal"
"2516",17065,"Illinois","Hamilton County","NHPI_AIC",0,9,9,200,"overcount"
"2517",17067,"Illinois","Hancock County","A_A",56,58,2,3.51,"overcount"
"2518",17067,"Illinois","Hancock County","A_AIC",94,109,15,14.78,"overcount"
"2519",17067,"Illinois","Hancock County","NHPI_A",15,4,-11,-115.79,"undercount"
"2520",17067,"Illinois","Hancock County","NHPI_AIC",23,15,-8,-42.11,"undercount"
"2521",17069,"Illinois","Hardin County","A_A",19,29,10,41.67,"overcount"
"2522",17069,"Illinois","Hardin County","A_AIC",34,40,6,16.22,"overcount"
"2523",17069,"Illinois","Hardin County","NHPI_A",5,2,-3,-85.71,"undercount"
"2524",17069,"Illinois","Hardin County","NHPI_AIC",8,12,4,40,"overcount"
"2525",17071,"Illinois","Henderson County","A_A",35,14,-21,-85.71,"undercount"
"2526",17071,"Illinois","Henderson County","A_AIC",49,28,-21,-54.55,"undercount"
"2527",17071,"Illinois","Henderson County","NHPI_A",5,5,0,0,"equal"
"2528",17071,"Illinois","Henderson County","NHPI_AIC",8,8,0,0,"equal"
"2529",17073,"Illinois","Henry County","A_A",232,192,-40,-18.87,"undercount"
"2530",17073,"Illinois","Henry County","A_AIC",363,373,10,2.72,"overcount"
"2531",17073,"Illinois","Henry County","NHPI_A",17,12,-5,-34.48,"undercount"
"2532",17073,"Illinois","Henry County","NHPI_AIC",41,44,3,7.06,"overcount"
"2533",17075,"Illinois","Iroquois County","A_A",140,105,-35,-28.57,"undercount"
"2534",17075,"Illinois","Iroquois County","A_AIC",193,183,-10,-5.32,"undercount"
"2535",17075,"Illinois","Iroquois County","NHPI_A",8,0,-8,-200,"undercount"
"2536",17075,"Illinois","Iroquois County","NHPI_AIC",17,15,-2,-12.5,"undercount"
"2537",17077,"Illinois","Jackson County","A_A",1909,2061,152,7.66,"overcount"
"2538",17077,"Illinois","Jackson County","A_AIC",2334,2459,125,5.22,"overcount"
"2539",17077,"Illinois","Jackson County","NHPI_A",37,24,-13,-42.62,"undercount"
"2540",17077,"Illinois","Jackson County","NHPI_AIC",113,82,-31,-31.79,"undercount"
"2541",17079,"Illinois","Jasper County","A_A",30,15,-15,-66.67,"undercount"
"2542",17079,"Illinois","Jasper County","A_AIC",37,22,-15,-50.85,"undercount"
"2543",17079,"Illinois","Jasper County","NHPI_A",2,4,2,66.67,"overcount"
"2544",17079,"Illinois","Jasper County","NHPI_AIC",3,7,4,80,"overcount"
"2545",17081,"Illinois","Jefferson County","A_A",426,354,-72,-18.46,"undercount"
"2546",17081,"Illinois","Jefferson County","A_AIC",552,479,-73,-14.16,"undercount"
"2547",17081,"Illinois","Jefferson County","NHPI_A",12,7,-5,-52.63,"undercount"
"2548",17081,"Illinois","Jefferson County","NHPI_AIC",33,43,10,26.32,"overcount"
"2549",17083,"Illinois","Jersey County","A_A",147,75,-72,-64.86,"undercount"
"2550",17083,"Illinois","Jersey County","A_AIC",214,150,-64,-35.16,"undercount"
"2551",17083,"Illinois","Jersey County","NHPI_A",7,3,-4,-80,"undercount"
"2552",17083,"Illinois","Jersey County","NHPI_AIC",21,21,0,0,"equal"
"2553",17085,"Illinois","Jo Daviess County","A_A",102,98,-4,-4,"undercount"
"2554",17085,"Illinois","Jo Daviess County","A_AIC",142,156,14,9.4,"overcount"
"2555",17085,"Illinois","Jo Daviess County","NHPI_A",10,6,-4,-50,"undercount"
"2556",17085,"Illinois","Jo Daviess County","NHPI_AIC",18,11,-7,-48.28,"undercount"
"2557",17087,"Illinois","Johnson County","A_A",31,18,-13,-53.06,"undercount"
"2558",17087,"Illinois","Johnson County","A_AIC",65,39,-26,-50,"undercount"
"2559",17087,"Illinois","Johnson County","NHPI_A",1,4,3,120,"overcount"
"2560",17087,"Illinois","Johnson County","NHPI_AIC",6,7,1,15.38,"overcount"
"2561",17089,"Illinois","Kane County","A_A",22502,21362,-1140,-5.2,"undercount"
"2562",17089,"Illinois","Kane County","A_AIC",25408,25602,194,0.76,"overcount"
"2563",17089,"Illinois","Kane County","NHPI_A",148,121,-27,-20.07,"undercount"
"2564",17089,"Illinois","Kane County","NHPI_AIC",371,395,24,6.27,"overcount"
"2565",17091,"Illinois","Kankakee County","A_A",1071,1083,12,1.11,"overcount"
"2566",17091,"Illinois","Kankakee County","A_AIC",1432,1512,80,5.43,"overcount"
"2567",17091,"Illinois","Kankakee County","NHPI_A",35,13,-22,-91.67,"undercount"
"2568",17091,"Illinois","Kankakee County","NHPI_AIC",101,76,-25,-28.25,"undercount"
"2569",17093,"Illinois","Kendall County","A_A",4465,4681,216,4.72,"overcount"
"2570",17093,"Illinois","Kendall County","A_AIC",5511,5985,474,8.25,"overcount"
"2571",17093,"Illinois","Kendall County","NHPI_A",62,12,-50,-135.14,"undercount"
"2572",17093,"Illinois","Kendall County","NHPI_AIC",142,117,-25,-19.31,"undercount"
"2573",17095,"Illinois","Knox County","A_A",430,385,-45,-11.04,"undercount"
"2574",17095,"Illinois","Knox County","A_AIC",606,710,104,15.81,"overcount"
"2575",17095,"Illinois","Knox County","NHPI_A",16,12,-4,-28.57,"undercount"
"2576",17095,"Illinois","Knox County","NHPI_AIC",50,185,135,114.89,"overcount"
"2577",17097,"Illinois","Lake County","A_A",59511,59221,-290,-0.49,"undercount"
"2578",17097,"Illinois","Lake County","A_AIC",65707,67099,1392,2.1,"overcount"
"2579",17097,"Illinois","Lake County","NHPI_A",332,343,11,3.26,"overcount"
"2580",17097,"Illinois","Lake County","NHPI_AIC",1021,1119,98,9.16,"overcount"
"2581",17099,"Illinois","LaSalle County","A_A",1036,863,-173,-18.22,"undercount"
"2582",17099,"Illinois","LaSalle County","A_AIC",1357,1266,-91,-6.94,"undercount"
"2583",17099,"Illinois","LaSalle County","NHPI_A",20,8,-12,-85.71,"undercount"
"2584",17099,"Illinois","LaSalle County","NHPI_AIC",54,29,-25,-60.24,"undercount"
"2585",17101,"Illinois","Lawrence County","A_A",68,58,-10,-15.87,"undercount"
"2586",17101,"Illinois","Lawrence County","A_AIC",90,90,0,0,"equal"
"2587",17101,"Illinois","Lawrence County","NHPI_A",2,7,5,111.11,"overcount"
"2588",17101,"Illinois","Lawrence County","NHPI_AIC",5,14,9,94.74,"overcount"
"2589",17103,"Illinois","Lee County","A_A",248,248,0,0,"equal"
"2590",17103,"Illinois","Lee County","A_AIC",341,352,11,3.17,"overcount"
"2591",17103,"Illinois","Lee County","NHPI_A",9,10,1,10.53,"overcount"
"2592",17103,"Illinois","Lee County","NHPI_AIC",23,31,8,29.63,"overcount"
"2593",17105,"Illinois","Livingston County","A_A",241,171,-70,-33.98,"undercount"
"2594",17105,"Illinois","Livingston County","A_AIC",340,269,-71,-23.32,"undercount"
"2595",17105,"Illinois","Livingston County","NHPI_A",4,1,-3,-120,"undercount"
"2596",17105,"Illinois","Livingston County","NHPI_AIC",22,32,10,37.04,"overcount"
"2597",17107,"Illinois","Logan County","A_A",190,178,-12,-6.52,"undercount"
"2598",17107,"Illinois","Logan County","A_AIC",298,285,-13,-4.46,"undercount"
"2599",17107,"Illinois","Logan County","NHPI_A",6,1,-5,-142.86,"undercount"
"2600",17107,"Illinois","Logan County","NHPI_AIC",14,36,22,88,"overcount"
"2601",17109,"Illinois","McDonough County","A_A",670,572,-98,-15.78,"undercount"
"2602",17109,"Illinois","McDonough County","A_AIC",808,698,-110,-14.61,"undercount"
"2603",17109,"Illinois","McDonough County","NHPI_A",4,6,2,40,"overcount"
"2604",17109,"Illinois","McDonough County","NHPI_AIC",21,40,19,62.3,"overcount"
"2605",17111,"Illinois","McHenry County","A_A",9010,8800,-210,-2.36,"undercount"
"2606",17111,"Illinois","McHenry County","A_AIC",11096,11420,324,2.88,"overcount"
"2607",17111,"Illinois","McHenry County","NHPI_A",112,47,-65,-81.76,"undercount"
"2608",17111,"Illinois","McHenry County","NHPI_AIC",255,249,-6,-2.38,"undercount"
"2609",17113,"Illinois","McLean County","A_A",8385,8179,-206,-2.49,"undercount"
"2610",17113,"Illinois","McLean County","A_AIC",9557,9485,-72,-0.76,"undercount"
"2611",17113,"Illinois","McLean County","NHPI_A",68,38,-30,-56.6,"undercount"
"2612",17113,"Illinois","McLean County","NHPI_AIC",180,154,-26,-15.57,"undercount"
"2613",17115,"Illinois","Macon County","A_A",1152,1517,365,27.35,"overcount"
"2614",17115,"Illinois","Macon County","A_AIC",1632,1959,327,18.21,"overcount"
"2615",17115,"Illinois","Macon County","NHPI_A",35,31,-4,-12.12,"undercount"
"2616",17115,"Illinois","Macon County","NHPI_AIC",144,88,-56,-48.28,"undercount"
"2617",17117,"Illinois","Macoupin County","A_A",170,179,9,5.16,"overcount"
"2618",17117,"Illinois","Macoupin County","A_AIC",283,347,64,20.32,"overcount"
"2619",17117,"Illinois","Macoupin County","NHPI_A",8,0,-8,-200,"undercount"
"2620",17117,"Illinois","Macoupin County","NHPI_AIC",24,36,12,40,"overcount"
"2621",17119,"Illinois","Madison County","A_A",2662,2807,145,5.3,"overcount"
"2622",17119,"Illinois","Madison County","A_AIC",4036,4400,364,8.63,"overcount"
"2623",17119,"Illinois","Madison County","NHPI_A",140,99,-41,-34.31,"undercount"
"2624",17119,"Illinois","Madison County","NHPI_AIC",308,306,-2,-0.65,"undercount"
"2625",17121,"Illinois","Marion County","A_A",223,349,126,44.06,"overcount"
"2626",17121,"Illinois","Marion County","A_AIC",305,460,155,40.52,"overcount"
"2627",17121,"Illinois","Marion County","NHPI_A",9,1,-8,-160,"undercount"
"2628",17121,"Illinois","Marion County","NHPI_AIC",27,30,3,10.53,"overcount"
"2629",17123,"Illinois","Marshall County","A_A",53,43,-10,-20.83,"undercount"
"2630",17123,"Illinois","Marshall County","A_AIC",98,79,-19,-21.47,"undercount"
"2631",17123,"Illinois","Marshall County","NHPI_A",3,0,-3,-200,"undercount"
"2632",17123,"Illinois","Marshall County","NHPI_AIC",7,19,12,92.31,"overcount"
"2633",17125,"Illinois","Mason County","A_A",73,26,-47,-94.95,"undercount"
"2634",17125,"Illinois","Mason County","A_AIC",111,63,-48,-55.17,"undercount"
"2635",17125,"Illinois","Mason County","NHPI_A",0,1,1,200,"overcount"
"2636",17125,"Illinois","Mason County","NHPI_AIC",4,4,0,0,"equal"
"2637",17127,"Illinois","Massac County","A_A",66,43,-23,-42.2,"undercount"
"2638",17127,"Illinois","Massac County","A_AIC",108,94,-14,-13.86,"undercount"
"2639",17127,"Illinois","Massac County","NHPI_A",2,6,4,100,"overcount"
"2640",17127,"Illinois","Massac County","NHPI_AIC",7,17,10,83.33,"overcount"
"2641",17129,"Illinois","Menard County","A_A",48,49,1,2.06,"overcount"
"2642",17129,"Illinois","Menard County","A_AIC",84,90,6,6.9,"overcount"
"2643",17129,"Illinois","Menard County","NHPI_A",3,2,-1,-40,"undercount"
"2644",17129,"Illinois","Menard County","NHPI_AIC",7,9,2,25,"overcount"
"2645",17131,"Illinois","Mercer County","A_A",75,39,-36,-63.16,"undercount"
"2646",17131,"Illinois","Mercer County","A_AIC",106,85,-21,-21.99,"undercount"
"2647",17131,"Illinois","Mercer County","NHPI_A",2,2,0,0,"equal"
"2648",17131,"Illinois","Mercer County","NHPI_AIC",5,12,7,82.35,"overcount"
"2649",17133,"Illinois","Monroe County","A_A",213,208,-5,-2.38,"undercount"
"2650",17133,"Illinois","Monroe County","A_AIC",342,371,29,8.13,"overcount"
"2651",17133,"Illinois","Monroe County","NHPI_A",11,2,-9,-138.46,"undercount"
"2652",17133,"Illinois","Monroe County","NHPI_AIC",21,11,-10,-62.5,"undercount"
"2653",17135,"Illinois","Montgomery County","A_A",135,131,-4,-3.01,"undercount"
"2654",17135,"Illinois","Montgomery County","A_AIC",194,211,17,8.4,"overcount"
"2655",17135,"Illinois","Montgomery County","NHPI_A",12,7,-5,-52.63,"undercount"
"2656",17135,"Illinois","Montgomery County","NHPI_AIC",23,25,2,8.33,"overcount"
"2657",17137,"Illinois","Morgan County","A_A",265,268,3,1.13,"overcount"
"2658",17137,"Illinois","Morgan County","A_AIC",347,352,5,1.43,"overcount"
"2659",17137,"Illinois","Morgan County","NHPI_A",14,18,4,25,"overcount"
"2660",17137,"Illinois","Morgan County","NHPI_AIC",27,37,10,31.25,"overcount"
"2661",17139,"Illinois","Moultrie County","A_A",40,49,9,20.22,"overcount"
"2662",17139,"Illinois","Moultrie County","A_AIC",68,82,14,18.67,"overcount"
"2663",17139,"Illinois","Moultrie County","NHPI_A",5,0,-5,-200,"undercount"
"2664",17139,"Illinois","Moultrie County","NHPI_AIC",11,7,-4,-44.44,"undercount"
"2665",17141,"Illinois","Ogle County","A_A",254,259,5,1.95,"overcount"
"2666",17141,"Illinois","Ogle County","A_AIC",405,465,60,13.79,"overcount"
"2667",17141,"Illinois","Ogle County","NHPI_A",9,0,-9,-200,"undercount"
"2668",17141,"Illinois","Ogle County","NHPI_AIC",32,37,5,14.49,"overcount"
"2669",17143,"Illinois","Peoria County","A_A",7380,7768,388,5.12,"overcount"
"2670",17143,"Illinois","Peoria County","A_AIC",8431,8913,482,5.56,"overcount"
"2671",17143,"Illinois","Peoria County","NHPI_A",89,62,-27,-35.76,"undercount"
"2672",17143,"Illinois","Peoria County","NHPI_AIC",243,163,-80,-39.41,"undercount"
"2673",17145,"Illinois","Perry County","A_A",108,127,19,16.17,"overcount"
"2674",17145,"Illinois","Perry County","A_AIC",161,154,-7,-4.44,"undercount"
"2675",17145,"Illinois","Perry County","NHPI_A",12,1,-11,-169.23,"undercount"
"2676",17145,"Illinois","Perry County","NHPI_AIC",18,20,2,10.53,"overcount"
"2677",17147,"Illinois","Piatt County","A_A",76,80,4,5.13,"overcount"
"2678",17147,"Illinois","Piatt County","A_AIC",145,140,-5,-3.51,"undercount"
"2679",17147,"Illinois","Piatt County","NHPI_A",7,2,-5,-111.11,"undercount"
"2680",17147,"Illinois","Piatt County","NHPI_AIC",17,15,-2,-12.5,"undercount"
"2681",17149,"Illinois","Pike County","A_A",50,47,-3,-6.19,"undercount"
"2682",17149,"Illinois","Pike County","A_AIC",72,68,-4,-5.71,"undercount"
"2683",17149,"Illinois","Pike County","NHPI_A",4,6,2,40,"overcount"
"2684",17149,"Illinois","Pike County","NHPI_AIC",6,11,5,58.82,"overcount"
"2685",17151,"Illinois","Pope County","A_A",15,16,1,6.45,"overcount"
"2686",17151,"Illinois","Pope County","A_AIC",23,38,15,49.18,"overcount"
"2687",17151,"Illinois","Pope County","NHPI_A",3,0,-3,-200,"undercount"
"2688",17151,"Illinois","Pope County","NHPI_AIC",3,5,2,50,"overcount"
"2689",17153,"Illinois","Pulaski County","A_A",23,13,-10,-55.56,"undercount"
"2690",17153,"Illinois","Pulaski County","A_AIC",53,35,-18,-40.91,"undercount"
"2691",17153,"Illinois","Pulaski County","NHPI_A",3,0,-3,-200,"undercount"
"2692",17153,"Illinois","Pulaski County","NHPI_AIC",6,7,1,15.38,"overcount"
"2693",17155,"Illinois","Putnam County","A_A",33,18,-15,-58.82,"undercount"
"2694",17155,"Illinois","Putnam County","A_AIC",46,35,-11,-27.16,"undercount"
"2695",17155,"Illinois","Putnam County","NHPI_A",5,4,-1,-22.22,"undercount"
"2696",17155,"Illinois","Putnam County","NHPI_AIC",6,6,0,0,"equal"
"2697",17157,"Illinois","Randolph County","A_A",151,89,-62,-51.67,"undercount"
"2698",17157,"Illinois","Randolph County","A_AIC",220,166,-54,-27.98,"undercount"
"2699",17157,"Illinois","Randolph County","NHPI_A",10,7,-3,-35.29,"undercount"
"2700",17157,"Illinois","Randolph County","NHPI_AIC",21,18,-3,-15.38,"undercount"
"2701",17159,"Illinois","Richland County","A_A",141,123,-18,-13.64,"undercount"
"2702",17159,"Illinois","Richland County","A_AIC",187,196,9,4.7,"overcount"
"2703",17159,"Illinois","Richland County","NHPI_A",4,7,3,54.55,"overcount"
"2704",17159,"Illinois","Richland County","NHPI_AIC",10,12,2,18.18,"overcount"
"2705",17161,"Illinois","Rock Island County","A_A",3633,4054,421,10.95,"overcount"
"2706",17161,"Illinois","Rock Island County","A_AIC",4348,4717,369,8.14,"overcount"
"2707",17161,"Illinois","Rock Island County","NHPI_A",44,39,-5,-12.05,"undercount"
"2708",17161,"Illinois","Rock Island County","NHPI_AIC",168,110,-58,-41.73,"undercount"
"2709",17163,"Illinois","St. Clair County","A_A",3842,3660,-182,-4.85,"undercount"
"2710",17163,"Illinois","St. Clair County","A_AIC",6143,6246,103,1.66,"overcount"
"2711",17163,"Illinois","St. Clair County","NHPI_A",202,185,-17,-8.79,"undercount"
"2712",17163,"Illinois","St. Clair County","NHPI_AIC",467,553,86,16.86,"overcount"
"2713",17165,"Illinois","Saline County","A_A",138,123,-15,-11.49,"undercount"
"2714",17165,"Illinois","Saline County","A_AIC",218,186,-32,-15.84,"undercount"
"2715",17165,"Illinois","Saline County","NHPI_A",15,1,-14,-175,"undercount"
"2716",17165,"Illinois","Saline County","NHPI_AIC",32,7,-25,-128.21,"undercount"
"2717",17167,"Illinois","Sangamon County","A_A",4225,4300,75,1.76,"overcount"
"2718",17167,"Illinois","Sangamon County","A_AIC",5222,5420,198,3.72,"overcount"
"2719",17167,"Illinois","Sangamon County","NHPI_A",56,55,-1,-1.8,"undercount"
"2720",17167,"Illinois","Sangamon County","NHPI_AIC",202,211,9,4.36,"overcount"
"2721",17169,"Illinois","Schuyler County","A_A",20,25,5,22.22,"overcount"
"2722",17169,"Illinois","Schuyler County","A_AIC",30,46,16,42.11,"overcount"
"2723",17169,"Illinois","Schuyler County","NHPI_A",0,2,2,200,"overcount"
"2724",17169,"Illinois","Schuyler County","NHPI_AIC",1,8,7,155.56,"overcount"
"2725",17171,"Illinois","Scott County","A_A",12,13,1,8,"overcount"
"2726",17171,"Illinois","Scott County","A_AIC",23,21,-2,-9.09,"undercount"
"2727",17171,"Illinois","Scott County","NHPI_A",36,1,-35,-189.19,"undercount"
"2728",17171,"Illinois","Scott County","NHPI_AIC",40,10,-30,-120,"undercount"
"2729",17173,"Illinois","Shelby County","A_A",77,83,6,7.5,"overcount"
"2730",17173,"Illinois","Shelby County","A_AIC",126,129,3,2.35,"overcount"
"2731",17173,"Illinois","Shelby County","NHPI_A",10,1,-9,-163.64,"undercount"
"2732",17173,"Illinois","Shelby County","NHPI_AIC",17,12,-5,-34.48,"undercount"
"2733",17175,"Illinois","Stark County","A_A",40,23,-17,-53.97,"undercount"
"2734",17175,"Illinois","Stark County","A_AIC",61,36,-25,-51.55,"undercount"
"2735",17175,"Illinois","Stark County","NHPI_A",0,0,0,0,"equal"
"2736",17175,"Illinois","Stark County","NHPI_AIC",4,4,0,0,"equal"
"2737",17177,"Illinois","Stephenson County","A_A",325,306,-19,-6.02,"undercount"
"2738",17177,"Illinois","Stephenson County","A_AIC",510,489,-21,-4.2,"undercount"
"2739",17177,"Illinois","Stephenson County","NHPI_A",15,11,-4,-30.77,"undercount"
"2740",17177,"Illinois","Stephenson County","NHPI_AIC",45,43,-2,-4.55,"undercount"
"2741",17179,"Illinois","Tazewell County","A_A",1191,1090,-101,-8.86,"undercount"
"2742",17179,"Illinois","Tazewell County","A_AIC",1747,1728,-19,-1.09,"undercount"
"2743",17179,"Illinois","Tazewell County","NHPI_A",39,49,10,22.73,"overcount"
"2744",17179,"Illinois","Tazewell County","NHPI_AIC",89,142,53,45.89,"overcount"
"2745",17181,"Illinois","Union County","A_A",80,69,-11,-14.77,"undercount"
"2746",17181,"Illinois","Union County","A_AIC",131,132,1,0.76,"overcount"
"2747",17181,"Illinois","Union County","NHPI_A",7,11,4,44.44,"overcount"
"2748",17181,"Illinois","Union County","NHPI_AIC",24,25,1,4.08,"overcount"
"2749",17183,"Illinois","Vermilion County","A_A",642,573,-69,-11.36,"undercount"
"2750",17183,"Illinois","Vermilion County","A_AIC",873,767,-106,-12.93,"undercount"
"2751",17183,"Illinois","Vermilion County","NHPI_A",32,11,-21,-97.67,"undercount"
"2752",17183,"Illinois","Vermilion County","NHPI_AIC",84,30,-54,-94.74,"undercount"
"2753",17185,"Illinois","Wabash County","A_A",137,266,129,64.02,"overcount"
"2754",17185,"Illinois","Wabash County","A_AIC",165,292,127,55.58,"overcount"
"2755",17185,"Illinois","Wabash County","NHPI_A",6,6,0,0,"equal"
"2756",17185,"Illinois","Wabash County","NHPI_AIC",14,12,-2,-15.38,"undercount"
"2757",17187,"Illinois","Warren County","A_A",397,329,-68,-18.73,"undercount"
"2758",17187,"Illinois","Warren County","A_AIC",437,400,-37,-8.84,"undercount"
"2759",17187,"Illinois","Warren County","NHPI_A",24,15,-9,-46.15,"undercount"
"2760",17187,"Illinois","Warren County","NHPI_AIC",34,38,4,11.11,"overcount"
"2761",17189,"Illinois","Washington County","A_A",68,65,-3,-4.51,"undercount"
"2762",17189,"Illinois","Washington County","A_AIC",83,83,0,0,"equal"
"2763",17189,"Illinois","Washington County","NHPI_A",3,20,17,147.83,"overcount"
"2764",17189,"Illinois","Washington County","NHPI_AIC",5,27,22,137.5,"overcount"
"2765",17191,"Illinois","Wayne County","A_A",94,50,-44,-61.11,"undercount"
"2766",17191,"Illinois","Wayne County","A_AIC",127,86,-41,-38.5,"undercount"
"2767",17191,"Illinois","Wayne County","NHPI_A",2,5,3,85.71,"overcount"
"2768",17191,"Illinois","Wayne County","NHPI_AIC",6,9,3,40,"overcount"
"2769",17193,"Illinois","White County","A_A",71,65,-6,-8.82,"undercount"
"2770",17193,"Illinois","White County","A_AIC",100,112,12,11.32,"overcount"
"2771",17193,"Illinois","White County","NHPI_A",6,18,12,100,"overcount"
"2772",17193,"Illinois","White County","NHPI_AIC",13,22,9,51.43,"overcount"
"2773",17195,"Illinois","Whiteside County","A_A",299,310,11,3.61,"overcount"
"2774",17195,"Illinois","Whiteside County","A_AIC",418,472,54,12.13,"overcount"
"2775",17195,"Illinois","Whiteside County","NHPI_A",2,9,7,127.27,"overcount"
"2776",17195,"Illinois","Whiteside County","NHPI_AIC",25,34,9,30.51,"overcount"
"2777",17197,"Illinois","Will County","A_A",41929,42650,721,1.7,"overcount"
"2778",17197,"Illinois","Will County","A_AIC",46637,48355,1718,3.62,"overcount"
"2779",17197,"Illinois","Will County","NHPI_A",121,113,-8,-6.84,"undercount"
"2780",17197,"Illinois","Will County","NHPI_AIC",434,511,77,16.3,"overcount"
"2781",17199,"Illinois","Williamson County","A_A",887,775,-112,-13.48,"undercount"
"2782",17199,"Illinois","Williamson County","A_AIC",1126,1065,-61,-5.57,"undercount"
"2783",17199,"Illinois","Williamson County","NHPI_A",16,9,-7,-56,"undercount"
"2784",17199,"Illinois","Williamson County","NHPI_AIC",49,24,-25,-68.49,"undercount"
"2785",17201,"Illinois","Winnebago County","A_A",7718,8062,344,4.36,"overcount"
"2786",17201,"Illinois","Winnebago County","A_AIC",9477,10036,559,5.73,"overcount"
"2787",17201,"Illinois","Winnebago County","NHPI_A",97,66,-31,-38.04,"undercount"
"2788",17201,"Illinois","Winnebago County","NHPI_AIC",261,257,-4,-1.54,"undercount"
"2789",17203,"Illinois","Woodford County","A_A",278,217,-61,-24.65,"undercount"
"2790",17203,"Illinois","Woodford County","A_AIC",391,390,-1,-0.26,"undercount"
"2791",17203,"Illinois","Woodford County","NHPI_A",14,10,-4,-33.33,"undercount"
"2792",17203,"Illinois","Woodford County","NHPI_AIC",20,23,3,13.95,"overcount"
"2793",18001,"Indiana","Adams County","A_A",133,135,2,1.49,"overcount"
"2794",18001,"Indiana","Adams County","A_AIC",175,204,29,15.3,"overcount"
"2795",18001,"Indiana","Adams County","NHPI_A",6,4,-2,-40,"undercount"
"2796",18001,"Indiana","Adams County","NHPI_AIC",13,30,17,79.07,"overcount"
"2797",18003,"Indiana","Allen County","A_A",18225,18414,189,1.03,"overcount"
"2798",18003,"Indiana","Allen County","A_AIC",20428,21143,715,3.44,"overcount"
"2799",18003,"Indiana","Allen County","NHPI_A",137,141,4,2.88,"overcount"
"2800",18003,"Indiana","Allen County","NHPI_AIC",431,495,64,13.82,"overcount"
"2801",18005,"Indiana","Bartholomew County","A_A",7043,5426,-1617,-25.94,"undercount"
"2802",18005,"Indiana","Bartholomew County","A_AIC",7291,5825,-1466,-22.35,"undercount"
"2803",18005,"Indiana","Bartholomew County","NHPI_A",50,45,-5,-10.53,"undercount"
"2804",18005,"Indiana","Bartholomew County","NHPI_AIC",98,132,34,29.57,"overcount"
"2805",18007,"Indiana","Benton County","A_A",18,15,-3,-18.18,"undercount"
"2806",18007,"Indiana","Benton County","A_AIC",28,22,-6,-24,"undercount"
"2807",18007,"Indiana","Benton County","NHPI_A",5,7,2,33.33,"overcount"
"2808",18007,"Indiana","Benton County","NHPI_AIC",6,13,7,73.68,"overcount"
"2809",18009,"Indiana","Blackford County","A_A",68,24,-44,-95.65,"undercount"
"2810",18009,"Indiana","Blackford County","A_AIC",88,58,-30,-41.1,"undercount"
"2811",18009,"Indiana","Blackford County","NHPI_A",4,0,-4,-200,"undercount"
"2812",18009,"Indiana","Blackford County","NHPI_AIC",8,15,7,60.87,"overcount"
"2813",18011,"Indiana","Boone County","A_A",2454,2412,-42,-1.73,"undercount"
"2814",18011,"Indiana","Boone County","A_AIC",2875,3017,142,4.82,"overcount"
"2815",18011,"Indiana","Boone County","NHPI_A",16,19,3,17.14,"overcount"
"2816",18011,"Indiana","Boone County","NHPI_AIC",48,77,29,46.4,"overcount"
"2817",18013,"Indiana","Brown County","A_A",65,69,4,5.97,"overcount"
"2818",18013,"Indiana","Brown County","A_AIC",113,98,-15,-14.22,"undercount"
"2819",18013,"Indiana","Brown County","NHPI_A",3,6,3,66.67,"overcount"
"2820",18013,"Indiana","Brown County","NHPI_AIC",10,9,-1,-10.53,"undercount"
"2821",18015,"Indiana","Carroll County","A_A",34,48,14,34.15,"overcount"
"2822",18015,"Indiana","Carroll County","A_AIC",63,94,31,39.49,"overcount"
"2823",18015,"Indiana","Carroll County","NHPI_A",2,0,-2,-200,"undercount"
"2824",18015,"Indiana","Carroll County","NHPI_AIC",8,11,3,31.58,"overcount"
"2825",18017,"Indiana","Cass County","A_A",720,587,-133,-20.35,"undercount"
"2826",18017,"Indiana","Cass County","A_AIC",773,727,-46,-6.13,"undercount"
"2827",18017,"Indiana","Cass County","NHPI_A",10,8,-2,-22.22,"undercount"
"2828",18017,"Indiana","Cass County","NHPI_AIC",23,35,12,41.38,"overcount"
"2829",18019,"Indiana","Clark County","A_A",1359,1314,-45,-3.37,"undercount"
"2830",18019,"Indiana","Clark County","A_AIC",1884,2036,152,7.76,"overcount"
"2831",18019,"Indiana","Clark County","NHPI_A",76,127,51,50.25,"overcount"
"2832",18019,"Indiana","Clark County","NHPI_AIC",197,249,52,23.32,"overcount"
"2833",18021,"Indiana","Clay County","A_A",87,91,4,4.49,"overcount"
"2834",18021,"Indiana","Clay County","A_AIC",130,146,16,11.59,"overcount"
"2835",18021,"Indiana","Clay County","NHPI_A",14,6,-8,-80,"undercount"
"2836",18021,"Indiana","Clay County","NHPI_AIC",19,25,6,27.27,"overcount"
"2837",18023,"Indiana","Clinton County","A_A",127,70,-57,-57.87,"undercount"
"2838",18023,"Indiana","Clinton County","A_AIC",165,155,-10,-6.25,"undercount"
"2839",18023,"Indiana","Clinton County","NHPI_A",5,13,8,88.89,"overcount"
"2840",18023,"Indiana","Clinton County","NHPI_AIC",12,40,28,107.69,"overcount"
"2841",18025,"Indiana","Crawford County","A_A",23,17,-6,-30,"undercount"
"2842",18025,"Indiana","Crawford County","A_AIC",48,25,-23,-63.01,"undercount"
"2843",18025,"Indiana","Crawford County","NHPI_A",10,1,-9,-163.64,"undercount"
"2844",18025,"Indiana","Crawford County","NHPI_AIC",16,15,-1,-6.45,"undercount"
"2845",18027,"Indiana","Daviess County","A_A",144,132,-12,-8.7,"undercount"
"2846",18027,"Indiana","Daviess County","A_AIC",194,224,30,14.35,"overcount"
"2847",18027,"Indiana","Daviess County","NHPI_A",5,8,3,46.15,"overcount"
"2848",18027,"Indiana","Daviess County","NHPI_AIC",10,23,13,78.79,"overcount"
"2849",18029,"Indiana","Dearborn County","A_A",226,211,-15,-6.86,"undercount"
"2850",18029,"Indiana","Dearborn County","A_AIC",337,400,63,17.1,"overcount"
"2851",18029,"Indiana","Dearborn County","NHPI_A",27,22,-5,-20.41,"undercount"
"2852",18029,"Indiana","Dearborn County","NHPI_AIC",45,73,28,47.46,"overcount"
"2853",18031,"Indiana","Decatur County","A_A",335,154,-181,-74.03,"undercount"
"2854",18031,"Indiana","Decatur County","A_AIC",394,211,-183,-60.5,"undercount"
"2855",18031,"Indiana","Decatur County","NHPI_A",13,8,-5,-47.62,"undercount"
"2856",18031,"Indiana","Decatur County","NHPI_AIC",28,27,-1,-3.64,"undercount"
"2857",18033,"Indiana","DeKalb County","A_A",198,229,31,14.52,"overcount"
"2858",18033,"Indiana","DeKalb County","A_AIC",298,342,44,13.75,"overcount"
"2859",18033,"Indiana","DeKalb County","NHPI_A",28,39,11,32.84,"overcount"
"2860",18033,"Indiana","DeKalb County","NHPI_AIC",46,82,36,56.25,"overcount"
"2861",18035,"Indiana","Delaware County","A_A",1523,1401,-122,-8.34,"undercount"
"2862",18035,"Indiana","Delaware County","A_AIC",2075,1909,-166,-8.33,"undercount"
"2863",18035,"Indiana","Delaware County","NHPI_A",59,58,-1,-1.71,"undercount"
"2864",18035,"Indiana","Delaware County","NHPI_AIC",195,145,-50,-29.41,"undercount"
"2865",18037,"Indiana","Dubois County","A_A",265,266,1,0.38,"overcount"
"2866",18037,"Indiana","Dubois County","A_AIC",333,364,31,8.9,"overcount"
"2867",18037,"Indiana","Dubois County","NHPI_A",5,5,0,0,"equal"
"2868",18037,"Indiana","Dubois County","NHPI_AIC",11,32,21,97.67,"overcount"
"2869",18039,"Indiana","Elkhart County","A_A",2436,2264,-172,-7.32,"undercount"
"2870",18039,"Indiana","Elkhart County","A_AIC",3203,3176,-27,-0.85,"undercount"
"2871",18039,"Indiana","Elkhart County","NHPI_A",81,56,-25,-36.5,"undercount"
"2872",18039,"Indiana","Elkhart County","NHPI_AIC",210,183,-27,-13.74,"undercount"
"2873",18041,"Indiana","Fayette County","A_A",80,58,-22,-31.88,"undercount"
"2874",18041,"Indiana","Fayette County","A_AIC",115,120,5,4.26,"overcount"
"2875",18041,"Indiana","Fayette County","NHPI_A",0,4,4,200,"overcount"
"2876",18041,"Indiana","Fayette County","NHPI_AIC",8,10,2,22.22,"overcount"
"2877",18043,"Indiana","Floyd County","A_A",963,981,18,1.85,"overcount"
"2878",18043,"Indiana","Floyd County","A_AIC",1299,1425,126,9.25,"overcount"
"2879",18043,"Indiana","Floyd County","NHPI_A",29,21,-8,-32,"undercount"
"2880",18043,"Indiana","Floyd County","NHPI_AIC",87,79,-8,-9.64,"undercount"
"2881",18045,"Indiana","Fountain County","A_A",74,43,-31,-52.99,"undercount"
"2882",18045,"Indiana","Fountain County","A_AIC",115,77,-38,-39.58,"undercount"
"2883",18045,"Indiana","Fountain County","NHPI_A",3,6,3,66.67,"overcount"
"2884",18045,"Indiana","Fountain County","NHPI_AIC",12,16,4,28.57,"overcount"
"2885",18047,"Indiana","Franklin County","A_A",167,91,-76,-58.91,"undercount"
"2886",18047,"Indiana","Franklin County","A_AIC",203,129,-74,-44.58,"undercount"
"2887",18047,"Indiana","Franklin County","NHPI_A",3,1,-2,-100,"undercount"
"2888",18047,"Indiana","Franklin County","NHPI_AIC",10,11,1,9.52,"overcount"
"2889",18049,"Indiana","Fulton County","A_A",127,76,-51,-50.25,"undercount"
"2890",18049,"Indiana","Fulton County","A_AIC",158,146,-12,-7.89,"undercount"
"2891",18049,"Indiana","Fulton County","NHPI_A",6,0,-6,-200,"undercount"
"2892",18049,"Indiana","Fulton County","NHPI_AIC",11,9,-2,-20,"undercount"
"2893",18051,"Indiana","Gibson County","A_A",177,218,41,20.76,"overcount"
"2894",18051,"Indiana","Gibson County","A_AIC",260,301,41,14.62,"overcount"
"2895",18051,"Indiana","Gibson County","NHPI_A",17,16,-1,-6.06,"undercount"
"2896",18051,"Indiana","Gibson County","NHPI_AIC",40,30,-10,-28.57,"undercount"
"2897",18053,"Indiana","Grant County","A_A",556,527,-29,-5.36,"undercount"
"2898",18053,"Indiana","Grant County","A_AIC",806,727,-79,-10.31,"undercount"
"2899",18053,"Indiana","Grant County","NHPI_A",18,22,4,20,"overcount"
"2900",18053,"Indiana","Grant County","NHPI_AIC",65,49,-16,-28.07,"undercount"
"2901",18055,"Indiana","Greene County","A_A",129,104,-25,-21.46,"undercount"
"2902",18055,"Indiana","Greene County","A_AIC",188,190,2,1.06,"overcount"
"2903",18055,"Indiana","Greene County","NHPI_A",6,4,-2,-40,"undercount"
"2904",18055,"Indiana","Greene County","NHPI_AIC",18,28,10,43.48,"overcount"
"2905",18057,"Indiana","Hamilton County","A_A",23199,23680,481,2.05,"overcount"
"2906",18057,"Indiana","Hamilton County","A_AIC",26614,27700,1086,4,"overcount"
"2907",18057,"Indiana","Hamilton County","NHPI_A",87,138,51,45.33,"overcount"
"2908",18057,"Indiana","Hamilton County","NHPI_AIC",351,417,66,17.19,"overcount"
"2909",18059,"Indiana","Hancock County","A_A",748,768,20,2.64,"overcount"
"2910",18059,"Indiana","Hancock County","A_AIC",1113,1353,240,19.46,"overcount"
"2911",18059,"Indiana","Hancock County","NHPI_A",29,45,16,43.24,"overcount"
"2912",18059,"Indiana","Hancock County","NHPI_AIC",70,97,27,32.34,"overcount"
"2913",18061,"Indiana","Harrison County","A_A",198,198,0,0,"equal"
"2914",18061,"Indiana","Harrison County","A_AIC",315,326,11,3.43,"overcount"
"2915",18061,"Indiana","Harrison County","NHPI_A",11,17,6,42.86,"overcount"
"2916",18061,"Indiana","Harrison County","NHPI_AIC",36,33,-3,-8.7,"undercount"
"2917",18063,"Indiana","Hendricks County","A_A",5431,5749,318,5.69,"overcount"
"2918",18063,"Indiana","Hendricks County","A_AIC",6613,7130,517,7.52,"overcount"
"2919",18063,"Indiana","Hendricks County","NHPI_A",72,66,-6,-8.7,"undercount"
"2920",18063,"Indiana","Hendricks County","NHPI_AIC",213,241,28,12.33,"overcount"
"2921",18065,"Indiana","Henry County","A_A",230,197,-33,-15.46,"undercount"
"2922",18065,"Indiana","Henry County","A_AIC",350,347,-3,-0.86,"undercount"
"2923",18065,"Indiana","Henry County","NHPI_A",20,6,-14,-107.69,"undercount"
"2924",18065,"Indiana","Henry County","NHPI_AIC",50,36,-14,-32.56,"undercount"
"2925",18067,"Indiana","Howard County","A_A",1118,1047,-71,-6.56,"undercount"
"2926",18067,"Indiana","Howard County","A_AIC",1449,1453,4,0.28,"overcount"
"2927",18067,"Indiana","Howard County","NHPI_A",15,19,4,23.53,"overcount"
"2928",18067,"Indiana","Howard County","NHPI_AIC",83,94,11,12.43,"overcount"
"2929",18069,"Indiana","Huntington County","A_A",229,177,-52,-25.62,"undercount"
"2930",18069,"Indiana","Huntington County","A_AIC",323,289,-34,-11.11,"undercount"
"2931",18069,"Indiana","Huntington County","NHPI_A",8,7,-1,-13.33,"undercount"
"2932",18069,"Indiana","Huntington County","NHPI_AIC",17,23,6,30,"overcount"
"2933",18071,"Indiana","Jackson County","A_A",1145,479,-666,-82.02,"undercount"
"2934",18071,"Indiana","Jackson County","A_AIC",1234,602,-632,-68.85,"undercount"
"2935",18071,"Indiana","Jackson County","NHPI_A",33,5,-28,-147.37,"undercount"
"2936",18071,"Indiana","Jackson County","NHPI_AIC",41,21,-20,-64.52,"undercount"
"2937",18073,"Indiana","Jasper County","A_A",156,91,-65,-52.63,"undercount"
"2938",18073,"Indiana","Jasper County","A_AIC",224,173,-51,-25.69,"undercount"
"2939",18073,"Indiana","Jasper County","NHPI_A",8,10,2,22.22,"overcount"
"2940",18073,"Indiana","Jasper County","NHPI_AIC",22,30,8,30.77,"overcount"
"2941",18075,"Indiana","Jay County","A_A",80,69,-11,-14.77,"undercount"
"2942",18075,"Indiana","Jay County","A_AIC",137,126,-11,-8.37,"undercount"
"2943",18075,"Indiana","Jay County","NHPI_A",3,12,9,120,"overcount"
"2944",18075,"Indiana","Jay County","NHPI_AIC",11,16,5,37.04,"overcount"
"2945",18077,"Indiana","Jefferson County","A_A",270,301,31,10.86,"overcount"
"2946",18077,"Indiana","Jefferson County","A_AIC",339,385,46,12.71,"overcount"
"2947",18077,"Indiana","Jefferson County","NHPI_A",42,10,-32,-123.08,"undercount"
"2948",18077,"Indiana","Jefferson County","NHPI_AIC",52,42,-10,-21.28,"undercount"
"2949",18079,"Indiana","Jennings County","A_A",99,49,-50,-67.57,"undercount"
"2950",18079,"Indiana","Jennings County","A_AIC",151,108,-43,-33.2,"undercount"
"2951",18079,"Indiana","Jennings County","NHPI_A",13,2,-11,-146.67,"undercount"
"2952",18079,"Indiana","Jennings County","NHPI_AIC",21,7,-14,-100,"undercount"
"2953",18081,"Indiana","Johnson County","A_A",7047,7490,443,6.09,"overcount"
"2954",18081,"Indiana","Johnson County","A_AIC",7915,8625,710,8.59,"overcount"
"2955",18081,"Indiana","Johnson County","NHPI_A",91,73,-18,-21.95,"undercount"
"2956",18081,"Indiana","Johnson County","NHPI_AIC",185,187,2,1.08,"overcount"
"2957",18083,"Indiana","Knox County","A_A",343,283,-60,-19.17,"undercount"
"2958",18083,"Indiana","Knox County","A_AIC",422,360,-62,-15.86,"undercount"
"2959",18083,"Indiana","Knox County","NHPI_A",17,13,-4,-26.67,"undercount"
"2960",18083,"Indiana","Knox County","NHPI_AIC",39,52,13,28.57,"overcount"
"2961",18085,"Indiana","Kosciusko County","A_A",1338,1343,5,0.37,"overcount"
"2962",18085,"Indiana","Kosciusko County","A_AIC",1573,1638,65,4.05,"overcount"
"2963",18085,"Indiana","Kosciusko County","NHPI_A",30,16,-14,-60.87,"undercount"
"2964",18085,"Indiana","Kosciusko County","NHPI_AIC",50,62,12,21.43,"overcount"
"2965",18087,"Indiana","LaGrange County","A_A",168,75,-93,-76.54,"undercount"
"2966",18087,"Indiana","LaGrange County","A_AIC",267,113,-154,-81.05,"undercount"
"2967",18087,"Indiana","LaGrange County","NHPI_A",9,1,-8,-160,"undercount"
"2968",18087,"Indiana","LaGrange County","NHPI_AIC",24,24,0,0,"equal"
"2969",18089,"Indiana","Lake County","A_A",7772,7397,-375,-4.94,"undercount"
"2970",18089,"Indiana","Lake County","A_AIC",9590,9693,103,1.07,"overcount"
"2971",18089,"Indiana","Lake County","NHPI_A",111,109,-2,-1.82,"undercount"
"2972",18089,"Indiana","Lake County","NHPI_AIC",381,342,-39,-10.79,"undercount"
"2973",18091,"Indiana","LaPorte County","A_A",664,753,89,12.56,"overcount"
"2974",18091,"Indiana","LaPorte County","A_AIC",1063,1163,100,8.98,"overcount"
"2975",18091,"Indiana","LaPorte County","NHPI_A",21,20,-1,-4.88,"undercount"
"2976",18091,"Indiana","LaPorte County","NHPI_AIC",104,108,4,3.77,"overcount"
"2977",18093,"Indiana","Lawrence County","A_A",293,209,-84,-33.47,"undercount"
"2978",18093,"Indiana","Lawrence County","A_AIC",402,364,-38,-9.92,"undercount"
"2979",18093,"Indiana","Lawrence County","NHPI_A",11,4,-7,-93.33,"undercount"
"2980",18093,"Indiana","Lawrence County","NHPI_AIC",29,33,4,12.9,"overcount"
"2981",18095,"Indiana","Madison County","A_A",757,669,-88,-12.34,"undercount"
"2982",18095,"Indiana","Madison County","A_AIC",1122,1093,-29,-2.62,"undercount"
"2983",18095,"Indiana","Madison County","NHPI_A",60,42,-18,-35.29,"undercount"
"2984",18095,"Indiana","Madison County","NHPI_AIC",134,99,-35,-30.04,"undercount"
"2985",18097,"Indiana","Marion County","A_A",38389,40206,1817,4.62,"overcount"
"2986",18097,"Indiana","Marion County","A_AIC",44031,46668,2637,5.81,"overcount"
"2987",18097,"Indiana","Marion County","NHPI_A",228,398,170,54.31,"overcount"
"2988",18097,"Indiana","Marion County","NHPI_AIC",1051,1274,223,19.18,"overcount"
"2989",18099,"Indiana","Marshall County","A_A",263,295,32,11.47,"overcount"
"2990",18099,"Indiana","Marshall County","A_AIC",377,431,54,13.37,"overcount"
"2991",18099,"Indiana","Marshall County","NHPI_A",5,11,6,75,"overcount"
"2992",18099,"Indiana","Marshall County","NHPI_AIC",24,16,-8,-40,"undercount"
"2993",18101,"Indiana","Martin County","A_A",51,33,-18,-42.86,"undercount"
"2994",18101,"Indiana","Martin County","A_AIC",68,73,5,7.09,"overcount"
"2995",18101,"Indiana","Martin County","NHPI_A",3,6,3,66.67,"overcount"
"2996",18101,"Indiana","Martin County","NHPI_AIC",8,16,8,66.67,"overcount"
"2997",18103,"Indiana","Miami County","A_A",162,130,-32,-21.92,"undercount"
"2998",18103,"Indiana","Miami County","A_AIC",265,239,-26,-10.32,"undercount"
"2999",18103,"Indiana","Miami County","NHPI_A",11,4,-7,-93.33,"undercount"
"3000",18103,"Indiana","Miami County","NHPI_AIC",29,36,7,21.54,"overcount"
"3001",18105,"Indiana","Monroe County","A_A",10196,8449,-1747,-18.74,"undercount"
"3002",18105,"Indiana","Monroe County","A_AIC",11759,10139,-1620,-14.8,"undercount"
"3003",18105,"Indiana","Monroe County","NHPI_A",92,37,-55,-85.27,"undercount"
"3004",18105,"Indiana","Monroe County","NHPI_AIC",225,188,-37,-17.92,"undercount"
"3005",18107,"Indiana","Montgomery County","A_A",337,236,-101,-35.25,"undercount"
"3006",18107,"Indiana","Montgomery County","A_AIC",437,375,-62,-15.27,"undercount"
"3007",18107,"Indiana","Montgomery County","NHPI_A",10,13,3,26.09,"overcount"
"3008",18107,"Indiana","Montgomery County","NHPI_AIC",24,47,23,64.79,"overcount"
"3009",18109,"Indiana","Morgan County","A_A",503,276,-227,-58.28,"undercount"
"3010",18109,"Indiana","Morgan County","A_AIC",683,478,-205,-35.31,"undercount"
"3011",18109,"Indiana","Morgan County","NHPI_A",29,11,-18,-90,"undercount"
"3012",18109,"Indiana","Morgan County","NHPI_AIC",52,50,-2,-3.92,"undercount"
"3013",18111,"Indiana","Newton County","A_A",62,37,-25,-50.51,"undercount"
"3014",18111,"Indiana","Newton County","A_AIC",87,55,-32,-45.07,"undercount"
"3015",18111,"Indiana","Newton County","NHPI_A",10,2,-8,-133.33,"undercount"
"3016",18111,"Indiana","Newton County","NHPI_AIC",14,20,6,35.29,"overcount"
"3017",18113,"Indiana","Noble County","A_A",251,228,-23,-9.6,"undercount"
"3018",18113,"Indiana","Noble County","A_AIC",393,444,51,12.19,"overcount"
"3019",18113,"Indiana","Noble County","NHPI_A",10,1,-9,-163.64,"undercount"
"3020",18113,"Indiana","Noble County","NHPI_AIC",24,36,12,40,"overcount"
"3021",18115,"Indiana","Ohio County","A_A",17,31,14,58.33,"overcount"
"3022",18115,"Indiana","Ohio County","A_AIC",33,41,8,21.62,"overcount"
"3023",18115,"Indiana","Ohio County","NHPI_A",1,0,-1,-200,"undercount"
"3024",18115,"Indiana","Ohio County","NHPI_AIC",2,13,11,146.67,"overcount"
"3025",18117,"Indiana","Orange County","A_A",89,62,-27,-35.76,"undercount"
"3026",18117,"Indiana","Orange County","A_AIC",131,98,-33,-28.82,"undercount"
"3027",18117,"Indiana","Orange County","NHPI_A",4,11,7,93.33,"overcount"
"3028",18117,"Indiana","Orange County","NHPI_AIC",11,34,23,102.22,"overcount"
"3029",18119,"Indiana","Owen County","A_A",122,62,-60,-65.22,"undercount"
"3030",18119,"Indiana","Owen County","A_AIC",192,154,-38,-21.97,"undercount"
"3031",18119,"Indiana","Owen County","NHPI_A",1,0,-1,-200,"undercount"
"3032",18119,"Indiana","Owen County","NHPI_AIC",10,18,8,57.14,"overcount"
"3033",18121,"Indiana","Parke County","A_A",30,30,0,0,"equal"
"3034",18121,"Indiana","Parke County","A_AIC",51,58,7,12.84,"overcount"
"3035",18121,"Indiana","Parke County","NHPI_A",4,0,-4,-200,"undercount"
"3036",18121,"Indiana","Parke County","NHPI_AIC",6,0,-6,-200,"undercount"
"3037",18123,"Indiana","Perry County","A_A",143,99,-44,-36.36,"undercount"
"3038",18123,"Indiana","Perry County","A_AIC",183,188,5,2.7,"overcount"
"3039",18123,"Indiana","Perry County","NHPI_A",11,3,-8,-114.29,"undercount"
"3040",18123,"Indiana","Perry County","NHPI_AIC",15,12,-3,-22.22,"undercount"
"3041",18125,"Indiana","Pike County","A_A",63,15,-48,-123.08,"undercount"
"3042",18125,"Indiana","Pike County","A_AIC",94,34,-60,-93.75,"undercount"
"3043",18125,"Indiana","Pike County","NHPI_A",5,0,-5,-200,"undercount"
"3044",18125,"Indiana","Pike County","NHPI_AIC",9,15,6,50,"overcount"
"3045",18127,"Indiana","Porter County","A_A",2422,2210,-212,-9.15,"undercount"
"3046",18127,"Indiana","Porter County","A_AIC",3244,3290,46,1.41,"overcount"
"3047",18127,"Indiana","Porter County","NHPI_A",39,51,12,26.67,"overcount"
"3048",18127,"Indiana","Porter County","NHPI_AIC",121,150,29,21.4,"overcount"
"3049",18129,"Indiana","Posey County","A_A",138,107,-31,-25.31,"undercount"
"3050",18129,"Indiana","Posey County","A_AIC",190,178,-12,-6.52,"undercount"
"3051",18129,"Indiana","Posey County","NHPI_A",6,3,-3,-66.67,"undercount"
"3052",18129,"Indiana","Posey County","NHPI_AIC",12,17,5,34.48,"overcount"
"3053",18131,"Indiana","Pulaski County","A_A",91,45,-46,-67.65,"undercount"
"3054",18131,"Indiana","Pulaski County","A_AIC",119,96,-23,-21.4,"undercount"
"3055",18131,"Indiana","Pulaski County","NHPI_A",3,3,0,0,"equal"
"3056",18131,"Indiana","Pulaski County","NHPI_AIC",5,12,7,82.35,"overcount"
"3057",18133,"Indiana","Putnam County","A_A",467,370,-97,-23.18,"undercount"
"3058",18133,"Indiana","Putnam County","A_AIC",600,553,-47,-8.15,"undercount"
"3059",18133,"Indiana","Putnam County","NHPI_A",14,15,1,6.9,"overcount"
"3060",18133,"Indiana","Putnam County","NHPI_AIC",35,92,57,89.76,"overcount"
"3061",18135,"Indiana","Randolph County","A_A",85,68,-17,-22.22,"undercount"
"3062",18135,"Indiana","Randolph County","A_AIC",138,136,-2,-1.46,"undercount"
"3063",18135,"Indiana","Randolph County","NHPI_A",18,0,-18,-200,"undercount"
"3064",18135,"Indiana","Randolph County","NHPI_AIC",33,15,-18,-75,"undercount"
"3065",18137,"Indiana","Ripley County","A_A",226,183,-43,-21.03,"undercount"
"3066",18137,"Indiana","Ripley County","A_AIC",292,256,-36,-13.14,"undercount"
"3067",18137,"Indiana","Ripley County","NHPI_A",6,0,-6,-200,"undercount"
"3068",18137,"Indiana","Ripley County","NHPI_AIC",22,3,-19,-152,"undercount"
"3069",18139,"Indiana","Rush County","A_A",68,54,-14,-22.95,"undercount"
"3070",18139,"Indiana","Rush County","A_AIC",94,84,-10,-11.24,"undercount"
"3071",18139,"Indiana","Rush County","NHPI_A",4,9,5,76.92,"overcount"
"3072",18139,"Indiana","Rush County","NHPI_AIC",12,15,3,22.22,"overcount"
"3073",18141,"Indiana","St. Joseph County","A_A",7135,6639,-496,-7.2,"undercount"
"3074",18141,"Indiana","St. Joseph County","A_AIC",8865,8676,-189,-2.15,"undercount"
"3075",18141,"Indiana","St. Joseph County","NHPI_A",162,176,14,8.28,"overcount"
"3076",18141,"Indiana","St. Joseph County","NHPI_AIC",400,425,25,6.06,"overcount"
"3077",18143,"Indiana","Scott County","A_A",210,87,-123,-82.83,"undercount"
"3078",18143,"Indiana","Scott County","A_AIC",264,161,-103,-48.47,"undercount"
"3079",18143,"Indiana","Scott County","NHPI_A",18,11,-7,-48.28,"undercount"
"3080",18143,"Indiana","Scott County","NHPI_AIC",28,26,-2,-7.41,"undercount"
"3081",18145,"Indiana","Shelby County","A_A",339,344,5,1.46,"overcount"
"3082",18145,"Indiana","Shelby County","A_AIC",450,481,31,6.66,"overcount"
"3083",18145,"Indiana","Shelby County","NHPI_A",25,3,-22,-157.14,"undercount"
"3084",18145,"Indiana","Shelby County","NHPI_AIC",52,40,-12,-26.09,"undercount"
"3085",18147,"Indiana","Spencer County","A_A",63,73,10,14.71,"overcount"
"3086",18147,"Indiana","Spencer County","A_AIC",98,126,28,25,"overcount"
"3087",18147,"Indiana","Spencer County","NHPI_A",1,1,0,0,"equal"
"3088",18147,"Indiana","Spencer County","NHPI_AIC",15,5,-10,-100,"undercount"
"3089",18149,"Indiana","Starke County","A_A",64,47,-17,-30.63,"undercount"
"3090",18149,"Indiana","Starke County","A_AIC",113,119,6,5.17,"overcount"
"3091",18149,"Indiana","Starke County","NHPI_A",0,4,4,200,"overcount"
"3092",18149,"Indiana","Starke County","NHPI_AIC",14,19,5,30.3,"overcount"
"3093",18151,"Indiana","Steuben County","A_A",235,187,-48,-22.75,"undercount"
"3094",18151,"Indiana","Steuben County","A_AIC",347,316,-31,-9.35,"undercount"
"3095",18151,"Indiana","Steuben County","NHPI_A",11,2,-9,-138.46,"undercount"
"3096",18151,"Indiana","Steuben County","NHPI_AIC",28,19,-9,-38.3,"undercount"
"3097",18153,"Indiana","Sullivan County","A_A",49,36,-13,-30.59,"undercount"
"3098",18153,"Indiana","Sullivan County","A_AIC",100,82,-18,-19.78,"undercount"
"3099",18153,"Indiana","Sullivan County","NHPI_A",1,8,7,155.56,"overcount"
"3100",18153,"Indiana","Sullivan County","NHPI_AIC",10,16,6,46.15,"overcount"
"3101",18155,"Indiana","Switzerland County","A_A",37,23,-14,-46.67,"undercount"
"3102",18155,"Indiana","Switzerland County","A_AIC",52,45,-7,-14.43,"undercount"
"3103",18155,"Indiana","Switzerland County","NHPI_A",2,0,-2,-200,"undercount"
"3104",18155,"Indiana","Switzerland County","NHPI_AIC",3,15,12,133.33,"overcount"
"3105",18157,"Indiana","Tippecanoe County","A_A",16037,13790,-2247,-15.07,"undercount"
"3106",18157,"Indiana","Tippecanoe County","A_AIC",17547,18253,706,3.94,"overcount"
"3107",18157,"Indiana","Tippecanoe County","NHPI_A",62,38,-24,-48,"undercount"
"3108",18157,"Indiana","Tippecanoe County","NHPI_AIC",233,2899,2666,170.24,"overcount"
"3109",18159,"Indiana","Tipton County","A_A",88,53,-35,-49.65,"undercount"
"3110",18159,"Indiana","Tipton County","A_AIC",118,91,-27,-25.84,"undercount"
"3111",18159,"Indiana","Tipton County","NHPI_A",4,2,-2,-66.67,"undercount"
"3112",18159,"Indiana","Tipton County","NHPI_AIC",14,17,3,19.35,"overcount"
"3113",18161,"Indiana","Union County","A_A",30,33,3,9.52,"overcount"
"3114",18161,"Indiana","Union County","A_AIC",63,60,-3,-4.88,"undercount"
"3115",18161,"Indiana","Union County","NHPI_A",5,8,3,46.15,"overcount"
"3116",18161,"Indiana","Union County","NHPI_AIC",10,16,6,46.15,"overcount"
"3117",18163,"Indiana","Vanderburgh County","A_A",2538,2433,-105,-4.22,"undercount"
"3118",18163,"Indiana","Vanderburgh County","A_AIC",3435,3427,-8,-0.23,"undercount"
"3119",18163,"Indiana","Vanderburgh County","NHPI_A",410,679,269,49.4,"overcount"
"3120",18163,"Indiana","Vanderburgh County","NHPI_AIC",560,823,263,38.03,"overcount"
"3121",18165,"Indiana","Vermillion County","A_A",46,46,0,0,"equal"
"3122",18165,"Indiana","Vermillion County","A_AIC",88,94,6,6.59,"overcount"
"3123",18165,"Indiana","Vermillion County","NHPI_A",6,11,5,58.82,"overcount"
"3124",18165,"Indiana","Vermillion County","NHPI_AIC",16,28,12,54.55,"overcount"
"3125",18167,"Indiana","Vigo County","A_A",2253,2044,-209,-9.73,"undercount"
"3126",18167,"Indiana","Vigo County","A_AIC",2734,2604,-130,-4.87,"undercount"
"3127",18167,"Indiana","Vigo County","NHPI_A",39,25,-14,-43.75,"undercount"
"3128",18167,"Indiana","Vigo County","NHPI_AIC",129,109,-20,-16.81,"undercount"
"3129",18169,"Indiana","Wabash County","A_A",184,163,-21,-12.1,"undercount"
"3130",18169,"Indiana","Wabash County","A_AIC",232,240,8,3.39,"overcount"
"3131",18169,"Indiana","Wabash County","NHPI_A",6,9,3,40,"overcount"
"3132",18169,"Indiana","Wabash County","NHPI_AIC",19,34,15,56.6,"overcount"
"3133",18171,"Indiana","Warren County","A_A",47,29,-18,-47.37,"undercount"
"3134",18171,"Indiana","Warren County","A_AIC",65,54,-11,-18.49,"undercount"
"3135",18171,"Indiana","Warren County","NHPI_A",6,0,-6,-200,"undercount"
"3136",18171,"Indiana","Warren County","NHPI_AIC",9,4,-5,-76.92,"undercount"
"3137",18173,"Indiana","Warrick County","A_A",1755,1650,-105,-6.17,"undercount"
"3138",18173,"Indiana","Warrick County","A_AIC",2021,1996,-25,-1.24,"undercount"
"3139",18173,"Indiana","Warrick County","NHPI_A",32,13,-19,-84.44,"undercount"
"3140",18173,"Indiana","Warrick County","NHPI_AIC",60,41,-19,-37.62,"undercount"
"3141",18175,"Indiana","Washington County","A_A",78,99,21,23.73,"overcount"
"3142",18175,"Indiana","Washington County","A_AIC",129,173,44,29.14,"overcount"
"3143",18175,"Indiana","Washington County","NHPI_A",4,10,6,85.71,"overcount"
"3144",18175,"Indiana","Washington County","NHPI_AIC",14,22,8,44.44,"overcount"
"3145",18177,"Indiana","Wayne County","A_A",717,717,0,0,"equal"
"3146",18177,"Indiana","Wayne County","A_AIC",1026,965,-61,-6.13,"undercount"
"3147",18177,"Indiana","Wayne County","NHPI_A",52,22,-30,-81.08,"undercount"
"3148",18177,"Indiana","Wayne County","NHPI_AIC",183,50,-133,-114.16,"undercount"
"3149",18179,"Indiana","Wells County","A_A",184,142,-42,-25.77,"undercount"
"3150",18179,"Indiana","Wells County","A_AIC",231,212,-19,-8.58,"undercount"
"3151",18179,"Indiana","Wells County","NHPI_A",8,5,-3,-46.15,"undercount"
"3152",18179,"Indiana","Wells County","NHPI_AIC",17,21,4,21.05,"overcount"
"3153",18181,"Indiana","White County","A_A",112,94,-18,-17.48,"undercount"
"3154",18181,"Indiana","White County","A_AIC",163,151,-12,-7.64,"undercount"
"3155",18181,"Indiana","White County","NHPI_A",6,6,0,0,"equal"
"3156",18181,"Indiana","White County","NHPI_AIC",13,25,12,63.16,"overcount"
"3157",18183,"Indiana","Whitley County","A_A",179,194,15,8.04,"overcount"
"3158",18183,"Indiana","Whitley County","A_AIC",275,344,69,22.29,"overcount"
"3159",18183,"Indiana","Whitley County","NHPI_A",9,3,-6,-100,"undercount"
"3160",18183,"Indiana","Whitley County","NHPI_AIC",19,21,2,10,"overcount"
"3161",19001,"Iowa","Adair County","A_A",37,23,-14,-46.67,"undercount"
"3162",19001,"Iowa","Adair County","A_AIC",50,38,-12,-27.27,"undercount"
"3163",19001,"Iowa","Adair County","NHPI_A",3,1,-2,-100,"undercount"
"3164",19001,"Iowa","Adair County","NHPI_AIC",6,3,-3,-66.67,"undercount"
"3165",19003,"Iowa","Adams County","A_A",21,14,-7,-40,"undercount"
"3166",19003,"Iowa","Adams County","A_AIC",28,24,-4,-15.38,"undercount"
"3167",19003,"Iowa","Adams County","NHPI_A",1,0,-1,-200,"undercount"
"3168",19003,"Iowa","Adams County","NHPI_AIC",1,0,-1,-200,"undercount"
"3169",19005,"Iowa","Allamakee County","A_A",59,41,-18,-36,"undercount"
"3170",19005,"Iowa","Allamakee County","A_AIC",77,64,-13,-18.44,"undercount"
"3171",19005,"Iowa","Allamakee County","NHPI_A",13,5,-8,-88.89,"undercount"
"3172",19005,"Iowa","Allamakee County","NHPI_AIC",17,10,-7,-51.85,"undercount"
"3173",19007,"Iowa","Appanoose County","A_A",100,69,-31,-36.69,"undercount"
"3174",19007,"Iowa","Appanoose County","A_AIC",129,114,-15,-12.35,"undercount"
"3175",19007,"Iowa","Appanoose County","NHPI_A",2,7,5,111.11,"overcount"
"3176",19007,"Iowa","Appanoose County","NHPI_AIC",6,12,6,66.67,"overcount"
"3177",19009,"Iowa","Audubon County","A_A",33,4,-29,-156.76,"undercount"
"3178",19009,"Iowa","Audubon County","A_AIC",48,30,-18,-46.15,"undercount"
"3179",19009,"Iowa","Audubon County","NHPI_A",2,1,-1,-66.67,"undercount"
"3180",19009,"Iowa","Audubon County","NHPI_AIC",4,9,5,76.92,"overcount"
"3181",19011,"Iowa","Benton County","A_A",120,88,-32,-30.77,"undercount"
"3182",19011,"Iowa","Benton County","A_AIC",162,150,-12,-7.69,"undercount"
"3183",19011,"Iowa","Benton County","NHPI_A",8,2,-6,-120,"undercount"
"3184",19011,"Iowa","Benton County","NHPI_AIC",11,14,3,24,"overcount"
"3185",19013,"Iowa","Black Hawk County","A_A",3431,3430,-1,-0.03,"undercount"
"3186",19013,"Iowa","Black Hawk County","A_AIC",4198,4211,13,0.31,"overcount"
"3187",19013,"Iowa","Black Hawk County","NHPI_A",573,848,275,38.71,"overcount"
"3188",19013,"Iowa","Black Hawk County","NHPI_AIC",680,954,274,33.54,"overcount"
"3189",19015,"Iowa","Boone County","A_A",133,102,-31,-26.38,"undercount"
"3190",19015,"Iowa","Boone County","A_AIC",212,198,-14,-6.83,"undercount"
"3191",19015,"Iowa","Boone County","NHPI_A",6,4,-2,-40,"undercount"
"3192",19015,"Iowa","Boone County","NHPI_AIC",27,28,1,3.64,"overcount"
"3193",19017,"Iowa","Bremer County","A_A",308,196,-112,-44.44,"undercount"
"3194",19017,"Iowa","Bremer County","A_AIC",377,293,-84,-25.07,"undercount"
"3195",19017,"Iowa","Bremer County","NHPI_A",4,2,-2,-66.67,"undercount"
"3196",19017,"Iowa","Bremer County","NHPI_AIC",14,11,-3,-24,"undercount"
"3197",19019,"Iowa","Buchanan County","A_A",132,52,-80,-86.96,"undercount"
"3198",19019,"Iowa","Buchanan County","A_AIC",179,113,-66,-45.21,"undercount"
"3199",19019,"Iowa","Buchanan County","NHPI_A",2,11,9,138.46,"overcount"
"3200",19019,"Iowa","Buchanan County","NHPI_AIC",14,16,2,13.33,"overcount"
"3201",19021,"Iowa","Buena Vista County","A_A",2110,1894,-216,-10.79,"undercount"
"3202",19021,"Iowa","Buena Vista County","A_AIC",2199,1979,-220,-10.53,"undercount"
"3203",19021,"Iowa","Buena Vista County","NHPI_A",404,622,218,42.5,"overcount"
"3204",19021,"Iowa","Buena Vista County","NHPI_AIC",413,640,227,43.11,"overcount"
"3205",19023,"Iowa","Butler County","A_A",140,29,-111,-131.36,"undercount"
"3206",19023,"Iowa","Butler County","A_AIC",173,73,-100,-81.3,"undercount"
"3207",19023,"Iowa","Butler County","NHPI_A",2,1,-1,-66.67,"undercount"
"3208",19023,"Iowa","Butler County","NHPI_AIC",7,16,9,78.26,"overcount"
"3209",19025,"Iowa","Calhoun County","A_A",33,24,-9,-31.58,"undercount"
"3210",19025,"Iowa","Calhoun County","A_AIC",54,53,-1,-1.87,"undercount"
"3211",19025,"Iowa","Calhoun County","NHPI_A",0,8,8,200,"overcount"
"3212",19025,"Iowa","Calhoun County","NHPI_AIC",2,15,13,152.94,"overcount"
"3213",19027,"Iowa","Carroll County","A_A",112,75,-37,-39.57,"undercount"
"3214",19027,"Iowa","Carroll County","A_AIC",159,121,-38,-27.14,"undercount"
"3215",19027,"Iowa","Carroll County","NHPI_A",1,0,-1,-200,"undercount"
"3216",19027,"Iowa","Carroll County","NHPI_AIC",10,9,-1,-10.53,"undercount"
"3217",19029,"Iowa","Cass County","A_A",55,36,-19,-41.76,"undercount"
"3218",19029,"Iowa","Cass County","A_AIC",74,88,14,17.28,"overcount"
"3219",19029,"Iowa","Cass County","NHPI_A",83,78,-5,-6.21,"undercount"
"3220",19029,"Iowa","Cass County","NHPI_AIC",85,90,5,5.71,"overcount"
"3221",19031,"Iowa","Cedar County","A_A",102,62,-40,-48.78,"undercount"
"3222",19031,"Iowa","Cedar County","A_AIC",170,139,-31,-20.06,"undercount"
"3223",19031,"Iowa","Cedar County","NHPI_A",7,2,-5,-111.11,"undercount"
"3224",19031,"Iowa","Cedar County","NHPI_AIC",12,17,5,34.48,"overcount"
"3225",19033,"Iowa","Cerro Gordo County","A_A",478,535,57,11.25,"overcount"
"3226",19033,"Iowa","Cerro Gordo County","A_AIC",658,733,75,10.78,"overcount"
"3227",19033,"Iowa","Cerro Gordo County","NHPI_A",73,137,64,60.95,"overcount"
"3228",19033,"Iowa","Cerro Gordo County","NHPI_AIC",100,181,81,57.65,"overcount"
"3229",19035,"Iowa","Cherokee County","A_A",82,59,-23,-32.62,"undercount"
"3230",19035,"Iowa","Cherokee County","A_AIC",102,81,-21,-22.95,"undercount"
"3231",19035,"Iowa","Cherokee County","NHPI_A",2,14,12,150,"overcount"
"3232",19035,"Iowa","Cherokee County","NHPI_AIC",5,26,21,135.48,"overcount"
"3233",19037,"Iowa","Chickasaw County","A_A",43,28,-15,-42.25,"undercount"
"3234",19037,"Iowa","Chickasaw County","A_AIC",64,40,-24,-46.15,"undercount"
"3235",19037,"Iowa","Chickasaw County","NHPI_A",3,0,-3,-200,"undercount"
"3236",19037,"Iowa","Chickasaw County","NHPI_AIC",4,8,4,66.67,"overcount"
"3237",19039,"Iowa","Clarke County","A_A",72,81,9,11.76,"overcount"
"3238",19039,"Iowa","Clarke County","A_AIC",112,93,-19,-18.54,"undercount"
"3239",19039,"Iowa","Clarke County","NHPI_A",24,40,16,50,"overcount"
"3240",19039,"Iowa","Clarke County","NHPI_AIC",28,52,24,60,"overcount"
"3241",19041,"Iowa","Clay County","A_A",117,105,-12,-10.81,"undercount"
"3242",19041,"Iowa","Clay County","A_AIC",160,162,2,1.24,"overcount"
"3243",19041,"Iowa","Clay County","NHPI_A",0,2,2,200,"overcount"
"3244",19041,"Iowa","Clay County","NHPI_AIC",14,4,-10,-111.11,"undercount"
"3245",19043,"Iowa","Clayton County","A_A",41,47,6,13.64,"overcount"
"3246",19043,"Iowa","Clayton County","A_AIC",86,90,4,4.55,"overcount"
"3247",19043,"Iowa","Clayton County","NHPI_A",15,6,-9,-85.71,"undercount"
"3248",19043,"Iowa","Clayton County","NHPI_AIC",29,26,-3,-10.91,"undercount"
"3249",19045,"Iowa","Clinton County","A_A",317,260,-57,-19.76,"undercount"
"3250",19045,"Iowa","Clinton County","A_AIC",479,450,-29,-6.24,"undercount"
"3251",19045,"Iowa","Clinton County","NHPI_A",21,10,-11,-70.97,"undercount"
"3252",19045,"Iowa","Clinton County","NHPI_AIC",54,27,-27,-66.67,"undercount"
"3253",19047,"Iowa","Crawford County","A_A",418,303,-115,-31.9,"undercount"
"3254",19047,"Iowa","Crawford County","A_AIC",439,330,-109,-28.35,"undercount"
"3255",19047,"Iowa","Crawford County","NHPI_A",13,6,-7,-73.68,"undercount"
"3256",19047,"Iowa","Crawford County","NHPI_AIC",21,12,-9,-54.55,"undercount"
"3257",19049,"Iowa","Dallas County","A_A",5011,5021,10,0.2,"overcount"
"3258",19049,"Iowa","Dallas County","A_AIC",5548,5959,411,7.14,"overcount"
"3259",19049,"Iowa","Dallas County","NHPI_A",56,32,-24,-54.55,"undercount"
"3260",19049,"Iowa","Dallas County","NHPI_AIC",103,133,30,25.42,"overcount"
"3261",19051,"Iowa","Davis County","A_A",38,16,-22,-81.48,"undercount"
"3262",19051,"Iowa","Davis County","A_AIC",62,50,-12,-21.43,"undercount"
"3263",19051,"Iowa","Davis County","NHPI_A",0,0,0,0,"equal"
"3264",19051,"Iowa","Davis County","NHPI_AIC",3,9,6,100,"overcount"
"3265",19053,"Iowa","Decatur County","A_A",66,39,-27,-51.43,"undercount"
"3266",19053,"Iowa","Decatur County","A_AIC",93,63,-30,-38.46,"undercount"
"3267",19053,"Iowa","Decatur County","NHPI_A",15,21,6,33.33,"overcount"
"3268",19053,"Iowa","Decatur County","NHPI_AIC",18,28,10,43.48,"overcount"
"3269",19055,"Iowa","Delaware County","A_A",58,39,-19,-39.18,"undercount"
"3270",19055,"Iowa","Delaware County","A_AIC",79,75,-4,-5.19,"undercount"
"3271",19055,"Iowa","Delaware County","NHPI_A",4,0,-4,-200,"undercount"
"3272",19055,"Iowa","Delaware County","NHPI_AIC",11,5,-6,-75,"undercount"
"3273",19057,"Iowa","Des Moines County","A_A",418,405,-13,-3.16,"undercount"
"3274",19057,"Iowa","Des Moines County","A_AIC",556,594,38,6.61,"overcount"
"3275",19057,"Iowa","Des Moines County","NHPI_A",18,21,3,15.38,"overcount"
"3276",19057,"Iowa","Des Moines County","NHPI_AIC",48,72,24,40,"overcount"
"3277",19059,"Iowa","Dickinson County","A_A",160,80,-80,-66.67,"undercount"
"3278",19059,"Iowa","Dickinson County","A_AIC",218,135,-83,-47.03,"undercount"
"3279",19059,"Iowa","Dickinson County","NHPI_A",7,1,-6,-150,"undercount"
"3280",19059,"Iowa","Dickinson County","NHPI_AIC",16,22,6,31.58,"overcount"
"3281",19061,"Iowa","Dubuque County","A_A",1267,1021,-246,-21.5,"undercount"
"3282",19061,"Iowa","Dubuque County","A_AIC",1682,1421,-261,-16.82,"undercount"
"3283",19061,"Iowa","Dubuque County","NHPI_A",655,814,159,21.65,"overcount"
"3284",19061,"Iowa","Dubuque County","NHPI_AIC",730,861,131,16.47,"overcount"
"3285",19063,"Iowa","Emmet County","A_A",59,32,-27,-59.34,"undercount"
"3286",19063,"Iowa","Emmet County","A_AIC",81,51,-30,-45.45,"undercount"
"3287",19063,"Iowa","Emmet County","NHPI_A",2,3,1,40,"overcount"
"3288",19063,"Iowa","Emmet County","NHPI_AIC",10,13,3,26.09,"overcount"
"3289",19065,"Iowa","Fayette County","A_A",200,78,-122,-87.77,"undercount"
"3290",19065,"Iowa","Fayette County","A_AIC",234,154,-80,-41.24,"undercount"
"3291",19065,"Iowa","Fayette County","NHPI_A",10,2,-8,-133.33,"undercount"
"3292",19065,"Iowa","Fayette County","NHPI_AIC",21,15,-6,-33.33,"undercount"
"3293",19067,"Iowa","Floyd County","A_A",223,296,73,28.13,"overcount"
"3294",19067,"Iowa","Floyd County","A_AIC",267,369,102,32.08,"overcount"
"3295",19067,"Iowa","Floyd County","NHPI_A",11,12,1,8.7,"overcount"
"3296",19067,"Iowa","Floyd County","NHPI_AIC",18,21,3,15.38,"overcount"
"3297",19069,"Iowa","Franklin County","A_A",59,49,-10,-18.52,"undercount"
"3298",19069,"Iowa","Franklin County","A_AIC",71,70,-1,-1.42,"undercount"
"3299",19069,"Iowa","Franklin County","NHPI_A",4,0,-4,-200,"undercount"
"3300",19069,"Iowa","Franklin County","NHPI_AIC",6,11,5,58.82,"overcount"
"3301",19071,"Iowa","Fremont County","A_A",24,8,-16,-100,"undercount"
"3302",19071,"Iowa","Fremont County","A_AIC",38,30,-8,-23.53,"undercount"
"3303",19071,"Iowa","Fremont County","NHPI_A",2,5,3,85.71,"overcount"
"3304",19071,"Iowa","Fremont County","NHPI_AIC",4,16,12,120,"overcount"
"3305",19073,"Iowa","Greene County","A_A",57,53,-4,-7.27,"undercount"
"3306",19073,"Iowa","Greene County","A_AIC",72,72,0,0,"equal"
"3307",19073,"Iowa","Greene County","NHPI_A",2,1,-1,-66.67,"undercount"
"3308",19073,"Iowa","Greene County","NHPI_AIC",7,18,11,88,"overcount"
"3309",19075,"Iowa","Grundy County","A_A",43,24,-19,-56.72,"undercount"
"3310",19075,"Iowa","Grundy County","A_AIC",61,77,16,23.19,"overcount"
"3311",19075,"Iowa","Grundy County","NHPI_A",6,2,-4,-100,"undercount"
"3312",19075,"Iowa","Grundy County","NHPI_AIC",8,9,1,11.76,"overcount"
"3313",19077,"Iowa","Guthrie County","A_A",33,40,7,19.18,"overcount"
"3314",19077,"Iowa","Guthrie County","A_AIC",56,61,5,8.55,"overcount"
"3315",19077,"Iowa","Guthrie County","NHPI_A",7,16,9,78.26,"overcount"
"3316",19077,"Iowa","Guthrie County","NHPI_AIC",12,27,15,76.92,"overcount"
"3317",19079,"Iowa","Hamilton County","A_A",356,328,-28,-8.19,"undercount"
"3318",19079,"Iowa","Hamilton County","A_AIC",411,400,-11,-2.71,"undercount"
"3319",19079,"Iowa","Hamilton County","NHPI_A",0,0,0,0,"equal"
"3320",19079,"Iowa","Hamilton County","NHPI_AIC",9,12,3,28.57,"overcount"
"3321",19081,"Iowa","Hancock County","A_A",63,25,-38,-86.36,"undercount"
"3322",19081,"Iowa","Hancock County","A_AIC",86,55,-31,-43.97,"undercount"
"3323",19081,"Iowa","Hancock County","NHPI_A",4,2,-2,-66.67,"undercount"
"3324",19081,"Iowa","Hancock County","NHPI_AIC",9,15,6,50,"overcount"
"3325",19083,"Iowa","Hardin County","A_A",144,94,-50,-42.02,"undercount"
"3326",19083,"Iowa","Hardin County","A_AIC",187,188,1,0.53,"overcount"
"3327",19083,"Iowa","Hardin County","NHPI_A",7,2,-5,-111.11,"undercount"
"3328",19083,"Iowa","Hardin County","NHPI_AIC",18,37,19,69.09,"overcount"
"3329",19085,"Iowa","Harrison County","A_A",52,51,-1,-1.94,"undercount"
"3330",19085,"Iowa","Harrison County","A_AIC",89,75,-14,-17.07,"undercount"
"3331",19085,"Iowa","Harrison County","NHPI_A",1,0,-1,-200,"undercount"
"3332",19085,"Iowa","Harrison County","NHPI_AIC",14,3,-11,-129.41,"undercount"
"3333",19087,"Iowa","Henry County","A_A",478,451,-27,-5.81,"undercount"
"3334",19087,"Iowa","Henry County","A_AIC",563,580,17,2.97,"overcount"
"3335",19087,"Iowa","Henry County","NHPI_A",25,8,-17,-103.03,"undercount"
"3336",19087,"Iowa","Henry County","NHPI_AIC",41,28,-13,-37.68,"undercount"
"3337",19089,"Iowa","Howard County","A_A",33,27,-6,-20,"undercount"
"3338",19089,"Iowa","Howard County","A_AIC",46,63,17,31.19,"overcount"
"3339",19089,"Iowa","Howard County","NHPI_A",6,7,1,15.38,"overcount"
"3340",19089,"Iowa","Howard County","NHPI_AIC",9,11,2,20,"overcount"
"3341",19091,"Iowa","Humboldt County","A_A",40,24,-16,-50,"undercount"
"3342",19091,"Iowa","Humboldt County","A_AIC",67,54,-13,-21.49,"undercount"
"3343",19091,"Iowa","Humboldt County","NHPI_A",1,8,7,155.56,"overcount"
"3344",19091,"Iowa","Humboldt County","NHPI_AIC",2,18,16,160,"overcount"
"3345",19093,"Iowa","Ida County","A_A",38,18,-20,-71.43,"undercount"
"3346",19093,"Iowa","Ida County","A_AIC",61,39,-22,-44,"undercount"
"3347",19093,"Iowa","Ida County","NHPI_A",2,11,9,138.46,"overcount"
"3348",19093,"Iowa","Ida County","NHPI_AIC",4,21,17,136,"overcount"
"3349",19095,"Iowa","Iowa County","A_A",84,84,0,0,"equal"
"3350",19095,"Iowa","Iowa County","A_AIC",111,151,40,30.53,"overcount"
"3351",19095,"Iowa","Iowa County","NHPI_A",6,3,-3,-66.67,"undercount"
"3352",19095,"Iowa","Iowa County","NHPI_AIC",13,28,15,73.17,"overcount"
"3353",19097,"Iowa","Jackson County","A_A",94,46,-48,-68.57,"undercount"
"3354",19097,"Iowa","Jackson County","A_AIC",150,89,-61,-51.05,"undercount"
"3355",19097,"Iowa","Jackson County","NHPI_A",122,190,68,43.59,"overcount"
"3356",19097,"Iowa","Jackson County","NHPI_AIC",135,210,75,43.48,"overcount"
"3357",19099,"Iowa","Jasper County","A_A",247,216,-31,-13.39,"undercount"
"3358",19099,"Iowa","Jasper County","A_AIC",369,361,-8,-2.19,"undercount"
"3359",19099,"Iowa","Jasper County","NHPI_A",20,30,10,40,"overcount"
"3360",19099,"Iowa","Jasper County","NHPI_AIC",43,62,19,36.19,"overcount"
"3361",19101,"Iowa","Jefferson County","A_A",2065,516,-1549,-120.03,"undercount"
"3362",19101,"Iowa","Jefferson County","A_AIC",2167,619,-1548,-111.13,"undercount"
"3363",19101,"Iowa","Jefferson County","NHPI_A",5,9,4,57.14,"overcount"
"3364",19101,"Iowa","Jefferson County","NHPI_AIC",25,32,7,24.56,"overcount"
"3365",19103,"Iowa","Johnson County","A_A",9939,8644,-1295,-13.94,"undercount"
"3366",19103,"Iowa","Johnson County","A_AIC",11434,10319,-1115,-10.25,"undercount"
"3367",19103,"Iowa","Johnson County","NHPI_A",78,41,-37,-62.18,"undercount"
"3368",19103,"Iowa","Johnson County","NHPI_AIC",223,183,-40,-19.7,"undercount"
"3369",19105,"Iowa","Jones County","A_A",114,58,-56,-65.12,"undercount"
"3370",19105,"Iowa","Jones County","A_AIC",150,120,-30,-22.22,"undercount"
"3371",19105,"Iowa","Jones County","NHPI_A",7,4,-3,-54.55,"undercount"
"3372",19105,"Iowa","Jones County","NHPI_AIC",17,28,11,48.89,"overcount"
"3373",19107,"Iowa","Keokuk County","A_A",29,16,-13,-57.78,"undercount"
"3374",19107,"Iowa","Keokuk County","A_AIC",50,41,-9,-19.78,"undercount"
"3375",19107,"Iowa","Keokuk County","NHPI_A",0,0,0,0,"equal"
"3376",19107,"Iowa","Keokuk County","NHPI_AIC",3,8,5,90.91,"overcount"
"3377",19109,"Iowa","Kossuth County","A_A",92,71,-21,-25.77,"undercount"
"3378",19109,"Iowa","Kossuth County","A_AIC",120,116,-4,-3.39,"undercount"
"3379",19109,"Iowa","Kossuth County","NHPI_A",5,5,0,0,"equal"
"3380",19109,"Iowa","Kossuth County","NHPI_AIC",12,14,2,15.38,"overcount"
"3381",19111,"Iowa","Lee County","A_A",208,139,-69,-39.77,"undercount"
"3382",19111,"Iowa","Lee County","A_AIC",318,239,-79,-28.37,"undercount"
"3383",19111,"Iowa","Lee County","NHPI_A",27,12,-15,-76.92,"undercount"
"3384",19111,"Iowa","Lee County","NHPI_AIC",61,31,-30,-65.22,"undercount"
"3385",19113,"Iowa","Linn County","A_A",5937,5367,-570,-10.08,"undercount"
"3386",19113,"Iowa","Linn County","A_AIC",7458,6999,-459,-6.35,"undercount"
"3387",19113,"Iowa","Linn County","NHPI_A",364,522,158,35.67,"overcount"
"3388",19113,"Iowa","Linn County","NHPI_AIC",551,703,152,24.24,"overcount"
"3389",19115,"Iowa","Louisa County","A_A",382,267,-115,-35.44,"undercount"
"3390",19115,"Iowa","Louisa County","A_AIC",415,297,-118,-33.15,"undercount"
"3391",19115,"Iowa","Louisa County","NHPI_A",17,0,-17,-200,"undercount"
"3392",19115,"Iowa","Louisa County","NHPI_AIC",22,3,-19,-152,"undercount"
"3393",19117,"Iowa","Lucas County","A_A",28,30,2,6.9,"overcount"
"3394",19117,"Iowa","Lucas County","A_AIC",54,57,3,5.41,"overcount"
"3395",19117,"Iowa","Lucas County","NHPI_A",4,2,-2,-66.67,"undercount"
"3396",19117,"Iowa","Lucas County","NHPI_AIC",7,17,10,83.33,"overcount"
"3397",19119,"Iowa","Lyon County","A_A",44,24,-20,-58.82,"undercount"
"3398",19119,"Iowa","Lyon County","A_AIC",73,48,-25,-41.32,"undercount"
"3399",19119,"Iowa","Lyon County","NHPI_A",24,43,19,56.72,"overcount"
"3400",19119,"Iowa","Lyon County","NHPI_AIC",33,45,12,30.77,"overcount"
"3401",19121,"Iowa","Madison County","A_A",150,89,-61,-51.05,"undercount"
"3402",19121,"Iowa","Madison County","A_AIC",226,176,-50,-24.88,"undercount"
"3403",19121,"Iowa","Madison County","NHPI_A",4,14,10,111.11,"overcount"
"3404",19121,"Iowa","Madison County","NHPI_AIC",15,29,14,63.64,"overcount"
"3405",19123,"Iowa","Mahaska County","A_A",419,251,-168,-50.15,"undercount"
"3406",19123,"Iowa","Mahaska County","A_AIC",488,369,-119,-27.77,"undercount"
"3407",19123,"Iowa","Mahaska County","NHPI_A",9,17,8,61.54,"overcount"
"3408",19123,"Iowa","Mahaska County","NHPI_AIC",19,38,19,66.67,"overcount"
"3409",19125,"Iowa","Marion County","A_A",471,402,-69,-15.81,"undercount"
"3410",19125,"Iowa","Marion County","A_AIC",583,560,-23,-4.02,"undercount"
"3411",19125,"Iowa","Marion County","NHPI_A",18,22,4,20,"overcount"
"3412",19125,"Iowa","Marion County","NHPI_AIC",36,39,3,8,"overcount"
"3413",19127,"Iowa","Marshall County","A_A",1444,1518,74,5,"overcount"
"3414",19127,"Iowa","Marshall County","A_AIC",1609,1689,80,4.85,"overcount"
"3415",19127,"Iowa","Marshall County","NHPI_A",58,33,-25,-54.95,"undercount"
"3416",19127,"Iowa","Marshall County","NHPI_AIC",79,42,-37,-61.16,"undercount"
"3417",19129,"Iowa","Mills County","A_A",63,48,-15,-27.03,"undercount"
"3418",19129,"Iowa","Mills County","A_AIC",101,103,2,1.96,"overcount"
"3419",19129,"Iowa","Mills County","NHPI_A",13,10,-3,-26.09,"undercount"
"3420",19129,"Iowa","Mills County","NHPI_AIC",24,21,-3,-13.33,"undercount"
"3421",19131,"Iowa","Mitchell County","A_A",52,46,-6,-12.24,"undercount"
"3422",19131,"Iowa","Mitchell County","A_AIC",73,80,7,9.15,"overcount"
"3423",19131,"Iowa","Mitchell County","NHPI_A",5,4,-1,-22.22,"undercount"
"3424",19131,"Iowa","Mitchell County","NHPI_AIC",8,14,6,54.55,"overcount"
"3425",19133,"Iowa","Monona County","A_A",27,29,2,7.14,"overcount"
"3426",19133,"Iowa","Monona County","A_AIC",43,46,3,6.74,"overcount"
"3427",19133,"Iowa","Monona County","NHPI_A",4,2,-2,-66.67,"undercount"
"3428",19133,"Iowa","Monona County","NHPI_AIC",7,10,3,35.29,"overcount"
"3429",19135,"Iowa","Monroe County","A_A",31,16,-15,-63.83,"undercount"
"3430",19135,"Iowa","Monroe County","A_AIC",53,50,-3,-5.83,"undercount"
"3431",19135,"Iowa","Monroe County","NHPI_A",1,3,2,100,"overcount"
"3432",19135,"Iowa","Monroe County","NHPI_AIC",4,7,3,54.55,"overcount"
"3433",19137,"Iowa","Montgomery County","A_A",38,28,-10,-30.3,"undercount"
"3434",19137,"Iowa","Montgomery County","A_AIC",64,45,-19,-34.86,"undercount"
"3435",19137,"Iowa","Montgomery County","NHPI_A",8,2,-6,-120,"undercount"
"3436",19137,"Iowa","Montgomery County","NHPI_AIC",14,4,-10,-111.11,"undercount"
"3437",19139,"Iowa","Muscatine County","A_A",434,416,-18,-4.24,"undercount"
"3438",19139,"Iowa","Muscatine County","A_AIC",552,544,-8,-1.46,"undercount"
"3439",19139,"Iowa","Muscatine County","NHPI_A",64,0,-64,-200,"undercount"
"3440",19139,"Iowa","Muscatine County","NHPI_AIC",85,4,-81,-182.02,"undercount"
"3441",19141,"Iowa","O'Brien County","A_A",101,81,-20,-21.98,"undercount"
"3442",19141,"Iowa","O'Brien County","A_AIC",135,133,-2,-1.49,"undercount"
"3443",19141,"Iowa","O'Brien County","NHPI_A",4,11,7,93.33,"overcount"
"3444",19141,"Iowa","O'Brien County","NHPI_AIC",13,19,6,37.5,"overcount"
"3445",19143,"Iowa","Osceola County","A_A",53,21,-32,-86.49,"undercount"
"3446",19143,"Iowa","Osceola County","A_AIC",70,51,-19,-31.4,"undercount"
"3447",19143,"Iowa","Osceola County","NHPI_A",13,36,23,93.88,"overcount"
"3448",19143,"Iowa","Osceola County","NHPI_AIC",15,41,26,92.86,"overcount"
"3449",19145,"Iowa","Page County","A_A",161,119,-42,-30,"undercount"
"3450",19145,"Iowa","Page County","A_AIC",217,203,-14,-6.67,"undercount"
"3451",19145,"Iowa","Page County","NHPI_A",5,0,-5,-200,"undercount"
"3452",19145,"Iowa","Page County","NHPI_AIC",17,15,-2,-12.5,"undercount"
"3453",19147,"Iowa","Palo Alto County","A_A",81,37,-44,-74.58,"undercount"
"3454",19147,"Iowa","Palo Alto County","A_AIC",109,65,-44,-50.57,"undercount"
"3455",19147,"Iowa","Palo Alto County","NHPI_A",7,6,-1,-15.38,"undercount"
"3456",19147,"Iowa","Palo Alto County","NHPI_AIC",13,14,1,7.41,"overcount"
"3457",19149,"Iowa","Plymouth County","A_A",162,114,-48,-34.78,"undercount"
"3458",19149,"Iowa","Plymouth County","A_AIC",247,189,-58,-26.61,"undercount"
"3459",19149,"Iowa","Plymouth County","NHPI_A",71,117,46,48.94,"overcount"
"3460",19149,"Iowa","Plymouth County","NHPI_AIC",81,134,53,49.3,"overcount"
"3461",19151,"Iowa","Pocahontas County","A_A",30,31,1,3.28,"overcount"
"3462",19151,"Iowa","Pocahontas County","A_AIC",53,57,4,7.27,"overcount"
"3463",19151,"Iowa","Pocahontas County","NHPI_A",24,23,-1,-4.26,"undercount"
"3464",19151,"Iowa","Pocahontas County","NHPI_AIC",29,31,2,6.67,"overcount"
"3465",19153,"Iowa","Polk County","A_A",25318,24567,-751,-3.01,"undercount"
"3466",19153,"Iowa","Polk County","A_AIC",28835,28791,-44,-0.15,"undercount"
"3467",19153,"Iowa","Polk County","NHPI_A",221,290,69,27.01,"overcount"
"3468",19153,"Iowa","Polk County","NHPI_AIC",592,768,176,25.88,"overcount"
"3469",19155,"Iowa","Pottawattamie County","A_A",864,797,-67,-8.07,"undercount"
"3470",19155,"Iowa","Pottawattamie County","A_AIC",1299,1183,-116,-9.35,"undercount"
"3471",19155,"Iowa","Pottawattamie County","NHPI_A",71,76,5,6.8,"overcount"
"3472",19155,"Iowa","Pottawattamie County","NHPI_AIC",139,140,1,0.72,"overcount"
"3473",19157,"Iowa","Poweshiek County","A_A",368,226,-142,-47.81,"undercount"
"3474",19157,"Iowa","Poweshiek County","A_AIC",473,323,-150,-37.69,"undercount"
"3475",19157,"Iowa","Poweshiek County","NHPI_A",25,21,-4,-17.39,"undercount"
"3476",19157,"Iowa","Poweshiek County","NHPI_AIC",39,29,-10,-29.41,"undercount"
"3477",19159,"Iowa","Ringgold County","A_A",34,8,-26,-123.81,"undercount"
"3478",19159,"Iowa","Ringgold County","A_AIC",43,28,-15,-42.25,"undercount"
"3479",19159,"Iowa","Ringgold County","NHPI_A",2,0,-2,-200,"undercount"
"3480",19159,"Iowa","Ringgold County","NHPI_AIC",4,0,-4,-200,"undercount"
"3481",19161,"Iowa","Sac County","A_A",44,31,-13,-34.67,"undercount"
"3482",19161,"Iowa","Sac County","A_AIC",61,44,-17,-32.38,"undercount"
"3483",19161,"Iowa","Sac County","NHPI_A",18,6,-12,-100,"undercount"
"3484",19161,"Iowa","Sac County","NHPI_AIC",19,14,-5,-30.3,"undercount"
"3485",19163,"Iowa","Scott County","A_A",5189,4887,-302,-5.99,"undercount"
"3486",19163,"Iowa","Scott County","A_AIC",6107,6108,1,0.02,"overcount"
"3487",19163,"Iowa","Scott County","NHPI_A",74,63,-11,-16.06,"undercount"
"3488",19163,"Iowa","Scott County","NHPI_AIC",215,185,-30,-15,"undercount"
"3489",19165,"Iowa","Shelby County","A_A",69,49,-20,-33.9,"undercount"
"3490",19165,"Iowa","Shelby County","A_AIC",102,72,-30,-34.48,"undercount"
"3491",19165,"Iowa","Shelby County","NHPI_A",2,3,1,40,"overcount"
"3492",19165,"Iowa","Shelby County","NHPI_AIC",6,10,4,50,"overcount"
"3493",19167,"Iowa","Sioux County","A_A",272,220,-52,-21.14,"undercount"
"3494",19167,"Iowa","Sioux County","A_AIC",345,341,-4,-1.17,"undercount"
"3495",19167,"Iowa","Sioux County","NHPI_A",12,5,-7,-82.35,"undercount"
"3496",19167,"Iowa","Sioux County","NHPI_AIC",21,16,-5,-27.03,"undercount"
"3497",19169,"Iowa","Story County","A_A",7898,5495,-2403,-35.88,"undercount"
"3498",19169,"Iowa","Story County","A_AIC",8632,7584,-1048,-12.93,"undercount"
"3499",19169,"Iowa","Story County","NHPI_A",25,29,4,14.81,"overcount"
"3500",19169,"Iowa","Story County","NHPI_AIC",78,1332,1254,177.87,"overcount"
"3501",19171,"Iowa","Tama County","A_A",76,80,4,5.13,"overcount"
"3502",19171,"Iowa","Tama County","A_AIC",159,132,-27,-18.56,"undercount"
"3503",19171,"Iowa","Tama County","NHPI_A",10,2,-8,-133.33,"undercount"
"3504",19171,"Iowa","Tama County","NHPI_AIC",17,43,26,86.67,"overcount"
"3505",19173,"Iowa","Taylor County","A_A",24,16,-8,-40,"undercount"
"3506",19173,"Iowa","Taylor County","A_AIC",36,24,-12,-40,"undercount"
"3507",19173,"Iowa","Taylor County","NHPI_A",0,1,1,200,"overcount"
"3508",19173,"Iowa","Taylor County","NHPI_AIC",2,4,2,66.67,"overcount"
"3509",19175,"Iowa","Union County","A_A",92,65,-27,-34.39,"undercount"
"3510",19175,"Iowa","Union County","A_AIC",122,97,-25,-22.83,"undercount"
"3511",19175,"Iowa","Union County","NHPI_A",7,7,0,0,"equal"
"3512",19175,"Iowa","Union County","NHPI_AIC",10,16,6,46.15,"overcount"
"3513",19177,"Iowa","Van Buren County","A_A",41,24,-17,-52.31,"undercount"
"3514",19177,"Iowa","Van Buren County","A_AIC",62,29,-33,-72.53,"undercount"
"3515",19177,"Iowa","Van Buren County","NHPI_A",1,0,-1,-200,"undercount"
"3516",19177,"Iowa","Van Buren County","NHPI_AIC",3,4,1,28.57,"overcount"
"3517",19179,"Iowa","Wapello County","A_A",637,632,-5,-0.79,"undercount"
"3518",19179,"Iowa","Wapello County","A_AIC",735,785,50,6.58,"overcount"
"3519",19179,"Iowa","Wapello County","NHPI_A",473,518,45,9.08,"overcount"
"3520",19179,"Iowa","Wapello County","NHPI_AIC",493,577,84,15.7,"overcount"
"3521",19181,"Iowa","Warren County","A_A",396,380,-16,-4.12,"undercount"
"3522",19181,"Iowa","Warren County","A_AIC",617,652,35,5.52,"overcount"
"3523",19181,"Iowa","Warren County","NHPI_A",61,17,-44,-112.82,"undercount"
"3524",19181,"Iowa","Warren County","NHPI_AIC",91,61,-30,-39.47,"undercount"
"3525",19183,"Iowa","Washington County","A_A",138,113,-25,-19.92,"undercount"
"3526",19183,"Iowa","Washington County","A_AIC",204,204,0,0,"equal"
"3527",19183,"Iowa","Washington County","NHPI_A",14,3,-11,-129.41,"undercount"
"3528",19183,"Iowa","Washington County","NHPI_AIC",20,8,-12,-85.71,"undercount"
"3529",19185,"Iowa","Wayne County","A_A",33,25,-8,-27.59,"undercount"
"3530",19185,"Iowa","Wayne County","A_AIC",52,45,-7,-14.43,"undercount"
"3531",19185,"Iowa","Wayne County","NHPI_A",1,1,0,0,"equal"
"3532",19185,"Iowa","Wayne County","NHPI_AIC",1,13,12,171.43,"overcount"
"3533",19187,"Iowa","Webster County","A_A",412,298,-114,-32.11,"undercount"
"3534",19187,"Iowa","Webster County","A_AIC",541,426,-115,-23.78,"undercount"
"3535",19187,"Iowa","Webster County","NHPI_A",12,16,4,28.57,"overcount"
"3536",19187,"Iowa","Webster County","NHPI_AIC",41,56,15,30.93,"overcount"
"3537",19189,"Iowa","Winnebago County","A_A",87,95,8,8.79,"overcount"
"3538",19189,"Iowa","Winnebago County","A_AIC",128,128,0,0,"equal"
"3539",19189,"Iowa","Winnebago County","NHPI_A",2,3,1,40,"overcount"
"3540",19189,"Iowa","Winnebago County","NHPI_AIC",6,17,11,95.65,"overcount"
"3541",19191,"Iowa","Winneshiek County","A_A",216,178,-38,-19.29,"undercount"
"3542",19191,"Iowa","Winneshiek County","A_AIC",247,254,7,2.79,"overcount"
"3543",19191,"Iowa","Winneshiek County","NHPI_A",3,12,9,120,"overcount"
"3544",19191,"Iowa","Winneshiek County","NHPI_AIC",7,22,15,103.45,"overcount"
"3545",19193,"Iowa","Woodbury County","A_A",2933,3006,73,2.46,"overcount"
"3546",19193,"Iowa","Woodbury County","A_AIC",3511,3603,92,2.59,"overcount"
"3547",19193,"Iowa","Woodbury County","NHPI_A",603,651,48,7.66,"overcount"
"3548",19193,"Iowa","Woodbury County","NHPI_AIC",717,752,35,4.77,"overcount"
"3549",19195,"Iowa","Worth County","A_A",47,26,-21,-57.53,"undercount"
"3550",19195,"Iowa","Worth County","A_AIC",66,45,-21,-37.84,"undercount"
"3551",19195,"Iowa","Worth County","NHPI_A",2,1,-1,-66.67,"undercount"
"3552",19195,"Iowa","Worth County","NHPI_AIC",8,6,-2,-28.57,"undercount"
"3553",19197,"Iowa","Wright County","A_A",62,69,7,10.69,"overcount"
"3554",19197,"Iowa","Wright County","A_AIC",109,119,10,8.77,"overcount"
"3555",19197,"Iowa","Wright County","NHPI_A",6,8,2,28.57,"overcount"
"3556",19197,"Iowa","Wright County","NHPI_AIC",9,17,8,61.54,"overcount"
"3557",20001,"Kansas","Allen County","A_A",125,67,-58,-60.42,"undercount"
"3558",20001,"Kansas","Allen County","A_AIC",167,123,-44,-30.34,"undercount"
"3559",20001,"Kansas","Allen County","NHPI_A",4,2,-2,-66.67,"undercount"
"3560",20001,"Kansas","Allen County","NHPI_AIC",17,26,9,41.86,"overcount"
"3561",20003,"Kansas","Anderson County","A_A",56,73,17,26.36,"overcount"
"3562",20003,"Kansas","Anderson County","A_AIC",72,84,12,15.38,"overcount"
"3563",20003,"Kansas","Anderson County","NHPI_A",1,0,-1,-200,"undercount"
"3564",20003,"Kansas","Anderson County","NHPI_AIC",4,5,1,22.22,"overcount"
"3565",20005,"Kansas","Atchison County","A_A",99,84,-15,-16.39,"undercount"
"3566",20005,"Kansas","Atchison County","A_AIC",151,160,9,5.79,"overcount"
"3567",20005,"Kansas","Atchison County","NHPI_A",11,10,-1,-9.52,"undercount"
"3568",20005,"Kansas","Atchison County","NHPI_AIC",28,37,9,27.69,"overcount"
"3569",20007,"Kansas","Barber County","A_A",19,16,-3,-17.14,"undercount"
"3570",20007,"Kansas","Barber County","A_AIC",27,39,12,36.36,"overcount"
"3571",20007,"Kansas","Barber County","NHPI_A",1,5,4,133.33,"overcount"
"3572",20007,"Kansas","Barber County","NHPI_AIC",4,8,4,66.67,"overcount"
"3573",20009,"Kansas","Barton County","A_A",74,80,6,7.79,"overcount"
"3574",20009,"Kansas","Barton County","A_AIC",117,134,17,13.55,"overcount"
"3575",20009,"Kansas","Barton County","NHPI_A",9,3,-6,-100,"undercount"
"3576",20009,"Kansas","Barton County","NHPI_AIC",18,5,-13,-113.04,"undercount"
"3577",20011,"Kansas","Bourbon County","A_A",166,98,-68,-51.52,"undercount"
"3578",20011,"Kansas","Bourbon County","A_AIC",208,163,-45,-24.26,"undercount"
"3579",20011,"Kansas","Bourbon County","NHPI_A",8,2,-6,-120,"undercount"
"3580",20011,"Kansas","Bourbon County","NHPI_AIC",16,20,4,22.22,"overcount"
"3581",20013,"Kansas","Brown County","A_A",67,42,-25,-45.87,"undercount"
"3582",20013,"Kansas","Brown County","A_AIC",85,82,-3,-3.59,"undercount"
"3583",20013,"Kansas","Brown County","NHPI_A",6,9,3,40,"overcount"
"3584",20013,"Kansas","Brown County","NHPI_AIC",9,19,10,71.43,"overcount"
"3585",20015,"Kansas","Butler County","A_A",945,996,51,5.26,"overcount"
"3586",20015,"Kansas","Butler County","A_AIC",1280,1412,132,9.81,"overcount"
"3587",20015,"Kansas","Butler County","NHPI_A",49,37,-12,-27.91,"undercount"
"3588",20015,"Kansas","Butler County","NHPI_AIC",92,106,14,14.14,"overcount"
"3589",20017,"Kansas","Chase County","A_A",7,11,4,44.44,"overcount"
"3590",20017,"Kansas","Chase County","A_AIC",12,14,2,15.38,"overcount"
"3591",20017,"Kansas","Chase County","NHPI_A",0,1,1,200,"overcount"
"3592",20017,"Kansas","Chase County","NHPI_AIC",2,2,0,0,"equal"
"3593",20019,"Kansas","Chautauqua County","A_A",8,19,11,81.48,"overcount"
"3594",20019,"Kansas","Chautauqua County","A_AIC",22,33,11,40,"overcount"
"3595",20019,"Kansas","Chautauqua County","NHPI_A",1,0,-1,-200,"undercount"
"3596",20019,"Kansas","Chautauqua County","NHPI_AIC",3,8,5,90.91,"overcount"
"3597",20021,"Kansas","Cherokee County","A_A",92,65,-27,-34.39,"undercount"
"3598",20021,"Kansas","Cherokee County","A_AIC",151,122,-29,-21.25,"undercount"
"3599",20021,"Kansas","Cherokee County","NHPI_A",95,26,-69,-114.05,"undercount"
"3600",20021,"Kansas","Cherokee County","NHPI_AIC",106,51,-55,-70.06,"undercount"
"3601",20023,"Kansas","Cheyenne County","A_A",29,12,-17,-82.93,"undercount"
"3602",20023,"Kansas","Cheyenne County","A_AIC",31,15,-16,-69.57,"undercount"
"3603",20023,"Kansas","Cheyenne County","NHPI_A",0,0,0,0,"equal"
"3604",20023,"Kansas","Cheyenne County","NHPI_AIC",2,13,11,146.67,"overcount"
"3605",20025,"Kansas","Clark County","A_A",29,24,-5,-18.87,"undercount"
"3606",20025,"Kansas","Clark County","A_AIC",36,32,-4,-11.76,"undercount"
"3607",20025,"Kansas","Clark County","NHPI_A",2,1,-1,-66.67,"undercount"
"3608",20025,"Kansas","Clark County","NHPI_AIC",3,5,2,50,"overcount"
"3609",20027,"Kansas","Clay County","A_A",44,54,10,20.41,"overcount"
"3610",20027,"Kansas","Clay County","A_AIC",78,87,9,10.91,"overcount"
"3611",20027,"Kansas","Clay County","NHPI_A",6,0,-6,-200,"undercount"
"3612",20027,"Kansas","Clay County","NHPI_AIC",12,3,-9,-120,"undercount"
"3613",20029,"Kansas","Cloud County","A_A",80,40,-40,-66.67,"undercount"
"3614",20029,"Kansas","Cloud County","A_AIC",113,71,-42,-45.65,"undercount"
"3615",20029,"Kansas","Cloud County","NHPI_A",1,4,3,120,"overcount"
"3616",20029,"Kansas","Cloud County","NHPI_AIC",5,11,6,75,"overcount"
"3617",20031,"Kansas","Coffey County","A_A",71,51,-20,-32.79,"undercount"
"3618",20031,"Kansas","Coffey County","A_AIC",92,72,-20,-24.39,"undercount"
"3619",20031,"Kansas","Coffey County","NHPI_A",0,1,1,200,"overcount"
"3620",20031,"Kansas","Coffey County","NHPI_AIC",2,3,1,40,"overcount"
"3621",20033,"Kansas","Comanche County","A_A",5,0,-5,-200,"undercount"
"3622",20033,"Kansas","Comanche County","A_AIC",12,6,-6,-66.67,"undercount"
"3623",20033,"Kansas","Comanche County","NHPI_A",1,1,0,0,"equal"
"3624",20033,"Kansas","Comanche County","NHPI_AIC",1,4,3,120,"overcount"
"3625",20035,"Kansas","Cowley County","A_A",655,507,-148,-25.47,"undercount"
"3626",20035,"Kansas","Cowley County","A_AIC",789,689,-100,-13.53,"undercount"
"3627",20035,"Kansas","Cowley County","NHPI_A",155,179,24,14.37,"overcount"
"3628",20035,"Kansas","Cowley County","NHPI_AIC",186,242,56,26.17,"overcount"
"3629",20037,"Kansas","Crawford County","A_A",697,462,-235,-40.55,"undercount"
"3630",20037,"Kansas","Crawford County","A_AIC",889,637,-252,-33.03,"undercount"
"3631",20037,"Kansas","Crawford County","NHPI_A",134,191,57,35.08,"overcount"
"3632",20037,"Kansas","Crawford County","NHPI_AIC",166,221,55,28.42,"overcount"
"3633",20039,"Kansas","Decatur County","A_A",6,10,4,50,"overcount"
"3634",20039,"Kansas","Decatur County","A_AIC",14,16,2,13.33,"overcount"
"3635",20039,"Kansas","Decatur County","NHPI_A",0,0,0,0,"equal"
"3636",20039,"Kansas","Decatur County","NHPI_AIC",0,1,1,200,"overcount"
"3637",20041,"Kansas","Dickinson County","A_A",121,74,-47,-48.21,"undercount"
"3638",20041,"Kansas","Dickinson County","A_AIC",185,143,-42,-25.61,"undercount"
"3639",20041,"Kansas","Dickinson County","NHPI_A",19,20,1,5.13,"overcount"
"3640",20041,"Kansas","Dickinson County","NHPI_AIC",33,29,-4,-12.9,"undercount"
"3641",20043,"Kansas","Doniphan County","A_A",39,32,-7,-19.72,"undercount"
"3642",20043,"Kansas","Doniphan County","A_AIC",63,48,-15,-27.03,"undercount"
"3643",20043,"Kansas","Doniphan County","NHPI_A",0,19,19,200,"overcount"
"3644",20043,"Kansas","Doniphan County","NHPI_AIC",2,26,24,171.43,"overcount"
"3645",20045,"Kansas","Douglas County","A_A",5824,4673,-1151,-21.93,"undercount"
"3646",20045,"Kansas","Douglas County","A_AIC",7229,6104,-1125,-16.88,"undercount"
"3647",20045,"Kansas","Douglas County","NHPI_A",93,89,-4,-4.4,"undercount"
"3648",20045,"Kansas","Douglas County","NHPI_AIC",267,204,-63,-26.75,"undercount"
"3649",20047,"Kansas","Edwards County","A_A",5,1,-4,-133.33,"undercount"
"3650",20047,"Kansas","Edwards County","A_AIC",16,9,-7,-56,"undercount"
"3651",20047,"Kansas","Edwards County","NHPI_A",0,1,1,200,"overcount"
"3652",20047,"Kansas","Edwards County","NHPI_AIC",2,5,3,85.71,"overcount"
"3653",20049,"Kansas","Elk County","A_A",13,3,-10,-125,"undercount"
"3654",20049,"Kansas","Elk County","A_AIC",30,18,-12,-50,"undercount"
"3655",20049,"Kansas","Elk County","NHPI_A",1,1,0,0,"equal"
"3656",20049,"Kansas","Elk County","NHPI_AIC",3,10,7,107.69,"overcount"
"3657",20051,"Kansas","Ellis County","A_A",407,265,-142,-42.26,"undercount"
"3658",20051,"Kansas","Ellis County","A_AIC",492,505,13,2.61,"overcount"
"3659",20051,"Kansas","Ellis County","NHPI_A",15,0,-15,-200,"undercount"
"3660",20051,"Kansas","Ellis County","NHPI_AIC",40,123,83,101.84,"overcount"
"3661",20053,"Kansas","Ellsworth County","A_A",39,23,-16,-51.61,"undercount"
"3662",20053,"Kansas","Ellsworth County","A_AIC",46,60,14,26.42,"overcount"
"3663",20053,"Kansas","Ellsworth County","NHPI_A",0,0,0,0,"equal"
"3664",20053,"Kansas","Ellsworth County","NHPI_AIC",4,6,2,40,"overcount"
"3665",20055,"Kansas","Finney County","A_A",1399,1534,135,9.21,"overcount"
"3666",20055,"Kansas","Finney County","A_AIC",1462,1653,191,12.26,"overcount"
"3667",20055,"Kansas","Finney County","NHPI_A",17,3,-14,-140,"undercount"
"3668",20055,"Kansas","Finney County","NHPI_AIC",30,32,2,6.45,"overcount"
"3669",20057,"Kansas","Ford County","A_A",435,411,-24,-5.67,"undercount"
"3670",20057,"Kansas","Ford County","A_AIC",511,510,-1,-0.2,"undercount"
"3671",20057,"Kansas","Ford County","NHPI_A",39,6,-33,-146.67,"undercount"
"3672",20057,"Kansas","Ford County","NHPI_AIC",56,31,-25,-57.47,"undercount"
"3673",20059,"Kansas","Franklin County","A_A",132,103,-29,-24.68,"undercount"
"3674",20059,"Kansas","Franklin County","A_AIC",206,194,-12,-6,"undercount"
"3675",20059,"Kansas","Franklin County","NHPI_A",5,7,2,33.33,"overcount"
"3676",20059,"Kansas","Franklin County","NHPI_AIC",20,22,2,9.52,"overcount"
"3677",20061,"Kansas","Geary County","A_A",971,1187,216,20.02,"overcount"
"3678",20061,"Kansas","Geary County","A_AIC",1570,2048,478,26.42,"overcount"
"3679",20061,"Kansas","Geary County","NHPI_A",383,458,75,17.84,"overcount"
"3680",20061,"Kansas","Geary County","NHPI_AIC",499,702,203,33.81,"overcount"
"3681",20063,"Kansas","Gove County","A_A",25,16,-9,-43.9,"undercount"
"3682",20063,"Kansas","Gove County","A_AIC",34,27,-7,-22.95,"undercount"
"3683",20063,"Kansas","Gove County","NHPI_A",1,1,0,0,"equal"
"3684",20063,"Kansas","Gove County","NHPI_AIC",2,8,6,120,"overcount"
"3685",20065,"Kansas","Graham County","A_A",41,14,-27,-98.18,"undercount"
"3686",20065,"Kansas","Graham County","A_AIC",55,22,-33,-85.71,"undercount"
"3687",20065,"Kansas","Graham County","NHPI_A",0,0,0,0,"equal"
"3688",20065,"Kansas","Graham County","NHPI_AIC",3,13,10,125,"overcount"
"3689",20067,"Kansas","Grant County","A_A",43,8,-35,-137.25,"undercount"
"3690",20067,"Kansas","Grant County","A_AIC",52,27,-25,-63.29,"undercount"
"3691",20067,"Kansas","Grant County","NHPI_A",0,3,3,200,"overcount"
"3692",20067,"Kansas","Grant County","NHPI_AIC",3,6,3,66.67,"overcount"
"3693",20069,"Kansas","Gray County","A_A",36,14,-22,-88,"undercount"
"3694",20069,"Kansas","Gray County","A_AIC",43,17,-26,-86.67,"undercount"
"3695",20069,"Kansas","Gray County","NHPI_A",0,0,0,0,"equal"
"3696",20069,"Kansas","Gray County","NHPI_AIC",4,3,-1,-28.57,"undercount"
"3697",20071,"Kansas","Greeley County","A_A",5,5,0,0,"equal"
"3698",20071,"Kansas","Greeley County","A_AIC",8,13,5,47.62,"overcount"
"3699",20071,"Kansas","Greeley County","NHPI_A",0,0,0,0,"equal"
"3700",20071,"Kansas","Greeley County","NHPI_AIC",0,7,7,200,"overcount"
"3701",20073,"Kansas","Greenwood County","A_A",23,36,13,44.07,"overcount"
"3702",20073,"Kansas","Greenwood County","A_AIC",38,48,10,23.26,"overcount"
"3703",20073,"Kansas","Greenwood County","NHPI_A",0,1,1,200,"overcount"
"3704",20073,"Kansas","Greenwood County","NHPI_AIC",7,1,-6,-150,"undercount"
"3705",20075,"Kansas","Hamilton County","A_A",6,8,2,28.57,"overcount"
"3706",20075,"Kansas","Hamilton County","A_AIC",13,13,0,0,"equal"
"3707",20075,"Kansas","Hamilton County","NHPI_A",3,0,-3,-200,"undercount"
"3708",20075,"Kansas","Hamilton County","NHPI_AIC",4,3,-1,-28.57,"undercount"
"3709",20077,"Kansas","Harper County","A_A",22,15,-7,-37.84,"undercount"
"3710",20077,"Kansas","Harper County","A_AIC",38,39,1,2.6,"overcount"
"3711",20077,"Kansas","Harper County","NHPI_A",1,2,1,66.67,"overcount"
"3712",20077,"Kansas","Harper County","NHPI_AIC",7,9,2,25,"overcount"
"3713",20079,"Kansas","Harvey County","A_A",368,260,-108,-34.39,"undercount"
"3714",20079,"Kansas","Harvey County","A_AIC",489,415,-74,-16.37,"undercount"
"3715",20079,"Kansas","Harvey County","NHPI_A",13,10,-3,-26.09,"undercount"
"3716",20079,"Kansas","Harvey County","NHPI_AIC",36,32,-4,-11.76,"undercount"
"3717",20081,"Kansas","Haskell County","A_A",27,1,-26,-185.71,"undercount"
"3718",20081,"Kansas","Haskell County","A_AIC",34,4,-30,-157.89,"undercount"
"3719",20081,"Kansas","Haskell County","NHPI_A",1,0,-1,-200,"undercount"
"3720",20081,"Kansas","Haskell County","NHPI_AIC",2,5,3,85.71,"overcount"
"3721",20083,"Kansas","Hodgeman County","A_A",63,10,-53,-145.21,"undercount"
"3722",20083,"Kansas","Hodgeman County","A_AIC",68,21,-47,-105.62,"undercount"
"3723",20083,"Kansas","Hodgeman County","NHPI_A",0,1,1,200,"overcount"
"3724",20083,"Kansas","Hodgeman County","NHPI_AIC",3,3,0,0,"equal"
"3725",20085,"Kansas","Jackson County","A_A",69,29,-40,-81.63,"undercount"
"3726",20085,"Kansas","Jackson County","A_AIC",106,54,-52,-65,"undercount"
"3727",20085,"Kansas","Jackson County","NHPI_A",4,19,15,130.43,"overcount"
"3728",20085,"Kansas","Jackson County","NHPI_AIC",11,33,22,100,"overcount"
"3729",20087,"Kansas","Jefferson County","A_A",56,41,-15,-30.93,"undercount"
"3730",20087,"Kansas","Jefferson County","A_AIC",102,108,6,5.71,"overcount"
"3731",20087,"Kansas","Jefferson County","NHPI_A",23,27,4,16,"overcount"
"3732",20087,"Kansas","Jefferson County","NHPI_AIC",33,46,13,32.91,"overcount"
"3733",20089,"Kansas","Jewell County","A_A",13,10,-3,-26.09,"undercount"
"3734",20089,"Kansas","Jewell County","A_AIC",17,27,10,45.45,"overcount"
"3735",20089,"Kansas","Jewell County","NHPI_A",0,0,0,0,"equal"
"3736",20089,"Kansas","Jewell County","NHPI_AIC",2,8,6,120,"overcount"
"3737",20091,"Kansas","Johnson County","A_A",32736,33142,406,1.23,"overcount"
"3738",20091,"Kansas","Johnson County","A_AIC",38235,40337,2102,5.35,"overcount"
"3739",20091,"Kansas","Johnson County","NHPI_A",183,354,171,63.69,"overcount"
"3740",20091,"Kansas","Johnson County","NHPI_AIC",734,1012,278,31.84,"overcount"
"3741",20093,"Kansas","Kearny County","A_A",20,10,-10,-66.67,"undercount"
"3742",20093,"Kansas","Kearny County","A_AIC",27,32,5,16.95,"overcount"
"3743",20093,"Kansas","Kearny County","NHPI_A",2,1,-1,-66.67,"undercount"
"3744",20093,"Kansas","Kearny County","NHPI_AIC",6,10,4,50,"overcount"
"3745",20095,"Kansas","Kingman County","A_A",43,35,-8,-20.51,"undercount"
"3746",20095,"Kansas","Kingman County","A_AIC",61,48,-13,-23.85,"undercount"
"3747",20095,"Kansas","Kingman County","NHPI_A",2,4,2,66.67,"overcount"
"3748",20095,"Kansas","Kingman County","NHPI_AIC",8,12,4,40,"overcount"
"3749",20097,"Kansas","Kiowa County","A_A",46,16,-30,-96.77,"undercount"
"3750",20097,"Kansas","Kiowa County","A_AIC",53,27,-26,-65,"undercount"
"3751",20097,"Kansas","Kiowa County","NHPI_A",1,4,3,120,"overcount"
"3752",20097,"Kansas","Kiowa County","NHPI_AIC",2,5,3,85.71,"overcount"
"3753",20099,"Kansas","Labette County","A_A",85,94,9,10.06,"overcount"
"3754",20099,"Kansas","Labette County","A_AIC",162,172,10,5.99,"overcount"
"3755",20099,"Kansas","Labette County","NHPI_A",8,9,1,11.76,"overcount"
"3756",20099,"Kansas","Labette County","NHPI_AIC",38,25,-13,-41.27,"undercount"
"3757",20101,"Kansas","Lane County","A_A",4,0,-4,-200,"undercount"
"3758",20101,"Kansas","Lane County","A_AIC",7,3,-4,-80,"undercount"
"3759",20101,"Kansas","Lane County","NHPI_A",1,2,1,66.67,"overcount"
"3760",20101,"Kansas","Lane County","NHPI_AIC",3,8,5,90.91,"overcount"
"3761",20103,"Kansas","Leavenworth County","A_A",1220,1074,-146,-12.73,"undercount"
"3762",20103,"Kansas","Leavenworth County","A_AIC",2016,1959,-57,-2.87,"undercount"
"3763",20103,"Kansas","Leavenworth County","NHPI_A",146,139,-7,-4.91,"undercount"
"3764",20103,"Kansas","Leavenworth County","NHPI_AIC",288,288,0,0,"equal"
"3765",20105,"Kansas","Lincoln County","A_A",15,8,-7,-60.87,"undercount"
"3766",20105,"Kansas","Lincoln County","A_AIC",24,12,-12,-66.67,"undercount"
"3767",20105,"Kansas","Lincoln County","NHPI_A",0,0,0,0,"equal"
"3768",20105,"Kansas","Lincoln County","NHPI_AIC",1,5,4,133.33,"overcount"
"3769",20107,"Kansas","Linn County","A_A",35,20,-15,-54.55,"undercount"
"3770",20107,"Kansas","Linn County","A_AIC",71,36,-35,-65.42,"undercount"
"3771",20107,"Kansas","Linn County","NHPI_A",3,10,7,107.69,"overcount"
"3772",20107,"Kansas","Linn County","NHPI_AIC",10,18,8,57.14,"overcount"
"3773",20109,"Kansas","Logan County","A_A",29,11,-18,-90,"undercount"
"3774",20109,"Kansas","Logan County","A_AIC",37,29,-8,-24.24,"undercount"
"3775",20109,"Kansas","Logan County","NHPI_A",0,2,2,200,"overcount"
"3776",20109,"Kansas","Logan County","NHPI_AIC",2,5,3,85.71,"overcount"
"3777",20111,"Kansas","Lyon County","A_A",761,632,-129,-18.52,"undercount"
"3778",20111,"Kansas","Lyon County","A_AIC",916,787,-129,-15.15,"undercount"
"3779",20111,"Kansas","Lyon County","NHPI_A",26,5,-21,-135.48,"undercount"
"3780",20111,"Kansas","Lyon County","NHPI_AIC",52,28,-24,-60,"undercount"
"3781",20113,"Kansas","McPherson County","A_A",275,213,-62,-25.41,"undercount"
"3782",20113,"Kansas","McPherson County","A_AIC",352,342,-10,-2.88,"undercount"
"3783",20113,"Kansas","McPherson County","NHPI_A",23,8,-15,-96.77,"undercount"
"3784",20113,"Kansas","McPherson County","NHPI_AIC",48,37,-11,-25.88,"undercount"
"3785",20115,"Kansas","Marion County","A_A",62,39,-23,-45.54,"undercount"
"3786",20115,"Kansas","Marion County","A_AIC",102,64,-38,-45.78,"undercount"
"3787",20115,"Kansas","Marion County","NHPI_A",8,7,-1,-13.33,"undercount"
"3788",20115,"Kansas","Marion County","NHPI_AIC",14,10,-4,-33.33,"undercount"
"3789",20117,"Kansas","Marshall County","A_A",43,41,-2,-4.76,"undercount"
"3790",20117,"Kansas","Marshall County","A_AIC",75,65,-10,-14.29,"undercount"
"3791",20117,"Kansas","Marshall County","NHPI_A",3,0,-3,-200,"undercount"
"3792",20117,"Kansas","Marshall County","NHPI_AIC",12,5,-7,-82.35,"undercount"
"3793",20119,"Kansas","Meade County","A_A",33,13,-20,-86.96,"undercount"
"3794",20119,"Kansas","Meade County","A_AIC",44,31,-13,-34.67,"undercount"
"3795",20119,"Kansas","Meade County","NHPI_A",0,0,0,0,"equal"
"3796",20119,"Kansas","Meade County","NHPI_AIC",1,5,4,133.33,"overcount"
"3797",20121,"Kansas","Miami County","A_A",207,163,-44,-23.78,"undercount"
"3798",20121,"Kansas","Miami County","A_AIC",330,300,-30,-9.52,"undercount"
"3799",20121,"Kansas","Miami County","NHPI_A",12,8,-4,-40,"undercount"
"3800",20121,"Kansas","Miami County","NHPI_AIC",37,34,-3,-8.45,"undercount"
"3801",20123,"Kansas","Mitchell County","A_A",45,13,-32,-110.34,"undercount"
"3802",20123,"Kansas","Mitchell County","A_AIC",64,28,-36,-78.26,"undercount"
"3803",20123,"Kansas","Mitchell County","NHPI_A",11,0,-11,-200,"undercount"
"3804",20123,"Kansas","Mitchell County","NHPI_AIC",16,6,-10,-90.91,"undercount"
"3805",20125,"Kansas","Montgomery County","A_A",302,191,-111,-45.03,"undercount"
"3806",20125,"Kansas","Montgomery County","A_AIC",461,298,-163,-42.95,"undercount"
"3807",20125,"Kansas","Montgomery County","NHPI_A",41,24,-17,-52.31,"undercount"
"3808",20125,"Kansas","Montgomery County","NHPI_AIC",98,64,-34,-41.98,"undercount"
"3809",20127,"Kansas","Morris County","A_A",38,19,-19,-66.67,"undercount"
"3810",20127,"Kansas","Morris County","A_AIC",63,26,-37,-83.15,"undercount"
"3811",20127,"Kansas","Morris County","NHPI_A",2,1,-1,-66.67,"undercount"
"3812",20127,"Kansas","Morris County","NHPI_AIC",7,5,-2,-33.33,"undercount"
"3813",20129,"Kansas","Morton County","A_A",39,34,-5,-13.7,"undercount"
"3814",20129,"Kansas","Morton County","A_AIC",45,51,6,12.5,"overcount"
"3815",20129,"Kansas","Morton County","NHPI_A",1,9,8,160,"overcount"
"3816",20129,"Kansas","Morton County","NHPI_AIC",1,20,19,180.95,"overcount"
"3817",20131,"Kansas","Nemaha County","A_A",32,35,3,8.96,"overcount"
"3818",20131,"Kansas","Nemaha County","A_AIC",58,79,21,30.66,"overcount"
"3819",20131,"Kansas","Nemaha County","NHPI_A",7,7,0,0,"equal"
"3820",20131,"Kansas","Nemaha County","NHPI_AIC",12,20,8,50,"overcount"
"3821",20133,"Kansas","Neosho County","A_A",97,84,-13,-14.36,"undercount"
"3822",20133,"Kansas","Neosho County","A_AIC",162,149,-13,-8.36,"undercount"
"3823",20133,"Kansas","Neosho County","NHPI_A",8,6,-2,-28.57,"undercount"
"3824",20133,"Kansas","Neosho County","NHPI_AIC",23,14,-9,-48.65,"undercount"
"3825",20135,"Kansas","Ness County","A_A",3,2,-1,-40,"undercount"
"3826",20135,"Kansas","Ness County","A_AIC",10,3,-7,-107.69,"undercount"
"3827",20135,"Kansas","Ness County","NHPI_A",0,0,0,0,"equal"
"3828",20135,"Kansas","Ness County","NHPI_AIC",0,3,3,200,"overcount"
"3829",20137,"Kansas","Norton County","A_A",60,35,-25,-52.63,"undercount"
"3830",20137,"Kansas","Norton County","A_AIC",83,54,-29,-42.34,"undercount"
"3831",20137,"Kansas","Norton County","NHPI_A",2,2,0,0,"equal"
"3832",20137,"Kansas","Norton County","NHPI_AIC",5,13,8,88.89,"overcount"
"3833",20139,"Kansas","Osage County","A_A",67,52,-15,-25.21,"undercount"
"3834",20139,"Kansas","Osage County","A_AIC",104,110,6,5.61,"overcount"
"3835",20139,"Kansas","Osage County","NHPI_A",6,3,-3,-66.67,"undercount"
"3836",20139,"Kansas","Osage County","NHPI_AIC",17,21,4,21.05,"overcount"
"3837",20141,"Kansas","Osborne County","A_A",41,18,-23,-77.97,"undercount"
"3838",20141,"Kansas","Osborne County","A_AIC",49,30,-19,-48.1,"undercount"
"3839",20141,"Kansas","Osborne County","NHPI_A",0,0,0,0,"equal"
"3840",20141,"Kansas","Osborne County","NHPI_AIC",1,4,3,120,"overcount"
"3841",20143,"Kansas","Ottawa County","A_A",20,10,-10,-66.67,"undercount"
"3842",20143,"Kansas","Ottawa County","A_AIC",38,23,-15,-49.18,"undercount"
"3843",20143,"Kansas","Ottawa County","NHPI_A",0,0,0,0,"equal"
"3844",20143,"Kansas","Ottawa County","NHPI_AIC",3,13,10,125,"overcount"
"3845",20145,"Kansas","Pawnee County","A_A",36,28,-8,-25,"undercount"
"3846",20145,"Kansas","Pawnee County","A_AIC",48,44,-4,-8.7,"undercount"
"3847",20145,"Kansas","Pawnee County","NHPI_A",2,0,-2,-200,"undercount"
"3848",20145,"Kansas","Pawnee County","NHPI_AIC",5,9,4,57.14,"overcount"
"3849",20147,"Kansas","Phillips County","A_A",61,17,-44,-112.82,"undercount"
"3850",20147,"Kansas","Phillips County","A_AIC",73,26,-47,-94.95,"undercount"
"3851",20147,"Kansas","Phillips County","NHPI_A",0,1,1,200,"overcount"
"3852",20147,"Kansas","Phillips County","NHPI_AIC",2,8,6,120,"overcount"
"3853",20149,"Kansas","Pottawatomie County","A_A",249,194,-55,-24.83,"undercount"
"3854",20149,"Kansas","Pottawatomie County","A_AIC",394,403,9,2.26,"overcount"
"3855",20149,"Kansas","Pottawatomie County","NHPI_A",34,27,-7,-22.95,"undercount"
"3856",20149,"Kansas","Pottawatomie County","NHPI_AIC",52,43,-9,-18.95,"undercount"
"3857",20151,"Kansas","Pratt County","A_A",83,45,-38,-59.38,"undercount"
"3858",20151,"Kansas","Pratt County","A_AIC",112,64,-48,-54.55,"undercount"
"3859",20151,"Kansas","Pratt County","NHPI_A",4,10,6,85.71,"overcount"
"3860",20151,"Kansas","Pratt County","NHPI_AIC",9,16,7,56,"overcount"
"3861",20153,"Kansas","Rawlins County","A_A",17,11,-6,-42.86,"undercount"
"3862",20153,"Kansas","Rawlins County","A_AIC",22,28,6,24,"overcount"
"3863",20153,"Kansas","Rawlins County","NHPI_A",0,0,0,0,"equal"
"3864",20153,"Kansas","Rawlins County","NHPI_AIC",0,4,4,200,"overcount"
"3865",20155,"Kansas","Reno County","A_A",348,333,-15,-4.41,"undercount"
"3866",20155,"Kansas","Reno County","A_AIC",578,593,15,2.56,"overcount"
"3867",20155,"Kansas","Reno County","NHPI_A",52,41,-11,-23.66,"undercount"
"3868",20155,"Kansas","Reno County","NHPI_AIC",90,94,4,4.35,"overcount"
"3869",20157,"Kansas","Republic County","A_A",33,11,-22,-100,"undercount"
"3870",20157,"Kansas","Republic County","A_AIC",40,16,-24,-85.71,"undercount"
"3871",20157,"Kansas","Republic County","NHPI_A",0,9,9,200,"overcount"
"3872",20157,"Kansas","Republic County","NHPI_AIC",2,11,9,138.46,"overcount"
"3873",20159,"Kansas","Rice County","A_A",95,30,-65,-104,"undercount"
"3874",20159,"Kansas","Rice County","A_AIC",135,62,-73,-74.11,"undercount"
"3875",20159,"Kansas","Rice County","NHPI_A",7,0,-7,-200,"undercount"
"3876",20159,"Kansas","Rice County","NHPI_AIC",15,12,-3,-22.22,"undercount"
"3877",20161,"Kansas","Riley County","A_A",3460,3376,-84,-2.46,"undercount"
"3878",20161,"Kansas","Riley County","A_AIC",4344,4301,-43,-0.99,"undercount"
"3879",20161,"Kansas","Riley County","NHPI_A",161,228,67,34.45,"overcount"
"3880",20161,"Kansas","Riley County","NHPI_AIC",274,400,126,37.39,"overcount"
"3881",20163,"Kansas","Rooks County","A_A",30,5,-25,-142.86,"undercount"
"3882",20163,"Kansas","Rooks County","A_AIC",39,28,-11,-32.84,"undercount"
"3883",20163,"Kansas","Rooks County","NHPI_A",4,9,5,76.92,"overcount"
"3884",20163,"Kansas","Rooks County","NHPI_AIC",6,18,12,100,"overcount"
"3885",20165,"Kansas","Rush County","A_A",12,14,2,15.38,"overcount"
"3886",20165,"Kansas","Rush County","A_AIC",19,22,3,14.63,"overcount"
"3887",20165,"Kansas","Rush County","NHPI_A",2,0,-2,-200,"undercount"
"3888",20165,"Kansas","Rush County","NHPI_AIC",2,6,4,100,"overcount"
"3889",20167,"Kansas","Russell County","A_A",40,41,1,2.47,"overcount"
"3890",20167,"Kansas","Russell County","A_AIC",56,65,9,14.88,"overcount"
"3891",20167,"Kansas","Russell County","NHPI_A",1,0,-1,-200,"undercount"
"3892",20167,"Kansas","Russell County","NHPI_AIC",4,4,0,0,"equal"
"3893",20169,"Kansas","Saline County","A_A",1135,1117,-18,-1.6,"undercount"
"3894",20169,"Kansas","Saline County","A_AIC",1506,1529,23,1.52,"overcount"
"3895",20169,"Kansas","Saline County","NHPI_A",28,28,0,0,"equal"
"3896",20169,"Kansas","Saline County","NHPI_AIC",99,119,20,18.35,"overcount"
"3897",20171,"Kansas","Scott County","A_A",47,15,-32,-103.23,"undercount"
"3898",20171,"Kansas","Scott County","A_AIC",58,41,-17,-34.34,"undercount"
"3899",20171,"Kansas","Scott County","NHPI_A",2,2,0,0,"equal"
"3900",20171,"Kansas","Scott County","NHPI_AIC",3,13,10,125,"overcount"
"3901",20173,"Kansas","Sedgwick County","A_A",23076,22376,-700,-3.08,"undercount"
"3902",20173,"Kansas","Sedgwick County","A_AIC",27495,27514,19,0.07,"overcount"
"3903",20173,"Kansas","Sedgwick County","NHPI_A",366,534,168,37.33,"overcount"
"3904",20173,"Kansas","Sedgwick County","NHPI_AIC",847,1315,468,43.29,"overcount"
"3905",20175,"Kansas","Seward County","A_A",536,532,-4,-0.75,"undercount"
"3906",20175,"Kansas","Seward County","A_AIC",582,610,28,4.7,"overcount"
"3907",20175,"Kansas","Seward County","NHPI_A",28,1,-27,-186.21,"undercount"
"3908",20175,"Kansas","Seward County","NHPI_AIC",34,27,-7,-22.95,"undercount"
"3909",20177,"Kansas","Shawnee County","A_A",2624,2506,-118,-4.6,"undercount"
"3910",20177,"Kansas","Shawnee County","A_AIC",3634,3617,-17,-0.47,"undercount"
"3911",20177,"Kansas","Shawnee County","NHPI_A",180,165,-15,-8.7,"undercount"
"3912",20177,"Kansas","Shawnee County","NHPI_AIC",352,368,16,4.44,"overcount"
"3913",20179,"Kansas","Sheridan County","A_A",10,12,2,18.18,"overcount"
"3914",20179,"Kansas","Sheridan County","A_AIC",14,20,6,35.29,"overcount"
"3915",20179,"Kansas","Sheridan County","NHPI_A",0,2,2,200,"overcount"
"3916",20179,"Kansas","Sheridan County","NHPI_AIC",0,11,11,200,"overcount"
"3917",20181,"Kansas","Sherman County","A_A",25,14,-11,-56.41,"undercount"
"3918",20181,"Kansas","Sherman County","A_AIC",38,37,-1,-2.67,"undercount"
"3919",20181,"Kansas","Sherman County","NHPI_A",8,1,-7,-155.56,"undercount"
"3920",20181,"Kansas","Sherman County","NHPI_AIC",11,10,-1,-9.52,"undercount"
"3921",20183,"Kansas","Smith County","A_A",11,9,-2,-20,"undercount"
"3922",20183,"Kansas","Smith County","A_AIC",21,22,1,4.65,"overcount"
"3923",20183,"Kansas","Smith County","NHPI_A",4,0,-4,-200,"undercount"
"3924",20183,"Kansas","Smith County","NHPI_AIC",7,8,1,13.33,"overcount"
"3925",20185,"Kansas","Stafford County","A_A",17,13,-4,-26.67,"undercount"
"3926",20185,"Kansas","Stafford County","A_AIC",26,19,-7,-31.11,"undercount"
"3927",20185,"Kansas","Stafford County","NHPI_A",2,0,-2,-200,"undercount"
"3928",20185,"Kansas","Stafford County","NHPI_AIC",4,8,4,66.67,"overcount"
"3929",20187,"Kansas","Stanton County","A_A",4,7,3,54.55,"overcount"
"3930",20187,"Kansas","Stanton County","A_AIC",28,20,-8,-33.33,"undercount"
"3931",20187,"Kansas","Stanton County","NHPI_A",0,0,0,0,"equal"
"3932",20187,"Kansas","Stanton County","NHPI_AIC",0,10,10,200,"overcount"
"3933",20189,"Kansas","Stevens County","A_A",28,22,-6,-24,"undercount"
"3934",20189,"Kansas","Stevens County","A_AIC",35,34,-1,-2.9,"undercount"
"3935",20189,"Kansas","Stevens County","NHPI_A",0,0,0,0,"equal"
"3936",20189,"Kansas","Stevens County","NHPI_AIC",5,0,-5,-200,"undercount"
"3937",20191,"Kansas","Sumner County","A_A",111,73,-38,-41.3,"undercount"
"3938",20191,"Kansas","Sumner County","A_AIC",165,130,-35,-23.73,"undercount"
"3939",20191,"Kansas","Sumner County","NHPI_A",6,0,-6,-200,"undercount"
"3940",20191,"Kansas","Sumner County","NHPI_AIC",18,8,-10,-76.92,"undercount"
"3941",20193,"Kansas","Thomas County","A_A",65,51,-14,-24.14,"undercount"
"3942",20193,"Kansas","Thomas County","A_AIC",89,64,-25,-32.68,"undercount"
"3943",20193,"Kansas","Thomas County","NHPI_A",7,0,-7,-200,"undercount"
"3944",20193,"Kansas","Thomas County","NHPI_AIC",11,5,-6,-75,"undercount"
"3945",20195,"Kansas","Trego County","A_A",15,12,-3,-22.22,"undercount"
"3946",20195,"Kansas","Trego County","A_AIC",23,24,1,4.26,"overcount"
"3947",20195,"Kansas","Trego County","NHPI_A",1,0,-1,-200,"undercount"
"3948",20195,"Kansas","Trego County","NHPI_AIC",2,7,5,111.11,"overcount"
"3949",20197,"Kansas","Wabaunsee County","A_A",25,12,-13,-70.27,"undercount"
"3950",20197,"Kansas","Wabaunsee County","A_AIC",45,55,10,20,"overcount"
"3951",20197,"Kansas","Wabaunsee County","NHPI_A",0,4,4,200,"overcount"
"3952",20197,"Kansas","Wabaunsee County","NHPI_AIC",7,8,1,13.33,"overcount"
"3953",20199,"Kansas","Wallace County","A_A",2,1,-1,-66.67,"undercount"
"3954",20199,"Kansas","Wallace County","A_AIC",5,5,0,0,"equal"
"3955",20199,"Kansas","Wallace County","NHPI_A",0,2,2,200,"overcount"
"3956",20199,"Kansas","Wallace County","NHPI_AIC",0,3,3,200,"overcount"
"3957",20201,"Kansas","Washington County","A_A",39,6,-33,-146.67,"undercount"
"3958",20201,"Kansas","Washington County","A_AIC",48,29,-19,-49.35,"undercount"
"3959",20201,"Kansas","Washington County","NHPI_A",3,2,-1,-40,"undercount"
"3960",20201,"Kansas","Washington County","NHPI_AIC",5,10,5,66.67,"overcount"
"3961",20203,"Kansas","Wichita County","A_A",7,0,-7,-200,"undercount"
"3962",20203,"Kansas","Wichita County","A_AIC",9,5,-4,-57.14,"undercount"
"3963",20203,"Kansas","Wichita County","NHPI_A",1,2,1,66.67,"overcount"
"3964",20203,"Kansas","Wichita County","NHPI_AIC",1,5,4,133.33,"overcount"
"3965",20205,"Kansas","Wilson County","A_A",40,35,-5,-13.33,"undercount"
"3966",20205,"Kansas","Wilson County","A_AIC",68,55,-13,-21.14,"undercount"
"3967",20205,"Kansas","Wilson County","NHPI_A",7,2,-5,-111.11,"undercount"
"3968",20205,"Kansas","Wilson County","NHPI_AIC",13,13,0,0,"equal"
"3969",20207,"Kansas","Woodson County","A_A",4,0,-4,-200,"undercount"
"3970",20207,"Kansas","Woodson County","A_AIC",14,25,11,56.41,"overcount"
"3971",20207,"Kansas","Woodson County","NHPI_A",0,0,0,0,"equal"
"3972",20207,"Kansas","Woodson County","NHPI_AIC",0,8,8,200,"overcount"
"3973",20209,"Kansas","Wyandotte County","A_A",8800,7666,-1134,-13.77,"undercount"
"3974",20209,"Kansas","Wyandotte County","A_AIC",9444,8356,-1088,-12.22,"undercount"
"3975",20209,"Kansas","Wyandotte County","NHPI_A",452,378,-74,-17.83,"undercount"
"3976",20209,"Kansas","Wyandotte County","NHPI_AIC",621,521,-100,-17.51,"undercount"
"3977",21001,"Kentucky","Adair County","A_A",91,72,-19,-23.31,"undercount"
"3978",21001,"Kentucky","Adair County","A_AIC",110,108,-2,-1.83,"undercount"
"3979",21001,"Kentucky","Adair County","NHPI_A",3,8,5,90.91,"overcount"
"3980",21001,"Kentucky","Adair County","NHPI_AIC",7,11,4,44.44,"overcount"
"3981",21003,"Kentucky","Allen County","A_A",60,53,-7,-12.39,"undercount"
"3982",21003,"Kentucky","Allen County","A_AIC",86,106,20,20.83,"overcount"
"3983",21003,"Kentucky","Allen County","NHPI_A",1,7,6,150,"overcount"
"3984",21003,"Kentucky","Allen County","NHPI_AIC",4,25,21,144.83,"overcount"
"3985",21005,"Kentucky","Anderson County","A_A",162,104,-58,-43.61,"undercount"
"3986",21005,"Kentucky","Anderson County","A_AIC",229,182,-47,-22.87,"undercount"
"3987",21005,"Kentucky","Anderson County","NHPI_A",5,4,-1,-22.22,"undercount"
"3988",21005,"Kentucky","Anderson County","NHPI_AIC",14,22,8,44.44,"overcount"
"3989",21007,"Kentucky","Ballard County","A_A",34,29,-5,-15.87,"undercount"
"3990",21007,"Kentucky","Ballard County","A_AIC",53,61,8,14.04,"overcount"
"3991",21007,"Kentucky","Ballard County","NHPI_A",4,0,-4,-200,"undercount"
"3992",21007,"Kentucky","Ballard County","NHPI_AIC",8,9,1,11.76,"overcount"
"3993",21009,"Kentucky","Barren County","A_A",331,257,-74,-25.17,"undercount"
"3994",21009,"Kentucky","Barren County","A_AIC",404,328,-76,-20.77,"undercount"
"3995",21009,"Kentucky","Barren County","NHPI_A",29,53,24,58.54,"overcount"
"3996",21009,"Kentucky","Barren County","NHPI_AIC",43,61,18,34.62,"overcount"
"3997",21011,"Kentucky","Bath County","A_A",62,17,-45,-113.92,"undercount"
"3998",21011,"Kentucky","Bath County","A_AIC",71,34,-37,-70.48,"undercount"
"3999",21011,"Kentucky","Bath County","NHPI_A",4,1,-3,-120,"undercount"
"4000",21011,"Kentucky","Bath County","NHPI_AIC",6,7,1,15.38,"overcount"
"4001",21013,"Kentucky","Bell County","A_A",103,122,19,16.89,"overcount"
"4002",21013,"Kentucky","Bell County","A_AIC",142,145,3,2.09,"overcount"
"4003",21013,"Kentucky","Bell County","NHPI_A",11,4,-7,-93.33,"undercount"
"4004",21013,"Kentucky","Bell County","NHPI_AIC",18,14,-4,-25,"undercount"
"4005",21015,"Kentucky","Boone County","A_A",3371,3097,-274,-8.47,"undercount"
"4006",21015,"Kentucky","Boone County","A_AIC",4253,4050,-203,-4.89,"undercount"
"4007",21015,"Kentucky","Boone County","NHPI_A",210,307,97,37.52,"overcount"
"4008",21015,"Kentucky","Boone County","NHPI_AIC",309,436,127,34.09,"overcount"
"4009",21017,"Kentucky","Bourbon County","A_A",91,78,-13,-15.38,"undercount"
"4010",21017,"Kentucky","Bourbon County","A_AIC",127,141,14,10.45,"overcount"
"4011",21017,"Kentucky","Bourbon County","NHPI_A",4,8,4,66.67,"overcount"
"4012",21017,"Kentucky","Bourbon County","NHPI_AIC",15,9,-6,-50,"undercount"
"4013",21019,"Kentucky","Boyd County","A_A",284,283,-1,-0.35,"undercount"
"4014",21019,"Kentucky","Boyd County","A_AIC",395,426,31,7.55,"overcount"
"4015",21019,"Kentucky","Boyd County","NHPI_A",16,6,-10,-90.91,"undercount"
"4016",21019,"Kentucky","Boyd County","NHPI_AIC",42,33,-9,-24,"undercount"
"4017",21021,"Kentucky","Boyle County","A_A",306,362,56,16.77,"overcount"
"4018",21021,"Kentucky","Boyle County","A_AIC",400,474,74,16.93,"overcount"
"4019",21021,"Kentucky","Boyle County","NHPI_A",9,3,-6,-100,"undercount"
"4020",21021,"Kentucky","Boyle County","NHPI_AIC",31,12,-19,-88.37,"undercount"
"4021",21023,"Kentucky","Bracken County","A_A",8,14,6,54.55,"overcount"
"4022",21023,"Kentucky","Bracken County","A_AIC",32,41,9,24.66,"overcount"
"4023",21023,"Kentucky","Bracken County","NHPI_A",1,0,-1,-200,"undercount"
"4024",21023,"Kentucky","Bracken County","NHPI_AIC",3,1,-2,-100,"undercount"
"4025",21025,"Kentucky","Breathitt County","A_A",76,38,-38,-66.67,"undercount"
"4026",21025,"Kentucky","Breathitt County","A_AIC",105,67,-38,-44.19,"undercount"
"4027",21025,"Kentucky","Breathitt County","NHPI_A",16,11,-5,-37.04,"undercount"
"4028",21025,"Kentucky","Breathitt County","NHPI_AIC",22,15,-7,-37.84,"undercount"
"4029",21027,"Kentucky","Breckinridge County","A_A",74,38,-36,-64.29,"undercount"
"4030",21027,"Kentucky","Breckinridge County","A_AIC",100,69,-31,-36.69,"undercount"
"4031",21027,"Kentucky","Breckinridge County","NHPI_A",7,3,-4,-80,"undercount"
"4032",21027,"Kentucky","Breckinridge County","NHPI_AIC",8,7,-1,-13.33,"undercount"
"4033",21029,"Kentucky","Bullitt County","A_A",509,464,-45,-9.25,"undercount"
"4034",21029,"Kentucky","Bullitt County","A_AIC",799,886,87,10.33,"overcount"
"4035",21029,"Kentucky","Bullitt County","NHPI_A",46,24,-22,-62.86,"undercount"
"4036",21029,"Kentucky","Bullitt County","NHPI_AIC",71,70,-1,-1.42,"undercount"
"4037",21031,"Kentucky","Butler County","A_A",30,23,-7,-26.42,"undercount"
"4038",21031,"Kentucky","Butler County","A_AIC",56,44,-12,-24,"undercount"
"4039",21031,"Kentucky","Butler County","NHPI_A",0,3,3,200,"overcount"
"4040",21031,"Kentucky","Butler County","NHPI_AIC",4,3,-1,-28.57,"undercount"
"4041",21033,"Kentucky","Caldwell County","A_A",60,53,-7,-12.39,"undercount"
"4042",21033,"Kentucky","Caldwell County","A_AIC",79,80,1,1.26,"overcount"
"4043",21033,"Kentucky","Caldwell County","NHPI_A",6,2,-4,-100,"undercount"
"4044",21033,"Kentucky","Caldwell County","NHPI_AIC",9,21,12,80,"overcount"
"4045",21035,"Kentucky","Calloway County","A_A",671,440,-231,-41.58,"undercount"
"4046",21035,"Kentucky","Calloway County","A_AIC",805,628,-177,-24.7,"undercount"
"4047",21035,"Kentucky","Calloway County","NHPI_A",15,11,-4,-30.77,"undercount"
"4048",21035,"Kentucky","Calloway County","NHPI_AIC",31,36,5,14.93,"overcount"
"4049",21037,"Kentucky","Campbell County","A_A",969,1028,59,5.91,"overcount"
"4050",21037,"Kentucky","Campbell County","A_AIC",1224,1532,308,22.35,"overcount"
"4051",21037,"Kentucky","Campbell County","NHPI_A",31,30,-1,-3.28,"undercount"
"4052",21037,"Kentucky","Campbell County","NHPI_AIC",67,133,66,66,"overcount"
"4053",21039,"Kentucky","Carlisle County","A_A",17,12,-5,-34.48,"undercount"
"4054",21039,"Kentucky","Carlisle County","A_AIC",36,20,-16,-57.14,"undercount"
"4055",21039,"Kentucky","Carlisle County","NHPI_A",0,0,0,0,"equal"
"4056",21039,"Kentucky","Carlisle County","NHPI_AIC",2,16,14,155.56,"overcount"
"4057",21041,"Kentucky","Carroll County","A_A",43,44,1,2.3,"overcount"
"4058",21041,"Kentucky","Carroll County","A_AIC",74,81,7,9.03,"overcount"
"4059",21041,"Kentucky","Carroll County","NHPI_A",3,6,3,66.67,"overcount"
"4060",21041,"Kentucky","Carroll County","NHPI_AIC",9,19,10,71.43,"overcount"
"4061",21043,"Kentucky","Carter County","A_A",67,58,-9,-14.4,"undercount"
"4062",21043,"Kentucky","Carter County","A_AIC",98,84,-14,-15.38,"undercount"
"4063",21043,"Kentucky","Carter County","NHPI_A",3,3,0,0,"equal"
"4064",21043,"Kentucky","Carter County","NHPI_AIC",8,14,6,54.55,"overcount"
"4065",21045,"Kentucky","Casey County","A_A",53,52,-1,-1.9,"undercount"
"4066",21045,"Kentucky","Casey County","A_AIC",76,58,-18,-26.87,"undercount"
"4067",21045,"Kentucky","Casey County","NHPI_A",3,1,-2,-100,"undercount"
"4068",21045,"Kentucky","Casey County","NHPI_AIC",7,4,-3,-54.55,"undercount"
"4069",21047,"Kentucky","Christian County","A_A",1039,943,-96,-9.69,"undercount"
"4070",21047,"Kentucky","Christian County","A_AIC",1639,1415,-224,-14.67,"undercount"
"4071",21047,"Kentucky","Christian County","NHPI_A",185,212,27,13.6,"overcount"
"4072",21047,"Kentucky","Christian County","NHPI_AIC",345,360,15,4.26,"overcount"
"4073",21049,"Kentucky","Clark County","A_A",234,210,-24,-10.81,"undercount"
"4074",21049,"Kentucky","Clark County","A_AIC",337,309,-28,-8.67,"undercount"
"4075",21049,"Kentucky","Clark County","NHPI_A",17,14,-3,-19.35,"undercount"
"4076",21049,"Kentucky","Clark County","NHPI_AIC",36,24,-12,-40,"undercount"
"4077",21051,"Kentucky","Clay County","A_A",37,21,-16,-55.17,"undercount"
"4078",21051,"Kentucky","Clay County","A_AIC",67,37,-30,-57.69,"undercount"
"4079",21051,"Kentucky","Clay County","NHPI_A",5,11,6,75,"overcount"
"4080",21051,"Kentucky","Clay County","NHPI_AIC",10,17,7,51.85,"overcount"
"4081",21053,"Kentucky","Clinton County","A_A",31,12,-19,-88.37,"undercount"
"4082",21053,"Kentucky","Clinton County","A_AIC",51,29,-22,-55,"undercount"
"4083",21053,"Kentucky","Clinton County","NHPI_A",7,3,-4,-80,"undercount"
"4084",21053,"Kentucky","Clinton County","NHPI_AIC",12,13,1,8,"overcount"
"4085",21055,"Kentucky","Crittenden County","A_A",21,6,-15,-111.11,"undercount"
"4086",21055,"Kentucky","Crittenden County","A_AIC",39,9,-30,-125,"undercount"
"4087",21055,"Kentucky","Crittenden County","NHPI_A",6,5,-1,-18.18,"undercount"
"4088",21055,"Kentucky","Crittenden County","NHPI_AIC",9,13,4,36.36,"overcount"
"4089",21057,"Kentucky","Cumberland County","A_A",9,2,-7,-127.27,"undercount"
"4090",21057,"Kentucky","Cumberland County","A_AIC",20,10,-10,-66.67,"undercount"
"4091",21057,"Kentucky","Cumberland County","NHPI_A",0,6,6,200,"overcount"
"4092",21057,"Kentucky","Cumberland County","NHPI_AIC",1,9,8,160,"overcount"
"4093",21059,"Kentucky","Daviess County","A_A",2038,2418,380,17.06,"overcount"
"4094",21059,"Kentucky","Daviess County","A_AIC",2320,2724,404,16.02,"overcount"
"4095",21059,"Kentucky","Daviess County","NHPI_A",76,59,-17,-25.19,"undercount"
"4096",21059,"Kentucky","Daviess County","NHPI_AIC",130,119,-11,-8.84,"undercount"
"4097",21061,"Kentucky","Edmonson County","A_A",52,32,-20,-47.62,"undercount"
"4098",21061,"Kentucky","Edmonson County","A_AIC",82,35,-47,-80.34,"undercount"
"4099",21061,"Kentucky","Edmonson County","NHPI_A",1,7,6,150,"overcount"
"4100",21061,"Kentucky","Edmonson County","NHPI_AIC",9,13,4,36.36,"overcount"
"4101",21063,"Kentucky","Elliott County","A_A",14,17,3,19.35,"overcount"
"4102",21063,"Kentucky","Elliott County","A_AIC",23,25,2,8.33,"overcount"
"4103",21063,"Kentucky","Elliott County","NHPI_A",12,0,-12,-200,"undercount"
"4104",21063,"Kentucky","Elliott County","NHPI_AIC",14,4,-10,-111.11,"undercount"
"4105",21065,"Kentucky","Estill County","A_A",17,7,-10,-83.33,"undercount"
"4106",21065,"Kentucky","Estill County","A_AIC",37,27,-10,-31.25,"undercount"
"4107",21065,"Kentucky","Estill County","NHPI_A",2,0,-2,-200,"undercount"
"4108",21065,"Kentucky","Estill County","NHPI_AIC",11,6,-5,-58.82,"undercount"
"4109",21067,"Kentucky","Fayette County","A_A",13654,13514,-140,-1.03,"undercount"
"4110",21067,"Kentucky","Fayette County","A_AIC",16051,16236,185,1.15,"overcount"
"4111",21067,"Kentucky","Fayette County","NHPI_A",150,135,-15,-10.53,"undercount"
"4112",21067,"Kentucky","Fayette County","NHPI_AIC",401,395,-6,-1.51,"undercount"
"4113",21069,"Kentucky","Fleming County","A_A",39,17,-22,-78.57,"undercount"
"4114",21069,"Kentucky","Fleming County","A_AIC",61,40,-21,-41.58,"undercount"
"4115",21069,"Kentucky","Fleming County","NHPI_A",1,3,2,100,"overcount"
"4116",21069,"Kentucky","Fleming County","NHPI_AIC",5,6,1,18.18,"overcount"
"4117",21071,"Kentucky","Floyd County","A_A",96,101,5,5.08,"overcount"
"4118",21071,"Kentucky","Floyd County","A_AIC",127,147,20,14.6,"overcount"
"4119",21071,"Kentucky","Floyd County","NHPI_A",2,2,0,0,"equal"
"4120",21071,"Kentucky","Floyd County","NHPI_AIC",12,8,-4,-40,"undercount"
"4121",21073,"Kentucky","Franklin County","A_A",1092,1040,-52,-4.88,"undercount"
"4122",21073,"Kentucky","Franklin County","A_AIC",1206,1233,27,2.21,"overcount"
"4123",21073,"Kentucky","Franklin County","NHPI_A",12,14,2,15.38,"overcount"
"4124",21073,"Kentucky","Franklin County","NHPI_AIC",48,39,-9,-20.69,"undercount"
"4125",21075,"Kentucky","Fulton County","A_A",44,19,-25,-79.37,"undercount"
"4126",21075,"Kentucky","Fulton County","A_AIC",55,40,-15,-31.58,"undercount"
"4127",21075,"Kentucky","Fulton County","NHPI_A",2,11,9,138.46,"overcount"
"4128",21075,"Kentucky","Fulton County","NHPI_AIC",2,25,23,170.37,"overcount"
"4129",21077,"Kentucky","Gallatin County","A_A",24,13,-11,-59.46,"undercount"
"4130",21077,"Kentucky","Gallatin County","A_AIC",41,36,-5,-12.99,"undercount"
"4131",21077,"Kentucky","Gallatin County","NHPI_A",9,7,-2,-25,"undercount"
"4132",21077,"Kentucky","Gallatin County","NHPI_AIC",12,14,2,15.38,"overcount"
"4133",21079,"Kentucky","Garrard County","A_A",57,51,-6,-11.11,"undercount"
"4134",21079,"Kentucky","Garrard County","A_AIC",76,93,17,20.12,"overcount"
"4135",21079,"Kentucky","Garrard County","NHPI_A",1,8,7,155.56,"overcount"
"4136",21079,"Kentucky","Garrard County","NHPI_AIC",7,22,15,103.45,"overcount"
"4137",21081,"Kentucky","Grant County","A_A",97,66,-31,-38.04,"undercount"
"4138",21081,"Kentucky","Grant County","A_AIC",131,161,30,20.55,"overcount"
"4139",21081,"Kentucky","Grant County","NHPI_A",33,33,0,0,"equal"
"4140",21081,"Kentucky","Grant County","NHPI_AIC",42,51,9,19.35,"overcount"
"4141",21083,"Kentucky","Graves County","A_A",170,179,9,5.16,"overcount"
"4142",21083,"Kentucky","Graves County","A_AIC",235,289,54,20.61,"overcount"
"4143",21083,"Kentucky","Graves County","NHPI_A",16,3,-13,-136.84,"undercount"
"4144",21083,"Kentucky","Graves County","NHPI_AIC",32,20,-12,-46.15,"undercount"
"4145",21085,"Kentucky","Grayson County","A_A",71,104,33,37.71,"overcount"
"4146",21085,"Kentucky","Grayson County","A_AIC",118,162,44,31.43,"overcount"
"4147",21085,"Kentucky","Grayson County","NHPI_A",5,2,-3,-85.71,"undercount"
"4148",21085,"Kentucky","Grayson County","NHPI_AIC",15,9,-6,-50,"undercount"
"4149",21087,"Kentucky","Green County","A_A",28,28,0,0,"equal"
"4150",21087,"Kentucky","Green County","A_AIC",46,42,-4,-9.09,"undercount"
"4151",21087,"Kentucky","Green County","NHPI_A",1,2,1,66.67,"overcount"
"4152",21087,"Kentucky","Green County","NHPI_AIC",3,7,4,80,"overcount"
"4153",21089,"Kentucky","Greenup County","A_A",202,230,28,12.96,"overcount"
"4154",21089,"Kentucky","Greenup County","A_AIC",247,291,44,16.36,"overcount"
"4155",21089,"Kentucky","Greenup County","NHPI_A",1,5,4,133.33,"overcount"
"4156",21089,"Kentucky","Greenup County","NHPI_AIC",8,23,15,96.77,"overcount"
"4157",21091,"Kentucky","Hancock County","A_A",34,34,0,0,"equal"
"4158",21091,"Kentucky","Hancock County","A_AIC",46,57,11,21.36,"overcount"
"4159",21091,"Kentucky","Hancock County","NHPI_A",1,0,-1,-200,"undercount"
"4160",21091,"Kentucky","Hancock County","NHPI_AIC",4,8,4,66.67,"overcount"
"4161",21093,"Kentucky","Hardin County","A_A",2409,2271,-138,-5.9,"undercount"
"4162",21093,"Kentucky","Hardin County","A_AIC",3689,3694,5,0.14,"overcount"
"4163",21093,"Kentucky","Hardin County","NHPI_A",344,400,56,15.05,"overcount"
"4164",21093,"Kentucky","Hardin County","NHPI_AIC",590,651,61,9.83,"overcount"
"4165",21095,"Kentucky","Harlan County","A_A",105,88,-17,-17.62,"undercount"
"4166",21095,"Kentucky","Harlan County","A_AIC",129,111,-18,-15,"undercount"
"4167",21095,"Kentucky","Harlan County","NHPI_A",15,0,-15,-200,"undercount"
"4168",21095,"Kentucky","Harlan County","NHPI_AIC",22,14,-8,-44.44,"undercount"
"4169",21097,"Kentucky","Harrison County","A_A",63,46,-17,-31.19,"undercount"
"4170",21097,"Kentucky","Harrison County","A_AIC",84,104,20,21.28,"overcount"
"4171",21097,"Kentucky","Harrison County","NHPI_A",13,1,-12,-171.43,"undercount"
"4172",21097,"Kentucky","Harrison County","NHPI_AIC",17,14,-3,-19.35,"undercount"
"4173",21099,"Kentucky","Hart County","A_A",84,45,-39,-60.47,"undercount"
"4174",21099,"Kentucky","Hart County","A_AIC",116,81,-35,-35.53,"undercount"
"4175",21099,"Kentucky","Hart County","NHPI_A",4,6,2,40,"overcount"
"4176",21099,"Kentucky","Hart County","NHPI_AIC",11,11,0,0,"equal"
"4177",21101,"Kentucky","Henderson County","A_A",228,239,11,4.71,"overcount"
"4178",21101,"Kentucky","Henderson County","A_AIC",331,419,88,23.47,"overcount"
"4179",21101,"Kentucky","Henderson County","NHPI_A",47,49,2,4.17,"overcount"
"4180",21101,"Kentucky","Henderson County","NHPI_AIC",72,65,-7,-10.22,"undercount"
"4181",21103,"Kentucky","Henry County","A_A",62,35,-27,-55.67,"undercount"
"4182",21103,"Kentucky","Henry County","A_AIC",90,77,-13,-15.57,"undercount"
"4183",21103,"Kentucky","Henry County","NHPI_A",14,0,-14,-200,"undercount"
"4184",21103,"Kentucky","Henry County","NHPI_AIC",21,0,-21,-200,"undercount"
"4185",21105,"Kentucky","Hickman County","A_A",20,11,-9,-58.06,"undercount"
"4186",21105,"Kentucky","Hickman County","A_AIC",28,16,-12,-54.55,"undercount"
"4187",21105,"Kentucky","Hickman County","NHPI_A",1,0,-1,-200,"undercount"
"4188",21105,"Kentucky","Hickman County","NHPI_AIC",4,6,2,40,"overcount"
"4189",21107,"Kentucky","Hopkins County","A_A",271,233,-38,-15.08,"undercount"
"4190",21107,"Kentucky","Hopkins County","A_AIC",386,362,-24,-6.42,"undercount"
"4191",21107,"Kentucky","Hopkins County","NHPI_A",29,29,0,0,"equal"
"4192",21107,"Kentucky","Hopkins County","NHPI_AIC",45,77,32,52.46,"overcount"
"4193",21109,"Kentucky","Jackson County","A_A",20,19,-1,-5.13,"undercount"
"4194",21109,"Kentucky","Jackson County","A_AIC",38,37,-1,-2.67,"undercount"
"4195",21109,"Kentucky","Jackson County","NHPI_A",1,4,3,120,"overcount"
"4196",21109,"Kentucky","Jackson County","NHPI_AIC",2,21,19,165.22,"overcount"
"4197",21111,"Kentucky","Jefferson County","A_A",24231,27130,2899,11.29,"overcount"
"4198",21111,"Kentucky","Jefferson County","A_AIC",28927,32999,4072,13.15,"overcount"
"4199",21111,"Kentucky","Jefferson County","NHPI_A",390,569,179,37.33,"overcount"
"4200",21111,"Kentucky","Jefferson County","NHPI_AIC",1107,1328,221,18.15,"overcount"
"4201",21113,"Kentucky","Jessamine County","A_A",731,658,-73,-10.51,"undercount"
"4202",21113,"Kentucky","Jessamine County","A_AIC",963,931,-32,-3.38,"undercount"
"4203",21113,"Kentucky","Jessamine County","NHPI_A",42,27,-15,-43.48,"undercount"
"4204",21113,"Kentucky","Jessamine County","NHPI_AIC",71,60,-11,-16.79,"undercount"
"4205",21115,"Kentucky","Johnson County","A_A",116,105,-11,-9.95,"undercount"
"4206",21115,"Kentucky","Johnson County","A_AIC",147,143,-4,-2.76,"undercount"
"4207",21115,"Kentucky","Johnson County","NHPI_A",6,4,-2,-40,"undercount"
"4208",21115,"Kentucky","Johnson County","NHPI_AIC",12,11,-1,-8.7,"undercount"
"4209",21117,"Kentucky","Kenton County","A_A",2205,2020,-185,-8.76,"undercount"
"4210",21117,"Kentucky","Kenton County","A_AIC",2909,2995,86,2.91,"overcount"
"4211",21117,"Kentucky","Kenton County","NHPI_A",201,241,40,18.1,"overcount"
"4212",21117,"Kentucky","Kenton County","NHPI_AIC",316,347,31,9.35,"overcount"
"4213",21119,"Kentucky","Knott County","A_A",22,18,-4,-20,"undercount"
"4214",21119,"Kentucky","Knott County","A_AIC",40,28,-12,-35.29,"undercount"
"4215",21119,"Kentucky","Knott County","NHPI_A",2,0,-2,-200,"undercount"
"4216",21119,"Kentucky","Knott County","NHPI_AIC",4,5,1,22.22,"overcount"
"4217",21121,"Kentucky","Knox County","A_A",111,85,-26,-26.53,"undercount"
"4218",21121,"Kentucky","Knox County","A_AIC",163,127,-36,-24.83,"undercount"
"4219",21121,"Kentucky","Knox County","NHPI_A",11,2,-9,-138.46,"undercount"
"4220",21121,"Kentucky","Knox County","NHPI_AIC",21,15,-6,-33.33,"undercount"
"4221",21123,"Kentucky","Larue County","A_A",44,29,-15,-41.1,"undercount"
"4222",21123,"Kentucky","Larue County","A_AIC",71,89,18,22.5,"overcount"
"4223",21123,"Kentucky","Larue County","NHPI_A",16,15,-1,-6.45,"undercount"
"4224",21123,"Kentucky","Larue County","NHPI_AIC",30,28,-2,-6.9,"undercount"
"4225",21125,"Kentucky","Laurel County","A_A",354,426,72,18.46,"overcount"
"4226",21125,"Kentucky","Laurel County","A_AIC",440,509,69,14.54,"overcount"
"4227",21125,"Kentucky","Laurel County","NHPI_A",9,4,-5,-76.92,"undercount"
"4228",21125,"Kentucky","Laurel County","NHPI_AIC",29,29,0,0,"equal"
"4229",21127,"Kentucky","Lawrence County","A_A",42,35,-7,-18.18,"undercount"
"4230",21127,"Kentucky","Lawrence County","A_AIC",68,62,-6,-9.23,"undercount"
"4231",21127,"Kentucky","Lawrence County","NHPI_A",5,4,-1,-22.22,"undercount"
"4232",21127,"Kentucky","Lawrence County","NHPI_AIC",11,9,-2,-20,"undercount"
"4233",21129,"Kentucky","Lee County","A_A",17,0,-17,-200,"undercount"
"4234",21129,"Kentucky","Lee County","A_AIC",28,1,-27,-186.21,"undercount"
"4235",21129,"Kentucky","Lee County","NHPI_A",0,0,0,0,"equal"
"4236",21129,"Kentucky","Lee County","NHPI_AIC",0,0,0,0,"equal"
"4237",21131,"Kentucky","Leslie County","A_A",30,16,-14,-60.87,"undercount"
"4238",21131,"Kentucky","Leslie County","A_AIC",44,19,-25,-79.37,"undercount"
"4239",21131,"Kentucky","Leslie County","NHPI_A",6,0,-6,-200,"undercount"
"4240",21131,"Kentucky","Leslie County","NHPI_AIC",7,2,-5,-111.11,"undercount"
"4241",21133,"Kentucky","Letcher County","A_A",58,57,-1,-1.74,"undercount"
"4242",21133,"Kentucky","Letcher County","A_AIC",84,72,-12,-15.38,"undercount"
"4243",21133,"Kentucky","Letcher County","NHPI_A",0,0,0,0,"equal"
"4244",21133,"Kentucky","Letcher County","NHPI_AIC",4,13,9,105.88,"overcount"
"4245",21135,"Kentucky","Lewis County","A_A",8,9,1,11.76,"overcount"
"4246",21135,"Kentucky","Lewis County","A_AIC",27,27,0,0,"equal"
"4247",21135,"Kentucky","Lewis County","NHPI_A",0,4,4,200,"overcount"
"4248",21135,"Kentucky","Lewis County","NHPI_AIC",3,6,3,66.67,"overcount"
"4249",21137,"Kentucky","Lincoln County","A_A",70,60,-10,-15.38,"undercount"
"4250",21137,"Kentucky","Lincoln County","A_AIC",105,71,-34,-38.64,"undercount"
"4251",21137,"Kentucky","Lincoln County","NHPI_A",2,2,0,0,"equal"
"4252",21137,"Kentucky","Lincoln County","NHPI_AIC",13,12,-1,-8,"undercount"
"4253",21139,"Kentucky","Livingston County","A_A",33,12,-21,-93.33,"undercount"
"4254",21139,"Kentucky","Livingston County","A_AIC",55,37,-18,-39.13,"undercount"
"4255",21139,"Kentucky","Livingston County","NHPI_A",9,6,-3,-40,"undercount"
"4256",21139,"Kentucky","Livingston County","NHPI_AIC",12,18,6,40,"overcount"
"4257",21141,"Kentucky","Logan County","A_A",88,95,7,7.65,"overcount"
"4258",21141,"Kentucky","Logan County","A_AIC",140,138,-2,-1.44,"undercount"
"4259",21141,"Kentucky","Logan County","NHPI_A",12,2,-10,-142.86,"undercount"
"4260",21141,"Kentucky","Logan County","NHPI_AIC",29,13,-16,-76.19,"undercount"
"4261",21143,"Kentucky","Lyon County","A_A",44,34,-10,-25.64,"undercount"
"4262",21143,"Kentucky","Lyon County","A_AIC",62,46,-16,-29.63,"undercount"
"4263",21143,"Kentucky","Lyon County","NHPI_A",1,0,-1,-200,"undercount"
"4264",21143,"Kentucky","Lyon County","NHPI_AIC",6,1,-5,-142.86,"undercount"
"4265",21145,"Kentucky","McCracken County","A_A",596,674,78,12.28,"overcount"
"4266",21145,"Kentucky","McCracken County","A_AIC",824,966,142,15.87,"overcount"
"4267",21145,"Kentucky","McCracken County","NHPI_A",55,18,-37,-101.37,"undercount"
"4268",21145,"Kentucky","McCracken County","NHPI_AIC",118,66,-52,-56.52,"undercount"
"4269",21147,"Kentucky","McCreary County","A_A",91,32,-59,-95.93,"undercount"
"4270",21147,"Kentucky","McCreary County","A_AIC",125,44,-81,-95.86,"undercount"
"4271",21147,"Kentucky","McCreary County","NHPI_A",5,3,-2,-50,"undercount"
"4272",21147,"Kentucky","McCreary County","NHPI_AIC",22,9,-13,-83.87,"undercount"
"4273",21149,"Kentucky","McLean County","A_A",19,13,-6,-37.5,"undercount"
"4274",21149,"Kentucky","McLean County","A_AIC",39,27,-12,-36.36,"undercount"
"4275",21149,"Kentucky","McLean County","NHPI_A",3,2,-1,-40,"undercount"
"4276",21149,"Kentucky","McLean County","NHPI_AIC",5,6,1,18.18,"overcount"
"4277",21151,"Kentucky","Madison County","A_A",1024,1013,-11,-1.08,"undercount"
"4278",21151,"Kentucky","Madison County","A_AIC",1407,2198,791,43.88,"overcount"
"4279",21151,"Kentucky","Madison County","NHPI_A",50,58,8,14.81,"overcount"
"4280",21151,"Kentucky","Madison County","NHPI_AIC",106,877,771,156.87,"overcount"
"4281",21153,"Kentucky","Magoffin County","A_A",21,5,-16,-123.08,"undercount"
"4282",21153,"Kentucky","Magoffin County","A_AIC",38,18,-20,-71.43,"undercount"
"4283",21153,"Kentucky","Magoffin County","NHPI_A",0,6,6,200,"overcount"
"4284",21153,"Kentucky","Magoffin County","NHPI_AIC",2,7,5,111.11,"overcount"
"4285",21155,"Kentucky","Marion County","A_A",157,124,-33,-23.49,"undercount"
"4286",21155,"Kentucky","Marion County","A_AIC",190,186,-4,-2.13,"undercount"
"4287",21155,"Kentucky","Marion County","NHPI_A",2,47,45,183.67,"overcount"
"4288",21155,"Kentucky","Marion County","NHPI_AIC",6,59,53,163.08,"overcount"
"4289",21157,"Kentucky","Marshall County","A_A",135,129,-6,-4.55,"undercount"
"4290",21157,"Kentucky","Marshall County","A_AIC",201,211,10,4.85,"overcount"
"4291",21157,"Kentucky","Marshall County","NHPI_A",3,9,6,100,"overcount"
"4292",21157,"Kentucky","Marshall County","NHPI_AIC",13,19,6,37.5,"overcount"
"4293",21159,"Kentucky","Martin County","A_A",25,17,-8,-38.1,"undercount"
"4294",21159,"Kentucky","Martin County","A_AIC",39,23,-16,-51.61,"undercount"
"4295",21159,"Kentucky","Martin County","NHPI_A",0,1,1,200,"overcount"
"4296",21159,"Kentucky","Martin County","NHPI_AIC",3,2,-1,-40,"undercount"
"4297",21161,"Kentucky","Mason County","A_A",149,107,-42,-32.81,"undercount"
"4298",21161,"Kentucky","Mason County","A_AIC",194,130,-64,-39.51,"undercount"
"4299",21161,"Kentucky","Mason County","NHPI_A",6,0,-6,-200,"undercount"
"4300",21161,"Kentucky","Mason County","NHPI_AIC",15,8,-7,-60.87,"undercount"
"4301",21163,"Kentucky","Meade County","A_A",214,221,7,3.22,"overcount"
"4302",21163,"Kentucky","Meade County","A_AIC",359,435,76,19.14,"overcount"
"4303",21163,"Kentucky","Meade County","NHPI_A",60,73,13,19.55,"overcount"
"4304",21163,"Kentucky","Meade County","NHPI_AIC",95,136,41,35.5,"overcount"
"4305",21165,"Kentucky","Menifee County","A_A",13,2,-11,-146.67,"undercount"
"4306",21165,"Kentucky","Menifee County","A_AIC",21,12,-9,-54.55,"undercount"
"4307",21165,"Kentucky","Menifee County","NHPI_A",6,2,-4,-100,"undercount"
"4308",21165,"Kentucky","Menifee County","NHPI_AIC",7,2,-5,-111.11,"undercount"
"4309",21167,"Kentucky","Mercer County","A_A",154,80,-74,-63.25,"undercount"
"4310",21167,"Kentucky","Mercer County","A_AIC",194,135,-59,-35.87,"undercount"
"4311",21167,"Kentucky","Mercer County","NHPI_A",19,14,-5,-30.3,"undercount"
"4312",21167,"Kentucky","Mercer County","NHPI_AIC",28,24,-4,-15.38,"undercount"
"4313",21169,"Kentucky","Metcalfe County","A_A",26,9,-17,-97.14,"undercount"
"4314",21169,"Kentucky","Metcalfe County","A_AIC",43,26,-17,-49.28,"undercount"
"4315",21169,"Kentucky","Metcalfe County","NHPI_A",0,0,0,0,"equal"
"4316",21169,"Kentucky","Metcalfe County","NHPI_AIC",0,12,12,200,"overcount"
"4317",21171,"Kentucky","Monroe County","A_A",28,10,-18,-94.74,"undercount"
"4318",21171,"Kentucky","Monroe County","A_AIC",45,18,-27,-85.71,"undercount"
"4319",21171,"Kentucky","Monroe County","NHPI_A",0,0,0,0,"equal"
"4320",21171,"Kentucky","Monroe County","NHPI_AIC",0,4,4,200,"overcount"
"4321",21173,"Kentucky","Montgomery County","A_A",116,145,29,22.22,"overcount"
"4322",21173,"Kentucky","Montgomery County","A_AIC",152,236,84,43.3,"overcount"
"4323",21173,"Kentucky","Montgomery County","NHPI_A",6,1,-5,-142.86,"undercount"
"4324",21173,"Kentucky","Montgomery County","NHPI_AIC",19,18,-1,-5.41,"undercount"
"4325",21175,"Kentucky","Morgan County","A_A",130,18,-112,-151.35,"undercount"
"4326",21175,"Kentucky","Morgan County","A_AIC",148,36,-112,-121.74,"undercount"
"4327",21175,"Kentucky","Morgan County","NHPI_A",1,4,3,120,"overcount"
"4328",21175,"Kentucky","Morgan County","NHPI_AIC",4,10,6,85.71,"overcount"
"4329",21177,"Kentucky","Muhlenberg County","A_A",104,58,-46,-56.79,"undercount"
"4330",21177,"Kentucky","Muhlenberg County","A_AIC",146,98,-48,-39.34,"undercount"
"4331",21177,"Kentucky","Muhlenberg County","NHPI_A",5,3,-2,-50,"undercount"
"4332",21177,"Kentucky","Muhlenberg County","NHPI_AIC",19,23,4,19.05,"overcount"
"4333",21179,"Kentucky","Nelson County","A_A",223,267,44,17.96,"overcount"
"4334",21179,"Kentucky","Nelson County","A_AIC",336,453,117,29.66,"overcount"
"4335",21179,"Kentucky","Nelson County","NHPI_A",16,8,-8,-66.67,"undercount"
"4336",21179,"Kentucky","Nelson County","NHPI_AIC",37,37,0,0,"equal"
"4337",21181,"Kentucky","Nicholas County","A_A",14,7,-7,-66.67,"undercount"
"4338",21181,"Kentucky","Nicholas County","A_AIC",23,25,2,8.33,"overcount"
"4339",21181,"Kentucky","Nicholas County","NHPI_A",0,2,2,200,"overcount"
"4340",21181,"Kentucky","Nicholas County","NHPI_AIC",2,6,4,100,"overcount"
"4341",21183,"Kentucky","Ohio County","A_A",60,59,-1,-1.68,"undercount"
"4342",21183,"Kentucky","Ohio County","A_AIC",88,116,28,27.45,"overcount"
"4343",21183,"Kentucky","Ohio County","NHPI_A",3,2,-1,-40,"undercount"
"4344",21183,"Kentucky","Ohio County","NHPI_AIC",8,16,8,66.67,"overcount"
"4345",21185,"Kentucky","Oldham County","A_A",1122,1182,60,5.21,"overcount"
"4346",21185,"Kentucky","Oldham County","A_AIC",1480,1803,323,19.68,"overcount"
"4347",21185,"Kentucky","Oldham County","NHPI_A",31,17,-14,-58.33,"undercount"
"4348",21185,"Kentucky","Oldham County","NHPI_AIC",86,69,-17,-21.94,"undercount"
"4349",21187,"Kentucky","Owen County","A_A",19,18,-1,-5.41,"undercount"
"4350",21187,"Kentucky","Owen County","A_AIC",36,58,22,46.81,"overcount"
"4351",21187,"Kentucky","Owen County","NHPI_A",1,4,3,120,"overcount"
"4352",21187,"Kentucky","Owen County","NHPI_AIC",4,19,15,130.43,"overcount"
"4353",21189,"Kentucky","Owsley County","A_A",4,1,-3,-120,"undercount"
"4354",21189,"Kentucky","Owsley County","A_AIC",10,2,-8,-133.33,"undercount"
"4355",21189,"Kentucky","Owsley County","NHPI_A",1,5,4,133.33,"overcount"
"4356",21189,"Kentucky","Owsley County","NHPI_AIC",3,6,3,66.67,"overcount"
"4357",21191,"Kentucky","Pendleton County","A_A",38,30,-8,-23.53,"undercount"
"4358",21191,"Kentucky","Pendleton County","A_AIC",82,78,-4,-5,"undercount"
"4359",21191,"Kentucky","Pendleton County","NHPI_A",5,3,-2,-50,"undercount"
"4360",21191,"Kentucky","Pendleton County","NHPI_AIC",10,15,5,40,"overcount"
"4361",21193,"Kentucky","Perry County","A_A",271,255,-16,-6.08,"undercount"
"4362",21193,"Kentucky","Perry County","A_AIC",304,288,-16,-5.41,"undercount"
"4363",21193,"Kentucky","Perry County","NHPI_A",12,1,-11,-169.23,"undercount"
"4364",21193,"Kentucky","Perry County","NHPI_AIC",18,14,-4,-25,"undercount"
"4365",21195,"Kentucky","Pike County","A_A",308,369,61,18.02,"overcount"
"4366",21195,"Kentucky","Pike County","A_AIC",382,445,63,15.24,"overcount"
"4367",21195,"Kentucky","Pike County","NHPI_A",16,11,-5,-37.04,"undercount"
"4368",21195,"Kentucky","Pike County","NHPI_AIC",31,33,2,6.25,"overcount"
"4369",21197,"Kentucky","Powell County","A_A",44,30,-14,-37.84,"undercount"
"4370",21197,"Kentucky","Powell County","A_AIC",68,53,-15,-24.79,"undercount"
"4371",21197,"Kentucky","Powell County","NHPI_A",5,0,-5,-200,"undercount"
"4372",21197,"Kentucky","Powell County","NHPI_AIC",9,7,-2,-25,"undercount"
"4373",21199,"Kentucky","Pulaski County","A_A",529,450,-79,-16.14,"undercount"
"4374",21199,"Kentucky","Pulaski County","A_AIC",659,576,-83,-13.44,"undercount"
"4375",21199,"Kentucky","Pulaski County","NHPI_A",22,11,-11,-66.67,"undercount"
"4376",21199,"Kentucky","Pulaski County","NHPI_AIC",49,30,-19,-48.1,"undercount"
"4377",21201,"Kentucky","Robertson County","A_A",2,7,5,111.11,"overcount"
"4378",21201,"Kentucky","Robertson County","A_AIC",6,11,5,58.82,"overcount"
"4379",21201,"Kentucky","Robertson County","NHPI_A",0,0,0,0,"equal"
"4380",21201,"Kentucky","Robertson County","NHPI_AIC",1,6,5,142.86,"overcount"
"4381",21203,"Kentucky","Rockcastle County","A_A",23,28,5,19.61,"overcount"
"4382",21203,"Kentucky","Rockcastle County","A_AIC",56,52,-4,-7.41,"undercount"
"4383",21203,"Kentucky","Rockcastle County","NHPI_A",3,0,-3,-200,"undercount"
"4384",21203,"Kentucky","Rockcastle County","NHPI_AIC",14,9,-5,-43.48,"undercount"
"4385",21205,"Kentucky","Rowan County","A_A",207,157,-50,-27.47,"undercount"
"4386",21205,"Kentucky","Rowan County","A_AIC",266,208,-58,-24.47,"undercount"
"4387",21205,"Kentucky","Rowan County","NHPI_A",4,5,1,22.22,"overcount"
"4388",21205,"Kentucky","Rowan County","NHPI_AIC",19,16,-3,-17.14,"undercount"
"4389",21207,"Kentucky","Russell County","A_A",93,107,14,14,"overcount"
"4390",21207,"Kentucky","Russell County","A_AIC",125,132,7,5.45,"overcount"
"4391",21207,"Kentucky","Russell County","NHPI_A",1,3,2,100,"overcount"
"4392",21207,"Kentucky","Russell County","NHPI_AIC",11,15,4,30.77,"overcount"
"4393",21209,"Kentucky","Scott County","A_A",738,594,-144,-21.62,"undercount"
"4394",21209,"Kentucky","Scott County","A_AIC",973,957,-16,-1.66,"undercount"
"4395",21209,"Kentucky","Scott County","NHPI_A",22,19,-3,-14.63,"undercount"
"4396",21209,"Kentucky","Scott County","NHPI_AIC",63,69,6,9.09,"overcount"
"4397",21211,"Kentucky","Shelby County","A_A",480,366,-114,-26.95,"undercount"
"4398",21211,"Kentucky","Shelby County","A_AIC",673,597,-76,-11.97,"undercount"
"4399",21211,"Kentucky","Shelby County","NHPI_A",37,22,-15,-50.85,"undercount"
"4400",21211,"Kentucky","Shelby County","NHPI_AIC",84,40,-44,-70.97,"undercount"
"4401",21213,"Kentucky","Simpson County","A_A",153,96,-57,-45.78,"undercount"
"4402",21213,"Kentucky","Simpson County","A_AIC",181,153,-28,-16.77,"undercount"
"4403",21213,"Kentucky","Simpson County","NHPI_A",17,5,-12,-109.09,"undercount"
"4404",21213,"Kentucky","Simpson County","NHPI_AIC",26,19,-7,-31.11,"undercount"
"4405",21215,"Kentucky","Spencer County","A_A",73,90,17,20.86,"overcount"
"4406",21215,"Kentucky","Spencer County","A_AIC",112,167,55,39.43,"overcount"
"4407",21215,"Kentucky","Spencer County","NHPI_A",16,13,-3,-20.69,"undercount"
"4408",21215,"Kentucky","Spencer County","NHPI_AIC",24,15,-9,-46.15,"undercount"
"4409",21217,"Kentucky","Taylor County","A_A",213,244,31,13.57,"overcount"
"4410",21217,"Kentucky","Taylor County","A_AIC",251,319,68,23.86,"overcount"
"4411",21217,"Kentucky","Taylor County","NHPI_A",16,10,-6,-46.15,"undercount"
"4412",21217,"Kentucky","Taylor County","NHPI_AIC",23,24,1,4.26,"overcount"
"4413",21219,"Kentucky","Todd County","A_A",27,24,-3,-11.76,"undercount"
"4414",21219,"Kentucky","Todd County","A_AIC",56,74,18,27.69,"overcount"
"4415",21219,"Kentucky","Todd County","NHPI_A",13,6,-7,-73.68,"undercount"
"4416",21219,"Kentucky","Todd County","NHPI_AIC",15,13,-2,-14.29,"undercount"
"4417",21221,"Kentucky","Trigg County","A_A",49,27,-22,-57.89,"undercount"
"4418",21221,"Kentucky","Trigg County","A_AIC",99,81,-18,-20,"undercount"
"4419",21221,"Kentucky","Trigg County","NHPI_A",9,6,-3,-40,"undercount"
"4420",21221,"Kentucky","Trigg County","NHPI_AIC",22,24,2,8.7,"overcount"
"4421",21223,"Kentucky","Trimble County","A_A",53,29,-24,-58.54,"undercount"
"4422",21223,"Kentucky","Trimble County","A_AIC",75,49,-26,-41.94,"undercount"
"4423",21223,"Kentucky","Trimble County","NHPI_A",10,4,-6,-85.71,"undercount"
"4424",21223,"Kentucky","Trimble County","NHPI_AIC",13,6,-7,-73.68,"undercount"
"4425",21225,"Kentucky","Union County","A_A",98,32,-66,-101.54,"undercount"
"4426",21225,"Kentucky","Union County","A_AIC",115,70,-45,-48.65,"undercount"
"4427",21225,"Kentucky","Union County","NHPI_A",12,1,-11,-169.23,"undercount"
"4428",21225,"Kentucky","Union County","NHPI_AIC",15,8,-7,-60.87,"undercount"
"4429",21227,"Kentucky","Warren County","A_A",6618,7411,793,11.31,"overcount"
"4430",21227,"Kentucky","Warren County","A_AIC",7235,8206,971,12.58,"overcount"
"4431",21227,"Kentucky","Warren County","NHPI_A",658,661,3,0.45,"overcount"
"4432",21227,"Kentucky","Warren County","NHPI_AIC",794,801,7,0.88,"overcount"
"4433",21229,"Kentucky","Washington County","A_A",89,38,-51,-80.31,"undercount"
"4434",21229,"Kentucky","Washington County","A_AIC",109,74,-35,-38.25,"undercount"
"4435",21229,"Kentucky","Washington County","NHPI_A",5,5,0,0,"equal"
"4436",21229,"Kentucky","Washington County","NHPI_AIC",10,11,1,9.52,"overcount"
"4437",21231,"Kentucky","Wayne County","A_A",75,62,-13,-18.98,"undercount"
"4438",21231,"Kentucky","Wayne County","A_AIC",103,87,-16,-16.84,"undercount"
"4439",21231,"Kentucky","Wayne County","NHPI_A",3,5,2,50,"overcount"
"4440",21231,"Kentucky","Wayne County","NHPI_AIC",9,11,2,20,"overcount"
"4441",21233,"Kentucky","Webster County","A_A",48,24,-24,-66.67,"undercount"
"4442",21233,"Kentucky","Webster County","A_AIC",63,61,-2,-3.23,"undercount"
"4443",21233,"Kentucky","Webster County","NHPI_A",26,1,-25,-185.19,"undercount"
"4444",21233,"Kentucky","Webster County","NHPI_AIC",30,9,-21,-107.69,"undercount"
"4445",21235,"Kentucky","Whitley County","A_A",150,204,54,30.51,"overcount"
"4446",21235,"Kentucky","Whitley County","A_AIC",223,281,58,23.02,"overcount"
"4447",21235,"Kentucky","Whitley County","NHPI_A",12,10,-2,-18.18,"undercount"
"4448",21235,"Kentucky","Whitley County","NHPI_AIC",22,47,25,72.46,"overcount"
"4449",21237,"Kentucky","Wolfe County","A_A",12,5,-7,-82.35,"undercount"
"4450",21237,"Kentucky","Wolfe County","A_AIC",18,18,0,0,"equal"
"4451",21237,"Kentucky","Wolfe County","NHPI_A",0,0,0,0,"equal"
"4452",21237,"Kentucky","Wolfe County","NHPI_AIC",1,5,4,133.33,"overcount"
"4453",21239,"Kentucky","Woodford County","A_A",187,157,-30,-17.44,"undercount"
"4454",21239,"Kentucky","Woodford County","A_AIC",244,327,83,29.07,"overcount"
"4455",21239,"Kentucky","Woodford County","NHPI_A",9,15,6,50,"overcount"
"4456",21239,"Kentucky","Woodford County","NHPI_AIC",19,40,21,71.19,"overcount"
"4457",22001,"Louisiana","Acadia Parish","A_A",184,171,-13,-7.32,"undercount"
"4458",22001,"Louisiana","Acadia Parish","A_AIC",276,243,-33,-12.72,"undercount"
"4459",22001,"Louisiana","Acadia Parish","NHPI_A",13,4,-9,-105.88,"undercount"
"4460",22001,"Louisiana","Acadia Parish","NHPI_AIC",35,21,-14,-50,"undercount"
"4461",22003,"Louisiana","Allen Parish","A_A",143,183,40,24.54,"overcount"
"4462",22003,"Louisiana","Allen Parish","A_AIC",220,250,30,12.77,"overcount"
"4463",22003,"Louisiana","Allen Parish","NHPI_A",3,7,4,80,"overcount"
"4464",22003,"Louisiana","Allen Parish","NHPI_AIC",24,34,10,34.48,"overcount"
"4465",22005,"Louisiana","Ascension Parish","A_A",1700,1708,8,0.47,"overcount"
"4466",22005,"Louisiana","Ascension Parish","A_AIC",2117,2340,223,10.01,"overcount"
"4467",22005,"Louisiana","Ascension Parish","NHPI_A",61,33,-28,-59.57,"undercount"
"4468",22005,"Louisiana","Ascension Parish","NHPI_AIC",153,127,-26,-18.57,"undercount"
"4469",22007,"Louisiana","Assumption Parish","A_A",97,56,-41,-53.59,"undercount"
"4470",22007,"Louisiana","Assumption Parish","A_AIC",122,85,-37,-35.75,"undercount"
"4471",22007,"Louisiana","Assumption Parish","NHPI_A",10,1,-9,-163.64,"undercount"
"4472",22007,"Louisiana","Assumption Parish","NHPI_AIC",17,10,-7,-51.85,"undercount"
"4473",22009,"Louisiana","Avoyelles Parish","A_A",201,351,150,54.35,"overcount"
"4474",22009,"Louisiana","Avoyelles Parish","A_AIC",287,426,139,38.99,"overcount"
"4475",22009,"Louisiana","Avoyelles Parish","NHPI_A",42,6,-36,-150,"undercount"
"4476",22009,"Louisiana","Avoyelles Parish","NHPI_AIC",67,30,-37,-76.29,"undercount"
"4477",22011,"Louisiana","Beauregard Parish","A_A",231,231,0,0,"equal"
"4478",22011,"Louisiana","Beauregard Parish","A_AIC",402,427,25,6.03,"overcount"
"4479",22011,"Louisiana","Beauregard Parish","NHPI_A",38,27,-11,-33.85,"undercount"
"4480",22011,"Louisiana","Beauregard Parish","NHPI_AIC",77,50,-27,-42.52,"undercount"
"4481",22013,"Louisiana","Bienville Parish","A_A",52,21,-31,-84.93,"undercount"
"4482",22013,"Louisiana","Bienville Parish","A_AIC",84,65,-19,-25.5,"undercount"
"4483",22013,"Louisiana","Bienville Parish","NHPI_A",6,5,-1,-18.18,"undercount"
"4484",22013,"Louisiana","Bienville Parish","NHPI_AIC",11,16,5,37.04,"overcount"
"4485",22015,"Louisiana","Bossier Parish","A_A",2253,2387,134,5.78,"overcount"
"4486",22015,"Louisiana","Bossier Parish","A_AIC",3330,3626,296,8.51,"overcount"
"4487",22015,"Louisiana","Bossier Parish","NHPI_A",115,118,3,2.58,"overcount"
"4488",22015,"Louisiana","Bossier Parish","NHPI_AIC",261,326,65,22.15,"overcount"
"4489",22017,"Louisiana","Caddo Parish","A_A",3218,3205,-13,-0.4,"undercount"
"4490",22017,"Louisiana","Caddo Parish","A_AIC",4112,4252,140,3.35,"overcount"
"4491",22017,"Louisiana","Caddo Parish","NHPI_A",115,122,7,5.91,"overcount"
"4492",22017,"Louisiana","Caddo Parish","NHPI_AIC",300,285,-15,-5.13,"undercount"
"4493",22019,"Louisiana","Calcasieu Parish","A_A",2876,3829,953,28.43,"overcount"
"4494",22019,"Louisiana","Calcasieu Parish","A_AIC",3609,4752,1143,27.34,"overcount"
"4495",22019,"Louisiana","Calcasieu Parish","NHPI_A",96,151,55,44.53,"overcount"
"4496",22019,"Louisiana","Calcasieu Parish","NHPI_AIC",243,315,72,25.81,"overcount"
"4497",22021,"Louisiana","Caldwell Parish","A_A",28,42,14,40,"overcount"
"4498",22021,"Louisiana","Caldwell Parish","A_AIC",52,55,3,5.61,"overcount"
"4499",22021,"Louisiana","Caldwell Parish","NHPI_A",0,3,3,200,"overcount"
"4500",22021,"Louisiana","Caldwell Parish","NHPI_AIC",6,13,7,73.68,"overcount"
"4501",22023,"Louisiana","Cameron Parish","A_A",27,13,-14,-70,"undercount"
"4502",22023,"Louisiana","Cameron Parish","A_AIC",46,32,-14,-35.9,"undercount"
"4503",22023,"Louisiana","Cameron Parish","NHPI_A",1,1,0,0,"equal"
"4504",22023,"Louisiana","Cameron Parish","NHPI_AIC",6,6,0,0,"equal"
"4505",22025,"Louisiana","Catahoula Parish","A_A",7,26,19,115.15,"overcount"
"4506",22025,"Louisiana","Catahoula Parish","A_AIC",26,46,20,55.56,"overcount"
"4507",22025,"Louisiana","Catahoula Parish","NHPI_A",0,7,7,200,"overcount"
"4508",22025,"Louisiana","Catahoula Parish","NHPI_AIC",4,16,12,120,"overcount"
"4509",22027,"Louisiana","Claiborne Parish","A_A",78,42,-36,-60,"undercount"
"4510",22027,"Louisiana","Claiborne Parish","A_AIC",111,94,-17,-16.59,"undercount"
"4511",22027,"Louisiana","Claiborne Parish","NHPI_A",4,0,-4,-200,"undercount"
"4512",22027,"Louisiana","Claiborne Parish","NHPI_AIC",14,4,-10,-111.11,"undercount"
"4513",22029,"Louisiana","Concordia Parish","A_A",83,115,32,32.32,"overcount"
"4514",22029,"Louisiana","Concordia Parish","A_AIC",104,118,14,12.61,"overcount"
"4515",22029,"Louisiana","Concordia Parish","NHPI_A",4,1,-3,-120,"undercount"
"4516",22029,"Louisiana","Concordia Parish","NHPI_AIC",10,10,0,0,"equal"
"4517",22031,"Louisiana","De Soto Parish","A_A",105,101,-4,-3.88,"undercount"
"4518",22031,"Louisiana","De Soto Parish","A_AIC",136,124,-12,-9.23,"undercount"
"4519",22031,"Louisiana","De Soto Parish","NHPI_A",13,1,-12,-171.43,"undercount"
"4520",22031,"Louisiana","De Soto Parish","NHPI_AIC",25,23,-2,-8.33,"undercount"
"4521",22033,"Louisiana","East Baton Rouge Parish","A_A",14931,14485,-446,-3.03,"undercount"
"4522",22033,"Louisiana","East Baton Rouge Parish","A_AIC",16914,16728,-186,-1.11,"undercount"
"4523",22033,"Louisiana","East Baton Rouge Parish","NHPI_A",92,106,14,14.14,"overcount"
"4524",22033,"Louisiana","East Baton Rouge Parish","NHPI_AIC",295,293,-2,-0.68,"undercount"
"4525",22035,"Louisiana","East Carroll Parish","A_A",29,17,-12,-52.17,"undercount"
"4526",22035,"Louisiana","East Carroll Parish","A_AIC",41,30,-11,-30.99,"undercount"
"4527",22035,"Louisiana","East Carroll Parish","NHPI_A",0,0,0,0,"equal"
"4528",22035,"Louisiana","East Carroll Parish","NHPI_AIC",3,6,3,66.67,"overcount"
"4529",22037,"Louisiana","East Feliciana Parish","A_A",51,48,-3,-6.06,"undercount"
"4530",22037,"Louisiana","East Feliciana Parish","A_AIC",79,102,23,25.41,"overcount"
"4531",22037,"Louisiana","East Feliciana Parish","NHPI_A",1,9,8,160,"overcount"
"4532",22037,"Louisiana","East Feliciana Parish","NHPI_AIC",13,22,9,51.43,"overcount"
"4533",22039,"Louisiana","Evangeline Parish","A_A",164,183,19,10.95,"overcount"
"4534",22039,"Louisiana","Evangeline Parish","A_AIC",207,254,47,20.39,"overcount"
"4535",22039,"Louisiana","Evangeline Parish","NHPI_A",5,2,-3,-85.71,"undercount"
"4536",22039,"Louisiana","Evangeline Parish","NHPI_AIC",21,27,6,25,"overcount"
"4537",22041,"Louisiana","Franklin Parish","A_A",75,38,-37,-65.49,"undercount"
"4538",22041,"Louisiana","Franklin Parish","A_AIC",107,76,-31,-33.88,"undercount"
"4539",22041,"Louisiana","Franklin Parish","NHPI_A",6,0,-6,-200,"undercount"
"4540",22041,"Louisiana","Franklin Parish","NHPI_AIC",13,14,1,7.41,"overcount"
"4541",22043,"Louisiana","Grant Parish","A_A",130,68,-62,-62.63,"undercount"
"4542",22043,"Louisiana","Grant Parish","A_AIC",172,129,-43,-28.57,"undercount"
"4543",22043,"Louisiana","Grant Parish","NHPI_A",11,6,-5,-58.82,"undercount"
"4544",22043,"Louisiana","Grant Parish","NHPI_AIC",24,26,2,8,"overcount"
"4545",22045,"Louisiana","Iberia Parish","A_A",1826,1942,116,6.16,"overcount"
"4546",22045,"Louisiana","Iberia Parish","A_AIC",2067,2146,79,3.75,"overcount"
"4547",22045,"Louisiana","Iberia Parish","NHPI_A",38,3,-35,-170.73,"undercount"
"4548",22045,"Louisiana","Iberia Parish","NHPI_AIC",99,44,-55,-76.92,"undercount"
"4549",22047,"Louisiana","Iberville Parish","A_A",130,124,-6,-4.72,"undercount"
"4550",22047,"Louisiana","Iberville Parish","A_AIC",163,209,46,24.73,"overcount"
"4551",22047,"Louisiana","Iberville Parish","NHPI_A",6,13,7,73.68,"overcount"
"4552",22047,"Louisiana","Iberville Parish","NHPI_AIC",24,34,10,34.48,"overcount"
"4553",22049,"Louisiana","Jackson Parish","A_A",67,146,79,74.18,"overcount"
"4554",22049,"Louisiana","Jackson Parish","A_AIC",122,183,61,40,"overcount"
"4555",22049,"Louisiana","Jackson Parish","NHPI_A",2,5,3,85.71,"overcount"
"4556",22049,"Louisiana","Jackson Parish","NHPI_AIC",13,15,2,14.29,"overcount"
"4557",22051,"Louisiana","Jefferson Parish","A_A",19018,19686,668,3.45,"overcount"
"4558",22051,"Louisiana","Jefferson Parish","A_AIC",21429,22853,1424,6.43,"overcount"
"4559",22051,"Louisiana","Jefferson Parish","NHPI_A",92,110,18,17.82,"overcount"
"4560",22051,"Louisiana","Jefferson Parish","NHPI_AIC",340,419,79,20.82,"overcount"
"4561",22053,"Louisiana","Jefferson Davis Parish","A_A",169,100,-69,-51.3,"undercount"
"4562",22053,"Louisiana","Jefferson Davis Parish","A_AIC",238,212,-26,-11.56,"undercount"
"4563",22053,"Louisiana","Jefferson Davis Parish","NHPI_A",5,4,-1,-22.22,"undercount"
"4564",22053,"Louisiana","Jefferson Davis Parish","NHPI_AIC",23,39,16,51.61,"overcount"
"4565",22055,"Louisiana","Lafayette Parish","A_A",4811,5235,424,8.44,"overcount"
"4566",22055,"Louisiana","Lafayette Parish","A_AIC",5736,6476,740,12.12,"overcount"
"4567",22055,"Louisiana","Lafayette Parish","NHPI_A",72,70,-2,-2.82,"undercount"
"4568",22055,"Louisiana","Lafayette Parish","NHPI_AIC",207,218,11,5.18,"overcount"
"4569",22057,"Louisiana","Lafourche Parish","A_A",837,778,-59,-7.31,"undercount"
"4570",22057,"Louisiana","Lafourche Parish","A_AIC",1045,1027,-18,-1.74,"undercount"
"4571",22057,"Louisiana","Lafourche Parish","NHPI_A",32,31,-1,-3.17,"undercount"
"4572",22057,"Louisiana","Lafourche Parish","NHPI_AIC",86,60,-26,-35.62,"undercount"
"4573",22059,"Louisiana","LaSalle Parish","A_A",46,253,207,138.46,"overcount"
"4574",22059,"Louisiana","LaSalle Parish","A_AIC",68,289,221,123.81,"overcount"
"4575",22059,"Louisiana","LaSalle Parish","NHPI_A",2,10,8,133.33,"overcount"
"4576",22059,"Louisiana","LaSalle Parish","NHPI_AIC",8,19,11,81.48,"overcount"
"4577",22061,"Louisiana","Lincoln Parish","A_A",659,693,34,5.03,"overcount"
"4578",22061,"Louisiana","Lincoln Parish","A_AIC",812,926,114,13.12,"overcount"
"4579",22061,"Louisiana","Lincoln Parish","NHPI_A",21,7,-14,-100,"undercount"
"4580",22061,"Louisiana","Lincoln Parish","NHPI_AIC",53,62,9,15.65,"overcount"
"4581",22063,"Louisiana","Livingston Parish","A_A",995,1146,151,14.11,"overcount"
"4582",22063,"Louisiana","Livingston Parish","A_AIC",1424,1709,285,18.19,"overcount"
"4583",22063,"Louisiana","Livingston Parish","NHPI_A",62,36,-26,-53.06,"undercount"
"4584",22063,"Louisiana","Livingston Parish","NHPI_AIC",94,139,45,38.63,"overcount"
"4585",22065,"Louisiana","Madison Parish","A_A",29,8,-21,-113.51,"undercount"
"4586",22065,"Louisiana","Madison Parish","A_AIC",45,24,-21,-60.87,"undercount"
"4587",22065,"Louisiana","Madison Parish","NHPI_A",1,5,4,133.33,"overcount"
"4588",22065,"Louisiana","Madison Parish","NHPI_AIC",4,17,13,123.81,"overcount"
"4589",22067,"Louisiana","Morehouse Parish","A_A",104,89,-15,-15.54,"undercount"
"4590",22067,"Louisiana","Morehouse Parish","A_AIC",164,166,2,1.21,"overcount"
"4591",22067,"Louisiana","Morehouse Parish","NHPI_A",15,3,-12,-133.33,"undercount"
"4592",22067,"Louisiana","Morehouse Parish","NHPI_AIC",32,19,-13,-50.98,"undercount"
"4593",22069,"Louisiana","Natchitoches Parish","A_A",237,176,-61,-29.54,"undercount"
"4594",22069,"Louisiana","Natchitoches Parish","A_AIC",352,285,-67,-21.04,"undercount"
"4595",22069,"Louisiana","Natchitoches Parish","NHPI_A",14,22,8,44.44,"overcount"
"4596",22069,"Louisiana","Natchitoches Parish","NHPI_AIC",57,56,-1,-1.77,"undercount"
"4597",22071,"Louisiana","Orleans Parish","A_A",11431,10648,-783,-7.09,"undercount"
"4598",22071,"Louisiana","Orleans Parish","A_AIC",13126,13086,-40,-0.31,"undercount"
"4599",22071,"Louisiana","Orleans Parish","NHPI_A",88,131,43,39.27,"overcount"
"4600",22071,"Louisiana","Orleans Parish","NHPI_AIC",303,390,87,25.11,"overcount"
"4601",22073,"Louisiana","Ouachita Parish","A_A",1560,2283,723,37.63,"overcount"
"4602",22073,"Louisiana","Ouachita Parish","A_AIC",2029,2860,831,33.99,"overcount"
"4603",22073,"Louisiana","Ouachita Parish","NHPI_A",48,31,-17,-43.04,"undercount"
"4604",22073,"Louisiana","Ouachita Parish","NHPI_AIC",153,106,-47,-36.29,"undercount"
"4605",22075,"Louisiana","Plaquemines Parish","A_A",994,1046,52,5.1,"overcount"
"4606",22075,"Louisiana","Plaquemines Parish","A_AIC",1130,1291,161,13.3,"overcount"
"4607",22075,"Louisiana","Plaquemines Parish","NHPI_A",20,40,20,66.67,"overcount"
"4608",22075,"Louisiana","Plaquemines Parish","NHPI_AIC",54,66,12,20,"overcount"
"4609",22077,"Louisiana","Pointe Coupee Parish","A_A",80,60,-20,-28.57,"undercount"
"4610",22077,"Louisiana","Pointe Coupee Parish","A_AIC",103,105,2,1.92,"overcount"
"4611",22077,"Louisiana","Pointe Coupee Parish","NHPI_A",1,2,1,66.67,"overcount"
"4612",22077,"Louisiana","Pointe Coupee Parish","NHPI_AIC",6,18,12,100,"overcount"
"4613",22079,"Louisiana","Rapides Parish","A_A",1746,1814,68,3.82,"overcount"
"4614",22079,"Louisiana","Rapides Parish","A_AIC",2264,2534,270,11.25,"overcount"
"4615",22079,"Louisiana","Rapides Parish","NHPI_A",51,33,-18,-42.86,"undercount"
"4616",22079,"Louisiana","Rapides Parish","NHPI_AIC",140,107,-33,-26.72,"undercount"
"4617",22081,"Louisiana","Red River Parish","A_A",19,0,-19,-200,"undercount"
"4618",22081,"Louisiana","Red River Parish","A_AIC",31,13,-18,-81.82,"undercount"
"4619",22081,"Louisiana","Red River Parish","NHPI_A",1,0,-1,-200,"undercount"
"4620",22081,"Louisiana","Red River Parish","NHPI_AIC",3,6,3,66.67,"overcount"
"4621",22083,"Louisiana","Richland Parish","A_A",70,50,-20,-33.33,"undercount"
"4622",22083,"Louisiana","Richland Parish","A_AIC",109,100,-9,-8.61,"undercount"
"4623",22083,"Louisiana","Richland Parish","NHPI_A",2,0,-2,-200,"undercount"
"4624",22083,"Louisiana","Richland Parish","NHPI_AIC",8,11,3,31.58,"overcount"
"4625",22085,"Louisiana","Sabine Parish","A_A",81,65,-16,-21.92,"undercount"
"4626",22085,"Louisiana","Sabine Parish","A_AIC",157,111,-46,-34.33,"undercount"
"4627",22085,"Louisiana","Sabine Parish","NHPI_A",3,12,9,120,"overcount"
"4628",22085,"Louisiana","Sabine Parish","NHPI_AIC",19,31,12,48,"overcount"
"4629",22087,"Louisiana","St. Bernard Parish","A_A",1062,993,-69,-6.72,"undercount"
"4630",22087,"Louisiana","St. Bernard Parish","A_AIC",1313,1337,24,1.81,"overcount"
"4631",22087,"Louisiana","St. Bernard Parish","NHPI_A",11,7,-4,-44.44,"undercount"
"4632",22087,"Louisiana","St. Bernard Parish","NHPI_AIC",40,41,1,2.47,"overcount"
"4633",22089,"Louisiana","St. Charles Parish","A_A",600,575,-25,-4.26,"undercount"
"4634",22089,"Louisiana","St. Charles Parish","A_AIC",790,827,37,4.58,"overcount"
"4635",22089,"Louisiana","St. Charles Parish","NHPI_A",25,23,-2,-8.33,"undercount"
"4636",22089,"Louisiana","St. Charles Parish","NHPI_AIC",55,51,-4,-7.55,"undercount"
"4637",22091,"Louisiana","St. Helena Parish","A_A",24,19,-5,-23.26,"undercount"
"4638",22091,"Louisiana","St. Helena Parish","A_AIC",44,25,-19,-55.07,"undercount"
"4639",22091,"Louisiana","St. Helena Parish","NHPI_A",3,4,1,28.57,"overcount"
"4640",22091,"Louisiana","St. Helena Parish","NHPI_AIC",4,10,6,85.71,"overcount"
"4641",22093,"Louisiana","St. James Parish","A_A",54,37,-17,-37.36,"undercount"
"4642",22093,"Louisiana","St. James Parish","A_AIC",84,74,-10,-12.66,"undercount"
"4643",22093,"Louisiana","St. James Parish","NHPI_A",5,2,-3,-85.71,"undercount"
"4644",22093,"Louisiana","St. James Parish","NHPI_AIC",13,12,-1,-8,"undercount"
"4645",22095,"Louisiana","St. John the Baptist Parish","A_A",484,318,-166,-41.4,"undercount"
"4646",22095,"Louisiana","St. John the Baptist Parish","A_AIC",604,418,-186,-36.4,"undercount"
"4647",22095,"Louisiana","St. John the Baptist Parish","NHPI_A",60,18,-42,-107.69,"undercount"
"4648",22095,"Louisiana","St. John the Baptist Parish","NHPI_AIC",92,36,-56,-87.5,"undercount"
"4649",22097,"Louisiana","St. Landry Parish","A_A",355,376,21,5.75,"overcount"
"4650",22097,"Louisiana","St. Landry Parish","A_AIC",520,513,-7,-1.36,"undercount"
"4651",22097,"Louisiana","St. Landry Parish","NHPI_A",10,13,3,26.09,"overcount"
"4652",22097,"Louisiana","St. Landry Parish","NHPI_AIC",58,45,-13,-25.24,"undercount"
"4653",22099,"Louisiana","St. Martin Parish","A_A",492,442,-50,-10.71,"undercount"
"4654",22099,"Louisiana","St. Martin Parish","A_AIC",625,613,-12,-1.94,"undercount"
"4655",22099,"Louisiana","St. Martin Parish","NHPI_A",15,3,-12,-133.33,"undercount"
"4656",22099,"Louisiana","St. Martin Parish","NHPI_AIC",51,37,-14,-31.82,"undercount"
"4657",22101,"Louisiana","St. Mary Parish","A_A",716,647,-69,-10.12,"undercount"
"4658",22101,"Louisiana","St. Mary Parish","A_AIC",883,853,-30,-3.46,"undercount"
"4659",22101,"Louisiana","St. Mary Parish","NHPI_A",17,13,-4,-26.67,"undercount"
"4660",22101,"Louisiana","St. Mary Parish","NHPI_AIC",63,58,-5,-8.26,"undercount"
"4661",22103,"Louisiana","St. Tammany Parish","A_A",3767,3862,95,2.49,"overcount"
"4662",22103,"Louisiana","St. Tammany Parish","A_AIC",5102,5704,602,11.14,"overcount"
"4663",22103,"Louisiana","St. Tammany Parish","NHPI_A",73,107,34,37.78,"overcount"
"4664",22103,"Louisiana","St. Tammany Parish","NHPI_AIC",252,343,91,30.59,"overcount"
"4665",22105,"Louisiana","Tangipahoa Parish","A_A",925,942,17,1.82,"overcount"
"4666",22105,"Louisiana","Tangipahoa Parish","A_AIC",1328,1392,64,4.71,"overcount"
"4667",22105,"Louisiana","Tangipahoa Parish","NHPI_A",47,23,-24,-68.57,"undercount"
"4668",22105,"Louisiana","Tangipahoa Parish","NHPI_AIC",141,127,-14,-10.45,"undercount"
"4669",22107,"Louisiana","Tensas Parish","A_A",9,10,1,10.53,"overcount"
"4670",22107,"Louisiana","Tensas Parish","A_AIC",19,25,6,27.27,"overcount"
"4671",22107,"Louisiana","Tensas Parish","NHPI_A",0,1,1,200,"overcount"
"4672",22107,"Louisiana","Tensas Parish","NHPI_AIC",5,6,1,18.18,"overcount"
"4673",22109,"Louisiana","Terrebonne Parish","A_A",1119,1297,178,14.74,"overcount"
"4674",22109,"Louisiana","Terrebonne Parish","A_AIC",1562,1730,168,10.21,"overcount"
"4675",22109,"Louisiana","Terrebonne Parish","NHPI_A",63,39,-24,-47.06,"undercount"
"4676",22109,"Louisiana","Terrebonne Parish","NHPI_AIC",280,108,-172,-88.66,"undercount"
"4677",22111,"Louisiana","Union Parish","A_A",46,38,-8,-19.05,"undercount"
"4678",22111,"Louisiana","Union Parish","A_AIC",75,74,-1,-1.34,"undercount"
"4679",22111,"Louisiana","Union Parish","NHPI_A",13,6,-7,-73.68,"undercount"
"4680",22111,"Louisiana","Union Parish","NHPI_AIC",22,20,-2,-9.52,"undercount"
"4681",22113,"Louisiana","Vermilion Parish","A_A",1268,1262,-6,-0.47,"undercount"
"4682",22113,"Louisiana","Vermilion Parish","A_AIC",1413,1457,44,3.07,"overcount"
"4683",22113,"Louisiana","Vermilion Parish","NHPI_A",9,9,0,0,"equal"
"4684",22113,"Louisiana","Vermilion Parish","NHPI_AIC",38,47,9,21.18,"overcount"
"4685",22115,"Louisiana","Vernon Parish","A_A",881,862,-19,-2.18,"undercount"
"4686",22115,"Louisiana","Vernon Parish","A_AIC",1435,1488,53,3.63,"overcount"
"4687",22115,"Louisiana","Vernon Parish","NHPI_A",210,291,81,32.34,"overcount"
"4688",22115,"Louisiana","Vernon Parish","NHPI_AIC",294,468,174,45.67,"overcount"
"4689",22117,"Louisiana","Washington Parish","A_A",150,163,13,8.31,"overcount"
"4690",22117,"Louisiana","Washington Parish","A_AIC",249,234,-15,-6.21,"undercount"
"4691",22117,"Louisiana","Washington Parish","NHPI_A",6,0,-6,-200,"undercount"
"4692",22117,"Louisiana","Washington Parish","NHPI_AIC",36,22,-14,-48.28,"undercount"
"4693",22119,"Louisiana","Webster Parish","A_A",172,138,-34,-21.94,"undercount"
"4694",22119,"Louisiana","Webster Parish","A_AIC",251,216,-35,-14.99,"undercount"
"4695",22119,"Louisiana","Webster Parish","NHPI_A",11,12,1,8.7,"overcount"
"4696",22119,"Louisiana","Webster Parish","NHPI_AIC",31,30,-1,-3.28,"undercount"
"4697",22121,"Louisiana","West Baton Rouge Parish","A_A",180,220,40,20,"overcount"
"4698",22121,"Louisiana","West Baton Rouge Parish","A_AIC",243,288,45,16.95,"overcount"
"4699",22121,"Louisiana","West Baton Rouge Parish","NHPI_A",1,8,7,155.56,"overcount"
"4700",22121,"Louisiana","West Baton Rouge Parish","NHPI_AIC",20,42,22,70.97,"overcount"
"4701",22123,"Louisiana","West Carroll Parish","A_A",26,13,-13,-66.67,"undercount"
"4702",22123,"Louisiana","West Carroll Parish","A_AIC",41,27,-14,-41.18,"undercount"
"4703",22123,"Louisiana","West Carroll Parish","NHPI_A",0,0,0,0,"equal"
"4704",22123,"Louisiana","West Carroll Parish","NHPI_AIC",4,4,0,0,"equal"
"4705",22125,"Louisiana","West Feliciana Parish","A_A",132,30,-102,-125.93,"undercount"
"4706",22125,"Louisiana","West Feliciana Parish","A_AIC",146,98,-48,-39.34,"undercount"
"4707",22125,"Louisiana","West Feliciana Parish","NHPI_A",4,7,3,54.55,"overcount"
"4708",22125,"Louisiana","West Feliciana Parish","NHPI_AIC",6,25,19,122.58,"overcount"
"4709",22127,"Louisiana","Winn Parish","A_A",36,172,136,130.77,"overcount"
"4710",22127,"Louisiana","Winn Parish","A_AIC",78,212,134,92.41,"overcount"
"4711",22127,"Louisiana","Winn Parish","NHPI_A",4,16,12,120,"overcount"
"4712",22127,"Louisiana","Winn Parish","NHPI_AIC",17,38,21,76.36,"overcount"
"4713",23001,"Maine","Androscoggin County","A_A",1023,917,-106,-10.93,"undercount"
"4714",23001,"Maine","Androscoggin County","A_AIC",1639,1524,-115,-7.27,"undercount"
"4715",23001,"Maine","Androscoggin County","NHPI_A",36,50,14,32.56,"overcount"
"4716",23001,"Maine","Androscoggin County","NHPI_AIC",118,128,10,8.13,"overcount"
"4717",23003,"Maine","Aroostook County","A_A",364,399,35,9.17,"overcount"
"4718",23003,"Maine","Aroostook County","A_AIC",517,559,42,7.81,"overcount"
"4719",23003,"Maine","Aroostook County","NHPI_A",24,18,-6,-28.57,"undercount"
"4720",23003,"Maine","Aroostook County","NHPI_AIC",52,59,7,12.61,"overcount"
"4721",23005,"Maine","Cumberland County","A_A",7366,7279,-87,-1.19,"undercount"
"4722",23005,"Maine","Cumberland County","A_AIC",9641,10113,472,4.78,"overcount"
"4723",23005,"Maine","Cumberland County","NHPI_A",89,98,9,9.63,"overcount"
"4724",23005,"Maine","Cumberland County","NHPI_AIC",271,351,80,25.72,"overcount"
"4725",23007,"Maine","Franklin County","A_A",158,384,226,83.39,"overcount"
"4726",23007,"Maine","Franklin County","A_AIC",249,484,235,64.12,"overcount"
"4727",23007,"Maine","Franklin County","NHPI_A",13,23,10,55.56,"overcount"
"4728",23007,"Maine","Franklin County","NHPI_AIC",27,42,15,43.48,"overcount"
"4729",23009,"Maine","Hancock County","A_A",688,571,-117,-18.59,"undercount"
"4730",23009,"Maine","Hancock County","A_AIC",861,875,14,1.61,"overcount"
"4731",23009,"Maine","Hancock County","NHPI_A",15,10,-5,-40,"undercount"
"4732",23009,"Maine","Hancock County","NHPI_AIC",34,59,25,53.76,"overcount"
"4733",23011,"Maine","Kennebec County","A_A",1196,1217,21,1.74,"overcount"
"4734",23011,"Maine","Kennebec County","A_AIC",1745,1913,168,9.19,"overcount"
"4735",23011,"Maine","Kennebec County","NHPI_A",39,29,-10,-29.41,"undercount"
"4736",23011,"Maine","Kennebec County","NHPI_AIC",112,128,16,13.33,"overcount"
"4737",23013,"Maine","Knox County","A_A",249,252,3,1.2,"overcount"
"4738",23013,"Maine","Knox County","A_AIC",366,419,53,13.5,"overcount"
"4739",23013,"Maine","Knox County","NHPI_A",11,18,7,48.28,"overcount"
"4740",23013,"Maine","Knox County","NHPI_AIC",40,50,10,22.22,"overcount"
"4741",23015,"Maine","Lincoln County","A_A",297,231,-66,-25,"undercount"
"4742",23015,"Maine","Lincoln County","A_AIC",393,378,-15,-3.89,"undercount"
"4743",23015,"Maine","Lincoln County","NHPI_A",6,9,3,40,"overcount"
"4744",23015,"Maine","Lincoln County","NHPI_AIC",19,41,22,73.33,"overcount"
"4745",23017,"Maine","Oxford County","A_A",454,276,-178,-48.77,"undercount"
"4746",23017,"Maine","Oxford County","A_AIC",656,486,-170,-29.77,"undercount"
"4747",23017,"Maine","Oxford County","NHPI_A",26,16,-10,-47.62,"undercount"
"4748",23017,"Maine","Oxford County","NHPI_AIC",64,48,-16,-28.57,"undercount"
"4749",23019,"Maine","Penobscot County","A_A",1789,1878,89,4.85,"overcount"
"4750",23019,"Maine","Penobscot County","A_AIC",2397,2706,309,12.11,"overcount"
"4751",23019,"Maine","Penobscot County","NHPI_A",47,37,-10,-23.81,"undercount"
"4752",23019,"Maine","Penobscot County","NHPI_AIC",137,151,14,9.72,"overcount"
"4753",23021,"Maine","Piscataquis County","A_A",196,131,-65,-39.76,"undercount"
"4754",23021,"Maine","Piscataquis County","A_AIC",241,209,-32,-14.22,"undercount"
"4755",23021,"Maine","Piscataquis County","NHPI_A",6,7,1,15.38,"overcount"
"4756",23021,"Maine","Piscataquis County","NHPI_AIC",19,22,3,14.63,"overcount"
"4757",23023,"Maine","Sagadahoc County","A_A",306,247,-59,-21.34,"undercount"
"4758",23023,"Maine","Sagadahoc County","A_AIC",453,480,27,5.79,"overcount"
"4759",23023,"Maine","Sagadahoc County","NHPI_A",12,3,-9,-120,"undercount"
"4760",23023,"Maine","Sagadahoc County","NHPI_AIC",44,36,-8,-20,"undercount"
"4761",23025,"Maine","Somerset County","A_A",345,266,-79,-25.86,"undercount"
"4762",23025,"Maine","Somerset County","A_AIC",470,424,-46,-10.29,"undercount"
"4763",23025,"Maine","Somerset County","NHPI_A",20,14,-6,-35.29,"undercount"
"4764",23025,"Maine","Somerset County","NHPI_AIC",43,52,9,18.95,"overcount"
"4765",23027,"Maine","Waldo County","A_A",241,201,-40,-18.1,"undercount"
"4766",23027,"Maine","Waldo County","A_AIC",342,355,13,3.73,"overcount"
"4767",23027,"Maine","Waldo County","NHPI_A",13,12,-1,-8,"undercount"
"4768",23027,"Maine","Waldo County","NHPI_AIC",25,41,16,48.48,"overcount"
"4769",23029,"Maine","Washington County","A_A",136,134,-2,-1.48,"undercount"
"4770",23029,"Maine","Washington County","A_AIC",230,262,32,13.01,"overcount"
"4771",23029,"Maine","Washington County","NHPI_A",4,7,3,54.55,"overcount"
"4772",23029,"Maine","Washington County","NHPI_AIC",19,24,5,23.26,"overcount"
"4773",23031,"Maine","York County","A_A",2892,2531,-361,-13.31,"undercount"
"4774",23031,"Maine","York County","A_AIC",3840,3842,2,0.05,"overcount"
"4775",23031,"Maine","York County","NHPI_A",61,58,-3,-5.04,"undercount"
"4776",23031,"Maine","York County","NHPI_AIC",150,190,40,23.53,"overcount"
"4777",24001,"Maryland","Allegany County","A_A",802,738,-64,-8.31,"undercount"
"4778",24001,"Maryland","Allegany County","A_AIC",992,960,-32,-3.28,"undercount"
"4779",24001,"Maryland","Allegany County","NHPI_A",42,22,-20,-62.5,"undercount"
"4780",24001,"Maryland","Allegany County","NHPI_AIC",92,59,-33,-43.71,"undercount"
"4781",24003,"Maryland","Anne Arundel County","A_A",24814,25443,629,2.5,"overcount"
"4782",24003,"Maryland","Anne Arundel County","A_AIC",32031,34280,2249,6.78,"overcount"
"4783",24003,"Maryland","Anne Arundel County","NHPI_A",445,430,-15,-3.43,"undercount"
"4784",24003,"Maryland","Anne Arundel County","NHPI_AIC",1314,1306,-8,-0.61,"undercount"
"4785",24005,"Maryland","Baltimore County","A_A",52492,55260,2768,5.14,"overcount"
"4786",24005,"Maryland","Baltimore County","A_AIC",59451,63639,4188,6.8,"overcount"
"4787",24005,"Maryland","Baltimore County","NHPI_A",290,290,0,0,"equal"
"4788",24005,"Maryland","Baltimore County","NHPI_AIC",1051,1092,41,3.83,"overcount"
"4789",24009,"Maryland","Calvert County","A_A",1760,1576,-184,-11.03,"undercount"
"4790",24009,"Maryland","Calvert County","A_AIC",2793,2815,22,0.78,"overcount"
"4791",24009,"Maryland","Calvert County","NHPI_A",104,76,-28,-31.11,"undercount"
"4792",24009,"Maryland","Calvert County","NHPI_AIC",244,265,21,8.25,"overcount"
"4793",24011,"Maryland","Caroline County","A_A",317,356,39,11.59,"overcount"
"4794",24011,"Maryland","Caroline County","A_AIC",435,533,98,20.25,"overcount"
"4795",24011,"Maryland","Caroline County","NHPI_A",13,13,0,0,"equal"
"4796",24011,"Maryland","Caroline County","NHPI_AIC",52,34,-18,-41.86,"undercount"
"4797",24013,"Maryland","Carroll County","A_A",3723,3816,93,2.47,"overcount"
"4798",24013,"Maryland","Carroll County","A_AIC",5005,5652,647,12.14,"overcount"
"4799",24013,"Maryland","Carroll County","NHPI_A",75,36,-39,-70.27,"undercount"
"4800",24013,"Maryland","Carroll County","NHPI_AIC",202,185,-17,-8.79,"undercount"
"4801",24015,"Maryland","Cecil County","A_A",1474,1256,-218,-15.97,"undercount"
"4802",24015,"Maryland","Cecil County","A_AIC",2072,2020,-52,-2.54,"undercount"
"4803",24015,"Maryland","Cecil County","NHPI_A",60,37,-23,-47.42,"undercount"
"4804",24015,"Maryland","Cecil County","NHPI_AIC",169,127,-42,-28.38,"undercount"
"4805",24017,"Maryland","Charles County","A_A",5399,5683,284,5.13,"overcount"
"4806",24017,"Maryland","Charles County","A_AIC",7280,7824,544,7.2,"overcount"
"4807",24017,"Maryland","Charles County","NHPI_A",149,155,6,3.95,"overcount"
"4808",24017,"Maryland","Charles County","NHPI_AIC",399,445,46,10.9,"overcount"
"4809",24019,"Maryland","Dorchester County","A_A",350,358,8,2.26,"overcount"
"4810",24019,"Maryland","Dorchester County","A_AIC",446,488,42,8.99,"overcount"
"4811",24019,"Maryland","Dorchester County","NHPI_A",11,10,-1,-9.52,"undercount"
"4812",24019,"Maryland","Dorchester County","NHPI_AIC",50,30,-20,-50,"undercount"
"4813",24021,"Maryland","Frederick County","A_A",13573,13685,112,0.82,"overcount"
"4814",24021,"Maryland","Frederick County","A_AIC",16426,17184,758,4.51,"overcount"
"4815",24021,"Maryland","Frederick County","NHPI_A",144,158,14,9.27,"overcount"
"4816",24021,"Maryland","Frederick County","NHPI_AIC",392,465,73,17.04,"overcount"
"4817",24023,"Maryland","Garrett County","A_A",125,83,-42,-40.38,"undercount"
"4818",24023,"Maryland","Garrett County","A_AIC",194,164,-30,-16.76,"undercount"
"4819",24023,"Maryland","Garrett County","NHPI_A",1,2,1,66.67,"overcount"
"4820",24023,"Maryland","Garrett County","NHPI_AIC",14,39,25,94.34,"overcount"
"4821",24025,"Maryland","Harford County","A_A",7824,8192,368,4.6,"overcount"
"4822",24025,"Maryland","Harford County","A_AIC",10240,11062,822,7.72,"overcount"
"4823",24025,"Maryland","Harford County","NHPI_A",172,180,8,4.55,"overcount"
"4824",24025,"Maryland","Harford County","NHPI_AIC",469,477,8,1.69,"overcount"
"4825",24027,"Maryland","Howard County","A_A",64702,66587,1885,2.87,"overcount"
"4826",24027,"Maryland","Howard County","A_AIC",70172,73130,2958,4.13,"overcount"
"4827",24027,"Maryland","Howard County","NHPI_A",182,114,-68,-45.95,"undercount"
"4828",24027,"Maryland","Howard County","NHPI_AIC",566,489,-77,-14.6,"undercount"
"4829",24029,"Maryland","Kent County","A_A",249,254,5,1.99,"overcount"
"4830",24029,"Maryland","Kent County","A_AIC",311,359,48,14.33,"overcount"
"4831",24029,"Maryland","Kent County","NHPI_A",6,0,-6,-200,"undercount"
"4832",24029,"Maryland","Kent County","NHPI_AIC",25,31,6,21.43,"overcount"
"4833",24031,"Maryland","Montgomery County","A_A",164167,164419,252,0.15,"overcount"
"4834",24031,"Maryland","Montgomery County","A_AIC",180294,183930,3636,2,"overcount"
"4835",24031,"Maryland","Montgomery County","NHPI_A",459,483,24,5.1,"overcount"
"4836",24031,"Maryland","Montgomery County","NHPI_AIC",1838,1694,-144,-8.15,"undercount"
"4837",24033,"Maryland","Prince George's County","A_A",37852,42195,4343,10.85,"overcount"
"4838",24033,"Maryland","Prince George's County","A_AIC",43493,49529,6036,12.98,"overcount"
"4839",24033,"Maryland","Prince George's County","NHPI_A",364,406,42,10.91,"overcount"
"4840",24033,"Maryland","Prince George's County","NHPI_AIC",1224,1299,75,5.95,"overcount"
"4841",24035,"Maryland","Queen Anne's County","A_A",608,610,2,0.33,"overcount"
"4842",24035,"Maryland","Queen Anne's County","A_AIC",936,972,36,3.77,"overcount"
"4843",24035,"Maryland","Queen Anne's County","NHPI_A",21,11,-10,-62.5,"undercount"
"4844",24035,"Maryland","Queen Anne's County","NHPI_AIC",58,62,4,6.67,"overcount"
"4845",24037,"Maryland","St. Mary's County","A_A",3287,3321,34,1.03,"overcount"
"4846",24037,"Maryland","St. Mary's County","A_AIC",4678,5171,493,10.01,"overcount"
"4847",24037,"Maryland","St. Mary's County","NHPI_A",125,86,-39,-36.97,"undercount"
"4848",24037,"Maryland","St. Mary's County","NHPI_AIC",291,303,12,4.04,"overcount"
"4849",24039,"Maryland","Somerset County","A_A",231,251,20,8.3,"overcount"
"4850",24039,"Maryland","Somerset County","A_AIC",346,333,-13,-3.83,"undercount"
"4851",24039,"Maryland","Somerset County","NHPI_A",11,1,-10,-166.67,"undercount"
"4852",24039,"Maryland","Somerset County","NHPI_AIC",45,21,-24,-72.73,"undercount"
"4853",24041,"Maryland","Talbot County","A_A",495,538,43,8.33,"overcount"
"4854",24041,"Maryland","Talbot County","A_AIC",646,719,73,10.7,"overcount"
"4855",24041,"Maryland","Talbot County","NHPI_A",22,11,-11,-66.67,"undercount"
"4856",24041,"Maryland","Talbot County","NHPI_AIC",65,60,-5,-8,"undercount"
"4857",24043,"Maryland","Washington County","A_A",2856,3138,282,9.41,"overcount"
"4858",24043,"Maryland","Washington County","A_AIC",3720,4202,482,12.17,"overcount"
"4859",24043,"Maryland","Washington County","NHPI_A",99,70,-29,-34.32,"undercount"
"4860",24043,"Maryland","Washington County","NHPI_AIC",242,224,-18,-7.73,"undercount"
"4861",24045,"Maryland","Wicomico County","A_A",3217,3167,-50,-1.57,"undercount"
"4862",24045,"Maryland","Wicomico County","A_AIC",3875,3808,-67,-1.74,"undercount"
"4863",24045,"Maryland","Wicomico County","NHPI_A",24,40,16,50,"overcount"
"4864",24045,"Maryland","Wicomico County","NHPI_AIC",145,175,30,18.75,"overcount"
"4865",24047,"Maryland","Worcester County","A_A",822,739,-83,-10.63,"undercount"
"4866",24047,"Maryland","Worcester County","A_AIC",1022,1004,-18,-1.78,"undercount"
"4867",24047,"Maryland","Worcester County","NHPI_A",17,7,-10,-83.33,"undercount"
"4868",24047,"Maryland","Worcester County","NHPI_AIC",68,24,-44,-95.65,"undercount"
"4869",24510,"Maryland","Baltimore city","A_A",15709,21273,5564,30.09,"overcount"
"4870",24510,"Maryland","Baltimore city","A_AIC",19267,25982,6715,29.68,"overcount"
"4871",24510,"Maryland","Baltimore city","NHPI_A",192,167,-25,-13.93,"undercount"
"4872",24510,"Maryland","Baltimore city","NHPI_AIC",685,643,-42,-6.33,"undercount"
"4873",25001,"Massachusetts","Barnstable County","A_A",3213,3308,95,2.91,"overcount"
"4874",25001,"Massachusetts","Barnstable County","A_AIC",4308,4559,251,5.66,"overcount"
"4875",25001,"Massachusetts","Barnstable County","NHPI_A",102,77,-25,-27.93,"undercount"
"4876",25001,"Massachusetts","Barnstable County","NHPI_AIC",305,238,-67,-24.68,"undercount"
"4877",25003,"Massachusetts","Berkshire County","A_A",2074,2033,-41,-2,"undercount"
"4878",25003,"Massachusetts","Berkshire County","A_AIC",2767,2838,71,2.53,"overcount"
"4879",25003,"Massachusetts","Berkshire County","NHPI_A",50,19,-31,-89.86,"undercount"
"4880",25003,"Massachusetts","Berkshire County","NHPI_AIC",165,96,-69,-52.87,"undercount"
"4881",25005,"Massachusetts","Bristol County","A_A",13907,13892,-15,-0.11,"undercount"
"4882",25005,"Massachusetts","Bristol County","A_AIC",16919,17096,177,1.04,"overcount"
"4883",25005,"Massachusetts","Bristol County","NHPI_A",353,219,-134,-46.85,"undercount"
"4884",25005,"Massachusetts","Bristol County","NHPI_AIC",1041,646,-395,-46.83,"undercount"
"4885",25007,"Massachusetts","Dukes County","A_A",226,190,-36,-17.31,"undercount"
"4886",25007,"Massachusetts","Dukes County","A_AIC",316,360,44,13.02,"overcount"
"4887",25007,"Massachusetts","Dukes County","NHPI_A",7,9,2,25,"overcount"
"4888",25007,"Massachusetts","Dukes County","NHPI_AIC",58,56,-2,-3.51,"undercount"
"4889",25009,"Massachusetts","Essex County","A_A",29883,29771,-112,-0.38,"undercount"
"4890",25009,"Massachusetts","Essex County","A_AIC",33200,35215,2015,5.89,"overcount"
"4891",25009,"Massachusetts","Essex County","NHPI_A",235,191,-44,-20.66,"undercount"
"4892",25009,"Massachusetts","Essex County","NHPI_AIC",738,617,-121,-17.86,"undercount"
"4893",25011,"Massachusetts","Franklin County","A_A",1177,1235,58,4.81,"overcount"
"4894",25011,"Massachusetts","Franklin County","A_AIC",1601,1804,203,11.92,"overcount"
"4895",25011,"Massachusetts","Franklin County","NHPI_A",117,14,-103,-157.25,"undercount"
"4896",25011,"Massachusetts","Franklin County","NHPI_AIC",203,73,-130,-94.2,"undercount"
"4897",25013,"Massachusetts","Hampden County","A_A",11948,12268,320,2.64,"overcount"
"4898",25013,"Massachusetts","Hampden County","A_AIC",13717,15104,1387,9.62,"overcount"
"4899",25013,"Massachusetts","Hampden County","NHPI_A",190,186,-4,-2.13,"undercount"
"4900",25013,"Massachusetts","Hampden County","NHPI_AIC",567,545,-22,-3.96,"undercount"
"4901",25015,"Massachusetts","Hampshire County","A_A",8896,10852,1956,19.81,"overcount"
"4902",25015,"Massachusetts","Hampshire County","A_AIC",10552,12952,2400,20.42,"overcount"
"4903",25015,"Massachusetts","Hampshire County","NHPI_A",90,64,-26,-33.77,"undercount"
"4904",25015,"Massachusetts","Hampshire County","NHPI_AIC",270,221,-49,-19.96,"undercount"
"4905",25017,"Massachusetts","Middlesex County","A_A",217381,213092,-4289,-1.99,"undercount"
"4906",25017,"Massachusetts","Middlesex County","A_AIC",236657,236606,-51,-0.02,"undercount"
"4907",25017,"Massachusetts","Middlesex County","NHPI_A",443,438,-5,-1.14,"undercount"
"4908",25017,"Massachusetts","Middlesex County","NHPI_AIC",1945,1669,-276,-15.27,"undercount"
"4909",25019,"Massachusetts","Nantucket County","A_A",204,271,67,28.21,"overcount"
"4910",25019,"Massachusetts","Nantucket County","A_AIC",246,381,135,43.06,"overcount"
"4911",25019,"Massachusetts","Nantucket County","NHPI_A",14,3,-11,-129.41,"undercount"
"4912",25019,"Massachusetts","Nantucket County","NHPI_AIC",28,40,12,35.29,"overcount"
"4913",25021,"Massachusetts","Norfolk County","A_A",87849,89156,1307,1.48,"overcount"
"4914",25021,"Massachusetts","Norfolk County","A_AIC",95306,97983,2677,2.77,"overcount"
"4915",25021,"Massachusetts","Norfolk County","NHPI_A",243,216,-27,-11.76,"undercount"
"4916",25021,"Massachusetts","Norfolk County","NHPI_AIC",834,791,-43,-5.29,"undercount"
"4917",25023,"Massachusetts","Plymouth County","A_A",8636,8089,-547,-6.54,"undercount"
"4918",25023,"Massachusetts","Plymouth County","A_AIC",11391,11171,-220,-1.95,"undercount"
"4919",25023,"Massachusetts","Plymouth County","NHPI_A",502,336,-166,-39.62,"undercount"
"4920",25023,"Massachusetts","Plymouth County","NHPI_AIC",1039,784,-255,-27.98,"undercount"
"4921",25025,"Massachusetts","Suffolk County","A_A",74569,81651,7082,9.07,"overcount"
"4922",25025,"Massachusetts","Suffolk County","A_AIC",80932,90187,9255,10.82,"overcount"
"4923",25025,"Massachusetts","Suffolk County","NHPI_A",472,429,-43,-9.54,"undercount"
"4924",25025,"Massachusetts","Suffolk County","NHPI_AIC",1623,1034,-589,-44.34,"undercount"
"4925",25027,"Massachusetts","Worcester County","A_A",44643,46873,2230,4.87,"overcount"
"4926",25027,"Massachusetts","Worcester County","A_AIC",49986,53492,3506,6.78,"overcount"
"4927",25027,"Massachusetts","Worcester County","NHPI_A",267,243,-24,-9.41,"undercount"
"4928",25027,"Massachusetts","Worcester County","NHPI_AIC",815,790,-25,-3.12,"undercount"
"4929",26001,"Michigan","Alcona County","A_A",43,14,-29,-101.75,"undercount"
"4930",26001,"Michigan","Alcona County","A_AIC",57,44,-13,-25.74,"undercount"
"4931",26001,"Michigan","Alcona County","NHPI_A",4,1,-3,-120,"undercount"
"4932",26001,"Michigan","Alcona County","NHPI_AIC",5,8,3,46.15,"overcount"
"4933",26003,"Michigan","Alger County","A_A",41,24,-17,-52.31,"undercount"
"4934",26003,"Michigan","Alger County","A_AIC",64,43,-21,-39.25,"undercount"
"4935",26003,"Michigan","Alger County","NHPI_A",0,1,1,200,"overcount"
"4936",26003,"Michigan","Alger County","NHPI_AIC",2,17,15,157.89,"overcount"
"4937",26005,"Michigan","Allegan County","A_A",954,840,-114,-12.71,"undercount"
"4938",26005,"Michigan","Allegan County","A_AIC",1318,1439,121,8.78,"overcount"
"4939",26005,"Michigan","Allegan County","NHPI_A",30,21,-9,-35.29,"undercount"
"4940",26005,"Michigan","Allegan County","NHPI_AIC",83,87,4,4.71,"overcount"
"4941",26007,"Michigan","Alpena County","A_A",153,112,-41,-30.94,"undercount"
"4942",26007,"Michigan","Alpena County","A_AIC",218,221,3,1.37,"overcount"
"4943",26007,"Michigan","Alpena County","NHPI_A",9,12,3,28.57,"overcount"
"4944",26007,"Michigan","Alpena County","NHPI_AIC",19,46,27,83.08,"overcount"
"4945",26009,"Michigan","Antrim County","A_A",85,70,-15,-19.35,"undercount"
"4946",26009,"Michigan","Antrim County","A_AIC",128,129,1,0.78,"overcount"
"4947",26009,"Michigan","Antrim County","NHPI_A",14,18,4,25,"overcount"
"4948",26009,"Michigan","Antrim County","NHPI_AIC",24,30,6,22.22,"overcount"
"4949",26011,"Michigan","Arenac County","A_A",49,38,-11,-25.29,"undercount"
"4950",26011,"Michigan","Arenac County","A_AIC",99,74,-25,-28.9,"undercount"
"4951",26011,"Michigan","Arenac County","NHPI_A",9,4,-5,-76.92,"undercount"
"4952",26011,"Michigan","Arenac County","NHPI_AIC",21,17,-4,-21.05,"undercount"
"4953",26013,"Michigan","Baraga County","A_A",30,18,-12,-50,"undercount"
"4954",26013,"Michigan","Baraga County","A_AIC",67,54,-13,-21.49,"undercount"
"4955",26013,"Michigan","Baraga County","NHPI_A",0,3,3,200,"overcount"
"4956",26013,"Michigan","Baraga County","NHPI_AIC",13,14,1,7.41,"overcount"
"4957",26015,"Michigan","Barry County","A_A",306,246,-60,-21.74,"undercount"
"4958",26015,"Michigan","Barry County","A_AIC",494,505,11,2.2,"overcount"
"4959",26015,"Michigan","Barry County","NHPI_A",9,15,6,50,"overcount"
"4960",26015,"Michigan","Barry County","NHPI_AIC",27,60,33,75.86,"overcount"
"4961",26017,"Michigan","Bay County","A_A",585,584,-1,-0.17,"undercount"
"4962",26017,"Michigan","Bay County","A_AIC",844,946,102,11.4,"overcount"
"4963",26017,"Michigan","Bay County","NHPI_A",14,0,-14,-200,"undercount"
"4964",26017,"Michigan","Bay County","NHPI_AIC",52,51,-1,-1.94,"undercount"
"4965",26019,"Michigan","Benzie County","A_A",83,76,-7,-8.81,"undercount"
"4966",26019,"Michigan","Benzie County","A_AIC",123,115,-8,-6.72,"undercount"
"4967",26019,"Michigan","Benzie County","NHPI_A",4,0,-4,-200,"undercount"
"4968",26019,"Michigan","Benzie County","NHPI_AIC",16,9,-7,-56,"undercount"
"4969",26021,"Michigan","Berrien County","A_A",3187,3217,30,0.94,"overcount"
"4970",26021,"Michigan","Berrien County","A_AIC",4096,4154,58,1.41,"overcount"
"4971",26021,"Michigan","Berrien County","NHPI_A",136,109,-27,-22.04,"undercount"
"4972",26021,"Michigan","Berrien County","NHPI_AIC",285,195,-90,-37.5,"undercount"
"4973",26023,"Michigan","Branch County","A_A",295,266,-29,-10.34,"undercount"
"4974",26023,"Michigan","Branch County","A_AIC",550,476,-74,-14.42,"undercount"
"4975",26023,"Michigan","Branch County","NHPI_A",6,10,4,50,"overcount"
"4976",26023,"Michigan","Branch County","NHPI_AIC",22,32,10,37.04,"overcount"
"4977",26025,"Michigan","Calhoun County","A_A",3739,3754,15,0.4,"overcount"
"4978",26025,"Michigan","Calhoun County","A_AIC",4417,4377,-40,-0.91,"undercount"
"4979",26025,"Michigan","Calhoun County","NHPI_A",46,41,-5,-11.49,"undercount"
"4980",26025,"Michigan","Calhoun County","NHPI_AIC",180,140,-40,-25,"undercount"
"4981",26027,"Michigan","Cass County","A_A",381,346,-35,-9.63,"undercount"
"4982",26027,"Michigan","Cass County","A_AIC",564,567,3,0.53,"overcount"
"4983",26027,"Michigan","Cass County","NHPI_A",12,11,-1,-8.7,"undercount"
"4984",26027,"Michigan","Cass County","NHPI_AIC",55,46,-9,-17.82,"undercount"
"4985",26029,"Michigan","Charlevoix County","A_A",153,122,-31,-22.55,"undercount"
"4986",26029,"Michigan","Charlevoix County","A_AIC",222,212,-10,-4.61,"undercount"
"4987",26029,"Michigan","Charlevoix County","NHPI_A",21,10,-11,-70.97,"undercount"
"4988",26029,"Michigan","Charlevoix County","NHPI_AIC",33,53,20,46.51,"overcount"
"4989",26031,"Michigan","Cheboygan County","A_A",107,85,-22,-22.92,"undercount"
"4990",26031,"Michigan","Cheboygan County","A_AIC",166,164,-2,-1.21,"undercount"
"4991",26031,"Michigan","Cheboygan County","NHPI_A",11,1,-10,-166.67,"undercount"
"4992",26031,"Michigan","Cheboygan County","NHPI_AIC",27,7,-20,-117.65,"undercount"
"4993",26033,"Michigan","Chippewa County","A_A",264,193,-71,-31.07,"undercount"
"4994",26033,"Michigan","Chippewa County","A_AIC",492,292,-200,-51.02,"undercount"
"4995",26033,"Michigan","Chippewa County","NHPI_A",20,13,-7,-42.42,"undercount"
"4996",26033,"Michigan","Chippewa County","NHPI_AIC",74,42,-32,-55.17,"undercount"
"4997",26035,"Michigan","Clare County","A_A",81,72,-9,-11.76,"undercount"
"4998",26035,"Michigan","Clare County","A_AIC",132,134,2,1.5,"overcount"
"4999",26035,"Michigan","Clare County","NHPI_A",11,0,-11,-200,"undercount"
"5000",26035,"Michigan","Clare County","NHPI_AIC",24,18,-6,-28.57,"undercount"
"5001",26037,"Michigan","Clinton County","A_A",1250,1885,635,40.51,"overcount"
"5002",26037,"Michigan","Clinton County","A_AIC",1646,2341,695,34.86,"overcount"
"5003",26037,"Michigan","Clinton County","NHPI_A",41,23,-18,-56.25,"undercount"
"5004",26037,"Michigan","Clinton County","NHPI_AIC",94,82,-12,-13.64,"undercount"
"5005",26039,"Michigan","Crawford County","A_A",102,58,-44,-55,"undercount"
"5006",26039,"Michigan","Crawford County","A_AIC",131,92,-39,-34.98,"undercount"
"5007",26039,"Michigan","Crawford County","NHPI_A",8,4,-4,-66.67,"undercount"
"5008",26039,"Michigan","Crawford County","NHPI_AIC",15,9,-6,-50,"undercount"
"5009",26041,"Michigan","Delta County","A_A",182,154,-28,-16.67,"undercount"
"5010",26041,"Michigan","Delta County","A_AIC",325,310,-15,-4.72,"undercount"
"5011",26041,"Michigan","Delta County","NHPI_A",10,10,0,0,"equal"
"5012",26041,"Michigan","Delta County","NHPI_AIC",40,36,-4,-10.53,"undercount"
"5013",26043,"Michigan","Dickinson County","A_A",183,150,-33,-19.82,"undercount"
"5014",26043,"Michigan","Dickinson County","A_AIC",256,243,-13,-5.21,"undercount"
"5015",26043,"Michigan","Dickinson County","NHPI_A",9,4,-5,-76.92,"undercount"
"5016",26043,"Michigan","Dickinson County","NHPI_AIC",25,8,-17,-103.03,"undercount"
"5017",26045,"Michigan","Eaton County","A_A",2662,2459,-203,-7.93,"undercount"
"5018",26045,"Michigan","Eaton County","A_AIC",3208,3014,-194,-6.24,"undercount"
"5019",26045,"Michigan","Eaton County","NHPI_A",37,13,-24,-96,"undercount"
"5020",26045,"Michigan","Eaton County","NHPI_AIC",140,117,-23,-17.9,"undercount"
"5021",26047,"Michigan","Emmet County","A_A",212,174,-38,-19.69,"undercount"
"5022",26047,"Michigan","Emmet County","A_AIC",313,301,-12,-3.91,"undercount"
"5023",26047,"Michigan","Emmet County","NHPI_A",41,22,-19,-60.32,"undercount"
"5024",26047,"Michigan","Emmet County","NHPI_AIC",63,54,-9,-15.38,"undercount"
"5025",26049,"Michigan","Genesee County","A_A",4128,4119,-9,-0.22,"undercount"
"5026",26049,"Michigan","Genesee County","A_AIC",6079,6066,-13,-0.21,"undercount"
"5027",26049,"Michigan","Genesee County","NHPI_A",87,131,44,40.37,"overcount"
"5028",26049,"Michigan","Genesee County","NHPI_AIC",354,372,18,4.96,"overcount"
"5029",26051,"Michigan","Gladwin County","A_A",108,72,-36,-40,"undercount"
"5030",26051,"Michigan","Gladwin County","A_AIC",154,107,-47,-36.02,"undercount"
"5031",26051,"Michigan","Gladwin County","NHPI_A",6,0,-6,-200,"undercount"
"5032",26051,"Michigan","Gladwin County","NHPI_AIC",14,10,-4,-33.33,"undercount"
"5033",26053,"Michigan","Gogebic County","A_A",56,41,-15,-30.93,"undercount"
"5034",26053,"Michigan","Gogebic County","A_AIC",95,92,-3,-3.21,"undercount"
"5035",26053,"Michigan","Gogebic County","NHPI_A",3,3,0,0,"equal"
"5036",26053,"Michigan","Gogebic County","NHPI_AIC",14,21,7,40,"overcount"
"5037",26055,"Michigan","Grand Traverse County","A_A",718,843,125,16.02,"overcount"
"5038",26055,"Michigan","Grand Traverse County","A_AIC",1122,1420,298,23.45,"overcount"
"5039",26055,"Michigan","Grand Traverse County","NHPI_A",63,41,-22,-42.31,"undercount"
"5040",26055,"Michigan","Grand Traverse County","NHPI_AIC",127,157,30,21.13,"overcount"
"5041",26057,"Michigan","Gratiot County","A_A",185,166,-19,-10.83,"undercount"
"5042",26057,"Michigan","Gratiot County","A_AIC",270,290,20,7.14,"overcount"
"5043",26057,"Michigan","Gratiot County","NHPI_A",14,28,14,66.67,"overcount"
"5044",26057,"Michigan","Gratiot County","NHPI_AIC",33,51,18,42.86,"overcount"
"5045",26059,"Michigan","Hillsdale County","A_A",212,200,-12,-5.83,"undercount"
"5046",26059,"Michigan","Hillsdale County","A_AIC",322,380,58,16.52,"overcount"
"5047",26059,"Michigan","Hillsdale County","NHPI_A",14,6,-8,-80,"undercount"
"5048",26059,"Michigan","Hillsdale County","NHPI_AIC",32,38,6,17.14,"overcount"
"5049",26061,"Michigan","Houghton County","A_A",928,855,-73,-8.19,"undercount"
"5050",26061,"Michigan","Houghton County","A_AIC",1072,1062,-10,-0.94,"undercount"
"5051",26061,"Michigan","Houghton County","NHPI_A",14,21,7,40,"overcount"
"5052",26061,"Michigan","Houghton County","NHPI_AIC",37,52,15,33.71,"overcount"
"5053",26063,"Michigan","Huron County","A_A",197,150,-47,-27.09,"undercount"
"5054",26063,"Michigan","Huron County","A_AIC",241,233,-8,-3.38,"undercount"
"5055",26063,"Michigan","Huron County","NHPI_A",4,5,1,22.22,"overcount"
"5056",26063,"Michigan","Huron County","NHPI_AIC",13,15,2,14.29,"overcount"
"5057",26065,"Michigan","Ingham County","A_A",19284,16680,-2604,-14.48,"undercount"
"5058",26065,"Michigan","Ingham County","A_AIC",21939,19339,-2600,-12.6,"undercount"
"5059",26065,"Michigan","Ingham County","NHPI_A",146,111,-35,-27.24,"undercount"
"5060",26065,"Michigan","Ingham County","NHPI_AIC",429,351,-78,-20,"undercount"
"5061",26067,"Michigan","Ionia County","A_A",291,229,-62,-23.85,"undercount"
"5062",26067,"Michigan","Ionia County","A_AIC",500,462,-38,-7.9,"undercount"
"5063",26067,"Michigan","Ionia County","NHPI_A",12,6,-6,-66.67,"undercount"
"5064",26067,"Michigan","Ionia County","NHPI_AIC",43,40,-3,-7.23,"undercount"
"5065",26069,"Michigan","Iosco County","A_A",198,158,-40,-22.47,"undercount"
"5066",26069,"Michigan","Iosco County","A_AIC",275,257,-18,-6.77,"undercount"
"5067",26069,"Michigan","Iosco County","NHPI_A",11,3,-8,-114.29,"undercount"
"5068",26069,"Michigan","Iosco County","NHPI_AIC",26,14,-12,-60,"undercount"
"5069",26071,"Michigan","Iron County","A_A",48,41,-7,-15.73,"undercount"
"5070",26071,"Michigan","Iron County","A_AIC",78,75,-3,-3.92,"undercount"
"5071",26071,"Michigan","Iron County","NHPI_A",2,0,-2,-200,"undercount"
"5072",26071,"Michigan","Iron County","NHPI_AIC",6,13,7,73.68,"overcount"
"5073",26073,"Michigan","Isabella County","A_A",1174,1134,-40,-3.47,"undercount"
"5074",26073,"Michigan","Isabella County","A_AIC",1560,1492,-68,-4.46,"undercount"
"5075",26073,"Michigan","Isabella County","NHPI_A",28,17,-11,-48.89,"undercount"
"5076",26073,"Michigan","Isabella County","NHPI_AIC",103,52,-51,-65.81,"undercount"
"5077",26075,"Michigan","Jackson County","A_A",1356,1483,127,8.95,"overcount"
"5078",26075,"Michigan","Jackson County","A_AIC",1905,2178,273,13.37,"overcount"
"5079",26075,"Michigan","Jackson County","NHPI_A",58,30,-28,-63.64,"undercount"
"5080",26075,"Michigan","Jackson County","NHPI_AIC",158,103,-55,-42.15,"undercount"
"5081",26077,"Michigan","Kalamazoo County","A_A",7378,7087,-291,-4.02,"undercount"
"5082",26077,"Michigan","Kalamazoo County","A_AIC",9267,9250,-17,-0.18,"undercount"
"5083",26077,"Michigan","Kalamazoo County","NHPI_A",113,64,-49,-55.37,"undercount"
"5084",26077,"Michigan","Kalamazoo County","NHPI_AIC",350,277,-73,-23.29,"undercount"
"5085",26079,"Michigan","Kalkaska County","A_A",111,60,-51,-59.65,"undercount"
"5086",26079,"Michigan","Kalkaska County","A_AIC",160,113,-47,-34.43,"undercount"
"5087",26079,"Michigan","Kalkaska County","NHPI_A",10,0,-10,-200,"undercount"
"5088",26079,"Michigan","Kalkaska County","NHPI_AIC",22,14,-8,-44.44,"undercount"
"5089",26081,"Michigan","Kent County","A_A",21844,22010,166,0.76,"overcount"
"5090",26081,"Michigan","Kent County","A_AIC",25732,27403,1671,6.29,"overcount"
"5091",26081,"Michigan","Kent County","NHPI_A",206,181,-25,-12.92,"undercount"
"5092",26081,"Michigan","Kent County","NHPI_AIC",654,726,72,10.43,"overcount"
"5093",26083,"Michigan","Keweenaw County","A_A",2,0,-2,-200,"undercount"
"5094",26083,"Michigan","Keweenaw County","A_AIC",9,9,0,0,"equal"
"5095",26083,"Michigan","Keweenaw County","NHPI_A",0,0,0,0,"equal"
"5096",26083,"Michigan","Keweenaw County","NHPI_AIC",0,5,5,200,"overcount"
"5097",26085,"Michigan","Lake County","A_A",36,45,9,22.22,"overcount"
"5098",26085,"Michigan","Lake County","A_AIC",78,66,-12,-16.67,"undercount"
"5099",26085,"Michigan","Lake County","NHPI_A",2,8,6,120,"overcount"
"5100",26085,"Michigan","Lake County","NHPI_AIC",22,30,8,30.77,"overcount"
"5101",26087,"Michigan","Lapeer County","A_A",568,421,-147,-29.73,"undercount"
"5102",26087,"Michigan","Lapeer County","A_AIC",839,752,-87,-10.94,"undercount"
"5103",26087,"Michigan","Lapeer County","NHPI_A",10,14,4,33.33,"overcount"
"5104",26087,"Michigan","Lapeer County","NHPI_AIC",38,61,23,46.46,"overcount"
"5105",26089,"Michigan","Leelanau County","A_A",128,106,-22,-18.8,"undercount"
"5106",26089,"Michigan","Leelanau County","A_AIC",194,193,-1,-0.52,"undercount"
"5107",26089,"Michigan","Leelanau County","NHPI_A",10,4,-6,-85.71,"undercount"
"5108",26089,"Michigan","Leelanau County","NHPI_AIC",19,33,14,53.85,"overcount"
"5109",26091,"Michigan","Lenawee County","A_A",463,478,15,3.19,"overcount"
"5110",26091,"Michigan","Lenawee County","A_AIC",782,928,146,17.08,"overcount"
"5111",26091,"Michigan","Lenawee County","NHPI_A",29,8,-21,-113.51,"undercount"
"5112",26091,"Michigan","Lenawee County","NHPI_AIC",83,41,-42,-67.74,"undercount"
"5113",26093,"Michigan","Livingston County","A_A",1809,1657,-152,-8.77,"undercount"
"5114",26093,"Michigan","Livingston County","A_AIC",2778,2915,137,4.81,"overcount"
"5115",26093,"Michigan","Livingston County","NHPI_A",88,113,25,24.88,"overcount"
"5116",26093,"Michigan","Livingston County","NHPI_AIC",165,243,78,38.24,"overcount"
"5117",26095,"Michigan","Luce County","A_A",15,3,-12,-133.33,"undercount"
"5118",26095,"Michigan","Luce County","A_AIC",39,19,-20,-68.97,"undercount"
"5119",26095,"Michigan","Luce County","NHPI_A",1,0,-1,-200,"undercount"
"5120",26095,"Michigan","Luce County","NHPI_AIC",4,11,7,93.33,"overcount"
"5121",26097,"Michigan","Mackinac County","A_A",108,28,-80,-117.65,"undercount"
"5122",26097,"Michigan","Mackinac County","A_AIC",146,50,-96,-97.96,"undercount"
"5123",26097,"Michigan","Mackinac County","NHPI_A",1,1,0,0,"equal"
"5124",26097,"Michigan","Mackinac County","NHPI_AIC",8,3,-5,-90.91,"undercount"
"5125",26099,"Michigan","Macomb County","A_A",38244,38507,263,0.69,"overcount"
"5126",26099,"Michigan","Macomb County","A_AIC",45649,45868,219,0.48,"overcount"
"5127",26099,"Michigan","Macomb County","NHPI_A",230,193,-37,-17.49,"undercount"
"5128",26099,"Michigan","Macomb County","NHPI_AIC",1190,779,-411,-41.75,"undercount"
"5129",26101,"Michigan","Manistee County","A_A",94,79,-15,-17.34,"undercount"
"5130",26101,"Michigan","Manistee County","A_AIC",159,157,-2,-1.27,"undercount"
"5131",26101,"Michigan","Manistee County","NHPI_A",15,2,-13,-152.94,"undercount"
"5132",26101,"Michigan","Manistee County","NHPI_AIC",32,13,-19,-84.44,"undercount"
"5133",26103,"Michigan","Marquette County","A_A",502,400,-102,-22.62,"undercount"
"5134",26103,"Michigan","Marquette County","A_AIC",754,710,-44,-6.01,"undercount"
"5135",26103,"Michigan","Marquette County","NHPI_A",20,17,-3,-16.22,"undercount"
"5136",26103,"Michigan","Marquette County","NHPI_AIC",68,43,-25,-45.05,"undercount"
"5137",26105,"Michigan","Mason County","A_A",239,154,-85,-43.26,"undercount"
"5138",26105,"Michigan","Mason County","A_AIC",321,262,-59,-20.24,"undercount"
"5139",26105,"Michigan","Mason County","NHPI_A",5,8,3,46.15,"overcount"
"5140",26105,"Michigan","Mason County","NHPI_AIC",21,41,20,64.52,"overcount"
"5141",26107,"Michigan","Mecosta County","A_A",373,324,-49,-14.06,"undercount"
"5142",26107,"Michigan","Mecosta County","A_AIC",526,476,-50,-9.98,"undercount"
"5143",26107,"Michigan","Mecosta County","NHPI_A",8,14,6,54.55,"overcount"
"5144",26107,"Michigan","Mecosta County","NHPI_AIC",51,20,-31,-87.32,"undercount"
"5145",26109,"Michigan","Menominee County","A_A",102,94,-8,-8.16,"undercount"
"5146",26109,"Michigan","Menominee County","A_AIC",169,179,10,5.75,"overcount"
"5147",26109,"Michigan","Menominee County","NHPI_A",10,5,-5,-66.67,"undercount"
"5148",26109,"Michigan","Menominee County","NHPI_AIC",21,18,-3,-15.38,"undercount"
"5149",26111,"Michigan","Midland County","A_A",1908,1768,-140,-7.62,"undercount"
"5150",26111,"Michigan","Midland County","A_AIC",2306,2271,-35,-1.53,"undercount"
"5151",26111,"Michigan","Midland County","NHPI_A",70,83,13,16.99,"overcount"
"5152",26111,"Michigan","Midland County","NHPI_AIC",116,127,11,9.05,"overcount"
"5153",26113,"Michigan","Missaukee County","A_A",84,51,-33,-48.89,"undercount"
"5154",26113,"Michigan","Missaukee County","A_AIC",119,99,-20,-18.35,"undercount"
"5155",26113,"Michigan","Missaukee County","NHPI_A",2,1,-1,-66.67,"undercount"
"5156",26113,"Michigan","Missaukee County","NHPI_AIC",14,8,-6,-54.55,"undercount"
"5157",26115,"Michigan","Monroe County","A_A",1036,974,-62,-6.17,"undercount"
"5158",26115,"Michigan","Monroe County","A_AIC",1503,1595,92,5.94,"overcount"
"5159",26115,"Michigan","Monroe County","NHPI_A",38,26,-12,-37.5,"undercount"
"5160",26115,"Michigan","Monroe County","NHPI_AIC",111,91,-20,-19.8,"undercount"
"5161",26117,"Michigan","Montcalm County","A_A",255,238,-17,-6.9,"undercount"
"5162",26117,"Michigan","Montcalm County","A_AIC",432,465,33,7.36,"overcount"
"5163",26117,"Michigan","Montcalm County","NHPI_A",18,23,5,24.39,"overcount"
"5164",26117,"Michigan","Montcalm County","NHPI_AIC",54,65,11,18.49,"overcount"
"5165",26119,"Michigan","Montmorency County","A_A",24,26,2,8,"overcount"
"5166",26119,"Michigan","Montmorency County","A_AIC",55,51,-4,-7.55,"undercount"
"5167",26119,"Michigan","Montmorency County","NHPI_A",1,0,-1,-200,"undercount"
"5168",26119,"Michigan","Montmorency County","NHPI_AIC",4,5,1,22.22,"overcount"
"5169",26121,"Michigan","Muskegon County","A_A",1161,1082,-79,-7.04,"undercount"
"5170",26121,"Michigan","Muskegon County","A_AIC",1906,1932,26,1.35,"overcount"
"5171",26121,"Michigan","Muskegon County","NHPI_A",30,37,7,20.9,"overcount"
"5172",26121,"Michigan","Muskegon County","NHPI_AIC",145,187,42,25.3,"overcount"
"5173",26123,"Michigan","Newaygo County","A_A",239,189,-50,-23.36,"undercount"
"5174",26123,"Michigan","Newaygo County","A_AIC",349,346,-3,-0.86,"undercount"
"5175",26123,"Michigan","Newaygo County","NHPI_A",15,14,-1,-6.9,"undercount"
"5176",26123,"Michigan","Newaygo County","NHPI_AIC",39,71,32,58.18,"overcount"
"5177",26125,"Michigan","Oakland County","A_A",103519,106228,2709,2.58,"overcount"
"5178",26125,"Michigan","Oakland County","A_AIC",114209,119332,5123,4.39,"overcount"
"5179",26125,"Michigan","Oakland County","NHPI_A",281,315,34,11.41,"overcount"
"5180",26125,"Michigan","Oakland County","NHPI_AIC",1258,963,-295,-26.56,"undercount"
"5181",26127,"Michigan","Oceana County","A_A",66,69,3,4.44,"overcount"
"5182",26127,"Michigan","Oceana County","A_AIC",118,153,35,25.83,"overcount"
"5183",26127,"Michigan","Oceana County","NHPI_A",4,4,0,0,"equal"
"5184",26127,"Michigan","Oceana County","NHPI_AIC",14,21,7,40,"overcount"
"5185",26129,"Michigan","Ogemaw County","A_A",139,58,-81,-82.23,"undercount"
"5186",26129,"Michigan","Ogemaw County","A_AIC",183,101,-82,-57.75,"undercount"
"5187",26129,"Michigan","Ogemaw County","NHPI_A",6,8,2,28.57,"overcount"
"5188",26129,"Michigan","Ogemaw County","NHPI_AIC",15,19,4,23.53,"overcount"
"5189",26131,"Michigan","Ontonagon County","A_A",34,23,-11,-38.6,"undercount"
"5190",26131,"Michigan","Ontonagon County","A_AIC",54,48,-6,-11.76,"undercount"
"5191",26131,"Michigan","Ontonagon County","NHPI_A",1,2,1,66.67,"overcount"
"5192",26131,"Michigan","Ontonagon County","NHPI_AIC",4,10,6,85.71,"overcount"
"5193",26133,"Michigan","Osceola County","A_A",74,42,-32,-55.17,"undercount"
"5194",26133,"Michigan","Osceola County","A_AIC",148,100,-48,-38.71,"undercount"
"5195",26133,"Michigan","Osceola County","NHPI_A",11,7,-4,-44.44,"undercount"
"5196",26133,"Michigan","Osceola County","NHPI_AIC",24,13,-11,-59.46,"undercount"
"5197",26135,"Michigan","Oscoda County","A_A",18,10,-8,-57.14,"undercount"
"5198",26135,"Michigan","Oscoda County","A_AIC",42,47,5,11.24,"overcount"
"5199",26135,"Michigan","Oscoda County","NHPI_A",3,0,-3,-200,"undercount"
"5200",26135,"Michigan","Oscoda County","NHPI_AIC",5,14,9,94.74,"overcount"
"5201",26137,"Michigan","Otsego County","A_A",169,91,-78,-60,"undercount"
"5202",26137,"Michigan","Otsego County","A_AIC",246,195,-51,-23.13,"undercount"
"5203",26137,"Michigan","Otsego County","NHPI_A",13,1,-12,-171.43,"undercount"
"5204",26137,"Michigan","Otsego County","NHPI_AIC",32,24,-8,-28.57,"undercount"
"5205",26139,"Michigan","Ottawa County","A_A",8213,8004,-209,-2.58,"undercount"
"5206",26139,"Michigan","Ottawa County","A_AIC",10020,10266,246,2.43,"overcount"
"5207",26139,"Michigan","Ottawa County","NHPI_A",98,100,2,2.02,"overcount"
"5208",26139,"Michigan","Ottawa County","NHPI_AIC",257,342,85,28.38,"overcount"
"5209",26141,"Michigan","Presque Isle County","A_A",78,56,-22,-32.84,"undercount"
"5210",26141,"Michigan","Presque Isle County","A_AIC",97,77,-20,-22.99,"undercount"
"5211",26141,"Michigan","Presque Isle County","NHPI_A",1,0,-1,-200,"undercount"
"5212",26141,"Michigan","Presque Isle County","NHPI_AIC",6,16,10,90.91,"overcount"
"5213",26143,"Michigan","Roscommon County","A_A",166,78,-88,-72.13,"undercount"
"5214",26143,"Michigan","Roscommon County","A_AIC",215,134,-81,-46.42,"undercount"
"5215",26143,"Michigan","Roscommon County","NHPI_A",5,10,5,66.67,"overcount"
"5216",26143,"Michigan","Roscommon County","NHPI_AIC",14,36,22,88,"overcount"
"5217",26145,"Michigan","Saginaw County","A_A",2512,2430,-82,-3.32,"undercount"
"5218",26145,"Michigan","Saginaw County","A_AIC",3128,3123,-5,-0.16,"undercount"
"5219",26145,"Michigan","Saginaw County","NHPI_A",64,85,21,28.19,"overcount"
"5220",26145,"Michigan","Saginaw County","NHPI_AIC",188,171,-17,-9.47,"undercount"
"5221",26147,"Michigan","St. Clair County","A_A",907,814,-93,-10.81,"undercount"
"5222",26147,"Michigan","St. Clair County","A_AIC",1444,1403,-41,-2.88,"undercount"
"5223",26147,"Michigan","St. Clair County","NHPI_A",43,13,-30,-107.14,"undercount"
"5224",26147,"Michigan","St. Clair County","NHPI_AIC",124,87,-37,-35.07,"undercount"
"5225",26149,"Michigan","St. Joseph County","A_A",394,421,27,6.63,"overcount"
"5226",26149,"Michigan","St. Joseph County","A_AIC",634,671,37,5.67,"overcount"
"5227",26149,"Michigan","St. Joseph County","NHPI_A",4,9,5,76.92,"overcount"
"5228",26149,"Michigan","St. Joseph County","NHPI_AIC",39,45,6,14.29,"overcount"
"5229",26151,"Michigan","Sanilac County","A_A",132,86,-46,-42.2,"undercount"
"5230",26151,"Michigan","Sanilac County","A_AIC",215,187,-28,-13.93,"undercount"
"5231",26151,"Michigan","Sanilac County","NHPI_A",13,2,-11,-146.67,"undercount"
"5232",26151,"Michigan","Sanilac County","NHPI_AIC",26,30,4,14.29,"overcount"
"5233",26153,"Michigan","Schoolcraft County","A_A",21,15,-6,-33.33,"undercount"
"5234",26153,"Michigan","Schoolcraft County","A_AIC",43,42,-1,-2.35,"undercount"
"5235",26153,"Michigan","Schoolcraft County","NHPI_A",0,1,1,200,"overcount"
"5236",26153,"Michigan","Schoolcraft County","NHPI_AIC",4,11,7,93.33,"overcount"
"5237",26155,"Michigan","Shiawassee County","A_A",352,292,-60,-18.63,"undercount"
"5238",26155,"Michigan","Shiawassee County","A_AIC",544,515,-29,-5.48,"undercount"
"5239",26155,"Michigan","Shiawassee County","NHPI_A",32,20,-12,-46.15,"undercount"
"5240",26155,"Michigan","Shiawassee County","NHPI_AIC",57,72,15,23.26,"overcount"
"5241",26157,"Michigan","Tuscola County","A_A",180,162,-18,-10.53,"undercount"
"5242",26157,"Michigan","Tuscola County","A_AIC",275,249,-26,-9.92,"undercount"
"5243",26157,"Michigan","Tuscola County","NHPI_A",19,12,-7,-45.16,"undercount"
"5244",26157,"Michigan","Tuscola County","NHPI_AIC",44,26,-18,-51.43,"undercount"
"5245",26159,"Michigan","Van Buren County","A_A",466,395,-71,-16.49,"undercount"
"5246",26159,"Michigan","Van Buren County","A_AIC",778,714,-64,-8.58,"undercount"
"5247",26159,"Michigan","Van Buren County","NHPI_A",22,27,5,20.41,"overcount"
"5248",26159,"Michigan","Van Buren County","NHPI_AIC",89,86,-3,-3.43,"undercount"
"5249",26161,"Michigan","Washtenaw County","A_A",33881,33788,-93,-0.27,"undercount"
"5250",26161,"Michigan","Washtenaw County","A_AIC",38900,40433,1533,3.86,"overcount"
"5251",26161,"Michigan","Washtenaw County","NHPI_A",146,188,42,25.15,"overcount"
"5252",26161,"Michigan","Washtenaw County","NHPI_AIC",478,569,91,17.38,"overcount"
"5253",26163,"Michigan","Wayne County","A_A",61487,65176,3689,5.82,"overcount"
"5254",26163,"Michigan","Wayne County","A_AIC",75526,78875,3349,4.34,"overcount"
"5255",26163,"Michigan","Wayne County","NHPI_A",186,346,160,60.15,"overcount"
"5256",26163,"Michigan","Wayne County","NHPI_AIC",1595,1649,54,3.33,"overcount"
"5257",26165,"Michigan","Wexford County","A_A",235,186,-49,-23.28,"undercount"
"5258",26165,"Michigan","Wexford County","A_AIC",343,342,-1,-0.29,"undercount"
"5259",26165,"Michigan","Wexford County","NHPI_A",24,1,-23,-184,"undercount"
"5260",26165,"Michigan","Wexford County","NHPI_AIC",35,18,-17,-64.15,"undercount"
"5261",27001,"Minnesota","Aitkin County","A_A",45,38,-7,-16.87,"undercount"
"5262",27001,"Minnesota","Aitkin County","A_AIC",97,83,-14,-15.56,"undercount"
"5263",27001,"Minnesota","Aitkin County","NHPI_A",5,3,-2,-50,"undercount"
"5264",27001,"Minnesota","Aitkin County","NHPI_AIC",11,12,1,8.7,"overcount"
"5265",27003,"Minnesota","Anoka County","A_A",19126,19341,215,1.12,"overcount"
"5266",27003,"Minnesota","Anoka County","A_AIC",22397,23338,941,4.12,"overcount"
"5267",27003,"Minnesota","Anoka County","NHPI_A",177,112,-65,-44.98,"undercount"
"5268",27003,"Minnesota","Anoka County","NHPI_AIC",430,465,35,7.82,"overcount"
"5269",27005,"Minnesota","Becker County","A_A",181,168,-13,-7.45,"undercount"
"5270",27005,"Minnesota","Becker County","A_AIC",325,300,-25,-8,"undercount"
"5271",27005,"Minnesota","Becker County","NHPI_A",19,9,-10,-71.43,"undercount"
"5272",27005,"Minnesota","Becker County","NHPI_AIC",35,38,3,8.22,"overcount"
"5273",27007,"Minnesota","Beltrami County","A_A",351,276,-75,-23.92,"undercount"
"5274",27007,"Minnesota","Beltrami County","A_AIC",595,542,-53,-9.32,"undercount"
"5275",27007,"Minnesota","Beltrami County","NHPI_A",27,15,-12,-57.14,"undercount"
"5276",27007,"Minnesota","Beltrami County","NHPI_AIC",64,52,-12,-20.69,"undercount"
"5277",27009,"Minnesota","Benton County","A_A",453,463,10,2.18,"overcount"
"5278",27009,"Minnesota","Benton County","A_AIC",697,748,51,7.06,"overcount"
"5279",27009,"Minnesota","Benton County","NHPI_A",25,9,-16,-94.12,"undercount"
"5280",27009,"Minnesota","Benton County","NHPI_AIC",54,30,-24,-57.14,"undercount"
"5281",27011,"Minnesota","Big Stone County","A_A",18,12,-6,-40,"undercount"
"5282",27011,"Minnesota","Big Stone County","A_AIC",30,23,-7,-26.42,"undercount"
"5283",27011,"Minnesota","Big Stone County","NHPI_A",0,4,4,200,"overcount"
"5284",27011,"Minnesota","Big Stone County","NHPI_AIC",3,13,10,125,"overcount"
"5285",27013,"Minnesota","Blue Earth County","A_A",1659,1851,192,10.94,"overcount"
"5286",27013,"Minnesota","Blue Earth County","A_AIC",2150,2445,295,12.84,"overcount"
"5287",27013,"Minnesota","Blue Earth County","NHPI_A",41,26,-15,-44.78,"undercount"
"5288",27013,"Minnesota","Blue Earth County","NHPI_AIC",87,97,10,10.87,"overcount"
"5289",27015,"Minnesota","Brown County","A_A",193,128,-65,-40.5,"undercount"
"5290",27015,"Minnesota","Brown County","A_AIC",259,192,-67,-29.71,"undercount"
"5291",27015,"Minnesota","Brown County","NHPI_A",4,6,2,40,"overcount"
"5292",27015,"Minnesota","Brown County","NHPI_AIC",15,11,-4,-30.77,"undercount"
"5293",27017,"Minnesota","Carlton County","A_A",202,153,-49,-27.61,"undercount"
"5294",27017,"Minnesota","Carlton County","A_AIC",351,346,-5,-1.43,"undercount"
"5295",27017,"Minnesota","Carlton County","NHPI_A",3,12,9,120,"overcount"
"5296",27017,"Minnesota","Carlton County","NHPI_AIC",27,69,42,87.5,"overcount"
"5297",27019,"Minnesota","Carver County","A_A",3684,3645,-39,-1.06,"undercount"
"5298",27019,"Minnesota","Carver County","A_AIC",4544,4824,280,5.98,"overcount"
"5299",27019,"Minnesota","Carver County","NHPI_A",32,15,-17,-72.34,"undercount"
"5300",27019,"Minnesota","Carver County","NHPI_AIC",90,100,10,10.53,"overcount"
"5301",27021,"Minnesota","Cass County","A_A",130,111,-19,-15.77,"undercount"
"5302",27021,"Minnesota","Cass County","A_AIC",280,206,-74,-30.45,"undercount"
"5303",27021,"Minnesota","Cass County","NHPI_A",4,0,-4,-200,"undercount"
"5304",27021,"Minnesota","Cass County","NHPI_AIC",28,15,-13,-60.47,"undercount"
"5305",27023,"Minnesota","Chippewa County","A_A",133,44,-89,-100.56,"undercount"
"5306",27023,"Minnesota","Chippewa County","A_AIC",189,85,-104,-75.91,"undercount"
"5307",27023,"Minnesota","Chippewa County","NHPI_A",179,296,117,49.26,"overcount"
"5308",27023,"Minnesota","Chippewa County","NHPI_AIC",187,297,110,45.45,"overcount"
"5309",27025,"Minnesota","Chisago County","A_A",800,787,-13,-1.64,"undercount"
"5310",27025,"Minnesota","Chisago County","A_AIC",1054,1142,88,8.01,"overcount"
"5311",27025,"Minnesota","Chisago County","NHPI_A",16,3,-13,-136.84,"undercount"
"5312",27025,"Minnesota","Chisago County","NHPI_AIC",47,75,28,45.9,"overcount"
"5313",27027,"Minnesota","Clay County","A_A",902,764,-138,-16.57,"undercount"
"5314",27027,"Minnesota","Clay County","A_AIC",1366,1214,-152,-11.78,"undercount"
"5315",27027,"Minnesota","Clay County","NHPI_A",34,18,-16,-61.54,"undercount"
"5316",27027,"Minnesota","Clay County","NHPI_AIC",77,91,14,16.67,"overcount"
"5317",27029,"Minnesota","Clearwater County","A_A",28,24,-4,-15.38,"undercount"
"5318",27029,"Minnesota","Clearwater County","A_AIC",89,50,-39,-56.12,"undercount"
"5319",27029,"Minnesota","Clearwater County","NHPI_A",2,2,0,0,"equal"
"5320",27029,"Minnesota","Clearwater County","NHPI_AIC",8,15,7,60.87,"overcount"
"5321",27031,"Minnesota","Cook County","A_A",59,48,-11,-20.56,"undercount"
"5322",27031,"Minnesota","Cook County","A_AIC",87,71,-16,-20.25,"undercount"
"5323",27031,"Minnesota","Cook County","NHPI_A",2,1,-1,-66.67,"undercount"
"5324",27031,"Minnesota","Cook County","NHPI_AIC",6,10,4,50,"overcount"
"5325",27033,"Minnesota","Cottonwood County","A_A",415,361,-54,-13.92,"undercount"
"5326",27033,"Minnesota","Cottonwood County","A_AIC",478,472,-6,-1.26,"undercount"
"5327",27033,"Minnesota","Cottonwood County","NHPI_A",37,80,43,73.5,"overcount"
"5328",27033,"Minnesota","Cottonwood County","NHPI_AIC",42,103,61,84.14,"overcount"
"5329",27035,"Minnesota","Crow Wing County","A_A",325,336,11,3.33,"overcount"
"5330",27035,"Minnesota","Crow Wing County","A_AIC",563,634,71,11.86,"overcount"
"5331",27035,"Minnesota","Crow Wing County","NHPI_A",19,19,0,0,"equal"
"5332",27035,"Minnesota","Crow Wing County","NHPI_AIC",50,65,15,26.09,"overcount"
"5333",27037,"Minnesota","Dakota County","A_A",23132,24301,1169,4.93,"overcount"
"5334",27037,"Minnesota","Dakota County","A_AIC",27093,29578,2485,8.77,"overcount"
"5335",27037,"Minnesota","Dakota County","NHPI_A",290,209,-81,-32.46,"undercount"
"5336",27037,"Minnesota","Dakota County","NHPI_AIC",713,680,-33,-4.74,"undercount"
"5337",27039,"Minnesota","Dodge County","A_A",169,104,-65,-47.62,"undercount"
"5338",27039,"Minnesota","Dodge County","A_AIC",295,253,-42,-15.33,"undercount"
"5339",27039,"Minnesota","Dodge County","NHPI_A",6,1,-5,-142.86,"undercount"
"5340",27039,"Minnesota","Dodge County","NHPI_AIC",29,18,-11,-46.81,"undercount"
"5341",27041,"Minnesota","Douglas County","A_A",231,227,-4,-1.75,"undercount"
"5342",27041,"Minnesota","Douglas County","A_AIC",337,379,42,11.73,"overcount"
"5343",27041,"Minnesota","Douglas County","NHPI_A",5,11,6,75,"overcount"
"5344",27041,"Minnesota","Douglas County","NHPI_AIC",23,36,13,44.07,"overcount"
"5345",27043,"Minnesota","Faribault County","A_A",51,49,-2,-4,"undercount"
"5346",27043,"Minnesota","Faribault County","A_AIC",95,93,-2,-2.13,"undercount"
"5347",27043,"Minnesota","Faribault County","NHPI_A",1,0,-1,-200,"undercount"
"5348",27043,"Minnesota","Faribault County","NHPI_AIC",14,5,-9,-94.74,"undercount"
"5349",27045,"Minnesota","Fillmore County","A_A",138,71,-67,-64.11,"undercount"
"5350",27045,"Minnesota","Fillmore County","A_AIC",192,148,-44,-25.88,"undercount"
"5351",27045,"Minnesota","Fillmore County","NHPI_A",3,2,-1,-40,"undercount"
"5352",27045,"Minnesota","Fillmore County","NHPI_AIC",7,10,3,35.29,"overcount"
"5353",27047,"Minnesota","Freeborn County","A_A",983,1135,152,14.35,"overcount"
"5354",27047,"Minnesota","Freeborn County","A_AIC",1127,1273,146,12.17,"overcount"
"5355",27047,"Minnesota","Freeborn County","NHPI_A",27,5,-22,-137.5,"undercount"
"5356",27047,"Minnesota","Freeborn County","NHPI_AIC",43,16,-27,-91.53,"undercount"
"5357",27049,"Minnesota","Goodhue County","A_A",327,352,25,7.36,"overcount"
"5358",27049,"Minnesota","Goodhue County","A_AIC",520,555,35,6.51,"overcount"
"5359",27049,"Minnesota","Goodhue County","NHPI_A",26,56,30,73.17,"overcount"
"5360",27049,"Minnesota","Goodhue County","NHPI_AIC",58,85,27,37.76,"overcount"
"5361",27051,"Minnesota","Grant County","A_A",22,14,-8,-44.44,"undercount"
"5362",27051,"Minnesota","Grant County","A_AIC",36,44,8,20,"overcount"
"5363",27051,"Minnesota","Grant County","NHPI_A",2,9,7,127.27,"overcount"
"5364",27051,"Minnesota","Grant County","NHPI_AIC",6,21,15,111.11,"overcount"
"5365",27053,"Minnesota","Hennepin County","A_A",95801,98206,2405,2.48,"overcount"
"5366",27053,"Minnesota","Hennepin County","A_AIC",107703,115276,7573,6.79,"overcount"
"5367",27053,"Minnesota","Hennepin County","NHPI_A",508,508,0,0,"equal"
"5368",27053,"Minnesota","Hennepin County","NHPI_AIC",1793,1825,32,1.77,"overcount"
"5369",27055,"Minnesota","Houston County","A_A",169,101,-68,-50.37,"undercount"
"5370",27055,"Minnesota","Houston County","A_AIC",233,180,-53,-25.67,"undercount"
"5371",27055,"Minnesota","Houston County","NHPI_A",4,4,0,0,"equal"
"5372",27055,"Minnesota","Houston County","NHPI_AIC",16,15,-1,-6.45,"undercount"
"5373",27057,"Minnesota","Hubbard County","A_A",111,70,-41,-45.3,"undercount"
"5374",27057,"Minnesota","Hubbard County","A_AIC",165,177,12,7.02,"overcount"
"5375",27057,"Minnesota","Hubbard County","NHPI_A",10,31,21,102.44,"overcount"
"5376",27057,"Minnesota","Hubbard County","NHPI_AIC",28,57,29,68.24,"overcount"
"5377",27059,"Minnesota","Isanti County","A_A",569,488,-81,-15.33,"undercount"
"5378",27059,"Minnesota","Isanti County","A_AIC",807,721,-86,-11.26,"undercount"
"5379",27059,"Minnesota","Isanti County","NHPI_A",16,13,-3,-20.69,"undercount"
"5380",27059,"Minnesota","Isanti County","NHPI_AIC",44,40,-4,-9.52,"undercount"
"5381",27061,"Minnesota","Itasca County","A_A",159,148,-11,-7.17,"undercount"
"5382",27061,"Minnesota","Itasca County","A_AIC",324,344,20,5.99,"overcount"
"5383",27061,"Minnesota","Itasca County","NHPI_A",22,2,-20,-166.67,"undercount"
"5384",27061,"Minnesota","Itasca County","NHPI_AIC",57,38,-19,-40,"undercount"
"5385",27063,"Minnesota","Jackson County","A_A",149,125,-24,-17.52,"undercount"
"5386",27063,"Minnesota","Jackson County","A_AIC",194,208,14,6.97,"overcount"
"5387",27063,"Minnesota","Jackson County","NHPI_A",0,0,0,0,"equal"
"5388",27063,"Minnesota","Jackson County","NHPI_AIC",7,2,-5,-111.11,"undercount"
"5389",27065,"Minnesota","Kanabec County","A_A",113,80,-33,-34.2,"undercount"
"5390",27065,"Minnesota","Kanabec County","A_AIC",174,148,-26,-16.15,"undercount"
"5391",27065,"Minnesota","Kanabec County","NHPI_A",5,0,-5,-200,"undercount"
"5392",27065,"Minnesota","Kanabec County","NHPI_AIC",16,7,-9,-78.26,"undercount"
"5393",27067,"Minnesota","Kandiyohi County","A_A",505,586,81,14.85,"overcount"
"5394",27067,"Minnesota","Kandiyohi County","A_AIC",639,723,84,12.33,"overcount"
"5395",27067,"Minnesota","Kandiyohi County","NHPI_A",52,37,-15,-33.71,"undercount"
"5396",27067,"Minnesota","Kandiyohi County","NHPI_AIC",63,68,5,7.63,"overcount"
"5397",27069,"Minnesota","Kittson County","A_A",25,18,-7,-32.56,"undercount"
"5398",27069,"Minnesota","Kittson County","A_AIC",38,39,1,2.6,"overcount"
"5399",27069,"Minnesota","Kittson County","NHPI_A",0,6,6,200,"overcount"
"5400",27069,"Minnesota","Kittson County","NHPI_AIC",1,14,13,173.33,"overcount"
"5401",27071,"Minnesota","Koochiching County","A_A",77,34,-43,-77.48,"undercount"
"5402",27071,"Minnesota","Koochiching County","A_AIC",113,69,-44,-48.35,"undercount"
"5403",27071,"Minnesota","Koochiching County","NHPI_A",1,12,11,169.23,"overcount"
"5404",27071,"Minnesota","Koochiching County","NHPI_AIC",11,17,6,42.86,"overcount"
"5405",27073,"Minnesota","Lac qui Parle County","A_A",55,40,-15,-31.58,"undercount"
"5406",27073,"Minnesota","Lac qui Parle County","A_AIC",71,65,-6,-8.82,"undercount"
"5407",27073,"Minnesota","Lac qui Parle County","NHPI_A",4,1,-3,-120,"undercount"
"5408",27073,"Minnesota","Lac qui Parle County","NHPI_AIC",7,7,0,0,"equal"
"5409",27075,"Minnesota","Lake County","A_A",57,55,-2,-3.57,"undercount"
"5410",27075,"Minnesota","Lake County","A_AIC",88,88,0,0,"equal"
"5411",27075,"Minnesota","Lake County","NHPI_A",3,0,-3,-200,"undercount"
"5412",27075,"Minnesota","Lake County","NHPI_AIC",14,11,-3,-24,"undercount"
"5413",27077,"Minnesota","Lake of the Woods County","A_A",62,17,-45,-113.92,"undercount"
"5414",27077,"Minnesota","Lake of the Woods County","A_AIC",82,57,-25,-35.97,"undercount"
"5415",27077,"Minnesota","Lake of the Woods County","NHPI_A",0,0,0,0,"equal"
"5416",27077,"Minnesota","Lake of the Woods County","NHPI_AIC",3,8,5,90.91,"overcount"
"5417",27079,"Minnesota","Le Sueur County","A_A",170,148,-22,-13.84,"undercount"
"5418",27079,"Minnesota","Le Sueur County","A_AIC",293,290,-3,-1.03,"undercount"
"5419",27079,"Minnesota","Le Sueur County","NHPI_A",9,20,11,75.86,"overcount"
"5420",27079,"Minnesota","Le Sueur County","NHPI_AIC",20,34,14,51.85,"overcount"
"5421",27081,"Minnesota","Lincoln County","A_A",34,22,-12,-42.86,"undercount"
"5422",27081,"Minnesota","Lincoln County","A_AIC",48,52,4,8,"overcount"
"5423",27081,"Minnesota","Lincoln County","NHPI_A",0,0,0,0,"equal"
"5424",27081,"Minnesota","Lincoln County","NHPI_AIC",4,4,0,0,"equal"
"5425",27083,"Minnesota","Lyon County","A_A",1248,1263,15,1.19,"overcount"
"5426",27083,"Minnesota","Lyon County","A_AIC",1337,1371,34,2.51,"overcount"
"5427",27083,"Minnesota","Lyon County","NHPI_A",11,3,-8,-114.29,"undercount"
"5428",27083,"Minnesota","Lyon County","NHPI_AIC",27,21,-6,-25,"undercount"
"5429",27085,"Minnesota","McLeod County","A_A",264,232,-32,-12.9,"undercount"
"5430",27085,"Minnesota","McLeod County","A_AIC",381,400,19,4.87,"overcount"
"5431",27085,"Minnesota","McLeod County","NHPI_A",27,27,0,0,"equal"
"5432",27085,"Minnesota","McLeod County","NHPI_AIC",45,46,1,2.2,"overcount"
"5433",27087,"Minnesota","Mahnomen County","A_A",5,8,3,46.15,"overcount"
"5434",27087,"Minnesota","Mahnomen County","A_AIC",31,14,-17,-75.56,"undercount"
"5435",27087,"Minnesota","Mahnomen County","NHPI_A",3,0,-3,-200,"undercount"
"5436",27087,"Minnesota","Mahnomen County","NHPI_AIC",14,2,-12,-150,"undercount"
"5437",27089,"Minnesota","Marshall County","A_A",22,19,-3,-14.63,"undercount"
"5438",27089,"Minnesota","Marshall County","A_AIC",42,44,2,4.65,"overcount"
"5439",27089,"Minnesota","Marshall County","NHPI_A",0,0,0,0,"equal"
"5440",27089,"Minnesota","Marshall County","NHPI_AIC",8,10,2,22.22,"overcount"
"5441",27091,"Minnesota","Martin County","A_A",125,92,-33,-30.41,"undercount"
"5442",27091,"Minnesota","Martin County","A_AIC",173,184,11,6.16,"overcount"
"5443",27091,"Minnesota","Martin County","NHPI_A",27,6,-21,-127.27,"undercount"
"5444",27091,"Minnesota","Martin County","NHPI_AIC",38,19,-19,-66.67,"undercount"
"5445",27093,"Minnesota","Meeker County","A_A",92,64,-28,-35.9,"undercount"
"5446",27093,"Minnesota","Meeker County","A_AIC",139,107,-32,-26.02,"undercount"
"5447",27093,"Minnesota","Meeker County","NHPI_A",9,2,-7,-127.27,"undercount"
"5448",27093,"Minnesota","Meeker County","NHPI_AIC",15,24,9,46.15,"overcount"
"5449",27095,"Minnesota","Mille Lacs County","A_A",184,128,-56,-35.9,"undercount"
"5450",27095,"Minnesota","Mille Lacs County","A_AIC",279,263,-16,-5.9,"undercount"
"5451",27095,"Minnesota","Mille Lacs County","NHPI_A",5,6,1,18.18,"overcount"
"5452",27095,"Minnesota","Mille Lacs County","NHPI_AIC",16,21,5,27.03,"overcount"
"5453",27097,"Minnesota","Morrison County","A_A",110,102,-8,-7.55,"undercount"
"5454",27097,"Minnesota","Morrison County","A_AIC",203,185,-18,-9.28,"undercount"
"5455",27097,"Minnesota","Morrison County","NHPI_A",11,5,-6,-75,"undercount"
"5456",27097,"Minnesota","Morrison County","NHPI_AIC",33,12,-21,-93.33,"undercount"
"5457",27099,"Minnesota","Mower County","A_A",2167,2071,-96,-4.53,"undercount"
"5458",27099,"Minnesota","Mower County","A_AIC",2393,2244,-149,-6.43,"undercount"
"5459",27099,"Minnesota","Mower County","NHPI_A",179,261,82,37.27,"overcount"
"5460",27099,"Minnesota","Mower County","NHPI_AIC",211,289,78,31.2,"overcount"
"5461",27101,"Minnesota","Murray County","A_A",147,108,-39,-30.59,"undercount"
"5462",27101,"Minnesota","Murray County","A_AIC",167,124,-43,-29.55,"undercount"
"5463",27101,"Minnesota","Murray County","NHPI_A",16,4,-12,-120,"undercount"
"5464",27101,"Minnesota","Murray County","NHPI_AIC",20,7,-13,-96.3,"undercount"
"5465",27103,"Minnesota","Nicollet County","A_A",542,560,18,3.27,"overcount"
"5466",27103,"Minnesota","Nicollet County","A_AIC",754,719,-35,-4.75,"undercount"
"5467",27103,"Minnesota","Nicollet County","NHPI_A",5,11,6,75,"overcount"
"5468",27103,"Minnesota","Nicollet County","NHPI_AIC",30,29,-1,-3.39,"undercount"
"5469",27105,"Minnesota","Nobles County","A_A",1504,1329,-175,-12.35,"undercount"
"5470",27105,"Minnesota","Nobles County","A_AIC",1612,1481,-131,-8.47,"undercount"
"5471",27105,"Minnesota","Nobles County","NHPI_A",13,41,28,103.7,"overcount"
"5472",27105,"Minnesota","Nobles County","NHPI_AIC",25,56,31,76.54,"overcount"
"5473",27107,"Minnesota","Norman County","A_A",33,18,-15,-58.82,"undercount"
"5474",27107,"Minnesota","Norman County","A_AIC",68,45,-23,-40.71,"undercount"
"5475",27107,"Minnesota","Norman County","NHPI_A",1,0,-1,-200,"undercount"
"5476",27107,"Minnesota","Norman County","NHPI_AIC",3,12,9,120,"overcount"
"5477",27109,"Minnesota","Olmsted County","A_A",10367,10276,-91,-0.88,"undercount"
"5478",27109,"Minnesota","Olmsted County","A_AIC",12091,12384,293,2.39,"overcount"
"5479",27109,"Minnesota","Olmsted County","NHPI_A",89,70,-19,-23.9,"undercount"
"5480",27109,"Minnesota","Olmsted County","NHPI_AIC",216,201,-15,-7.19,"undercount"
"5481",27111,"Minnesota","Otter Tail County","A_A",336,349,13,3.8,"overcount"
"5482",27111,"Minnesota","Otter Tail County","A_AIC",563,608,45,7.69,"overcount"
"5483",27111,"Minnesota","Otter Tail County","NHPI_A",32,17,-15,-61.22,"undercount"
"5484",27111,"Minnesota","Otter Tail County","NHPI_AIC",67,54,-13,-21.49,"undercount"
"5485",27113,"Minnesota","Pennington County","A_A",139,121,-18,-13.85,"undercount"
"5486",27113,"Minnesota","Pennington County","A_AIC",203,194,-9,-4.53,"undercount"
"5487",27113,"Minnesota","Pennington County","NHPI_A",1,6,5,142.86,"overcount"
"5488",27113,"Minnesota","Pennington County","NHPI_AIC",11,25,14,77.78,"overcount"
"5489",27115,"Minnesota","Pine County","A_A",239,264,25,9.94,"overcount"
"5490",27115,"Minnesota","Pine County","A_AIC",356,383,27,7.31,"overcount"
"5491",27115,"Minnesota","Pine County","NHPI_A",7,2,-5,-111.11,"undercount"
"5492",27115,"Minnesota","Pine County","NHPI_AIC",39,36,-3,-8,"undercount"
"5493",27117,"Minnesota","Pipestone County","A_A",81,67,-14,-18.92,"undercount"
"5494",27117,"Minnesota","Pipestone County","A_AIC",118,93,-25,-23.7,"undercount"
"5495",27117,"Minnesota","Pipestone County","NHPI_A",0,0,0,0,"equal"
"5496",27117,"Minnesota","Pipestone County","NHPI_AIC",6,7,1,15.38,"overcount"
"5497",27119,"Minnesota","Polk County","A_A",254,161,-93,-44.82,"undercount"
"5498",27119,"Minnesota","Polk County","A_AIC",386,328,-58,-16.25,"undercount"
"5499",27119,"Minnesota","Polk County","NHPI_A",14,4,-10,-111.11,"undercount"
"5500",27119,"Minnesota","Polk County","NHPI_AIC",43,43,0,0,"equal"
"5501",27121,"Minnesota","Pope County","A_A",76,53,-23,-35.66,"undercount"
"5502",27121,"Minnesota","Pope County","A_AIC",97,83,-14,-15.56,"undercount"
"5503",27121,"Minnesota","Pope County","NHPI_A",2,0,-2,-200,"undercount"
"5504",27121,"Minnesota","Pope County","NHPI_AIC",11,4,-7,-93.33,"undercount"
"5505",27123,"Minnesota","Ramsey County","A_A",84847,86147,1300,1.52,"overcount"
"5506",27123,"Minnesota","Ramsey County","A_AIC",90002,92826,2824,3.09,"overcount"
"5507",27123,"Minnesota","Ramsey County","NHPI_A",257,216,-41,-17.34,"undercount"
"5508",27123,"Minnesota","Ramsey County","NHPI_AIC",910,923,13,1.42,"overcount"
"5509",27125,"Minnesota","Red Lake County","A_A",13,6,-7,-73.68,"undercount"
"5510",27125,"Minnesota","Red Lake County","A_AIC",25,27,2,7.69,"overcount"
"5511",27125,"Minnesota","Red Lake County","NHPI_A",0,3,3,200,"overcount"
"5512",27125,"Minnesota","Red Lake County","NHPI_AIC",0,7,7,200,"overcount"
"5513",27127,"Minnesota","Redwood County","A_A",404,420,16,3.88,"overcount"
"5514",27127,"Minnesota","Redwood County","A_AIC",482,510,28,5.65,"overcount"
"5515",27127,"Minnesota","Redwood County","NHPI_A",9,1,-8,-160,"undercount"
"5516",27127,"Minnesota","Redwood County","NHPI_AIC",23,27,4,16,"overcount"
"5517",27129,"Minnesota","Renville County","A_A",112,61,-51,-58.96,"undercount"
"5518",27129,"Minnesota","Renville County","A_AIC",154,133,-21,-14.63,"undercount"
"5519",27129,"Minnesota","Renville County","NHPI_A",3,5,2,50,"overcount"
"5520",27129,"Minnesota","Renville County","NHPI_AIC",12,15,3,22.22,"overcount"
"5521",27131,"Minnesota","Rice County","A_A",1413,1611,198,13.1,"overcount"
"5522",27131,"Minnesota","Rice County","A_AIC",1910,2074,164,8.23,"overcount"
"5523",27131,"Minnesota","Rice County","NHPI_A",54,12,-42,-127.27,"undercount"
"5524",27131,"Minnesota","Rice County","NHPI_AIC",99,118,19,17.51,"overcount"
"5525",27133,"Minnesota","Rock County","A_A",65,63,-2,-3.12,"undercount"
"5526",27133,"Minnesota","Rock County","A_AIC",112,109,-3,-2.71,"undercount"
"5527",27133,"Minnesota","Rock County","NHPI_A",1,10,9,163.64,"overcount"
"5528",27133,"Minnesota","Rock County","NHPI_AIC",7,23,16,106.67,"overcount"
"5529",27135,"Minnesota","Roseau County","A_A",423,403,-20,-4.84,"undercount"
"5530",27135,"Minnesota","Roseau County","A_AIC",511,494,-17,-3.38,"undercount"
"5531",27135,"Minnesota","Roseau County","NHPI_A",4,10,6,85.71,"overcount"
"5532",27135,"Minnesota","Roseau County","NHPI_AIC",15,24,9,46.15,"overcount"
"5533",27137,"Minnesota","St. Louis County","A_A",2204,1917,-287,-13.93,"undercount"
"5534",27137,"Minnesota","St. Louis County","A_AIC",3201,3123,-78,-2.47,"undercount"
"5535",27137,"Minnesota","St. Louis County","NHPI_A",87,60,-27,-36.73,"undercount"
"5536",27137,"Minnesota","St. Louis County","NHPI_AIC",221,270,49,19.96,"overcount"
"5537",27139,"Minnesota","Scott County","A_A",9824,10068,244,2.45,"overcount"
"5538",27139,"Minnesota","Scott County","A_AIC",11295,11837,542,4.69,"overcount"
"5539",27139,"Minnesota","Scott County","NHPI_A",111,69,-42,-46.67,"undercount"
"5540",27139,"Minnesota","Scott County","NHPI_AIC",242,233,-9,-3.79,"undercount"
"5541",27141,"Minnesota","Sherburne County","A_A",1398,1295,-103,-7.65,"undercount"
"5542",27141,"Minnesota","Sherburne County","A_AIC",2022,2051,29,1.42,"overcount"
"5543",27141,"Minnesota","Sherburne County","NHPI_A",38,25,-13,-41.27,"undercount"
"5544",27141,"Minnesota","Sherburne County","NHPI_AIC",105,139,34,27.87,"overcount"
"5545",27143,"Minnesota","Sibley County","A_A",107,76,-31,-33.88,"undercount"
"5546",27143,"Minnesota","Sibley County","A_AIC",155,127,-28,-19.86,"undercount"
"5547",27143,"Minnesota","Sibley County","NHPI_A",4,10,6,85.71,"overcount"
"5548",27143,"Minnesota","Sibley County","NHPI_AIC",10,13,3,26.09,"overcount"
"5549",27145,"Minnesota","Stearns County","A_A",3695,3178,-517,-15.04,"undercount"
"5550",27145,"Minnesota","Stearns County","A_AIC",4672,4088,-584,-13.33,"undercount"
"5551",27145,"Minnesota","Stearns County","NHPI_A",140,67,-73,-70.53,"undercount"
"5552",27145,"Minnesota","Stearns County","NHPI_AIC",237,198,-39,-17.93,"undercount"
"5553",27147,"Minnesota","Steele County","A_A",359,340,-19,-5.44,"undercount"
"5554",27147,"Minnesota","Steele County","A_AIC",500,531,31,6.01,"overcount"
"5555",27147,"Minnesota","Steele County","NHPI_A",18,18,0,0,"equal"
"5556",27147,"Minnesota","Steele County","NHPI_AIC",26,50,24,63.16,"overcount"
"5557",27149,"Minnesota","Stevens County","A_A",192,68,-124,-95.38,"undercount"
"5558",27149,"Minnesota","Stevens County","A_AIC",241,122,-119,-65.56,"undercount"
"5559",27149,"Minnesota","Stevens County","NHPI_A",1,1,0,0,"equal"
"5560",27149,"Minnesota","Stevens County","NHPI_AIC",4,4,0,0,"equal"
"5561",27151,"Minnesota","Swift County","A_A",68,78,10,13.7,"overcount"
"5562",27151,"Minnesota","Swift County","A_AIC",88,114,26,25.74,"overcount"
"5563",27151,"Minnesota","Swift County","NHPI_A",102,133,31,26.38,"overcount"
"5564",27151,"Minnesota","Swift County","NHPI_AIC",105,137,32,26.45,"overcount"
"5565",27153,"Minnesota","Todd County","A_A",111,97,-14,-13.46,"undercount"
"5566",27153,"Minnesota","Todd County","A_AIC",185,168,-17,-9.63,"undercount"
"5567",27153,"Minnesota","Todd County","NHPI_A",57,83,26,37.14,"overcount"
"5568",27153,"Minnesota","Todd County","NHPI_AIC",69,95,26,31.71,"overcount"
"5569",27155,"Minnesota","Traverse County","A_A",17,0,-17,-200,"undercount"
"5570",27155,"Minnesota","Traverse County","A_AIC",32,27,-5,-16.95,"undercount"
"5571",27155,"Minnesota","Traverse County","NHPI_A",2,0,-2,-200,"undercount"
"5572",27155,"Minnesota","Traverse County","NHPI_AIC",4,5,1,22.22,"overcount"
"5573",27157,"Minnesota","Wabasha County","A_A",134,97,-37,-32.03,"undercount"
"5574",27157,"Minnesota","Wabasha County","A_AIC",199,176,-23,-12.27,"undercount"
"5575",27157,"Minnesota","Wabasha County","NHPI_A",3,6,3,66.67,"overcount"
"5576",27157,"Minnesota","Wabasha County","NHPI_AIC",12,22,10,58.82,"overcount"
"5577",27159,"Minnesota","Wadena County","A_A",73,54,-19,-29.92,"undercount"
"5578",27159,"Minnesota","Wadena County","A_AIC",121,67,-54,-57.45,"undercount"
"5579",27159,"Minnesota","Wadena County","NHPI_A",1,9,8,160,"overcount"
"5580",27159,"Minnesota","Wadena County","NHPI_AIC",10,11,1,9.52,"overcount"
"5581",27161,"Minnesota","Waseca County","A_A",149,116,-33,-24.91,"undercount"
"5582",27161,"Minnesota","Waseca County","A_AIC",202,183,-19,-9.87,"undercount"
"5583",27161,"Minnesota","Waseca County","NHPI_A",14,12,-2,-15.38,"undercount"
"5584",27161,"Minnesota","Waseca County","NHPI_AIC",26,29,3,10.91,"overcount"
"5585",27163,"Minnesota","Washington County","A_A",17995,18678,683,3.72,"overcount"
"5586",27163,"Minnesota","Washington County","A_AIC",20421,21788,1367,6.48,"overcount"
"5587",27163,"Minnesota","Washington County","NHPI_A",147,75,-72,-64.86,"undercount"
"5588",27163,"Minnesota","Washington County","NHPI_AIC",379,394,15,3.88,"overcount"
"5589",27165,"Minnesota","Watonwan County","A_A",107,86,-21,-21.76,"undercount"
"5590",27165,"Minnesota","Watonwan County","A_AIC",124,124,0,0,"equal"
"5591",27165,"Minnesota","Watonwan County","NHPI_A",4,0,-4,-200,"undercount"
"5592",27165,"Minnesota","Watonwan County","NHPI_AIC",6,9,3,40,"overcount"
"5593",27167,"Minnesota","Wilkin County","A_A",37,10,-27,-114.89,"undercount"
"5594",27167,"Minnesota","Wilkin County","A_AIC",51,37,-14,-31.82,"undercount"
"5595",27167,"Minnesota","Wilkin County","NHPI_A",0,1,1,200,"overcount"
"5596",27167,"Minnesota","Wilkin County","NHPI_AIC",2,3,1,40,"overcount"
"5597",27169,"Minnesota","Winona County","A_A",1329,938,-391,-34.49,"undercount"
"5598",27169,"Minnesota","Winona County","A_AIC",1502,1238,-264,-19.27,"undercount"
"5599",27169,"Minnesota","Winona County","NHPI_A",8,4,-4,-66.67,"undercount"
"5600",27169,"Minnesota","Winona County","NHPI_AIC",20,51,31,87.32,"overcount"
"5601",27171,"Minnesota","Wright County","A_A",1987,1917,-70,-3.59,"undercount"
"5602",27171,"Minnesota","Wright County","A_AIC",2833,3064,231,7.83,"overcount"
"5603",27171,"Minnesota","Wright County","NHPI_A",54,35,-19,-42.7,"undercount"
"5604",27171,"Minnesota","Wright County","NHPI_AIC",127,125,-2,-1.59,"undercount"
"5605",27173,"Minnesota","Yellow Medicine County","A_A",54,29,-25,-60.24,"undercount"
"5606",27173,"Minnesota","Yellow Medicine County","A_AIC",78,67,-11,-15.17,"undercount"
"5607",27173,"Minnesota","Yellow Medicine County","NHPI_A",7,1,-6,-150,"undercount"
"5608",27173,"Minnesota","Yellow Medicine County","NHPI_AIC",9,9,0,0,"equal"
"5609",28001,"Mississippi","Adams County","A_A",174,168,-6,-3.51,"undercount"
"5610",28001,"Mississippi","Adams County","A_AIC",228,207,-21,-9.66,"undercount"
"5611",28001,"Mississippi","Adams County","NHPI_A",3,7,4,80,"overcount"
"5612",28001,"Mississippi","Adams County","NHPI_AIC",16,24,8,40,"overcount"
"5613",28003,"Mississippi","Alcorn County","A_A",171,192,21,11.57,"overcount"
"5614",28003,"Mississippi","Alcorn County","A_AIC",228,276,48,19.05,"overcount"
"5615",28003,"Mississippi","Alcorn County","NHPI_A",6,19,13,104,"overcount"
"5616",28003,"Mississippi","Alcorn County","NHPI_AIC",21,25,4,17.39,"overcount"
"5617",28005,"Mississippi","Amite County","A_A",25,31,6,21.43,"overcount"
"5618",28005,"Mississippi","Amite County","A_AIC",47,56,9,17.48,"overcount"
"5619",28005,"Mississippi","Amite County","NHPI_A",3,0,-3,-200,"undercount"
"5620",28005,"Mississippi","Amite County","NHPI_AIC",5,9,4,57.14,"overcount"
"5621",28007,"Mississippi","Attala County","A_A",75,97,22,25.58,"overcount"
"5622",28007,"Mississippi","Attala County","A_AIC",107,138,31,25.31,"overcount"
"5623",28007,"Mississippi","Attala County","NHPI_A",4,4,0,0,"equal"
"5624",28007,"Mississippi","Attala County","NHPI_AIC",7,15,8,72.73,"overcount"
"5625",28009,"Mississippi","Benton County","A_A",15,1,-14,-175,"undercount"
"5626",28009,"Mississippi","Benton County","A_AIC",37,13,-24,-96,"undercount"
"5627",28009,"Mississippi","Benton County","NHPI_A",1,0,-1,-200,"undercount"
"5628",28009,"Mississippi","Benton County","NHPI_AIC",4,1,-3,-120,"undercount"
"5629",28011,"Mississippi","Bolivar County","A_A",307,272,-35,-12.09,"undercount"
"5630",28011,"Mississippi","Bolivar County","A_AIC",343,332,-11,-3.26,"undercount"
"5631",28011,"Mississippi","Bolivar County","NHPI_A",11,0,-11,-200,"undercount"
"5632",28011,"Mississippi","Bolivar County","NHPI_AIC",17,10,-7,-51.85,"undercount"
"5633",28013,"Mississippi","Calhoun County","A_A",24,17,-7,-34.15,"undercount"
"5634",28013,"Mississippi","Calhoun County","A_AIC",44,32,-12,-31.58,"undercount"
"5635",28013,"Mississippi","Calhoun County","NHPI_A",2,0,-2,-200,"undercount"
"5636",28013,"Mississippi","Calhoun County","NHPI_AIC",6,2,-4,-100,"undercount"
"5637",28015,"Mississippi","Carroll County","A_A",22,29,7,27.45,"overcount"
"5638",28015,"Mississippi","Carroll County","A_AIC",33,62,29,61.05,"overcount"
"5639",28015,"Mississippi","Carroll County","NHPI_A",2,0,-2,-200,"undercount"
"5640",28015,"Mississippi","Carroll County","NHPI_AIC",5,14,9,94.74,"overcount"
"5641",28017,"Mississippi","Chickasaw County","A_A",73,44,-29,-49.57,"undercount"
"5642",28017,"Mississippi","Chickasaw County","A_AIC",101,80,-21,-23.2,"undercount"
"5643",28017,"Mississippi","Chickasaw County","NHPI_A",1,0,-1,-200,"undercount"
"5644",28017,"Mississippi","Chickasaw County","NHPI_AIC",9,7,-2,-25,"undercount"
"5645",28019,"Mississippi","Choctaw County","A_A",33,6,-27,-138.46,"undercount"
"5646",28019,"Mississippi","Choctaw County","A_AIC",49,30,-19,-48.1,"undercount"
"5647",28019,"Mississippi","Choctaw County","NHPI_A",1,0,-1,-200,"undercount"
"5648",28019,"Mississippi","Choctaw County","NHPI_AIC",4,7,3,54.55,"overcount"
"5649",28021,"Mississippi","Claiborne County","A_A",65,0,-65,-200,"undercount"
"5650",28021,"Mississippi","Claiborne County","A_AIC",78,12,-66,-146.67,"undercount"
"5651",28021,"Mississippi","Claiborne County","NHPI_A",4,0,-4,-200,"undercount"
"5652",28021,"Mississippi","Claiborne County","NHPI_AIC",10,9,-1,-10.53,"undercount"
"5653",28023,"Mississippi","Clarke County","A_A",32,8,-24,-120,"undercount"
"5654",28023,"Mississippi","Clarke County","A_AIC",42,36,-6,-15.38,"undercount"
"5655",28023,"Mississippi","Clarke County","NHPI_A",1,6,5,142.86,"overcount"
"5656",28023,"Mississippi","Clarke County","NHPI_AIC",2,18,16,160,"overcount"
"5657",28025,"Mississippi","Clay County","A_A",78,57,-21,-31.11,"undercount"
"5658",28025,"Mississippi","Clay County","A_AIC",105,77,-28,-30.77,"undercount"
"5659",28025,"Mississippi","Clay County","NHPI_A",3,1,-2,-100,"undercount"
"5660",28025,"Mississippi","Clay County","NHPI_AIC",8,8,0,0,"equal"
"5661",28027,"Mississippi","Coahoma County","A_A",87,112,25,25.13,"overcount"
"5662",28027,"Mississippi","Coahoma County","A_AIC",112,156,44,32.84,"overcount"
"5663",28027,"Mississippi","Coahoma County","NHPI_A",5,0,-5,-200,"undercount"
"5664",28027,"Mississippi","Coahoma County","NHPI_AIC",7,10,3,35.29,"overcount"
"5665",28029,"Mississippi","Copiah County","A_A",110,121,11,9.52,"overcount"
"5666",28029,"Mississippi","Copiah County","A_AIC",170,143,-27,-17.25,"undercount"
"5667",28029,"Mississippi","Copiah County","NHPI_A",6,24,18,120,"overcount"
"5668",28029,"Mississippi","Copiah County","NHPI_AIC",23,34,11,38.6,"overcount"
"5669",28031,"Mississippi","Covington County","A_A",87,85,-2,-2.33,"undercount"
"5670",28031,"Mississippi","Covington County","A_AIC",126,115,-11,-9.13,"undercount"
"5671",28031,"Mississippi","Covington County","NHPI_A",8,4,-4,-66.67,"undercount"
"5672",28031,"Mississippi","Covington County","NHPI_AIC",12,15,3,22.22,"overcount"
"5673",28033,"Mississippi","DeSoto County","A_A",3029,3051,22,0.72,"overcount"
"5674",28033,"Mississippi","DeSoto County","A_AIC",3823,4212,389,9.68,"overcount"
"5675",28033,"Mississippi","DeSoto County","NHPI_A",92,143,51,43.4,"overcount"
"5676",28033,"Mississippi","DeSoto County","NHPI_AIC",199,269,70,29.91,"overcount"
"5677",28035,"Mississippi","Forrest County","A_A",802,790,-12,-1.51,"undercount"
"5678",28035,"Mississippi","Forrest County","A_AIC",1017,1070,53,5.08,"overcount"
"5679",28035,"Mississippi","Forrest County","NHPI_A",25,29,4,14.81,"overcount"
"5680",28035,"Mississippi","Forrest County","NHPI_AIC",82,79,-3,-3.73,"undercount"
"5681",28037,"Mississippi","Franklin County","A_A",11,8,-3,-31.58,"undercount"
"5682",28037,"Mississippi","Franklin County","A_AIC",24,20,-4,-18.18,"undercount"
"5683",28037,"Mississippi","Franklin County","NHPI_A",2,0,-2,-200,"undercount"
"5684",28037,"Mississippi","Franklin County","NHPI_AIC",6,5,-1,-18.18,"undercount"
"5685",28039,"Mississippi","George County","A_A",158,77,-81,-68.94,"undercount"
"5686",28039,"Mississippi","George County","A_AIC",203,113,-90,-56.96,"undercount"
"5687",28039,"Mississippi","George County","NHPI_A",1,1,0,0,"equal"
"5688",28039,"Mississippi","George County","NHPI_AIC",10,11,1,9.52,"overcount"
"5689",28041,"Mississippi","Greene County","A_A",25,21,-4,-17.39,"undercount"
"5690",28041,"Mississippi","Greene County","A_AIC",39,42,3,7.41,"overcount"
"5691",28041,"Mississippi","Greene County","NHPI_A",1,3,2,100,"overcount"
"5692",28041,"Mississippi","Greene County","NHPI_AIC",5,9,4,57.14,"overcount"
"5693",28043,"Mississippi","Grenada County","A_A",103,84,-19,-20.32,"undercount"
"5694",28043,"Mississippi","Grenada County","A_AIC",132,130,-2,-1.53,"undercount"
"5695",28043,"Mississippi","Grenada County","NHPI_A",2,2,0,0,"equal"
"5696",28043,"Mississippi","Grenada County","NHPI_AIC",13,9,-4,-36.36,"undercount"
"5697",28045,"Mississippi","Hancock County","A_A",434,435,1,0.23,"overcount"
"5698",28045,"Mississippi","Hancock County","A_AIC",628,686,58,8.83,"overcount"
"5699",28045,"Mississippi","Hancock County","NHPI_A",21,9,-12,-80,"undercount"
"5700",28045,"Mississippi","Hancock County","NHPI_AIC",45,54,9,18.18,"overcount"
"5701",28047,"Mississippi","Harrison County","A_A",5874,5999,125,2.11,"overcount"
"5702",28047,"Mississippi","Harrison County","A_AIC",7724,8263,539,6.74,"overcount"
"5703",28047,"Mississippi","Harrison County","NHPI_A",191,259,68,30.22,"overcount"
"5704",28047,"Mississippi","Harrison County","NHPI_AIC",480,576,96,18.18,"overcount"
"5705",28049,"Mississippi","Hinds County","A_A",1637,2196,559,29.17,"overcount"
"5706",28049,"Mississippi","Hinds County","A_AIC",2086,2706,620,25.88,"overcount"
"5707",28049,"Mississippi","Hinds County","NHPI_A",17,46,29,92.06,"overcount"
"5708",28049,"Mississippi","Hinds County","NHPI_AIC",127,117,-10,-8.2,"undercount"
"5709",28051,"Mississippi","Holmes County","A_A",40,20,-20,-66.67,"undercount"
"5710",28051,"Mississippi","Holmes County","A_AIC",57,32,-25,-56.18,"undercount"
"5711",28051,"Mississippi","Holmes County","NHPI_A",1,0,-1,-200,"undercount"
"5712",28051,"Mississippi","Holmes County","NHPI_AIC",4,4,0,0,"equal"
"5713",28053,"Mississippi","Humphreys County","A_A",39,10,-29,-118.37,"undercount"
"5714",28053,"Mississippi","Humphreys County","A_AIC",50,22,-28,-77.78,"undercount"
"5715",28053,"Mississippi","Humphreys County","NHPI_A",0,0,0,0,"equal"
"5716",28053,"Mississippi","Humphreys County","NHPI_AIC",4,8,4,66.67,"overcount"
"5717",28055,"Mississippi","Issaquena County","A_A",6,5,-1,-18.18,"undercount"
"5718",28055,"Mississippi","Issaquena County","A_AIC",7,8,1,13.33,"overcount"
"5719",28055,"Mississippi","Issaquena County","NHPI_A",0,0,0,0,"equal"
"5720",28055,"Mississippi","Issaquena County","NHPI_AIC",0,2,2,200,"overcount"
"5721",28057,"Mississippi","Itawamba County","A_A",118,50,-68,-80.95,"undercount"
"5722",28057,"Mississippi","Itawamba County","A_AIC",133,79,-54,-50.94,"undercount"
"5723",28057,"Mississippi","Itawamba County","NHPI_A",3,0,-3,-200,"undercount"
"5724",28057,"Mississippi","Itawamba County","NHPI_AIC",7,9,2,25,"overcount"
"5725",28059,"Mississippi","Jackson County","A_A",3265,3206,-59,-1.82,"undercount"
"5726",28059,"Mississippi","Jackson County","A_AIC",4176,4367,191,4.47,"overcount"
"5727",28059,"Mississippi","Jackson County","NHPI_A",110,91,-19,-18.91,"undercount"
"5728",28059,"Mississippi","Jackson County","NHPI_AIC",223,232,9,3.96,"overcount"
"5729",28061,"Mississippi","Jasper County","A_A",24,8,-16,-100,"undercount"
"5730",28061,"Mississippi","Jasper County","A_AIC",43,35,-8,-20.51,"undercount"
"5731",28061,"Mississippi","Jasper County","NHPI_A",5,1,-4,-133.33,"undercount"
"5732",28061,"Mississippi","Jasper County","NHPI_AIC",6,6,0,0,"equal"
"5733",28063,"Mississippi","Jefferson County","A_A",11,14,3,24,"overcount"
"5734",28063,"Mississippi","Jefferson County","A_AIC",23,27,4,16,"overcount"
"5735",28063,"Mississippi","Jefferson County","NHPI_A",1,5,4,133.33,"overcount"
"5736",28063,"Mississippi","Jefferson County","NHPI_AIC",3,11,8,114.29,"overcount"
"5737",28065,"Mississippi","Jefferson Davis County","A_A",31,21,-10,-38.46,"undercount"
"5738",28065,"Mississippi","Jefferson Davis County","A_AIC",40,32,-8,-22.22,"undercount"
"5739",28065,"Mississippi","Jefferson Davis County","NHPI_A",4,0,-4,-200,"undercount"
"5740",28065,"Mississippi","Jefferson Davis County","NHPI_AIC",7,6,-1,-15.38,"undercount"
"5741",28067,"Mississippi","Jones County","A_A",289,280,-9,-3.16,"undercount"
"5742",28067,"Mississippi","Jones County","A_AIC",392,437,45,10.86,"overcount"
"5743",28067,"Mississippi","Jones County","NHPI_A",11,25,14,77.78,"overcount"
"5744",28067,"Mississippi","Jones County","NHPI_AIC",27,39,12,36.36,"overcount"
"5745",28069,"Mississippi","Kemper County","A_A",19,6,-13,-104,"undercount"
"5746",28069,"Mississippi","Kemper County","A_AIC",29,9,-20,-105.26,"undercount"
"5747",28069,"Mississippi","Kemper County","NHPI_A",0,1,1,200,"overcount"
"5748",28069,"Mississippi","Kemper County","NHPI_AIC",2,5,3,85.71,"overcount"
"5749",28071,"Mississippi","Lafayette County","A_A",1267,1700,433,29.19,"overcount"
"5750",28071,"Mississippi","Lafayette County","A_AIC",1513,2090,577,32.03,"overcount"
"5751",28071,"Mississippi","Lafayette County","NHPI_A",17,24,7,34.15,"overcount"
"5752",28071,"Mississippi","Lafayette County","NHPI_AIC",42,54,12,25,"overcount"
"5753",28073,"Mississippi","Lamar County","A_A",923,1103,180,17.77,"overcount"
"5754",28073,"Mississippi","Lamar County","A_AIC",1093,1468,375,29.29,"overcount"
"5755",28073,"Mississippi","Lamar County","NHPI_A",44,50,6,12.77,"overcount"
"5756",28073,"Mississippi","Lamar County","NHPI_AIC",62,101,39,47.85,"overcount"
"5757",28075,"Mississippi","Lauderdale County","A_A",577,610,33,5.56,"overcount"
"5758",28075,"Mississippi","Lauderdale County","A_AIC",750,832,82,10.37,"overcount"
"5759",28075,"Mississippi","Lauderdale County","NHPI_A",15,28,13,60.47,"overcount"
"5760",28075,"Mississippi","Lauderdale County","NHPI_AIC",56,72,16,25,"overcount"
"5761",28077,"Mississippi","Lawrence County","A_A",56,33,-23,-51.69,"undercount"
"5762",28077,"Mississippi","Lawrence County","A_AIC",70,57,-13,-20.47,"undercount"
"5763",28077,"Mississippi","Lawrence County","NHPI_A",0,5,5,200,"overcount"
"5764",28077,"Mississippi","Lawrence County","NHPI_AIC",1,7,6,150,"overcount"
"5765",28079,"Mississippi","Leake County","A_A",88,78,-10,-12.05,"undercount"
"5766",28079,"Mississippi","Leake County","A_AIC",130,89,-41,-37.44,"undercount"
"5767",28079,"Mississippi","Leake County","NHPI_A",1,5,4,133.33,"overcount"
"5768",28079,"Mississippi","Leake County","NHPI_AIC",9,24,15,90.91,"overcount"
"5769",28081,"Mississippi","Lee County","A_A",812,931,119,13.65,"overcount"
"5770",28081,"Mississippi","Lee County","A_AIC",989,1169,180,16.68,"overcount"
"5771",28081,"Mississippi","Lee County","NHPI_A",24,25,1,4.08,"overcount"
"5772",28081,"Mississippi","Lee County","NHPI_AIC",55,48,-7,-13.59,"undercount"
"5773",28083,"Mississippi","Leflore County","A_A",151,205,54,30.34,"overcount"
"5774",28083,"Mississippi","Leflore County","A_AIC",172,245,73,35.01,"overcount"
"5775",28083,"Mississippi","Leflore County","NHPI_A",3,0,-3,-200,"undercount"
"5776",28083,"Mississippi","Leflore County","NHPI_AIC",8,10,2,22.22,"overcount"
"5777",28085,"Mississippi","Lincoln County","A_A",159,163,4,2.48,"overcount"
"5778",28085,"Mississippi","Lincoln County","A_AIC",210,241,31,13.75,"overcount"
"5779",28085,"Mississippi","Lincoln County","NHPI_A",8,8,0,0,"equal"
"5780",28085,"Mississippi","Lincoln County","NHPI_AIC",23,29,6,23.08,"overcount"
"5781",28087,"Mississippi","Lowndes County","A_A",568,517,-51,-9.4,"undercount"
"5782",28087,"Mississippi","Lowndes County","A_AIC",733,798,65,8.49,"overcount"
"5783",28087,"Mississippi","Lowndes County","NHPI_A",24,17,-7,-34.15,"undercount"
"5784",28087,"Mississippi","Lowndes County","NHPI_AIC",73,55,-18,-28.12,"undercount"
"5785",28089,"Mississippi","Madison County","A_A",2999,3199,200,6.45,"overcount"
"5786",28089,"Mississippi","Madison County","A_AIC",3309,3729,420,11.94,"overcount"
"5787",28089,"Mississippi","Madison County","NHPI_A",24,14,-10,-52.63,"undercount"
"5788",28089,"Mississippi","Madison County","NHPI_AIC",89,44,-45,-67.67,"undercount"
"5789",28091,"Mississippi","Marion County","A_A",98,69,-29,-34.73,"undercount"
"5790",28091,"Mississippi","Marion County","A_AIC",160,134,-26,-17.69,"undercount"
"5791",28091,"Mississippi","Marion County","NHPI_A",10,0,-10,-200,"undercount"
"5792",28091,"Mississippi","Marion County","NHPI_AIC",25,14,-11,-56.41,"undercount"
"5793",28093,"Mississippi","Marshall County","A_A",94,74,-20,-23.81,"undercount"
"5794",28093,"Mississippi","Marshall County","A_AIC",160,137,-23,-15.49,"undercount"
"5795",28093,"Mississippi","Marshall County","NHPI_A",9,20,11,75.86,"overcount"
"5796",28093,"Mississippi","Marshall County","NHPI_AIC",29,56,27,63.53,"overcount"
"5797",28095,"Mississippi","Monroe County","A_A",112,67,-45,-50.28,"undercount"
"5798",28095,"Mississippi","Monroe County","A_AIC",159,119,-40,-28.78,"undercount"
"5799",28095,"Mississippi","Monroe County","NHPI_A",7,3,-4,-80,"undercount"
"5800",28095,"Mississippi","Monroe County","NHPI_AIC",18,11,-7,-48.28,"undercount"
"5801",28097,"Mississippi","Montgomery County","A_A",62,24,-38,-88.37,"undercount"
"5802",28097,"Mississippi","Montgomery County","A_AIC",79,53,-26,-39.39,"undercount"
"5803",28097,"Mississippi","Montgomery County","NHPI_A",1,0,-1,-200,"undercount"
"5804",28097,"Mississippi","Montgomery County","NHPI_AIC",3,12,9,120,"overcount"
"5805",28099,"Mississippi","Neshoba County","A_A",140,122,-18,-13.74,"undercount"
"5806",28099,"Mississippi","Neshoba County","A_AIC",224,161,-63,-32.73,"undercount"
"5807",28099,"Mississippi","Neshoba County","NHPI_A",8,0,-8,-200,"undercount"
"5808",28099,"Mississippi","Neshoba County","NHPI_AIC",32,10,-22,-104.76,"undercount"
"5809",28101,"Mississippi","Newton County","A_A",101,85,-16,-17.2,"undercount"
"5810",28101,"Mississippi","Newton County","A_AIC",140,112,-28,-22.22,"undercount"
"5811",28101,"Mississippi","Newton County","NHPI_A",5,3,-2,-50,"undercount"
"5812",28101,"Mississippi","Newton County","NHPI_AIC",11,7,-4,-44.44,"undercount"
"5813",28103,"Mississippi","Noxubee County","A_A",25,14,-11,-56.41,"undercount"
"5814",28103,"Mississippi","Noxubee County","A_AIC",39,23,-16,-51.61,"undercount"
"5815",28103,"Mississippi","Noxubee County","NHPI_A",1,5,4,133.33,"overcount"
"5816",28103,"Mississippi","Noxubee County","NHPI_AIC",2,10,8,133.33,"overcount"
"5817",28105,"Mississippi","Oktibbeha County","A_A",1540,1544,4,0.26,"overcount"
"5818",28105,"Mississippi","Oktibbeha County","A_AIC",1742,1787,45,2.55,"overcount"
"5819",28105,"Mississippi","Oktibbeha County","NHPI_A",37,25,-12,-38.71,"undercount"
"5820",28105,"Mississippi","Oktibbeha County","NHPI_AIC",74,44,-30,-50.85,"undercount"
"5821",28107,"Mississippi","Panola County","A_A",62,62,0,0,"equal"
"5822",28107,"Mississippi","Panola County","A_AIC",150,111,-39,-29.89,"undercount"
"5823",28107,"Mississippi","Panola County","NHPI_A",2,4,2,66.67,"overcount"
"5824",28107,"Mississippi","Panola County","NHPI_AIC",20,19,-1,-5.13,"undercount"
"5825",28109,"Mississippi","Pearl River County","A_A",229,278,49,19.33,"overcount"
"5826",28109,"Mississippi","Pearl River County","A_AIC",428,493,65,14.12,"overcount"
"5827",28109,"Mississippi","Pearl River County","NHPI_A",47,0,-47,-200,"undercount"
"5828",28109,"Mississippi","Pearl River County","NHPI_AIC",81,30,-51,-91.89,"undercount"
"5829",28111,"Mississippi","Perry County","A_A",18,29,11,46.81,"overcount"
"5830",28111,"Mississippi","Perry County","A_AIC",41,65,24,45.28,"overcount"
"5831",28111,"Mississippi","Perry County","NHPI_A",6,3,-3,-66.67,"undercount"
"5832",28111,"Mississippi","Perry County","NHPI_AIC",9,19,10,71.43,"overcount"
"5833",28113,"Mississippi","Pike County","A_A",258,268,10,3.8,"overcount"
"5834",28113,"Mississippi","Pike County","A_AIC",310,332,22,6.85,"overcount"
"5835",28113,"Mississippi","Pike County","NHPI_A",9,7,-2,-25,"undercount"
"5836",28113,"Mississippi","Pike County","NHPI_AIC",29,27,-2,-7.14,"undercount"
"5837",28115,"Mississippi","Pontotoc County","A_A",120,55,-65,-74.29,"undercount"
"5838",28115,"Mississippi","Pontotoc County","A_AIC",170,110,-60,-42.86,"undercount"
"5839",28115,"Mississippi","Pontotoc County","NHPI_A",6,5,-1,-18.18,"undercount"
"5840",28115,"Mississippi","Pontotoc County","NHPI_AIC",23,17,-6,-30,"undercount"
"5841",28117,"Mississippi","Prentiss County","A_A",76,86,10,12.35,"overcount"
"5842",28117,"Mississippi","Prentiss County","A_AIC",111,113,2,1.79,"overcount"
"5843",28117,"Mississippi","Prentiss County","NHPI_A",6,9,3,40,"overcount"
"5844",28117,"Mississippi","Prentiss County","NHPI_AIC",14,12,-2,-15.38,"undercount"
"5845",28119,"Mississippi","Quitman County","A_A",14,12,-2,-15.38,"undercount"
"5846",28119,"Mississippi","Quitman County","A_AIC",31,20,-11,-43.14,"undercount"
"5847",28119,"Mississippi","Quitman County","NHPI_A",3,3,0,0,"equal"
"5848",28119,"Mississippi","Quitman County","NHPI_AIC",6,4,-2,-40,"undercount"
"5849",28121,"Mississippi","Rankin County","A_A",2105,2274,169,7.72,"overcount"
"5850",28121,"Mississippi","Rankin County","A_AIC",2554,2917,363,13.27,"overcount"
"5851",28121,"Mississippi","Rankin County","NHPI_A",81,94,13,14.86,"overcount"
"5852",28121,"Mississippi","Rankin County","NHPI_AIC",167,143,-24,-15.48,"undercount"
"5853",28123,"Mississippi","Scott County","A_A",114,103,-11,-10.14,"undercount"
"5854",28123,"Mississippi","Scott County","A_AIC",151,150,-1,-0.66,"undercount"
"5855",28123,"Mississippi","Scott County","NHPI_A",28,0,-28,-200,"undercount"
"5856",28123,"Mississippi","Scott County","NHPI_AIC",37,12,-25,-102.04,"undercount"
"5857",28125,"Mississippi","Sharkey County","A_A",34,14,-20,-83.33,"undercount"
"5858",28125,"Mississippi","Sharkey County","A_AIC",40,21,-19,-62.3,"undercount"
"5859",28125,"Mississippi","Sharkey County","NHPI_A",0,3,3,200,"overcount"
"5860",28125,"Mississippi","Sharkey County","NHPI_AIC",0,5,5,200,"overcount"
"5861",28127,"Mississippi","Simpson County","A_A",154,92,-62,-50.41,"undercount"
"5862",28127,"Mississippi","Simpson County","A_AIC",205,148,-57,-32.29,"undercount"
"5863",28127,"Mississippi","Simpson County","NHPI_A",38,2,-36,-180,"undercount"
"5864",28127,"Mississippi","Simpson County","NHPI_AIC",54,16,-38,-108.57,"undercount"
"5865",28129,"Mississippi","Smith County","A_A",22,21,-1,-4.65,"undercount"
"5866",28129,"Mississippi","Smith County","A_AIC",34,38,4,11.11,"overcount"
"5867",28129,"Mississippi","Smith County","NHPI_A",3,0,-3,-200,"undercount"
"5868",28129,"Mississippi","Smith County","NHPI_AIC",6,4,-2,-40,"undercount"
"5869",28131,"Mississippi","Stone County","A_A",75,89,14,17.07,"overcount"
"5870",28131,"Mississippi","Stone County","A_AIC",150,161,11,7.07,"overcount"
"5871",28131,"Mississippi","Stone County","NHPI_A",8,10,2,22.22,"overcount"
"5872",28131,"Mississippi","Stone County","NHPI_AIC",19,19,0,0,"equal"
"5873",28133,"Mississippi","Sunflower County","A_A",103,92,-11,-11.28,"undercount"
"5874",28133,"Mississippi","Sunflower County","A_AIC",120,118,-2,-1.68,"undercount"
"5875",28133,"Mississippi","Sunflower County","NHPI_A",9,0,-9,-200,"undercount"
"5876",28133,"Mississippi","Sunflower County","NHPI_AIC",19,22,3,14.63,"overcount"
"5877",28135,"Mississippi","Tallahatchie County","A_A",138,10,-128,-172.97,"undercount"
"5878",28135,"Mississippi","Tallahatchie County","A_AIC",172,14,-158,-169.89,"undercount"
"5879",28135,"Mississippi","Tallahatchie County","NHPI_A",12,3,-9,-120,"undercount"
"5880",28135,"Mississippi","Tallahatchie County","NHPI_AIC",22,14,-8,-44.44,"undercount"
"5881",28137,"Mississippi","Tate County","A_A",91,63,-28,-36.36,"undercount"
"5882",28137,"Mississippi","Tate County","A_AIC",156,107,-49,-37.26,"undercount"
"5883",28137,"Mississippi","Tate County","NHPI_A",4,1,-3,-120,"undercount"
"5884",28137,"Mississippi","Tate County","NHPI_AIC",24,32,8,28.57,"overcount"
"5885",28139,"Mississippi","Tippah County","A_A",63,24,-39,-89.66,"undercount"
"5886",28139,"Mississippi","Tippah County","A_AIC",91,51,-40,-56.34,"undercount"
"5887",28139,"Mississippi","Tippah County","NHPI_A",4,0,-4,-200,"undercount"
"5888",28139,"Mississippi","Tippah County","NHPI_AIC",7,5,-2,-33.33,"undercount"
"5889",28141,"Mississippi","Tishomingo County","A_A",47,42,-5,-11.24,"undercount"
"5890",28141,"Mississippi","Tishomingo County","A_AIC",66,73,7,10.07,"overcount"
"5891",28141,"Mississippi","Tishomingo County","NHPI_A",2,0,-2,-200,"undercount"
"5892",28141,"Mississippi","Tishomingo County","NHPI_AIC",11,11,0,0,"equal"
"5893",28143,"Mississippi","Tunica County","A_A",76,27,-49,-95.15,"undercount"
"5894",28143,"Mississippi","Tunica County","A_AIC",94,45,-49,-70.5,"undercount"
"5895",28143,"Mississippi","Tunica County","NHPI_A",3,0,-3,-200,"undercount"
"5896",28143,"Mississippi","Tunica County","NHPI_AIC",9,3,-6,-100,"undercount"
"5897",28145,"Mississippi","Union County","A_A",299,109,-190,-93.14,"undercount"
"5898",28145,"Mississippi","Union County","A_AIC",379,157,-222,-82.84,"undercount"
"5899",28145,"Mississippi","Union County","NHPI_A",5,0,-5,-200,"undercount"
"5900",28145,"Mississippi","Union County","NHPI_AIC",30,7,-23,-124.32,"undercount"
"5901",28147,"Mississippi","Walthall County","A_A",67,48,-19,-33.04,"undercount"
"5902",28147,"Mississippi","Walthall County","A_AIC",100,55,-45,-58.06,"undercount"
"5903",28147,"Mississippi","Walthall County","NHPI_A",15,8,-7,-60.87,"undercount"
"5904",28147,"Mississippi","Walthall County","NHPI_AIC",29,19,-10,-41.67,"undercount"
"5905",28149,"Mississippi","Warren County","A_A",358,379,21,5.7,"overcount"
"5906",28149,"Mississippi","Warren County","A_AIC",445,561,116,23.06,"overcount"
"5907",28149,"Mississippi","Warren County","NHPI_A",12,0,-12,-200,"undercount"
"5908",28149,"Mississippi","Warren County","NHPI_AIC",36,4,-32,-160,"undercount"
"5909",28151,"Mississippi","Washington County","A_A",332,302,-30,-9.46,"undercount"
"5910",28151,"Mississippi","Washington County","A_AIC",393,355,-38,-10.16,"undercount"
"5911",28151,"Mississippi","Washington County","NHPI_A",10,5,-5,-66.67,"undercount"
"5912",28151,"Mississippi","Washington County","NHPI_AIC",28,26,-2,-7.41,"undercount"
"5913",28153,"Mississippi","Wayne County","A_A",48,35,-13,-31.33,"undercount"
"5914",28153,"Mississippi","Wayne County","A_AIC",87,53,-34,-48.57,"undercount"
"5915",28153,"Mississippi","Wayne County","NHPI_A",2,4,2,66.67,"overcount"
"5916",28153,"Mississippi","Wayne County","NHPI_AIC",12,8,-4,-40,"undercount"
"5917",28155,"Mississippi","Webster County","A_A",16,13,-3,-20.69,"undercount"
"5918",28155,"Mississippi","Webster County","A_AIC",31,31,0,0,"equal"
"5919",28155,"Mississippi","Webster County","NHPI_A",0,1,1,200,"overcount"
"5920",28155,"Mississippi","Webster County","NHPI_AIC",0,3,3,200,"overcount"
"5921",28157,"Mississippi","Wilkinson County","A_A",9,8,-1,-11.76,"undercount"
"5922",28157,"Mississippi","Wilkinson County","A_AIC",21,31,10,38.46,"overcount"
"5923",28157,"Mississippi","Wilkinson County","NHPI_A",2,0,-2,-200,"undercount"
"5924",28157,"Mississippi","Wilkinson County","NHPI_AIC",5,0,-5,-200,"undercount"
"5925",28159,"Mississippi","Winston County","A_A",58,39,-19,-39.18,"undercount"
"5926",28159,"Mississippi","Winston County","A_AIC",75,64,-11,-15.83,"undercount"
"5927",28159,"Mississippi","Winston County","NHPI_A",4,1,-3,-120,"undercount"
"5928",28159,"Mississippi","Winston County","NHPI_AIC",9,6,-3,-40,"undercount"
"5929",28161,"Mississippi","Yalobusha County","A_A",29,21,-8,-32,"undercount"
"5930",28161,"Mississippi","Yalobusha County","A_AIC",48,55,7,13.59,"overcount"
"5931",28161,"Mississippi","Yalobusha County","NHPI_A",1,2,1,66.67,"overcount"
"5932",28161,"Mississippi","Yalobusha County","NHPI_AIC",6,13,7,73.68,"overcount"
"5933",28163,"Mississippi","Yazoo County","A_A",147,116,-31,-23.57,"undercount"
"5934",28163,"Mississippi","Yazoo County","A_AIC",199,165,-34,-18.68,"undercount"
"5935",28163,"Mississippi","Yazoo County","NHPI_A",5,6,1,18.18,"overcount"
"5936",28163,"Mississippi","Yazoo County","NHPI_AIC",22,20,-2,-9.52,"undercount"
"5937",29001,"Missouri","Adair County","A_A",694,685,-9,-1.31,"undercount"
"5938",29001,"Missouri","Adair County","A_AIC",842,881,39,4.53,"overcount"
"5939",29001,"Missouri","Adair County","NHPI_A",17,13,-4,-26.67,"undercount"
"5940",29001,"Missouri","Adair County","NHPI_AIC",33,33,0,0,"equal"
"5941",29003,"Missouri","Andrew County","A_A",121,89,-32,-30.48,"undercount"
"5942",29003,"Missouri","Andrew County","A_AIC",160,135,-25,-16.95,"undercount"
"5943",29003,"Missouri","Andrew County","NHPI_A",8,0,-8,-200,"undercount"
"5944",29003,"Missouri","Andrew County","NHPI_AIC",15,11,-4,-30.77,"undercount"
"5945",29005,"Missouri","Atchison County","A_A",18,12,-6,-40,"undercount"
"5946",29005,"Missouri","Atchison County","A_AIC",26,38,12,37.5,"overcount"
"5947",29005,"Missouri","Atchison County","NHPI_A",3,0,-3,-200,"undercount"
"5948",29005,"Missouri","Atchison County","NHPI_AIC",5,4,-1,-22.22,"undercount"
"5949",29007,"Missouri","Audrain County","A_A",134,114,-20,-16.13,"undercount"
"5950",29007,"Missouri","Audrain County","A_AIC",215,208,-7,-3.31,"undercount"
"5951",29007,"Missouri","Audrain County","NHPI_A",23,2,-21,-168,"undercount"
"5952",29007,"Missouri","Audrain County","NHPI_AIC",39,31,-8,-22.86,"undercount"
"5953",29009,"Missouri","Barry County","A_A",791,808,17,2.13,"overcount"
"5954",29009,"Missouri","Barry County","A_AIC",862,926,64,7.16,"overcount"
"5955",29009,"Missouri","Barry County","NHPI_A",54,71,17,27.2,"overcount"
"5956",29009,"Missouri","Barry County","NHPI_AIC",74,94,20,23.81,"overcount"
"5957",29011,"Missouri","Barton County","A_A",68,42,-26,-47.27,"undercount"
"5958",29011,"Missouri","Barton County","A_AIC",102,80,-22,-24.18,"undercount"
"5959",29011,"Missouri","Barton County","NHPI_A",3,2,-1,-40,"undercount"
"5960",29011,"Missouri","Barton County","NHPI_AIC",8,4,-4,-66.67,"undercount"
"5961",29013,"Missouri","Bates County","A_A",51,50,-1,-1.98,"undercount"
"5962",29013,"Missouri","Bates County","A_AIC",93,88,-5,-5.52,"undercount"
"5963",29013,"Missouri","Bates County","NHPI_A",10,9,-1,-10.53,"undercount"
"5964",29013,"Missouri","Bates County","NHPI_AIC",17,25,8,38.1,"overcount"
"5965",29015,"Missouri","Benton County","A_A",87,51,-36,-52.17,"undercount"
"5966",29015,"Missouri","Benton County","A_AIC",145,111,-34,-26.56,"undercount"
"5967",29015,"Missouri","Benton County","NHPI_A",14,0,-14,-200,"undercount"
"5968",29015,"Missouri","Benton County","NHPI_AIC",21,10,-11,-70.97,"undercount"
"5969",29017,"Missouri","Bollinger County","A_A",27,20,-7,-29.79,"undercount"
"5970",29017,"Missouri","Bollinger County","A_AIC",60,26,-34,-79.07,"undercount"
"5971",29017,"Missouri","Bollinger County","NHPI_A",3,3,0,0,"equal"
"5972",29017,"Missouri","Bollinger County","NHPI_AIC",9,5,-4,-57.14,"undercount"
"5973",29019,"Missouri","Boone County","A_A",9061,7838,-1223,-14.47,"undercount"
"5974",29019,"Missouri","Boone County","A_AIC",10619,9744,-875,-8.59,"undercount"
"5975",29019,"Missouri","Boone County","NHPI_A",154,122,-32,-23.19,"undercount"
"5976",29019,"Missouri","Boone County","NHPI_AIC",325,345,20,5.97,"overcount"
"5977",29021,"Missouri","Buchanan County","A_A",1346,1051,-295,-24.61,"undercount"
"5978",29021,"Missouri","Buchanan County","A_AIC",1655,1477,-178,-11.37,"undercount"
"5979",29021,"Missouri","Buchanan County","NHPI_A",377,428,51,12.67,"overcount"
"5980",29021,"Missouri","Buchanan County","NHPI_AIC",456,572,116,22.57,"overcount"
"5981",29023,"Missouri","Butler County","A_A",401,310,-91,-25.6,"undercount"
"5982",29023,"Missouri","Butler County","A_AIC",533,465,-68,-13.63,"undercount"
"5983",29023,"Missouri","Butler County","NHPI_A",17,14,-3,-19.35,"undercount"
"5984",29023,"Missouri","Butler County","NHPI_AIC",45,31,-14,-36.84,"undercount"
"5985",29025,"Missouri","Caldwell County","A_A",33,28,-5,-16.39,"undercount"
"5986",29025,"Missouri","Caldwell County","A_AIC",73,78,5,6.62,"overcount"
"5987",29025,"Missouri","Caldwell County","NHPI_A",10,7,-3,-35.29,"undercount"
"5988",29025,"Missouri","Caldwell County","NHPI_AIC",16,23,7,35.9,"overcount"
"5989",29027,"Missouri","Callaway County","A_A",331,222,-109,-39.42,"undercount"
"5990",29027,"Missouri","Callaway County","A_AIC",462,442,-20,-4.42,"undercount"
"5991",29027,"Missouri","Callaway County","NHPI_A",23,30,7,26.42,"overcount"
"5992",29027,"Missouri","Callaway County","NHPI_AIC",62,70,8,12.12,"overcount"
"5993",29029,"Missouri","Camden County","A_A",283,222,-61,-24.16,"undercount"
"5994",29029,"Missouri","Camden County","A_AIC",429,390,-39,-9.52,"undercount"
"5995",29029,"Missouri","Camden County","NHPI_A",21,40,19,62.3,"overcount"
"5996",29029,"Missouri","Camden County","NHPI_AIC",36,75,39,70.27,"overcount"
"5997",29031,"Missouri","Cape Girardeau County","A_A",1500,1313,-187,-13.3,"undercount"
"5998",29031,"Missouri","Cape Girardeau County","A_AIC",1834,1731,-103,-5.78,"undercount"
"5999",29031,"Missouri","Cape Girardeau County","NHPI_A",33,14,-19,-80.85,"undercount"
"6000",29031,"Missouri","Cape Girardeau County","NHPI_AIC",87,51,-36,-52.17,"undercount"
"6001",29033,"Missouri","Carroll County","A_A",15,15,0,0,"equal"
"6002",29033,"Missouri","Carroll County","A_AIC",33,36,3,8.7,"overcount"
"6003",29033,"Missouri","Carroll County","NHPI_A",10,0,-10,-200,"undercount"
"6004",29033,"Missouri","Carroll County","NHPI_AIC",11,1,-10,-166.67,"undercount"
"6005",29035,"Missouri","Carter County","A_A",7,18,11,88,"overcount"
"6006",29035,"Missouri","Carter County","A_AIC",24,28,4,15.38,"overcount"
"6007",29035,"Missouri","Carter County","NHPI_A",1,1,0,0,"equal"
"6008",29035,"Missouri","Carter County","NHPI_AIC",3,3,0,0,"equal"
"6009",29037,"Missouri","Cass County","A_A",837,868,31,3.64,"overcount"
"6010",29037,"Missouri","Cass County","A_AIC",1504,1587,83,5.37,"overcount"
"6011",29037,"Missouri","Cass County","NHPI_A",112,78,-34,-35.79,"undercount"
"6012",29037,"Missouri","Cass County","NHPI_AIC",198,214,16,7.77,"overcount"
"6013",29039,"Missouri","Cedar County","A_A",63,44,-19,-35.51,"undercount"
"6014",29039,"Missouri","Cedar County","A_AIC",100,109,9,8.61,"overcount"
"6015",29039,"Missouri","Cedar County","NHPI_A",9,7,-2,-25,"undercount"
"6016",29039,"Missouri","Cedar County","NHPI_AIC",13,20,7,42.42,"overcount"
"6017",29041,"Missouri","Chariton County","A_A",14,3,-11,-129.41,"undercount"
"6018",29041,"Missouri","Chariton County","A_AIC",29,24,-5,-18.87,"undercount"
"6019",29041,"Missouri","Chariton County","NHPI_A",0,3,3,200,"overcount"
"6020",29041,"Missouri","Chariton County","NHPI_AIC",0,15,15,200,"overcount"
"6021",29043,"Missouri","Christian County","A_A",590,635,45,7.35,"overcount"
"6022",29043,"Missouri","Christian County","A_AIC",1025,1212,187,16.72,"overcount"
"6023",29043,"Missouri","Christian County","NHPI_A",40,71,31,55.86,"overcount"
"6024",29043,"Missouri","Christian County","NHPI_AIC",103,176,73,52.33,"overcount"
"6025",29045,"Missouri","Clark County","A_A",27,12,-15,-76.92,"undercount"
"6026",29045,"Missouri","Clark County","A_AIC",44,29,-15,-41.1,"undercount"
"6027",29045,"Missouri","Clark County","NHPI_A",0,0,0,0,"equal"
"6028",29045,"Missouri","Clark County","NHPI_AIC",0,9,9,200,"overcount"
"6029",29047,"Missouri","Clay County","A_A",6238,6140,-98,-1.58,"undercount"
"6030",29047,"Missouri","Clay County","A_AIC",8154,8451,297,3.58,"overcount"
"6031",29047,"Missouri","Clay County","NHPI_A",833,1004,171,18.62,"overcount"
"6032",29047,"Missouri","Clay County","NHPI_AIC",1165,1407,242,18.82,"overcount"
"6033",29049,"Missouri","Clinton County","A_A",98,85,-13,-14.21,"undercount"
"6034",29049,"Missouri","Clinton County","A_AIC",165,173,8,4.73,"overcount"
"6035",29049,"Missouri","Clinton County","NHPI_A",10,5,-5,-66.67,"undercount"
"6036",29049,"Missouri","Clinton County","NHPI_AIC",29,6,-23,-131.43,"undercount"
"6037",29051,"Missouri","Cole County","A_A",1031,971,-60,-5.99,"undercount"
"6038",29051,"Missouri","Cole County","A_AIC",1340,1422,82,5.94,"overcount"
"6039",29051,"Missouri","Cole County","NHPI_A",61,56,-5,-8.55,"undercount"
"6040",29051,"Missouri","Cole County","NHPI_AIC",147,139,-8,-5.59,"undercount"
"6041",29053,"Missouri","Cooper County","A_A",114,68,-46,-50.55,"undercount"
"6042",29053,"Missouri","Cooper County","A_AIC",164,150,-14,-8.92,"undercount"
"6043",29053,"Missouri","Cooper County","NHPI_A",6,10,4,50,"overcount"
"6044",29053,"Missouri","Cooper County","NHPI_AIC",21,32,11,41.51,"overcount"
"6045",29055,"Missouri","Crawford County","A_A",65,81,16,21.92,"overcount"
"6046",29055,"Missouri","Crawford County","A_AIC",113,161,48,35.04,"overcount"
"6047",29055,"Missouri","Crawford County","NHPI_A",16,14,-2,-13.33,"undercount"
"6048",29055,"Missouri","Crawford County","NHPI_AIC",31,34,3,9.23,"overcount"
"6049",29057,"Missouri","Dade County","A_A",38,24,-14,-45.16,"undercount"
"6050",29057,"Missouri","Dade County","A_AIC",61,48,-13,-23.85,"undercount"
"6051",29057,"Missouri","Dade County","NHPI_A",3,0,-3,-200,"undercount"
"6052",29057,"Missouri","Dade County","NHPI_AIC",6,1,-5,-142.86,"undercount"
"6053",29059,"Missouri","Dallas County","A_A",76,29,-47,-89.52,"undercount"
"6054",29059,"Missouri","Dallas County","A_AIC",118,62,-56,-62.22,"undercount"
"6055",29059,"Missouri","Dallas County","NHPI_A",12,22,10,58.82,"overcount"
"6056",29059,"Missouri","Dallas County","NHPI_AIC",22,32,10,37.04,"overcount"
"6057",29061,"Missouri","Daviess County","A_A",13,21,8,47.06,"overcount"
"6058",29061,"Missouri","Daviess County","A_AIC",41,40,-1,-2.47,"undercount"
"6059",29061,"Missouri","Daviess County","NHPI_A",2,10,8,133.33,"overcount"
"6060",29061,"Missouri","Daviess County","NHPI_AIC",11,19,8,53.33,"overcount"
"6061",29063,"Missouri","DeKalb County","A_A",51,45,-6,-12.5,"undercount"
"6062",29063,"Missouri","DeKalb County","A_AIC",71,76,5,6.8,"overcount"
"6063",29063,"Missouri","DeKalb County","NHPI_A",8,2,-6,-120,"undercount"
"6064",29063,"Missouri","DeKalb County","NHPI_AIC",16,19,3,17.14,"overcount"
"6065",29065,"Missouri","Dent County","A_A",128,54,-74,-81.32,"undercount"
"6066",29065,"Missouri","Dent County","A_AIC",169,92,-77,-59,"undercount"
"6067",29065,"Missouri","Dent County","NHPI_A",8,7,-1,-13.33,"undercount"
"6068",29065,"Missouri","Dent County","NHPI_AIC",24,20,-4,-18.18,"undercount"
"6069",29067,"Missouri","Douglas County","A_A",55,24,-31,-78.48,"undercount"
"6070",29067,"Missouri","Douglas County","A_AIC",90,37,-53,-83.46,"undercount"
"6071",29067,"Missouri","Douglas County","NHPI_A",3,0,-3,-200,"undercount"
"6072",29067,"Missouri","Douglas County","NHPI_AIC",15,11,-4,-30.77,"undercount"
"6073",29069,"Missouri","Dunklin County","A_A",244,78,-166,-103.11,"undercount"
"6074",29069,"Missouri","Dunklin County","A_AIC",290,108,-182,-91.46,"undercount"
"6075",29069,"Missouri","Dunklin County","NHPI_A",6,4,-2,-40,"undercount"
"6076",29069,"Missouri","Dunklin County","NHPI_AIC",31,37,6,17.65,"overcount"
"6077",29071,"Missouri","Franklin County","A_A",566,534,-32,-5.82,"undercount"
"6078",29071,"Missouri","Franklin County","A_AIC",862,950,88,9.71,"overcount"
"6079",29071,"Missouri","Franklin County","NHPI_A",59,32,-27,-59.34,"undercount"
"6080",29071,"Missouri","Franklin County","NHPI_AIC",114,100,-14,-13.08,"undercount"
"6081",29073,"Missouri","Gasconade County","A_A",58,52,-6,-10.91,"undercount"
"6082",29073,"Missouri","Gasconade County","A_AIC",93,90,-3,-3.28,"undercount"
"6083",29073,"Missouri","Gasconade County","NHPI_A",4,9,5,76.92,"overcount"
"6084",29073,"Missouri","Gasconade County","NHPI_AIC",16,36,20,76.92,"overcount"
"6085",29075,"Missouri","Gentry County","A_A",28,9,-19,-102.7,"undercount"
"6086",29075,"Missouri","Gentry County","A_AIC",41,31,-10,-27.78,"undercount"
"6087",29075,"Missouri","Gentry County","NHPI_A",1,1,0,0,"equal"
"6088",29075,"Missouri","Gentry County","NHPI_AIC",3,4,1,28.57,"overcount"
"6089",29077,"Missouri","Greene County","A_A",6744,6259,-485,-7.46,"undercount"
"6090",29077,"Missouri","Greene County","A_AIC",8579,8716,137,1.58,"overcount"
"6091",29077,"Missouri","Greene County","NHPI_A",329,382,53,14.91,"overcount"
"6092",29077,"Missouri","Greene County","NHPI_AIC",640,833,193,26.21,"overcount"
"6093",29079,"Missouri","Grundy County","A_A",101,54,-47,-60.65,"undercount"
"6094",29079,"Missouri","Grundy County","A_AIC",121,97,-24,-22.02,"undercount"
"6095",29079,"Missouri","Grundy County","NHPI_A",3,8,5,90.91,"overcount"
"6096",29079,"Missouri","Grundy County","NHPI_AIC",15,14,-1,-6.9,"undercount"
"6097",29081,"Missouri","Harrison County","A_A",35,24,-11,-37.29,"undercount"
"6098",29081,"Missouri","Harrison County","A_AIC",50,41,-9,-19.78,"undercount"
"6099",29081,"Missouri","Harrison County","NHPI_A",11,3,-8,-114.29,"undercount"
"6100",29081,"Missouri","Harrison County","NHPI_AIC",15,13,-2,-14.29,"undercount"
"6101",29083,"Missouri","Henry County","A_A",86,93,7,7.82,"overcount"
"6102",29083,"Missouri","Henry County","A_AIC",137,144,7,4.98,"overcount"
"6103",29083,"Missouri","Henry County","NHPI_A",18,6,-12,-100,"undercount"
"6104",29083,"Missouri","Henry County","NHPI_AIC",34,15,-19,-77.55,"undercount"
"6105",29085,"Missouri","Hickory County","A_A",21,15,-6,-33.33,"undercount"
"6106",29085,"Missouri","Hickory County","A_AIC",35,22,-13,-45.61,"undercount"
"6107",29085,"Missouri","Hickory County","NHPI_A",9,0,-9,-200,"undercount"
"6108",29085,"Missouri","Hickory County","NHPI_AIC",14,8,-6,-54.55,"undercount"
"6109",29087,"Missouri","Holt County","A_A",15,2,-13,-152.94,"undercount"
"6110",29087,"Missouri","Holt County","A_AIC",22,26,4,16.67,"overcount"
"6111",29087,"Missouri","Holt County","NHPI_A",1,0,-1,-200,"undercount"
"6112",29087,"Missouri","Holt County","NHPI_AIC",5,2,-3,-85.71,"undercount"
"6113",29089,"Missouri","Howard County","A_A",33,27,-6,-20,"undercount"
"6114",29089,"Missouri","Howard County","A_AIC",61,75,14,20.59,"overcount"
"6115",29089,"Missouri","Howard County","NHPI_A",5,3,-2,-50,"undercount"
"6116",29089,"Missouri","Howard County","NHPI_AIC",18,13,-5,-32.26,"undercount"
"6117",29091,"Missouri","Howell County","A_A",286,217,-69,-27.44,"undercount"
"6118",29091,"Missouri","Howell County","A_AIC",416,352,-64,-16.67,"undercount"
"6119",29091,"Missouri","Howell County","NHPI_A",18,17,-1,-5.71,"undercount"
"6120",29091,"Missouri","Howell County","NHPI_AIC",42,44,2,4.65,"overcount"
"6121",29093,"Missouri","Iron County","A_A",14,34,20,83.33,"overcount"
"6122",29093,"Missouri","Iron County","A_AIC",35,69,34,65.38,"overcount"
"6123",29093,"Missouri","Iron County","NHPI_A",0,2,2,200,"overcount"
"6124",29093,"Missouri","Iron County","NHPI_AIC",8,11,3,31.58,"overcount"
"6125",29095,"Missouri","Jackson County","A_A",13859,15166,1307,9.01,"overcount"
"6126",29095,"Missouri","Jackson County","A_AIC",18315,20961,2646,13.47,"overcount"
"6127",29095,"Missouri","Jackson County","NHPI_A",1879,1742,-137,-7.57,"undercount"
"6128",29095,"Missouri","Jackson County","NHPI_AIC",3110,3214,104,3.29,"overcount"
"6129",29097,"Missouri","Jasper County","A_A",1470,1515,45,3.02,"overcount"
"6130",29097,"Missouri","Jasper County","A_AIC",2014,2191,177,8.42,"overcount"
"6131",29097,"Missouri","Jasper County","NHPI_A",354,440,86,21.66,"overcount"
"6132",29097,"Missouri","Jasper County","NHPI_AIC",482,626,144,25.99,"overcount"
"6133",29099,"Missouri","Jefferson County","A_A",1848,1844,-4,-0.22,"undercount"
"6134",29099,"Missouri","Jefferson County","A_AIC",2816,3068,252,8.57,"overcount"
"6135",29099,"Missouri","Jefferson County","NHPI_A",75,71,-4,-5.48,"undercount"
"6136",29099,"Missouri","Jefferson County","NHPI_AIC",182,226,44,21.57,"overcount"
"6137",29101,"Missouri","Johnson County","A_A",929,831,-98,-11.14,"undercount"
"6138",29101,"Missouri","Johnson County","A_AIC",1388,1367,-21,-1.52,"undercount"
"6139",29101,"Missouri","Johnson County","NHPI_A",149,212,63,34.9,"overcount"
"6140",29101,"Missouri","Johnson County","NHPI_AIC",227,320,93,34,"overcount"
"6141",29103,"Missouri","Knox County","A_A",17,21,4,21.05,"overcount"
"6142",29103,"Missouri","Knox County","A_AIC",26,26,0,0,"equal"
"6143",29103,"Missouri","Knox County","NHPI_A",0,0,0,0,"equal"
"6144",29103,"Missouri","Knox County","NHPI_AIC",3,3,0,0,"equal"
"6145",29105,"Missouri","Laclede County","A_A",212,195,-17,-8.35,"undercount"
"6146",29105,"Missouri","Laclede County","A_AIC",390,332,-58,-16.07,"undercount"
"6147",29105,"Missouri","Laclede County","NHPI_A",31,17,-14,-58.33,"undercount"
"6148",29105,"Missouri","Laclede County","NHPI_AIC",71,59,-12,-18.46,"undercount"
"6149",29107,"Missouri","Lafayette County","A_A",175,122,-53,-35.69,"undercount"
"6150",29107,"Missouri","Lafayette County","A_AIC",276,241,-35,-13.54,"undercount"
"6151",29107,"Missouri","Lafayette County","NHPI_A",56,12,-44,-129.41,"undercount"
"6152",29107,"Missouri","Lafayette County","NHPI_AIC",84,60,-24,-33.33,"undercount"
"6153",29109,"Missouri","Lawrence County","A_A",200,171,-29,-15.63,"undercount"
"6154",29109,"Missouri","Lawrence County","A_AIC",299,275,-24,-8.36,"undercount"
"6155",29109,"Missouri","Lawrence County","NHPI_A",18,40,22,75.86,"overcount"
"6156",29109,"Missouri","Lawrence County","NHPI_AIC",36,45,9,22.22,"overcount"
"6157",29111,"Missouri","Lewis County","A_A",40,22,-18,-58.06,"undercount"
"6158",29111,"Missouri","Lewis County","A_AIC",59,45,-14,-26.92,"undercount"
"6159",29111,"Missouri","Lewis County","NHPI_A",7,0,-7,-200,"undercount"
"6160",29111,"Missouri","Lewis County","NHPI_AIC",10,4,-6,-85.71,"undercount"
"6161",29113,"Missouri","Lincoln County","A_A",282,238,-44,-16.92,"undercount"
"6162",29113,"Missouri","Lincoln County","A_AIC",478,498,20,4.1,"overcount"
"6163",29113,"Missouri","Lincoln County","NHPI_A",28,31,3,10.17,"overcount"
"6164",29113,"Missouri","Lincoln County","NHPI_AIC",65,65,0,0,"equal"
"6165",29115,"Missouri","Linn County","A_A",27,22,-5,-20.41,"undercount"
"6166",29115,"Missouri","Linn County","A_AIC",45,51,6,12.5,"overcount"
"6167",29115,"Missouri","Linn County","NHPI_A",6,6,0,0,"equal"
"6168",29115,"Missouri","Linn County","NHPI_AIC",10,15,5,40,"overcount"
"6169",29117,"Missouri","Livingston County","A_A",103,87,-16,-16.84,"undercount"
"6170",29117,"Missouri","Livingston County","A_AIC",144,141,-3,-2.11,"undercount"
"6171",29117,"Missouri","Livingston County","NHPI_A",6,5,-1,-18.18,"undercount"
"6172",29117,"Missouri","Livingston County","NHPI_AIC",14,13,-1,-7.41,"undercount"
"6173",29119,"Missouri","McDonald County","A_A",349,376,27,7.45,"overcount"
"6174",29119,"Missouri","McDonald County","A_AIC",438,479,41,8.94,"overcount"
"6175",29119,"Missouri","McDonald County","NHPI_A",707,868,161,20.44,"overcount"
"6176",29119,"Missouri","McDonald County","NHPI_AIC",735,914,179,21.71,"overcount"
"6177",29121,"Missouri","Macon County","A_A",121,88,-33,-31.58,"undercount"
"6178",29121,"Missouri","Macon County","A_AIC",148,147,-1,-0.68,"undercount"
"6179",29121,"Missouri","Macon County","NHPI_A",9,4,-5,-76.92,"undercount"
"6180",29121,"Missouri","Macon County","NHPI_AIC",18,8,-10,-76.92,"undercount"
"6181",29123,"Missouri","Madison County","A_A",100,41,-59,-83.69,"undercount"
"6182",29123,"Missouri","Madison County","A_AIC",130,78,-52,-50,"undercount"
"6183",29123,"Missouri","Madison County","NHPI_A",2,0,-2,-200,"undercount"
"6184",29123,"Missouri","Madison County","NHPI_AIC",8,16,8,66.67,"overcount"
"6185",29125,"Missouri","Maries County","A_A",31,7,-24,-126.32,"undercount"
"6186",29125,"Missouri","Maries County","A_AIC",55,53,-2,-3.7,"undercount"
"6187",29125,"Missouri","Maries County","NHPI_A",3,0,-3,-200,"undercount"
"6188",29125,"Missouri","Maries County","NHPI_AIC",12,6,-6,-66.67,"undercount"
"6189",29127,"Missouri","Marion County","A_A",186,175,-11,-6.09,"undercount"
"6190",29127,"Missouri","Marion County","A_AIC",273,304,31,10.75,"overcount"
"6191",29127,"Missouri","Marion County","NHPI_A",25,16,-9,-43.9,"undercount"
"6192",29127,"Missouri","Marion County","NHPI_AIC",56,62,6,10.17,"overcount"
"6193",29129,"Missouri","Mercer County","A_A",27,0,-27,-200,"undercount"
"6194",29129,"Missouri","Mercer County","A_AIC",34,11,-23,-102.22,"undercount"
"6195",29129,"Missouri","Mercer County","NHPI_A",0,0,0,0,"equal"
"6196",29129,"Missouri","Mercer County","NHPI_AIC",3,4,1,28.57,"overcount"
"6197",29131,"Missouri","Miller County","A_A",104,66,-38,-44.71,"undercount"
"6198",29131,"Missouri","Miller County","A_AIC",158,119,-39,-28.16,"undercount"
"6199",29131,"Missouri","Miller County","NHPI_A",52,31,-21,-50.6,"undercount"
"6200",29131,"Missouri","Miller County","NHPI_AIC",70,57,-13,-20.47,"undercount"
"6201",29133,"Missouri","Mississippi County","A_A",27,21,-6,-25,"undercount"
"6202",29133,"Missouri","Mississippi County","A_AIC",52,37,-15,-33.71,"undercount"
"6203",29133,"Missouri","Mississippi County","NHPI_A",2,0,-2,-200,"undercount"
"6204",29133,"Missouri","Mississippi County","NHPI_AIC",12,10,-2,-18.18,"undercount"
"6205",29135,"Missouri","Moniteau County","A_A",57,42,-15,-30.3,"undercount"
"6206",29135,"Missouri","Moniteau County","A_AIC",107,71,-36,-40.45,"undercount"
"6207",29135,"Missouri","Moniteau County","NHPI_A",14,16,2,13.33,"overcount"
"6208",29135,"Missouri","Moniteau County","NHPI_AIC",29,34,5,15.87,"overcount"
"6209",29137,"Missouri","Monroe County","A_A",36,32,-4,-11.76,"undercount"
"6210",29137,"Missouri","Monroe County","A_AIC",63,51,-12,-21.05,"undercount"
"6211",29137,"Missouri","Monroe County","NHPI_A",3,1,-2,-100,"undercount"
"6212",29137,"Missouri","Monroe County","NHPI_AIC",7,3,-4,-80,"undercount"
"6213",29139,"Missouri","Montgomery County","A_A",57,50,-7,-13.08,"undercount"
"6214",29139,"Missouri","Montgomery County","A_AIC",85,80,-5,-6.06,"undercount"
"6215",29139,"Missouri","Montgomery County","NHPI_A",5,5,0,0,"equal"
"6216",29139,"Missouri","Montgomery County","NHPI_AIC",14,15,1,6.9,"overcount"
"6217",29141,"Missouri","Morgan County","A_A",95,65,-30,-37.5,"undercount"
"6218",29141,"Missouri","Morgan County","A_AIC",155,119,-36,-26.28,"undercount"
"6219",29141,"Missouri","Morgan County","NHPI_A",8,12,4,40,"overcount"
"6220",29141,"Missouri","Morgan County","NHPI_AIC",21,29,8,32,"overcount"
"6221",29143,"Missouri","New Madrid County","A_A",66,62,-4,-6.25,"undercount"
"6222",29143,"Missouri","New Madrid County","A_AIC",105,96,-9,-8.96,"undercount"
"6223",29143,"Missouri","New Madrid County","NHPI_A",9,4,-5,-76.92,"undercount"
"6224",29143,"Missouri","New Madrid County","NHPI_AIC",15,16,1,6.45,"overcount"
"6225",29145,"Missouri","Newton County","A_A",821,805,-16,-1.97,"undercount"
"6226",29145,"Missouri","Newton County","A_AIC",1068,1067,-1,-0.09,"undercount"
"6227",29145,"Missouri","Newton County","NHPI_A",660,790,130,17.93,"overcount"
"6228",29145,"Missouri","Newton County","NHPI_AIC",739,889,150,18.43,"overcount"
"6229",29147,"Missouri","Nodaway County","A_A",329,392,63,17.48,"overcount"
"6230",29147,"Missouri","Nodaway County","A_AIC",403,469,66,15.14,"overcount"
"6231",29147,"Missouri","Nodaway County","NHPI_A",3,4,1,28.57,"overcount"
"6232",29147,"Missouri","Nodaway County","NHPI_AIC",20,20,0,0,"equal"
"6233",29149,"Missouri","Oregon County","A_A",36,8,-28,-127.27,"undercount"
"6234",29149,"Missouri","Oregon County","A_AIC",59,40,-19,-38.38,"undercount"
"6235",29149,"Missouri","Oregon County","NHPI_A",5,0,-5,-200,"undercount"
"6236",29149,"Missouri","Oregon County","NHPI_AIC",9,3,-6,-100,"undercount"
"6237",29151,"Missouri","Osage County","A_A",22,3,-19,-152,"undercount"
"6238",29151,"Missouri","Osage County","A_AIC",34,16,-18,-72,"undercount"
"6239",29151,"Missouri","Osage County","NHPI_A",8,10,2,22.22,"overcount"
"6240",29151,"Missouri","Osage County","NHPI_AIC",10,13,3,26.09,"overcount"
"6241",29153,"Missouri","Ozark County","A_A",21,14,-7,-40,"undercount"
"6242",29153,"Missouri","Ozark County","A_AIC",47,46,-1,-2.15,"undercount"
"6243",29153,"Missouri","Ozark County","NHPI_A",0,5,5,200,"overcount"
"6244",29153,"Missouri","Ozark County","NHPI_AIC",5,6,1,18.18,"overcount"
"6245",29155,"Missouri","Pemiscot County","A_A",68,36,-32,-61.54,"undercount"
"6246",29155,"Missouri","Pemiscot County","A_AIC",102,52,-50,-64.94,"undercount"
"6247",29155,"Missouri","Pemiscot County","NHPI_A",6,4,-2,-40,"undercount"
"6248",29155,"Missouri","Pemiscot County","NHPI_AIC",12,16,4,28.57,"overcount"
"6249",29157,"Missouri","Perry County","A_A",192,129,-63,-39.25,"undercount"
"6250",29157,"Missouri","Perry County","A_AIC",233,181,-52,-25.12,"undercount"
"6251",29157,"Missouri","Perry County","NHPI_A",4,0,-4,-200,"undercount"
"6252",29157,"Missouri","Perry County","NHPI_AIC",14,18,4,25,"overcount"
"6253",29159,"Missouri","Pettis County","A_A",322,294,-28,-9.09,"undercount"
"6254",29159,"Missouri","Pettis County","A_AIC",500,480,-20,-4.08,"undercount"
"6255",29159,"Missouri","Pettis County","NHPI_A",144,120,-24,-18.18,"undercount"
"6256",29159,"Missouri","Pettis County","NHPI_AIC",180,156,-24,-14.29,"undercount"
"6257",29161,"Missouri","Phelps County","A_A",1537,1541,4,0.26,"overcount"
"6258",29161,"Missouri","Phelps County","A_AIC",1794,1959,165,8.79,"overcount"
"6259",29161,"Missouri","Phelps County","NHPI_A",32,20,-12,-46.15,"undercount"
"6260",29161,"Missouri","Phelps County","NHPI_AIC",73,49,-24,-39.34,"undercount"
"6261",29163,"Missouri","Pike County","A_A",68,30,-38,-77.55,"undercount"
"6262",29163,"Missouri","Pike County","A_AIC",109,78,-31,-33.16,"undercount"
"6263",29163,"Missouri","Pike County","NHPI_A",4,7,3,54.55,"overcount"
"6264",29163,"Missouri","Pike County","NHPI_AIC",23,16,-7,-35.9,"undercount"
"6265",29165,"Missouri","Platte County","A_A",3037,2752,-285,-9.85,"undercount"
"6266",29165,"Missouri","Platte County","A_AIC",3932,3854,-78,-2,"undercount"
"6267",29165,"Missouri","Platte County","NHPI_A",567,721,154,23.91,"overcount"
"6268",29165,"Missouri","Platte County","NHPI_AIC",716,941,225,27.16,"overcount"
"6269",29167,"Missouri","Polk County","A_A",275,131,-144,-70.94,"undercount"
"6270",29167,"Missouri","Polk County","A_AIC",375,250,-125,-40,"undercount"
"6271",29167,"Missouri","Polk County","NHPI_A",13,4,-9,-105.88,"undercount"
"6272",29167,"Missouri","Polk County","NHPI_AIC",36,26,-10,-32.26,"undercount"
"6273",29169,"Missouri","Pulaski County","A_A",1568,1790,222,13.22,"overcount"
"6274",29169,"Missouri","Pulaski County","A_AIC",2256,2637,381,15.57,"overcount"
"6275",29169,"Missouri","Pulaski County","NHPI_A",330,419,89,23.77,"overcount"
"6276",29169,"Missouri","Pulaski County","NHPI_AIC",508,655,147,25.28,"overcount"
"6277",29171,"Missouri","Putnam County","A_A",23,0,-23,-200,"undercount"
"6278",29171,"Missouri","Putnam County","A_AIC",37,8,-29,-128.89,"undercount"
"6279",29171,"Missouri","Putnam County","NHPI_A",1,0,-1,-200,"undercount"
"6280",29171,"Missouri","Putnam County","NHPI_AIC",6,9,3,40,"overcount"
"6281",29173,"Missouri","Ralls County","A_A",31,17,-14,-58.33,"undercount"
"6282",29173,"Missouri","Ralls County","A_AIC",61,21,-40,-97.56,"undercount"
"6283",29173,"Missouri","Ralls County","NHPI_A",16,4,-12,-120,"undercount"
"6284",29173,"Missouri","Ralls County","NHPI_AIC",22,13,-9,-51.43,"undercount"
"6285",29175,"Missouri","Randolph County","A_A",162,95,-67,-52.14,"undercount"
"6286",29175,"Missouri","Randolph County","A_AIC",244,196,-48,-21.82,"undercount"
"6287",29175,"Missouri","Randolph County","NHPI_A",9,10,1,10.53,"overcount"
"6288",29175,"Missouri","Randolph County","NHPI_AIC",30,31,1,3.28,"overcount"
"6289",29177,"Missouri","Ray County","A_A",76,76,0,0,"equal"
"6290",29177,"Missouri","Ray County","A_AIC",141,136,-5,-3.61,"undercount"
"6291",29177,"Missouri","Ray County","NHPI_A",25,8,-17,-103.03,"undercount"
"6292",29177,"Missouri","Ray County","NHPI_AIC",40,45,5,11.76,"overcount"
"6293",29179,"Missouri","Reynolds County","A_A",12,18,6,40,"overcount"
"6294",29179,"Missouri","Reynolds County","A_AIC",36,35,-1,-2.82,"undercount"
"6295",29179,"Missouri","Reynolds County","NHPI_A",1,2,1,66.67,"overcount"
"6296",29179,"Missouri","Reynolds County","NHPI_AIC",5,8,3,46.15,"overcount"
"6297",29181,"Missouri","Ripley County","A_A",39,28,-11,-32.84,"undercount"
"6298",29181,"Missouri","Ripley County","A_AIC",72,52,-20,-32.26,"undercount"
"6299",29181,"Missouri","Ripley County","NHPI_A",1,1,0,0,"equal"
"6300",29181,"Missouri","Ripley County","NHPI_AIC",12,5,-7,-82.35,"undercount"
"6301",29183,"Missouri","St. Charles County","A_A",11400,11153,-247,-2.19,"undercount"
"6302",29183,"Missouri","St. Charles County","A_AIC",13958,14714,756,5.27,"overcount"
"6303",29183,"Missouri","St. Charles County","NHPI_A",170,202,32,17.2,"overcount"
"6304",29183,"Missouri","St. Charles County","NHPI_AIC",435,569,134,26.69,"overcount"
"6305",29185,"Missouri","St. Clair County","A_A",32,19,-13,-50.98,"undercount"
"6306",29185,"Missouri","St. Clair County","A_AIC",54,48,-6,-11.76,"undercount"
"6307",29185,"Missouri","St. Clair County","NHPI_A",2,7,5,111.11,"overcount"
"6308",29185,"Missouri","St. Clair County","NHPI_AIC",10,13,3,26.09,"overcount"
"6309",29186,"Missouri","Ste. Genevieve County","A_A",49,29,-20,-51.28,"undercount"
"6310",29186,"Missouri","Ste. Genevieve County","A_AIC",79,84,5,6.13,"overcount"
"6311",29186,"Missouri","Ste. Genevieve County","NHPI_A",116,2,-114,-193.22,"undercount"
"6312",29186,"Missouri","Ste. Genevieve County","NHPI_AIC",124,17,-107,-151.77,"undercount"
"6313",29187,"Missouri","St. Francois County","A_A",281,403,122,35.67,"overcount"
"6314",29187,"Missouri","St. Francois County","A_AIC",437,633,196,36.64,"overcount"
"6315",29187,"Missouri","St. Francois County","NHPI_A",39,21,-18,-60,"undercount"
"6316",29187,"Missouri","St. Francois County","NHPI_AIC",73,67,-6,-8.57,"undercount"
"6317",29189,"Missouri","St. Louis County","A_A",48067,48993,926,1.91,"overcount"
"6318",29189,"Missouri","St. Louis County","A_AIC",55945,58577,2632,4.6,"overcount"
"6319",29189,"Missouri","St. Louis County","NHPI_A",157,274,117,54.29,"overcount"
"6320",29189,"Missouri","St. Louis County","NHPI_AIC",917,972,55,5.82,"overcount"
"6321",29195,"Missouri","Saline County","A_A",223,197,-26,-12.38,"undercount"
"6322",29195,"Missouri","Saline County","A_AIC",296,266,-30,-10.68,"undercount"
"6323",29195,"Missouri","Saline County","NHPI_A",316,397,81,22.72,"overcount"
"6324",29195,"Missouri","Saline County","NHPI_AIC",341,431,90,23.32,"overcount"
"6325",29197,"Missouri","Schuyler County","A_A",15,27,12,57.14,"overcount"
"6326",29197,"Missouri","Schuyler County","A_AIC",22,44,22,66.67,"overcount"
"6327",29197,"Missouri","Schuyler County","NHPI_A",0,1,1,200,"overcount"
"6328",29197,"Missouri","Schuyler County","NHPI_AIC",5,3,-2,-50,"undercount"
"6329",29199,"Missouri","Scotland County","A_A",11,5,-6,-75,"undercount"
"6330",29199,"Missouri","Scotland County","A_AIC",18,20,2,10.53,"overcount"
"6331",29199,"Missouri","Scotland County","NHPI_A",0,1,1,200,"overcount"
"6332",29199,"Missouri","Scotland County","NHPI_AIC",2,7,5,111.11,"overcount"
"6333",29201,"Missouri","Scott County","A_A",163,153,-10,-6.33,"undercount"
"6334",29201,"Missouri","Scott County","A_AIC",239,225,-14,-6.03,"undercount"
"6335",29201,"Missouri","Scott County","NHPI_A",12,2,-10,-142.86,"undercount"
"6336",29201,"Missouri","Scott County","NHPI_AIC",38,21,-17,-57.63,"undercount"
"6337",29203,"Missouri","Shannon County","A_A",22,13,-9,-51.43,"undercount"
"6338",29203,"Missouri","Shannon County","A_AIC",42,45,3,6.9,"overcount"
"6339",29203,"Missouri","Shannon County","NHPI_A",1,1,0,0,"equal"
"6340",29203,"Missouri","Shannon County","NHPI_AIC",7,20,13,96.3,"overcount"
"6341",29205,"Missouri","Shelby County","A_A",14,2,-12,-150,"undercount"
"6342",29205,"Missouri","Shelby County","A_AIC",25,22,-3,-12.77,"undercount"
"6343",29205,"Missouri","Shelby County","NHPI_A",0,0,0,0,"equal"
"6344",29205,"Missouri","Shelby County","NHPI_AIC",1,11,10,166.67,"overcount"
"6345",29207,"Missouri","Stoddard County","A_A",110,90,-20,-20,"undercount"
"6346",29207,"Missouri","Stoddard County","A_AIC",171,158,-13,-7.9,"undercount"
"6347",29207,"Missouri","Stoddard County","NHPI_A",5,2,-3,-85.71,"undercount"
"6348",29207,"Missouri","Stoddard County","NHPI_AIC",15,15,0,0,"equal"
"6349",29209,"Missouri","Stone County","A_A",142,136,-6,-4.32,"undercount"
"6350",29209,"Missouri","Stone County","A_AIC",199,213,14,6.8,"overcount"
"6351",29209,"Missouri","Stone County","NHPI_A",16,21,5,27.03,"overcount"
"6352",29209,"Missouri","Stone County","NHPI_AIC",34,45,11,27.85,"overcount"
"6353",29211,"Missouri","Sullivan County","A_A",21,32,11,41.51,"overcount"
"6354",29211,"Missouri","Sullivan County","A_AIC",27,51,24,61.54,"overcount"
"6355",29211,"Missouri","Sullivan County","NHPI_A",2,1,-1,-66.67,"undercount"
"6356",29211,"Missouri","Sullivan County","NHPI_AIC",3,7,4,80,"overcount"
"6357",29213,"Missouri","Taney County","A_A",595,621,26,4.28,"overcount"
"6358",29213,"Missouri","Taney County","A_AIC",840,993,153,16.69,"overcount"
"6359",29213,"Missouri","Taney County","NHPI_A",58,187,129,105.31,"overcount"
"6360",29213,"Missouri","Taney County","NHPI_AIC",110,292,182,90.55,"overcount"
"6361",29215,"Missouri","Texas County","A_A",81,67,-14,-18.92,"undercount"
"6362",29215,"Missouri","Texas County","A_AIC",136,130,-6,-4.51,"undercount"
"6363",29215,"Missouri","Texas County","NHPI_A",12,6,-6,-66.67,"undercount"
"6364",29215,"Missouri","Texas County","NHPI_AIC",30,29,-1,-3.39,"undercount"
"6365",29217,"Missouri","Vernon County","A_A",140,105,-35,-28.57,"undercount"
"6366",29217,"Missouri","Vernon County","A_AIC",180,167,-13,-7.49,"undercount"
"6367",29217,"Missouri","Vernon County","NHPI_A",7,18,11,88,"overcount"
"6368",29217,"Missouri","Vernon County","NHPI_AIC",21,40,19,62.3,"overcount"
"6369",29219,"Missouri","Warren County","A_A",144,145,1,0.69,"overcount"
"6370",29219,"Missouri","Warren County","A_AIC",249,296,47,17.25,"overcount"
"6371",29219,"Missouri","Warren County","NHPI_A",17,1,-16,-177.78,"undercount"
"6372",29219,"Missouri","Warren County","NHPI_AIC",35,33,-2,-5.88,"undercount"
"6373",29221,"Missouri","Washington County","A_A",77,42,-35,-58.82,"undercount"
"6374",29221,"Missouri","Washington County","A_AIC",113,89,-24,-23.76,"undercount"
"6375",29221,"Missouri","Washington County","NHPI_A",6,1,-5,-142.86,"undercount"
"6376",29221,"Missouri","Washington County","NHPI_AIC",17,19,2,11.11,"overcount"
"6377",29223,"Missouri","Wayne County","A_A",36,24,-12,-40,"undercount"
"6378",29223,"Missouri","Wayne County","A_AIC",52,45,-7,-14.43,"undercount"
"6379",29223,"Missouri","Wayne County","NHPI_A",4,5,1,22.22,"overcount"
"6380",29223,"Missouri","Wayne County","NHPI_AIC",7,14,7,66.67,"overcount"
"6381",29225,"Missouri","Webster County","A_A",137,142,5,3.58,"overcount"
"6382",29225,"Missouri","Webster County","A_AIC",241,262,21,8.35,"overcount"
"6383",29225,"Missouri","Webster County","NHPI_A",9,9,0,0,"equal"
"6384",29225,"Missouri","Webster County","NHPI_AIC",32,32,0,0,"equal"
"6385",29227,"Missouri","Worth County","A_A",5,7,2,33.33,"overcount"
"6386",29227,"Missouri","Worth County","A_AIC",8,7,-1,-13.33,"undercount"
"6387",29227,"Missouri","Worth County","NHPI_A",0,5,5,200,"overcount"
"6388",29227,"Missouri","Worth County","NHPI_AIC",0,6,6,200,"overcount"
"6389",29229,"Missouri","Wright County","A_A",76,54,-22,-33.85,"undercount"
"6390",29229,"Missouri","Wright County","A_AIC",101,112,11,10.33,"overcount"
"6391",29229,"Missouri","Wright County","NHPI_A",14,5,-9,-94.74,"undercount"
"6392",29229,"Missouri","Wright County","NHPI_AIC",19,23,4,19.05,"overcount"
"6393",29510,"Missouri","St. Louis city","A_A",10368,12338,1970,17.35,"overcount"
"6394",29510,"Missouri","St. Louis city","A_AIC",12548,15135,2587,18.69,"overcount"
"6395",29510,"Missouri","St. Louis city","NHPI_A",94,88,-6,-6.59,"undercount"
"6396",29510,"Missouri","St. Louis city","NHPI_AIC",389,328,-61,-17.02,"undercount"
"6397",30001,"Montana","Beaverhead County","A_A",53,37,-16,-35.56,"undercount"
"6398",30001,"Montana","Beaverhead County","A_AIC",89,62,-27,-35.76,"undercount"
"6399",30001,"Montana","Beaverhead County","NHPI_A",55,3,-52,-179.31,"undercount"
"6400",30001,"Montana","Beaverhead County","NHPI_AIC",67,9,-58,-152.63,"undercount"
"6401",30003,"Montana","Big Horn County","A_A",93,44,-49,-71.53,"undercount"
"6402",30003,"Montana","Big Horn County","A_AIC",130,96,-34,-30.09,"undercount"
"6403",30003,"Montana","Big Horn County","NHPI_A",3,9,6,100,"overcount"
"6404",30003,"Montana","Big Horn County","NHPI_AIC",14,21,7,40,"overcount"
"6405",30005,"Montana","Blaine County","A_A",15,13,-2,-14.29,"undercount"
"6406",30005,"Montana","Blaine County","A_AIC",32,51,19,45.78,"overcount"
"6407",30005,"Montana","Blaine County","NHPI_A",1,0,-1,-200,"undercount"
"6408",30005,"Montana","Blaine County","NHPI_AIC",2,20,18,163.64,"overcount"
"6409",30007,"Montana","Broadwater County","A_A",21,6,-15,-111.11,"undercount"
"6410",30007,"Montana","Broadwater County","A_AIC",35,32,-3,-8.96,"undercount"
"6411",30007,"Montana","Broadwater County","NHPI_A",9,0,-9,-200,"undercount"
"6412",30007,"Montana","Broadwater County","NHPI_AIC",11,10,-1,-9.52,"undercount"
"6413",30009,"Montana","Carbon County","A_A",41,21,-20,-64.52,"undercount"
"6414",30009,"Montana","Carbon County","A_AIC",64,74,10,14.49,"overcount"
"6415",30009,"Montana","Carbon County","NHPI_A",5,0,-5,-200,"undercount"
"6416",30009,"Montana","Carbon County","NHPI_AIC",11,30,19,92.68,"overcount"
"6417",30011,"Montana","Carter County","A_A",1,1,0,0,"equal"
"6418",30011,"Montana","Carter County","A_AIC",2,15,13,152.94,"overcount"
"6419",30011,"Montana","Carter County","NHPI_A",0,0,0,0,"equal"
"6420",30011,"Montana","Carter County","NHPI_AIC",3,10,7,107.69,"overcount"
"6421",30013,"Montana","Cascade County","A_A",821,941,120,13.62,"overcount"
"6422",30013,"Montana","Cascade County","A_AIC",1565,1787,222,13.25,"overcount"
"6423",30013,"Montana","Cascade County","NHPI_A",74,115,41,43.39,"overcount"
"6424",30013,"Montana","Cascade County","NHPI_AIC",231,318,87,31.69,"overcount"
"6425",30015,"Montana","Chouteau County","A_A",24,18,-6,-28.57,"undercount"
"6426",30015,"Montana","Chouteau County","A_AIC",41,52,11,23.66,"overcount"
"6427",30015,"Montana","Chouteau County","NHPI_A",4,0,-4,-200,"undercount"
"6428",30015,"Montana","Chouteau County","NHPI_AIC",10,4,-6,-85.71,"undercount"
"6429",30017,"Montana","Custer County","A_A",97,53,-44,-58.67,"undercount"
"6430",30017,"Montana","Custer County","A_AIC",144,120,-24,-18.18,"undercount"
"6431",30017,"Montana","Custer County","NHPI_A",3,7,4,80,"overcount"
"6432",30017,"Montana","Custer County","NHPI_AIC",12,26,14,73.68,"overcount"
"6433",30019,"Montana","Daniels County","A_A",3,14,11,129.41,"overcount"
"6434",30019,"Montana","Daniels County","A_AIC",10,39,29,118.37,"overcount"
"6435",30019,"Montana","Daniels County","NHPI_A",0,0,0,0,"equal"
"6436",30019,"Montana","Daniels County","NHPI_AIC",0,4,4,200,"overcount"
"6437",30021,"Montana","Dawson County","A_A",49,62,13,23.42,"overcount"
"6438",30021,"Montana","Dawson County","A_AIC",61,100,39,48.45,"overcount"
"6439",30021,"Montana","Dawson County","NHPI_A",3,1,-2,-100,"undercount"
"6440",30021,"Montana","Dawson County","NHPI_AIC",6,9,3,40,"overcount"
"6441",30023,"Montana","Deer Lodge County","A_A",42,34,-8,-21.05,"undercount"
"6442",30023,"Montana","Deer Lodge County","A_AIC",70,76,6,8.22,"overcount"
"6443",30023,"Montana","Deer Lodge County","NHPI_A",4,2,-2,-66.67,"undercount"
"6444",30023,"Montana","Deer Lodge County","NHPI_AIC",13,14,1,7.41,"overcount"
"6445",30025,"Montana","Fallon County","A_A",23,5,-18,-128.57,"undercount"
"6446",30025,"Montana","Fallon County","A_AIC",30,16,-14,-60.87,"undercount"
"6447",30025,"Montana","Fallon County","NHPI_A",5,2,-3,-85.71,"undercount"
"6448",30025,"Montana","Fallon County","NHPI_AIC",7,13,6,60,"overcount"
"6449",30027,"Montana","Fergus County","A_A",83,39,-44,-72.13,"undercount"
"6450",30027,"Montana","Fergus County","A_AIC",116,85,-31,-30.85,"undercount"
"6451",30027,"Montana","Fergus County","NHPI_A",0,0,0,0,"equal"
"6452",30027,"Montana","Fergus County","NHPI_AIC",9,4,-5,-76.92,"undercount"
"6453",30029,"Montana","Flathead County","A_A",878,705,-173,-21.86,"undercount"
"6454",30029,"Montana","Flathead County","A_AIC",1463,1524,61,4.08,"overcount"
"6455",30029,"Montana","Flathead County","NHPI_A",68,86,18,23.38,"overcount"
"6456",30029,"Montana","Flathead County","NHPI_AIC",173,260,87,40.18,"overcount"
"6457",30031,"Montana","Gallatin County","A_A",1915,1437,-478,-28.52,"undercount"
"6458",30031,"Montana","Gallatin County","A_AIC",2791,2695,-96,-3.5,"undercount"
"6459",30031,"Montana","Gallatin County","NHPI_A",72,91,19,23.31,"overcount"
"6460",30031,"Montana","Gallatin County","NHPI_AIC",202,245,43,19.24,"overcount"
"6461",30033,"Montana","Garfield County","A_A",1,2,1,66.67,"overcount"
"6462",30033,"Montana","Garfield County","A_AIC",2,5,3,85.71,"overcount"
"6463",30033,"Montana","Garfield County","NHPI_A",0,1,1,200,"overcount"
"6464",30033,"Montana","Garfield County","NHPI_AIC",0,3,3,200,"overcount"
"6465",30035,"Montana","Glacier County","A_A",45,39,-6,-14.29,"undercount"
"6466",30035,"Montana","Glacier County","A_AIC",83,81,-2,-2.44,"undercount"
"6467",30035,"Montana","Glacier County","NHPI_A",2,16,14,155.56,"overcount"
"6468",30035,"Montana","Glacier County","NHPI_AIC",12,42,30,111.11,"overcount"
"6469",30037,"Montana","Golden Valley County","A_A",5,0,-5,-200,"undercount"
"6470",30037,"Montana","Golden Valley County","A_AIC",11,0,-11,-200,"undercount"
"6471",30037,"Montana","Golden Valley County","NHPI_A",2,1,-1,-66.67,"undercount"
"6472",30037,"Montana","Golden Valley County","NHPI_AIC",2,2,0,0,"equal"
"6473",30039,"Montana","Granite County","A_A",16,3,-13,-136.84,"undercount"
"6474",30039,"Montana","Granite County","A_AIC",29,12,-17,-82.93,"undercount"
"6475",30039,"Montana","Granite County","NHPI_A",1,0,-1,-200,"undercount"
"6476",30039,"Montana","Granite County","NHPI_AIC",2,7,5,111.11,"overcount"
"6477",30041,"Montana","Hill County","A_A",100,79,-21,-23.46,"undercount"
"6478",30041,"Montana","Hill County","A_AIC",204,201,-3,-1.48,"undercount"
"6479",30041,"Montana","Hill County","NHPI_A",8,8,0,0,"equal"
"6480",30041,"Montana","Hill County","NHPI_AIC",43,34,-9,-23.38,"undercount"
"6481",30043,"Montana","Jefferson County","A_A",70,49,-21,-35.29,"undercount"
"6482",30043,"Montana","Jefferson County","A_AIC",122,107,-15,-13.1,"undercount"
"6483",30043,"Montana","Jefferson County","NHPI_A",12,0,-12,-200,"undercount"
"6484",30043,"Montana","Jefferson County","NHPI_AIC",26,18,-8,-36.36,"undercount"
"6485",30045,"Montana","Judith Basin County","A_A",12,6,-6,-66.67,"undercount"
"6486",30045,"Montana","Judith Basin County","A_AIC",14,12,-2,-15.38,"undercount"
"6487",30045,"Montana","Judith Basin County","NHPI_A",0,2,2,200,"overcount"
"6488",30045,"Montana","Judith Basin County","NHPI_AIC",0,10,10,200,"overcount"
"6489",30047,"Montana","Lake County","A_A",218,138,-80,-44.94,"undercount"
"6490",30047,"Montana","Lake County","A_AIC",342,275,-67,-21.72,"undercount"
"6491",30047,"Montana","Lake County","NHPI_A",34,21,-13,-47.27,"undercount"
"6492",30047,"Montana","Lake County","NHPI_AIC",84,71,-13,-16.77,"undercount"
"6493",30049,"Montana","Lewis and Clark County","A_A",548,554,6,1.09,"overcount"
"6494",30049,"Montana","Lewis and Clark County","A_AIC",915,1097,182,18.09,"overcount"
"6495",30049,"Montana","Lewis and Clark County","NHPI_A",39,44,5,12.05,"overcount"
"6496",30049,"Montana","Lewis and Clark County","NHPI_AIC",118,165,47,33.22,"overcount"
"6497",30051,"Montana","Liberty County","A_A",4,6,2,40,"overcount"
"6498",30051,"Montana","Liberty County","A_AIC",16,15,-1,-6.45,"undercount"
"6499",30051,"Montana","Liberty County","NHPI_A",1,0,-1,-200,"undercount"
"6500",30051,"Montana","Liberty County","NHPI_AIC",4,11,7,93.33,"overcount"
"6501",30053,"Montana","Lincoln County","A_A",80,100,20,22.22,"overcount"
"6502",30053,"Montana","Lincoln County","A_AIC",169,203,34,18.28,"overcount"
"6503",30053,"Montana","Lincoln County","NHPI_A",23,13,-10,-55.56,"undercount"
"6504",30053,"Montana","Lincoln County","NHPI_AIC",46,55,9,17.82,"overcount"
"6505",30055,"Montana","McCone County","A_A",5,8,3,46.15,"overcount"
"6506",30055,"Montana","McCone County","A_AIC",15,24,9,46.15,"overcount"
"6507",30055,"Montana","McCone County","NHPI_A",0,2,2,200,"overcount"
"6508",30055,"Montana","McCone County","NHPI_AIC",2,8,6,120,"overcount"
"6509",30057,"Montana","Madison County","A_A",45,30,-15,-40,"undercount"
"6510",30057,"Montana","Madison County","A_AIC",64,71,7,10.37,"overcount"
"6511",30057,"Montana","Madison County","NHPI_A",3,6,3,66.67,"overcount"
"6512",30057,"Montana","Madison County","NHPI_AIC",8,27,19,108.57,"overcount"
"6513",30059,"Montana","Meagher County","A_A",8,2,-6,-120,"undercount"
"6514",30059,"Montana","Meagher County","A_AIC",9,22,13,83.87,"overcount"
"6515",30059,"Montana","Meagher County","NHPI_A",0,0,0,0,"equal"
"6516",30059,"Montana","Meagher County","NHPI_AIC",2,8,6,120,"overcount"
"6517",30061,"Montana","Mineral County","A_A",31,21,-10,-38.46,"undercount"
"6518",30061,"Montana","Mineral County","A_AIC",53,56,3,5.5,"overcount"
"6519",30061,"Montana","Mineral County","NHPI_A",1,5,4,133.33,"overcount"
"6520",30061,"Montana","Mineral County","NHPI_AIC",3,20,17,147.83,"overcount"
"6521",30063,"Montana","Missoula County","A_A",2314,1457,-857,-45.45,"undercount"
"6522",30063,"Montana","Missoula County","A_AIC",3385,2615,-770,-25.67,"undercount"
"6523",30063,"Montana","Missoula County","NHPI_A",110,125,15,12.77,"overcount"
"6524",30063,"Montana","Missoula County","NHPI_AIC",294,349,55,17.11,"overcount"
"6525",30065,"Montana","Musselshell County","A_A",63,23,-40,-93.02,"undercount"
"6526",30065,"Montana","Musselshell County","A_AIC",75,33,-42,-77.78,"undercount"
"6527",30065,"Montana","Musselshell County","NHPI_A",2,5,3,85.71,"overcount"
"6528",30065,"Montana","Musselshell County","NHPI_AIC",6,8,2,28.57,"overcount"
"6529",30067,"Montana","Park County","A_A",77,75,-2,-2.63,"undercount"
"6530",30067,"Montana","Park County","A_AIC",160,165,5,3.08,"overcount"
"6531",30067,"Montana","Park County","NHPI_A",7,0,-7,-200,"undercount"
"6532",30067,"Montana","Park County","NHPI_AIC",32,15,-17,-72.34,"undercount"
"6533",30069,"Montana","Petroleum County","A_A",0,0,0,0,"equal"
"6534",30069,"Montana","Petroleum County","A_AIC",1,4,3,120,"overcount"
"6535",30069,"Montana","Petroleum County","NHPI_A",0,1,1,200,"overcount"
"6536",30069,"Montana","Petroleum County","NHPI_AIC",1,8,7,155.56,"overcount"
"6537",30071,"Montana","Phillips County","A_A",13,16,3,20.69,"overcount"
"6538",30071,"Montana","Phillips County","A_AIC",36,36,0,0,"equal"
"6539",30071,"Montana","Phillips County","NHPI_A",1,0,-1,-200,"undercount"
"6540",30071,"Montana","Phillips County","NHPI_AIC",6,7,1,15.38,"overcount"
"6541",30073,"Montana","Pondera County","A_A",31,25,-6,-21.43,"undercount"
"6542",30073,"Montana","Pondera County","A_AIC",52,31,-21,-50.6,"undercount"
"6543",30073,"Montana","Pondera County","NHPI_A",5,11,6,75,"overcount"
"6544",30073,"Montana","Pondera County","NHPI_AIC",14,20,6,35.29,"overcount"
"6545",30075,"Montana","Powder River County","A_A",2,0,-2,-200,"undercount"
"6546",30075,"Montana","Powder River County","A_AIC",10,2,-8,-133.33,"undercount"
"6547",30075,"Montana","Powder River County","NHPI_A",0,0,0,0,"equal"
"6548",30075,"Montana","Powder River County","NHPI_AIC",3,3,0,0,"equal"
"6549",30077,"Montana","Powell County","A_A",28,23,-5,-19.61,"undercount"
"6550",30077,"Montana","Powell County","A_AIC",53,42,-11,-23.16,"undercount"
"6551",30077,"Montana","Powell County","NHPI_A",4,3,-1,-28.57,"undercount"
"6552",30077,"Montana","Powell County","NHPI_AIC",9,7,-2,-25,"undercount"
"6553",30079,"Montana","Prairie County","A_A",9,10,1,10.53,"overcount"
"6554",30079,"Montana","Prairie County","A_AIC",13,16,3,20.69,"overcount"
"6555",30079,"Montana","Prairie County","NHPI_A",0,0,0,0,"equal"
"6556",30079,"Montana","Prairie County","NHPI_AIC",1,2,1,66.67,"overcount"
"6557",30081,"Montana","Ravalli County","A_A",312,263,-49,-17.04,"undercount"
"6558",30081,"Montana","Ravalli County","A_AIC",464,503,39,8.07,"overcount"
"6559",30081,"Montana","Ravalli County","NHPI_A",40,51,11,24.18,"overcount"
"6560",30081,"Montana","Ravalli County","NHPI_AIC",78,98,20,22.73,"overcount"
"6561",30083,"Montana","Richland County","A_A",62,125,63,67.38,"overcount"
"6562",30083,"Montana","Richland County","A_AIC",106,173,67,48.03,"overcount"
"6563",30083,"Montana","Richland County","NHPI_A",3,5,2,50,"overcount"
"6564",30083,"Montana","Richland County","NHPI_AIC",17,14,-3,-19.35,"undercount"
"6565",30085,"Montana","Roosevelt County","A_A",63,48,-15,-27.03,"undercount"
"6566",30085,"Montana","Roosevelt County","A_AIC",102,102,0,0,"equal"
"6567",30085,"Montana","Roosevelt County","NHPI_A",6,0,-6,-200,"undercount"
"6568",30085,"Montana","Roosevelt County","NHPI_AIC",17,3,-14,-140,"undercount"
"6569",30087,"Montana","Rosebud County","A_A",139,33,-106,-123.26,"undercount"
"6570",30087,"Montana","Rosebud County","A_AIC",173,64,-109,-91.98,"undercount"
"6571",30087,"Montana","Rosebud County","NHPI_A",4,2,-2,-66.67,"undercount"
"6572",30087,"Montana","Rosebud County","NHPI_AIC",18,15,-3,-18.18,"undercount"
"6573",30089,"Montana","Sanders County","A_A",49,56,7,13.33,"overcount"
"6574",30089,"Montana","Sanders County","A_AIC",87,117,30,29.41,"overcount"
"6575",30089,"Montana","Sanders County","NHPI_A",2,3,1,40,"overcount"
"6576",30089,"Montana","Sanders County","NHPI_AIC",16,27,11,51.16,"overcount"
"6577",30091,"Montana","Sheridan County","A_A",22,13,-9,-51.43,"undercount"
"6578",30091,"Montana","Sheridan County","A_AIC",32,26,-6,-20.69,"undercount"
"6579",30091,"Montana","Sheridan County","NHPI_A",0,0,0,0,"equal"
"6580",30091,"Montana","Sheridan County","NHPI_AIC",7,8,1,13.33,"overcount"
"6581",30093,"Montana","Silver Bow County","A_A",276,216,-60,-24.39,"undercount"
"6582",30093,"Montana","Silver Bow County","A_AIC",434,361,-73,-18.36,"undercount"
"6583",30093,"Montana","Silver Bow County","NHPI_A",28,20,-8,-33.33,"undercount"
"6584",30093,"Montana","Silver Bow County","NHPI_AIC",67,67,0,0,"equal"
"6585",30095,"Montana","Stillwater County","A_A",41,23,-18,-56.25,"undercount"
"6586",30095,"Montana","Stillwater County","A_AIC",81,60,-21,-29.79,"undercount"
"6587",30095,"Montana","Stillwater County","NHPI_A",5,0,-5,-200,"undercount"
"6588",30095,"Montana","Stillwater County","NHPI_AIC",15,20,5,28.57,"overcount"
"6589",30097,"Montana","Sweet Grass County","A_A",27,15,-12,-57.14,"undercount"
"6590",30097,"Montana","Sweet Grass County","A_AIC",45,38,-7,-16.87,"undercount"
"6591",30097,"Montana","Sweet Grass County","NHPI_A",1,3,2,100,"overcount"
"6592",30097,"Montana","Sweet Grass County","NHPI_AIC",3,14,11,129.41,"overcount"
"6593",30099,"Montana","Teton County","A_A",78,15,-63,-135.48,"undercount"
"6594",30099,"Montana","Teton County","A_AIC",101,36,-65,-94.89,"undercount"
"6595",30099,"Montana","Teton County","NHPI_A",1,6,5,142.86,"overcount"
"6596",30099,"Montana","Teton County","NHPI_AIC",9,19,10,71.43,"overcount"
"6597",30101,"Montana","Toole County","A_A",35,36,1,2.82,"overcount"
"6598",30101,"Montana","Toole County","A_AIC",55,59,4,7.02,"overcount"
"6599",30101,"Montana","Toole County","NHPI_A",2,0,-2,-200,"undercount"
"6600",30101,"Montana","Toole County","NHPI_AIC",5,7,2,33.33,"overcount"
"6601",30103,"Montana","Treasure County","A_A",6,4,-2,-40,"undercount"
"6602",30103,"Montana","Treasure County","A_AIC",8,8,0,0,"equal"
"6603",30103,"Montana","Treasure County","NHPI_A",0,1,1,200,"overcount"
"6604",30103,"Montana","Treasure County","NHPI_AIC",0,4,4,200,"overcount"
"6605",30105,"Montana","Valley County","A_A",76,19,-57,-120,"undercount"
"6606",30105,"Montana","Valley County","A_AIC",102,47,-55,-73.83,"undercount"
"6607",30105,"Montana","Valley County","NHPI_A",4,0,-4,-200,"undercount"
"6608",30105,"Montana","Valley County","NHPI_AIC",11,17,6,42.86,"overcount"
"6609",30107,"Montana","Wheatland County","A_A",12,3,-9,-120,"undercount"
"6610",30107,"Montana","Wheatland County","A_AIC",19,9,-10,-71.43,"undercount"
"6611",30107,"Montana","Wheatland County","NHPI_A",0,0,0,0,"equal"
"6612",30107,"Montana","Wheatland County","NHPI_AIC",1,10,9,163.64,"overcount"
"6613",30109,"Montana","Wibaux County","A_A",8,5,-3,-46.15,"undercount"
"6614",30109,"Montana","Wibaux County","A_AIC",11,13,2,16.67,"overcount"
"6615",30109,"Montana","Wibaux County","NHPI_A",2,2,0,0,"equal"
"6616",30109,"Montana","Wibaux County","NHPI_AIC",2,2,0,0,"equal"
"6617",30111,"Montana","Yellowstone County","A_A",1234,1281,47,3.74,"overcount"
"6618",30111,"Montana","Yellowstone County","A_AIC",2246,2521,275,11.54,"overcount"
"6619",30111,"Montana","Yellowstone County","NHPI_A",121,213,92,55.09,"overcount"
"6620",30111,"Montana","Yellowstone County","NHPI_AIC",390,554,164,34.75,"overcount"
"6621",31001,"Nebraska","Adams County","A_A",380,419,39,9.76,"overcount"
"6622",31001,"Nebraska","Adams County","A_AIC",452,546,94,18.84,"overcount"
"6623",31001,"Nebraska","Adams County","NHPI_A",13,9,-4,-36.36,"undercount"
"6624",31001,"Nebraska","Adams County","NHPI_AIC",25,38,13,41.27,"overcount"
"6625",31003,"Nebraska","Antelope County","A_A",25,22,-3,-12.77,"undercount"
"6626",31003,"Nebraska","Antelope County","A_AIC",35,35,0,0,"equal"
"6627",31003,"Nebraska","Antelope County","NHPI_A",1,0,-1,-200,"undercount"
"6628",31003,"Nebraska","Antelope County","NHPI_AIC",2,0,-2,-200,"undercount"
"6629",31005,"Nebraska","Arthur County","A_A",1,0,-1,-200,"undercount"
"6630",31005,"Nebraska","Arthur County","A_AIC",1,3,2,100,"overcount"
"6631",31005,"Nebraska","Arthur County","NHPI_A",0,0,0,0,"equal"
"6632",31005,"Nebraska","Arthur County","NHPI_AIC",0,0,0,0,"equal"
"6633",31007,"Nebraska","Banner County","A_A",2,2,0,0,"equal"
"6634",31007,"Nebraska","Banner County","A_AIC",2,6,4,100,"overcount"
"6635",31007,"Nebraska","Banner County","NHPI_A",0,0,0,0,"equal"
"6636",31007,"Nebraska","Banner County","NHPI_AIC",0,2,2,200,"overcount"
"6637",31009,"Nebraska","Blaine County","A_A",0,1,1,200,"overcount"
"6638",31009,"Nebraska","Blaine County","A_AIC",0,4,4,200,"overcount"
"6639",31009,"Nebraska","Blaine County","NHPI_A",0,0,0,0,"equal"
"6640",31009,"Nebraska","Blaine County","NHPI_AIC",0,1,1,200,"overcount"
"6641",31011,"Nebraska","Boone County","A_A",10,7,-3,-35.29,"undercount"
"6642",31011,"Nebraska","Boone County","A_AIC",14,14,0,0,"equal"
"6643",31011,"Nebraska","Boone County","NHPI_A",0,0,0,0,"equal"
"6644",31011,"Nebraska","Boone County","NHPI_AIC",1,6,5,142.86,"overcount"
"6645",31013,"Nebraska","Box Butte County","A_A",79,71,-8,-10.67,"undercount"
"6646",31013,"Nebraska","Box Butte County","A_AIC",118,109,-9,-7.93,"undercount"
"6647",31013,"Nebraska","Box Butte County","NHPI_A",2,0,-2,-200,"undercount"
"6648",31013,"Nebraska","Box Butte County","NHPI_AIC",11,6,-5,-58.82,"undercount"
"6649",31015,"Nebraska","Boyd County","A_A",26,0,-26,-200,"undercount"
"6650",31015,"Nebraska","Boyd County","A_AIC",28,5,-23,-139.39,"undercount"
"6651",31015,"Nebraska","Boyd County","NHPI_A",0,0,0,0,"equal"
"6652",31015,"Nebraska","Boyd County","NHPI_AIC",0,1,1,200,"overcount"
"6653",31017,"Nebraska","Brown County","A_A",6,6,0,0,"equal"
"6654",31017,"Nebraska","Brown County","A_AIC",12,17,5,34.48,"overcount"
"6655",31017,"Nebraska","Brown County","NHPI_A",3,0,-3,-200,"undercount"
"6656",31017,"Nebraska","Brown County","NHPI_AIC",3,7,4,80,"overcount"
"6657",31019,"Nebraska","Buffalo County","A_A",709,663,-46,-6.71,"undercount"
"6658",31019,"Nebraska","Buffalo County","A_AIC",879,867,-12,-1.37,"undercount"
"6659",31019,"Nebraska","Buffalo County","NHPI_A",26,35,9,29.51,"overcount"
"6660",31019,"Nebraska","Buffalo County","NHPI_AIC",46,62,16,29.63,"overcount"
"6661",31021,"Nebraska","Burt County","A_A",26,35,9,29.51,"overcount"
"6662",31021,"Nebraska","Burt County","A_AIC",57,49,-8,-15.09,"undercount"
"6663",31021,"Nebraska","Burt County","NHPI_A",2,17,15,157.89,"overcount"
"6664",31021,"Nebraska","Burt County","NHPI_AIC",8,23,15,96.77,"overcount"
"6665",31023,"Nebraska","Butler County","A_A",32,9,-23,-112.2,"undercount"
"6666",31023,"Nebraska","Butler County","A_AIC",50,28,-22,-56.41,"undercount"
"6667",31023,"Nebraska","Butler County","NHPI_A",0,1,1,200,"overcount"
"6668",31023,"Nebraska","Butler County","NHPI_AIC",5,2,-3,-85.71,"undercount"
"6669",31025,"Nebraska","Cass County","A_A",137,104,-33,-27.39,"undercount"
"6670",31025,"Nebraska","Cass County","A_AIC",239,230,-9,-3.84,"undercount"
"6671",31025,"Nebraska","Cass County","NHPI_A",15,8,-7,-60.87,"undercount"
"6672",31025,"Nebraska","Cass County","NHPI_AIC",38,32,-6,-17.14,"undercount"
"6673",31027,"Nebraska","Cedar County","A_A",22,9,-13,-83.87,"undercount"
"6674",31027,"Nebraska","Cedar County","A_AIC",47,33,-14,-35,"undercount"
"6675",31027,"Nebraska","Cedar County","NHPI_A",0,2,2,200,"overcount"
"6676",31027,"Nebraska","Cedar County","NHPI_AIC",4,3,-1,-28.57,"undercount"
"6677",31029,"Nebraska","Chase County","A_A",8,11,3,31.58,"overcount"
"6678",31029,"Nebraska","Chase County","A_AIC",16,15,-1,-6.45,"undercount"
"6679",31029,"Nebraska","Chase County","NHPI_A",0,0,0,0,"equal"
"6680",31029,"Nebraska","Chase County","NHPI_AIC",2,2,0,0,"equal"
"6681",31031,"Nebraska","Cherry County","A_A",34,7,-27,-131.71,"undercount"
"6682",31031,"Nebraska","Cherry County","A_AIC",68,34,-34,-66.67,"undercount"
"6683",31031,"Nebraska","Cherry County","NHPI_A",3,0,-3,-200,"undercount"
"6684",31031,"Nebraska","Cherry County","NHPI_AIC",7,4,-3,-54.55,"undercount"
"6685",31033,"Nebraska","Cheyenne County","A_A",97,77,-20,-22.99,"undercount"
"6686",31033,"Nebraska","Cheyenne County","A_AIC",129,103,-26,-22.41,"undercount"
"6687",31033,"Nebraska","Cheyenne County","NHPI_A",5,0,-5,-200,"undercount"
"6688",31033,"Nebraska","Cheyenne County","NHPI_AIC",14,12,-2,-15.38,"undercount"
"6689",31035,"Nebraska","Clay County","A_A",12,10,-2,-18.18,"undercount"
"6690",31035,"Nebraska","Clay County","A_AIC",25,16,-9,-43.9,"undercount"
"6691",31035,"Nebraska","Clay County","NHPI_A",2,0,-2,-200,"undercount"
"6692",31035,"Nebraska","Clay County","NHPI_AIC",2,8,6,120,"overcount"
"6693",31037,"Nebraska","Colfax County","A_A",72,50,-22,-36.07,"undercount"
"6694",31037,"Nebraska","Colfax County","A_AIC",89,76,-13,-15.76,"undercount"
"6695",31037,"Nebraska","Colfax County","NHPI_A",7,2,-5,-111.11,"undercount"
"6696",31037,"Nebraska","Colfax County","NHPI_AIC",9,7,-2,-25,"undercount"
"6697",31039,"Nebraska","Cuming County","A_A",35,19,-16,-59.26,"undercount"
"6698",31039,"Nebraska","Cuming County","A_AIC",52,44,-8,-16.67,"undercount"
"6699",31039,"Nebraska","Cuming County","NHPI_A",1,9,8,160,"overcount"
"6700",31039,"Nebraska","Cuming County","NHPI_AIC",4,20,16,133.33,"overcount"
"6701",31041,"Nebraska","Custer County","A_A",22,19,-3,-14.63,"undercount"
"6702",31041,"Nebraska","Custer County","A_AIC",43,26,-17,-49.28,"undercount"
"6703",31041,"Nebraska","Custer County","NHPI_A",1,2,1,66.67,"overcount"
"6704",31041,"Nebraska","Custer County","NHPI_AIC",5,2,-3,-85.71,"undercount"
"6705",31043,"Nebraska","Dakota County","A_A",710,602,-108,-16.46,"undercount"
"6706",31043,"Nebraska","Dakota County","A_AIC",802,674,-128,-17.34,"undercount"
"6707",31043,"Nebraska","Dakota County","NHPI_A",103,154,51,39.69,"overcount"
"6708",31043,"Nebraska","Dakota County","NHPI_AIC",123,168,45,30.93,"overcount"
"6709",31045,"Nebraska","Dawes County","A_A",134,53,-81,-86.63,"undercount"
"6710",31045,"Nebraska","Dawes County","A_AIC",172,104,-68,-49.28,"undercount"
"6711",31045,"Nebraska","Dawes County","NHPI_A",28,6,-22,-129.41,"undercount"
"6712",31045,"Nebraska","Dawes County","NHPI_AIC",41,19,-22,-73.33,"undercount"
"6713",31047,"Nebraska","Dawson County","A_A",267,192,-75,-32.68,"undercount"
"6714",31047,"Nebraska","Dawson County","A_AIC",298,231,-67,-25.33,"undercount"
"6715",31047,"Nebraska","Dawson County","NHPI_A",77,42,-35,-58.82,"undercount"
"6716",31047,"Nebraska","Dawson County","NHPI_AIC",85,65,-20,-26.67,"undercount"
"6717",31049,"Nebraska","Deuel County","A_A",7,6,-1,-15.38,"undercount"
"6718",31049,"Nebraska","Deuel County","A_AIC",10,10,0,0,"equal"
"6719",31049,"Nebraska","Deuel County","NHPI_A",0,0,0,0,"equal"
"6720",31049,"Nebraska","Deuel County","NHPI_AIC",0,3,3,200,"overcount"
"6721",31051,"Nebraska","Dixon County","A_A",16,19,3,17.14,"overcount"
"6722",31051,"Nebraska","Dixon County","A_AIC",25,26,1,3.92,"overcount"
"6723",31051,"Nebraska","Dixon County","NHPI_A",2,0,-2,-200,"undercount"
"6724",31051,"Nebraska","Dixon County","NHPI_AIC",3,14,11,129.41,"overcount"
"6725",31053,"Nebraska","Dodge County","A_A",200,184,-16,-8.33,"undercount"
"6726",31053,"Nebraska","Dodge County","A_AIC",309,290,-19,-6.34,"undercount"
"6727",31053,"Nebraska","Dodge County","NHPI_A",44,12,-32,-114.29,"undercount"
"6728",31053,"Nebraska","Dodge County","NHPI_AIC",66,28,-38,-80.85,"undercount"
"6729",31055,"Nebraska","Douglas County","A_A",24682,27761,3079,11.74,"overcount"
"6730",31055,"Nebraska","Douglas County","A_AIC",28696,33451,4755,15.3,"overcount"
"6731",31055,"Nebraska","Douglas County","NHPI_A",263,412,149,44.15,"overcount"
"6732",31055,"Nebraska","Douglas County","NHPI_AIC",872,1168,296,29.02,"overcount"
"6733",31057,"Nebraska","Dundy County","A_A",3,1,-2,-100,"undercount"
"6734",31057,"Nebraska","Dundy County","A_AIC",9,9,0,0,"equal"
"6735",31057,"Nebraska","Dundy County","NHPI_A",2,3,1,40,"overcount"
"6736",31057,"Nebraska","Dundy County","NHPI_AIC",2,3,1,40,"overcount"
"6737",31059,"Nebraska","Fillmore County","A_A",32,13,-19,-84.44,"undercount"
"6738",31059,"Nebraska","Fillmore County","A_AIC",45,24,-21,-60.87,"undercount"
"6739",31059,"Nebraska","Fillmore County","NHPI_A",0,1,1,200,"overcount"
"6740",31059,"Nebraska","Fillmore County","NHPI_AIC",4,3,-1,-28.57,"undercount"
"6741",31061,"Nebraska","Franklin County","A_A",5,14,9,94.74,"overcount"
"6742",31061,"Nebraska","Franklin County","A_AIC",15,22,7,37.84,"overcount"
"6743",31061,"Nebraska","Franklin County","NHPI_A",0,0,0,0,"equal"
"6744",31061,"Nebraska","Franklin County","NHPI_AIC",2,3,1,40,"overcount"
"6745",31063,"Nebraska","Frontier County","A_A",5,0,-5,-200,"undercount"
"6746",31063,"Nebraska","Frontier County","A_AIC",12,7,-5,-52.63,"undercount"
"6747",31063,"Nebraska","Frontier County","NHPI_A",0,3,3,200,"overcount"
"6748",31063,"Nebraska","Frontier County","NHPI_AIC",1,13,12,171.43,"overcount"
"6749",31065,"Nebraska","Furnas County","A_A",16,6,-10,-90.91,"undercount"
"6750",31065,"Nebraska","Furnas County","A_AIC",29,33,4,12.9,"overcount"
"6751",31065,"Nebraska","Furnas County","NHPI_A",2,0,-2,-200,"undercount"
"6752",31065,"Nebraska","Furnas County","NHPI_AIC",5,2,-3,-85.71,"undercount"
"6753",31067,"Nebraska","Gage County","A_A",137,99,-38,-32.2,"undercount"
"6754",31067,"Nebraska","Gage County","A_AIC",189,150,-39,-23.01,"undercount"
"6755",31067,"Nebraska","Gage County","NHPI_A",3,1,-2,-100,"undercount"
"6756",31067,"Nebraska","Gage County","NHPI_AIC",17,13,-4,-26.67,"undercount"
"6757",31069,"Nebraska","Garden County","A_A",0,2,2,200,"overcount"
"6758",31069,"Nebraska","Garden County","A_AIC",6,4,-2,-40,"undercount"
"6759",31069,"Nebraska","Garden County","NHPI_A",3,2,-1,-40,"undercount"
"6760",31069,"Nebraska","Garden County","NHPI_AIC",3,5,2,50,"overcount"
"6761",31071,"Nebraska","Garfield County","A_A",2,0,-2,-200,"undercount"
"6762",31071,"Nebraska","Garfield County","A_AIC",3,0,-3,-200,"undercount"
"6763",31071,"Nebraska","Garfield County","NHPI_A",0,0,0,0,"equal"
"6764",31071,"Nebraska","Garfield County","NHPI_AIC",1,2,1,66.67,"overcount"
"6765",31073,"Nebraska","Gosper County","A_A",10,13,3,26.09,"overcount"
"6766",31073,"Nebraska","Gosper County","A_AIC",15,19,4,23.53,"overcount"
"6767",31073,"Nebraska","Gosper County","NHPI_A",0,0,0,0,"equal"
"6768",31073,"Nebraska","Gosper County","NHPI_AIC",1,7,6,150,"overcount"
"6769",31075,"Nebraska","Grant County","A_A",1,1,0,0,"equal"
"6770",31075,"Nebraska","Grant County","A_AIC",4,1,-3,-120,"undercount"
"6771",31075,"Nebraska","Grant County","NHPI_A",0,0,0,0,"equal"
"6772",31075,"Nebraska","Grant County","NHPI_AIC",0,0,0,0,"equal"
"6773",31077,"Nebraska","Greeley County","A_A",7,6,-1,-15.38,"undercount"
"6774",31077,"Nebraska","Greeley County","A_AIC",8,11,3,31.58,"overcount"
"6775",31077,"Nebraska","Greeley County","NHPI_A",0,1,1,200,"overcount"
"6776",31077,"Nebraska","Greeley County","NHPI_AIC",0,6,6,200,"overcount"
"6777",31079,"Nebraska","Hall County","A_A",705,696,-9,-1.28,"undercount"
"6778",31079,"Nebraska","Hall County","A_AIC",921,911,-10,-1.09,"undercount"
"6779",31079,"Nebraska","Hall County","NHPI_A",54,29,-25,-60.24,"undercount"
"6780",31079,"Nebraska","Hall County","NHPI_AIC",95,39,-56,-83.58,"undercount"
"6781",31081,"Nebraska","Hamilton County","A_A",31,17,-14,-58.33,"undercount"
"6782",31081,"Nebraska","Hamilton County","A_AIC",51,38,-13,-29.21,"undercount"
"6783",31081,"Nebraska","Hamilton County","NHPI_A",1,0,-1,-200,"undercount"
"6784",31081,"Nebraska","Hamilton County","NHPI_AIC",5,0,-5,-200,"undercount"
"6785",31083,"Nebraska","Harlan County","A_A",8,11,3,31.58,"overcount"
"6786",31083,"Nebraska","Harlan County","A_AIC",23,14,-9,-48.65,"undercount"
"6787",31083,"Nebraska","Harlan County","NHPI_A",0,0,0,0,"equal"
"6788",31083,"Nebraska","Harlan County","NHPI_AIC",3,3,0,0,"equal"
"6789",31085,"Nebraska","Hayes County","A_A",5,2,-3,-85.71,"undercount"
"6790",31085,"Nebraska","Hayes County","A_AIC",9,15,6,50,"overcount"
"6791",31085,"Nebraska","Hayes County","NHPI_A",1,0,-1,-200,"undercount"
"6792",31085,"Nebraska","Hayes County","NHPI_AIC",1,5,4,133.33,"overcount"
"6793",31087,"Nebraska","Hitchcock County","A_A",4,2,-2,-66.67,"undercount"
"6794",31087,"Nebraska","Hitchcock County","A_AIC",11,4,-7,-93.33,"undercount"
"6795",31087,"Nebraska","Hitchcock County","NHPI_A",0,4,4,200,"overcount"
"6796",31087,"Nebraska","Hitchcock County","NHPI_AIC",0,6,6,200,"overcount"
"6797",31089,"Nebraska","Holt County","A_A",43,50,7,15.05,"overcount"
"6798",31089,"Nebraska","Holt County","A_AIC",61,59,-2,-3.33,"undercount"
"6799",31089,"Nebraska","Holt County","NHPI_A",3,1,-2,-100,"undercount"
"6800",31089,"Nebraska","Holt County","NHPI_AIC",8,1,-7,-155.56,"undercount"
"6801",31091,"Nebraska","Hooker County","A_A",2,1,-1,-66.67,"undercount"
"6802",31091,"Nebraska","Hooker County","A_AIC",3,2,-1,-40,"undercount"
"6803",31091,"Nebraska","Hooker County","NHPI_A",0,0,0,0,"equal"
"6804",31091,"Nebraska","Hooker County","NHPI_AIC",1,2,1,66.67,"overcount"
"6805",31093,"Nebraska","Howard County","A_A",31,12,-19,-88.37,"undercount"
"6806",31093,"Nebraska","Howard County","A_AIC",39,30,-9,-26.09,"undercount"
"6807",31093,"Nebraska","Howard County","NHPI_A",6,1,-5,-142.86,"undercount"
"6808",31093,"Nebraska","Howard County","NHPI_AIC",7,8,1,13.33,"overcount"
"6809",31095,"Nebraska","Jefferson County","A_A",24,18,-6,-28.57,"undercount"
"6810",31095,"Nebraska","Jefferson County","A_AIC",40,42,2,4.88,"overcount"
"6811",31095,"Nebraska","Jefferson County","NHPI_A",2,0,-2,-200,"undercount"
"6812",31095,"Nebraska","Jefferson County","NHPI_AIC",7,9,2,25,"overcount"
"6813",31097,"Nebraska","Johnson County","A_A",63,76,13,18.71,"overcount"
"6814",31097,"Nebraska","Johnson County","A_AIC",71,93,22,26.83,"overcount"
"6815",31097,"Nebraska","Johnson County","NHPI_A",0,0,0,0,"equal"
"6816",31097,"Nebraska","Johnson County","NHPI_AIC",3,0,-3,-200,"undercount"
"6817",31099,"Nebraska","Kearney County","A_A",23,13,-10,-55.56,"undercount"
"6818",31099,"Nebraska","Kearney County","A_AIC",37,19,-18,-64.29,"undercount"
"6819",31099,"Nebraska","Kearney County","NHPI_A",4,2,-2,-66.67,"undercount"
"6820",31099,"Nebraska","Kearney County","NHPI_AIC",8,16,8,66.67,"overcount"
"6821",31101,"Nebraska","Keith County","A_A",49,39,-10,-22.73,"undercount"
"6822",31101,"Nebraska","Keith County","A_AIC",88,66,-22,-28.57,"undercount"
"6823",31101,"Nebraska","Keith County","NHPI_A",0,7,7,200,"overcount"
"6824",31101,"Nebraska","Keith County","NHPI_AIC",9,19,10,71.43,"overcount"
"6825",31103,"Nebraska","Keya Paha County","A_A",5,0,-5,-200,"undercount"
"6826",31103,"Nebraska","Keya Paha County","A_AIC",5,0,-5,-200,"undercount"
"6827",31103,"Nebraska","Keya Paha County","NHPI_A",0,1,1,200,"overcount"
"6828",31103,"Nebraska","Keya Paha County","NHPI_AIC",0,2,2,200,"overcount"
"6829",31105,"Nebraska","Kimball County","A_A",33,15,-18,-75,"undercount"
"6830",31105,"Nebraska","Kimball County","A_AIC",51,16,-35,-104.48,"undercount"
"6831",31105,"Nebraska","Kimball County","NHPI_A",4,0,-4,-200,"undercount"
"6832",31105,"Nebraska","Kimball County","NHPI_AIC",10,2,-8,-133.33,"undercount"
"6833",31107,"Nebraska","Knox County","A_A",37,28,-9,-27.69,"undercount"
"6834",31107,"Nebraska","Knox County","A_AIC",56,52,-4,-7.41,"undercount"
"6835",31107,"Nebraska","Knox County","NHPI_A",1,3,2,100,"overcount"
"6836",31107,"Nebraska","Knox County","NHPI_AIC",11,7,-4,-44.44,"undercount"
"6837",31109,"Nebraska","Lancaster County","A_A",14787,14076,-711,-4.93,"undercount"
"6838",31109,"Nebraska","Lancaster County","A_AIC",17267,17303,36,0.21,"overcount"
"6839",31109,"Nebraska","Lancaster County","NHPI_A",237,177,-60,-28.99,"undercount"
"6840",31109,"Nebraska","Lancaster County","NHPI_AIC",524,494,-30,-5.89,"undercount"
"6841",31111,"Nebraska","Lincoln County","A_A",289,337,48,15.34,"overcount"
"6842",31111,"Nebraska","Lincoln County","A_AIC",397,429,32,7.75,"overcount"
"6843",31111,"Nebraska","Lincoln County","NHPI_A",11,6,-5,-58.82,"undercount"
"6844",31111,"Nebraska","Lincoln County","NHPI_AIC",28,23,-5,-19.61,"undercount"
"6845",31113,"Nebraska","Logan County","A_A",3,4,1,28.57,"overcount"
"6846",31113,"Nebraska","Logan County","A_AIC",4,6,2,40,"overcount"
"6847",31113,"Nebraska","Logan County","NHPI_A",0,0,0,0,"equal"
"6848",31113,"Nebraska","Logan County","NHPI_AIC",0,0,0,0,"equal"
"6849",31115,"Nebraska","Loup County","A_A",1,1,0,0,"equal"
"6850",31115,"Nebraska","Loup County","A_AIC",1,10,9,163.64,"overcount"
"6851",31115,"Nebraska","Loup County","NHPI_A",0,0,0,0,"equal"
"6852",31115,"Nebraska","Loup County","NHPI_AIC",0,0,0,0,"equal"
"6853",31117,"Nebraska","McPherson County","A_A",1,2,1,66.67,"overcount"
"6854",31117,"Nebraska","McPherson County","A_AIC",1,7,6,150,"overcount"
"6855",31117,"Nebraska","McPherson County","NHPI_A",0,0,0,0,"equal"
"6856",31117,"Nebraska","McPherson County","NHPI_AIC",0,0,0,0,"equal"
"6857",31119,"Nebraska","Madison County","A_A",607,445,-162,-30.8,"undercount"
"6858",31119,"Nebraska","Madison County","A_AIC",720,595,-125,-19.01,"undercount"
"6859",31119,"Nebraska","Madison County","NHPI_A",11,7,-4,-44.44,"undercount"
"6860",31119,"Nebraska","Madison County","NHPI_AIC",38,53,15,32.97,"overcount"
"6861",31121,"Nebraska","Merrick County","A_A",84,29,-55,-97.35,"undercount"
"6862",31121,"Nebraska","Merrick County","A_AIC",104,54,-50,-63.29,"undercount"
"6863",31121,"Nebraska","Merrick County","NHPI_A",6,3,-3,-66.67,"undercount"
"6864",31121,"Nebraska","Merrick County","NHPI_AIC",6,10,4,50,"overcount"
"6865",31123,"Nebraska","Morrill County","A_A",25,20,-5,-22.22,"undercount"
"6866",31123,"Nebraska","Morrill County","A_AIC",35,29,-6,-18.75,"undercount"
"6867",31123,"Nebraska","Morrill County","NHPI_A",0,0,0,0,"equal"
"6868",31123,"Nebraska","Morrill County","NHPI_AIC",1,9,8,160,"overcount"
"6869",31125,"Nebraska","Nance County","A_A",5,5,0,0,"equal"
"6870",31125,"Nebraska","Nance County","A_AIC",14,30,16,72.73,"overcount"
"6871",31125,"Nebraska","Nance County","NHPI_A",1,0,-1,-200,"undercount"
"6872",31125,"Nebraska","Nance County","NHPI_AIC",1,7,6,150,"overcount"
"6873",31127,"Nebraska","Nemaha County","A_A",36,31,-5,-14.93,"undercount"
"6874",31127,"Nebraska","Nemaha County","A_AIC",49,42,-7,-15.38,"undercount"
"6875",31127,"Nebraska","Nemaha County","NHPI_A",4,0,-4,-200,"undercount"
"6876",31127,"Nebraska","Nemaha County","NHPI_AIC",7,4,-3,-54.55,"undercount"
"6877",31129,"Nebraska","Nuckolls County","A_A",61,4,-57,-175.38,"undercount"
"6878",31129,"Nebraska","Nuckolls County","A_AIC",68,8,-60,-157.89,"undercount"
"6879",31129,"Nebraska","Nuckolls County","NHPI_A",0,0,0,0,"equal"
"6880",31129,"Nebraska","Nuckolls County","NHPI_AIC",3,1,-2,-100,"undercount"
"6881",31131,"Nebraska","Otoe County","A_A",109,86,-23,-23.59,"undercount"
"6882",31131,"Nebraska","Otoe County","A_AIC",162,182,20,11.63,"overcount"
"6883",31131,"Nebraska","Otoe County","NHPI_A",17,0,-17,-200,"undercount"
"6884",31131,"Nebraska","Otoe County","NHPI_AIC",26,7,-19,-115.15,"undercount"
"6885",31133,"Nebraska","Pawnee County","A_A",8,0,-8,-200,"undercount"
"6886",31133,"Nebraska","Pawnee County","A_AIC",22,11,-11,-66.67,"undercount"
"6887",31133,"Nebraska","Pawnee County","NHPI_A",0,1,1,200,"overcount"
"6888",31133,"Nebraska","Pawnee County","NHPI_AIC",1,2,1,66.67,"overcount"
"6889",31135,"Nebraska","Perkins County","A_A",6,5,-1,-18.18,"undercount"
"6890",31135,"Nebraska","Perkins County","A_AIC",12,19,7,45.16,"overcount"
"6891",31135,"Nebraska","Perkins County","NHPI_A",2,3,1,40,"overcount"
"6892",31135,"Nebraska","Perkins County","NHPI_AIC",4,6,2,40,"overcount"
"6893",31137,"Nebraska","Phelps County","A_A",44,29,-15,-41.1,"undercount"
"6894",31137,"Nebraska","Phelps County","A_AIC",64,45,-19,-34.86,"undercount"
"6895",31137,"Nebraska","Phelps County","NHPI_A",2,1,-1,-66.67,"undercount"
"6896",31137,"Nebraska","Phelps County","NHPI_AIC",5,7,2,33.33,"overcount"
"6897",31139,"Nebraska","Pierce County","A_A",29,12,-17,-82.93,"undercount"
"6898",31139,"Nebraska","Pierce County","A_AIC",42,39,-3,-7.41,"undercount"
"6899",31139,"Nebraska","Pierce County","NHPI_A",0,2,2,200,"overcount"
"6900",31139,"Nebraska","Pierce County","NHPI_AIC",1,3,2,100,"overcount"
"6901",31141,"Nebraska","Platte County","A_A",338,198,-140,-52.24,"undercount"
"6902",31141,"Nebraska","Platte County","A_AIC",403,298,-105,-29.96,"undercount"
"6903",31141,"Nebraska","Platte County","NHPI_A",12,17,5,34.48,"overcount"
"6904",31141,"Nebraska","Platte County","NHPI_AIC",26,32,6,20.69,"overcount"
"6905",31143,"Nebraska","Polk County","A_A",11,2,-9,-138.46,"undercount"
"6906",31143,"Nebraska","Polk County","A_AIC",21,4,-17,-136,"undercount"
"6907",31143,"Nebraska","Polk County","NHPI_A",2,1,-1,-66.67,"undercount"
"6908",31143,"Nebraska","Polk County","NHPI_AIC",4,2,-2,-66.67,"undercount"
"6909",31145,"Nebraska","Red Willow County","A_A",33,39,6,16.67,"overcount"
"6910",31145,"Nebraska","Red Willow County","A_AIC",55,57,2,3.57,"overcount"
"6911",31145,"Nebraska","Red Willow County","NHPI_A",2,12,10,142.86,"overcount"
"6912",31145,"Nebraska","Red Willow County","NHPI_AIC",5,15,10,100,"overcount"
"6913",31147,"Nebraska","Richardson County","A_A",41,35,-6,-15.79,"undercount"
"6914",31147,"Nebraska","Richardson County","A_AIC",79,56,-23,-34.07,"undercount"
"6915",31147,"Nebraska","Richardson County","NHPI_A",1,0,-1,-200,"undercount"
"6916",31147,"Nebraska","Richardson County","NHPI_AIC",6,0,-6,-200,"undercount"
"6917",31149,"Nebraska","Rock County","A_A",4,1,-3,-120,"undercount"
"6918",31149,"Nebraska","Rock County","A_AIC",5,5,0,0,"equal"
"6919",31149,"Nebraska","Rock County","NHPI_A",0,0,0,0,"equal"
"6920",31149,"Nebraska","Rock County","NHPI_AIC",0,3,3,200,"overcount"
"6921",31151,"Nebraska","Saline County","A_A",407,281,-126,-36.63,"undercount"
"6922",31151,"Nebraska","Saline County","A_AIC",457,327,-130,-33.16,"undercount"
"6923",31151,"Nebraska","Saline County","NHPI_A",24,46,22,62.86,"overcount"
"6924",31151,"Nebraska","Saline County","NHPI_AIC",34,52,18,41.86,"overcount"
"6925",31153,"Nebraska","Sarpy County","A_A",4971,4819,-152,-3.11,"undercount"
"6926",31153,"Nebraska","Sarpy County","A_AIC",7220,7478,258,3.51,"overcount"
"6927",31153,"Nebraska","Sarpy County","NHPI_A",185,227,42,20.39,"overcount"
"6928",31153,"Nebraska","Sarpy County","NHPI_AIC",473,598,125,23.34,"overcount"
"6929",31155,"Nebraska","Saunders County","A_A",101,86,-15,-16.04,"undercount"
"6930",31155,"Nebraska","Saunders County","A_AIC",216,178,-38,-19.29,"undercount"
"6931",31155,"Nebraska","Saunders County","NHPI_A",2,5,3,85.71,"overcount"
"6932",31155,"Nebraska","Saunders County","NHPI_AIC",14,10,-4,-33.33,"undercount"
"6933",31157,"Nebraska","Scotts Bluff County","A_A",270,285,15,5.41,"overcount"
"6934",31157,"Nebraska","Scotts Bluff County","A_AIC",382,414,32,8.04,"overcount"
"6935",31157,"Nebraska","Scotts Bluff County","NHPI_A",22,36,14,48.28,"overcount"
"6936",31157,"Nebraska","Scotts Bluff County","NHPI_AIC",39,74,35,61.95,"overcount"
"6937",31159,"Nebraska","Seward County","A_A",82,57,-25,-35.97,"undercount"
"6938",31159,"Nebraska","Seward County","A_AIC",147,126,-21,-15.38,"undercount"
"6939",31159,"Nebraska","Seward County","NHPI_A",2,6,4,100,"overcount"
"6940",31159,"Nebraska","Seward County","NHPI_AIC",12,19,7,45.16,"overcount"
"6941",31161,"Nebraska","Sheridan County","A_A",37,29,-8,-24.24,"undercount"
"6942",31161,"Nebraska","Sheridan County","A_AIC",69,46,-23,-40,"undercount"
"6943",31161,"Nebraska","Sheridan County","NHPI_A",7,2,-5,-111.11,"undercount"
"6944",31161,"Nebraska","Sheridan County","NHPI_AIC",12,9,-3,-28.57,"undercount"
"6945",31163,"Nebraska","Sherman County","A_A",13,5,-8,-88.89,"undercount"
"6946",31163,"Nebraska","Sherman County","A_AIC",18,12,-6,-40,"undercount"
"6947",31163,"Nebraska","Sherman County","NHPI_A",0,2,2,200,"overcount"
"6948",31163,"Nebraska","Sherman County","NHPI_AIC",1,14,13,173.33,"overcount"
"6949",31165,"Nebraska","Sioux County","A_A",3,4,1,28.57,"overcount"
"6950",31165,"Nebraska","Sioux County","A_AIC",3,8,5,90.91,"overcount"
"6951",31165,"Nebraska","Sioux County","NHPI_A",0,2,2,200,"overcount"
"6952",31165,"Nebraska","Sioux County","NHPI_AIC",0,4,4,200,"overcount"
"6953",31167,"Nebraska","Stanton County","A_A",17,18,1,5.71,"overcount"
"6954",31167,"Nebraska","Stanton County","A_AIC",33,48,15,37.04,"overcount"
"6955",31167,"Nebraska","Stanton County","NHPI_A",0,7,7,200,"overcount"
"6956",31167,"Nebraska","Stanton County","NHPI_AIC",1,7,6,150,"overcount"
"6957",31169,"Nebraska","Thayer County","A_A",13,10,-3,-26.09,"undercount"
"6958",31169,"Nebraska","Thayer County","A_AIC",21,20,-1,-4.88,"undercount"
"6959",31169,"Nebraska","Thayer County","NHPI_A",1,5,4,133.33,"overcount"
"6960",31169,"Nebraska","Thayer County","NHPI_AIC",4,21,17,136,"overcount"
"6961",31171,"Nebraska","Thomas County","A_A",2,0,-2,-200,"undercount"
"6962",31171,"Nebraska","Thomas County","A_AIC",4,3,-1,-28.57,"undercount"
"6963",31171,"Nebraska","Thomas County","NHPI_A",0,0,0,0,"equal"
"6964",31171,"Nebraska","Thomas County","NHPI_AIC",0,0,0,0,"equal"
"6965",31173,"Nebraska","Thurston County","A_A",47,10,-37,-129.82,"undercount"
"6966",31173,"Nebraska","Thurston County","A_AIC",79,17,-62,-129.17,"undercount"
"6967",31173,"Nebraska","Thurston County","NHPI_A",2,4,2,66.67,"overcount"
"6968",31173,"Nebraska","Thurston County","NHPI_AIC",5,5,0,0,"equal"
"6969",31175,"Nebraska","Valley County","A_A",16,5,-11,-104.76,"undercount"
"6970",31175,"Nebraska","Valley County","A_AIC",30,12,-18,-85.71,"undercount"
"6971",31175,"Nebraska","Valley County","NHPI_A",0,5,5,200,"overcount"
"6972",31175,"Nebraska","Valley County","NHPI_AIC",0,7,7,200,"overcount"
"6973",31177,"Nebraska","Washington County","A_A",88,100,12,12.77,"overcount"
"6974",31177,"Nebraska","Washington County","A_AIC",163,184,21,12.1,"overcount"
"6975",31177,"Nebraska","Washington County","NHPI_A",11,1,-10,-166.67,"undercount"
"6976",31177,"Nebraska","Washington County","NHPI_AIC",33,16,-17,-69.39,"undercount"
"6977",31179,"Nebraska","Wayne County","A_A",56,122,66,74.16,"overcount"
"6978",31179,"Nebraska","Wayne County","A_AIC",88,203,115,79.04,"overcount"
"6979",31179,"Nebraska","Wayne County","NHPI_A",10,8,-2,-22.22,"undercount"
"6980",31179,"Nebraska","Wayne County","NHPI_AIC",18,70,52,118.18,"overcount"
"6981",31181,"Nebraska","Webster County","A_A",11,11,0,0,"equal"
"6982",31181,"Nebraska","Webster County","A_AIC",20,21,1,4.88,"overcount"
"6983",31181,"Nebraska","Webster County","NHPI_A",14,0,-14,-200,"undercount"
"6984",31181,"Nebraska","Webster County","NHPI_AIC",17,1,-16,-177.78,"undercount"
"6985",31183,"Nebraska","Wheeler County","A_A",3,0,-3,-200,"undercount"
"6986",31183,"Nebraska","Wheeler County","A_AIC",4,5,1,22.22,"overcount"
"6987",31183,"Nebraska","Wheeler County","NHPI_A",0,0,0,0,"equal"
"6988",31183,"Nebraska","Wheeler County","NHPI_AIC",0,1,1,200,"overcount"
"6989",31185,"Nebraska","York County","A_A",96,90,-6,-6.45,"undercount"
"6990",31185,"Nebraska","York County","A_AIC",144,124,-20,-14.93,"undercount"
"6991",31185,"Nebraska","York County","NHPI_A",3,2,-1,-40,"undercount"
"6992",31185,"Nebraska","York County","NHPI_AIC",12,13,1,8,"overcount"
"6993",32001,"Nevada","Churchill County","A_A",688,659,-29,-4.31,"undercount"
"6994",32001,"Nevada","Churchill County","A_AIC",1110,1088,-22,-2,"undercount"
"6995",32001,"Nevada","Churchill County","NHPI_A",90,87,-3,-3.39,"undercount"
"6996",32001,"Nevada","Churchill County","NHPI_AIC",185,174,-11,-6.13,"undercount"
"6997",32003,"Nevada","Clark County","A_A",234353,234212,-141,-0.06,"undercount"
"6998",32003,"Nevada","Clark County","A_AIC",284137,287932,3795,1.33,"overcount"
"6999",32003,"Nevada","Clark County","NHPI_A",17343,19091,1748,9.6,"overcount"
"7000",32003,"Nevada","Clark County","NHPI_AIC",33555,37722,4167,11.69,"overcount"
"7001",32005,"Nevada","Douglas County","A_A",900,902,2,0.22,"overcount"
"7002",32005,"Nevada","Douglas County","A_AIC",1391,1483,92,6.4,"overcount"
"7003",32005,"Nevada","Douglas County","NHPI_A",96,81,-15,-16.95,"undercount"
"7004",32005,"Nevada","Douglas County","NHPI_AIC",236,259,23,9.29,"overcount"
"7005",32007,"Nevada","Elko County","A_A",630,560,-70,-11.76,"undercount"
"7006",32007,"Nevada","Elko County","A_AIC",1016,958,-58,-5.88,"undercount"
"7007",32007,"Nevada","Elko County","NHPI_A",70,85,15,19.35,"overcount"
"7008",32007,"Nevada","Elko County","NHPI_AIC",203,226,23,10.72,"overcount"
"7009",32009,"Nevada","Esmeralda County","A_A",8,6,-2,-28.57,"undercount"
"7010",32009,"Nevada","Esmeralda County","A_AIC",16,11,-5,-37.04,"undercount"
"7011",32009,"Nevada","Esmeralda County","NHPI_A",1,0,-1,-200,"undercount"
"7012",32009,"Nevada","Esmeralda County","NHPI_AIC",7,7,0,0,"equal"
"7013",32011,"Nevada","Eureka County","A_A",26,8,-18,-105.88,"undercount"
"7014",32011,"Nevada","Eureka County","A_AIC",37,21,-16,-55.17,"undercount"
"7015",32011,"Nevada","Eureka County","NHPI_A",4,3,-1,-28.57,"undercount"
"7016",32011,"Nevada","Eureka County","NHPI_AIC",11,13,2,16.67,"overcount"
"7017",32013,"Nevada","Humboldt County","A_A",149,158,9,5.86,"overcount"
"7018",32013,"Nevada","Humboldt County","A_AIC",261,269,8,3.02,"overcount"
"7019",32013,"Nevada","Humboldt County","NHPI_A",31,26,-5,-17.54,"undercount"
"7020",32013,"Nevada","Humboldt County","NHPI_AIC",70,61,-9,-13.74,"undercount"
"7021",32015,"Nevada","Lander County","A_A",56,35,-21,-46.15,"undercount"
"7022",32015,"Nevada","Lander County","A_AIC",72,78,6,8,"overcount"
"7023",32015,"Nevada","Lander County","NHPI_A",1,10,9,163.64,"overcount"
"7024",32015,"Nevada","Lander County","NHPI_AIC",9,42,33,129.41,"overcount"
"7025",32017,"Nevada","Lincoln County","A_A",38,22,-16,-53.33,"undercount"
"7026",32017,"Nevada","Lincoln County","A_AIC",65,42,-23,-42.99,"undercount"
"7027",32017,"Nevada","Lincoln County","NHPI_A",18,13,-5,-32.26,"undercount"
"7028",32017,"Nevada","Lincoln County","NHPI_AIC",33,33,0,0,"equal"
"7029",32019,"Nevada","Lyon County","A_A",881,927,46,5.09,"overcount"
"7030",32019,"Nevada","Lyon County","A_AIC",1403,1586,183,12.24,"overcount"
"7031",32019,"Nevada","Lyon County","NHPI_A",170,174,4,2.33,"overcount"
"7032",32019,"Nevada","Lyon County","NHPI_AIC",339,414,75,19.92,"overcount"
"7033",32021,"Nevada","Mineral County","A_A",145,66,-79,-74.88,"undercount"
"7034",32021,"Nevada","Mineral County","A_AIC",177,123,-54,-36,"undercount"
"7035",32021,"Nevada","Mineral County","NHPI_A",10,8,-2,-22.22,"undercount"
"7036",32021,"Nevada","Mineral County","NHPI_AIC",21,27,6,25,"overcount"
"7037",32023,"Nevada","Nye County","A_A",862,1041,179,18.81,"overcount"
"7038",32023,"Nevada","Nye County","A_AIC",1350,1587,237,16.14,"overcount"
"7039",32023,"Nevada","Nye County","NHPI_A",236,220,-16,-7.02,"undercount"
"7040",32023,"Nevada","Nye County","NHPI_AIC",378,486,108,25,"overcount"
"7041",32027,"Nevada","Pershing County","A_A",83,109,26,27.08,"overcount"
"7042",32027,"Nevada","Pershing County","A_AIC",121,152,31,22.71,"overcount"
"7043",32027,"Nevada","Pershing County","NHPI_A",18,24,6,28.57,"overcount"
"7044",32027,"Nevada","Pershing County","NHPI_AIC",36,41,5,12.99,"overcount"
"7045",32029,"Nevada","Storey County","A_A",95,67,-28,-34.57,"undercount"
"7046",32029,"Nevada","Storey County","A_AIC",118,131,13,10.44,"overcount"
"7047",32029,"Nevada","Storey County","NHPI_A",17,8,-9,-72,"undercount"
"7048",32029,"Nevada","Storey County","NHPI_AIC",26,33,7,23.73,"overcount"
"7049",32031,"Nevada","Washoe County","A_A",26560,28460,1900,6.91,"overcount"
"7050",32031,"Nevada","Washoe County","A_AIC",34124,37472,3348,9.35,"overcount"
"7051",32031,"Nevada","Washoe County","NHPI_A",2985,3288,303,9.66,"overcount"
"7052",32031,"Nevada","Washoe County","NHPI_AIC",4864,5561,697,13.37,"overcount"
"7053",32033,"Nevada","White Pine County","A_A",93,105,12,12.12,"overcount"
"7054",32033,"Nevada","White Pine County","A_AIC",133,154,21,14.63,"overcount"
"7055",32033,"Nevada","White Pine County","NHPI_A",13,22,9,51.43,"overcount"
"7056",32033,"Nevada","White Pine County","NHPI_AIC",34,41,7,18.67,"overcount"
"7057",32510,"Nevada","Carson City","A_A",1340,1371,31,2.29,"overcount"
"7058",32510,"Nevada","Carson City","A_AIC",1881,2100,219,11,"overcount"
"7059",32510,"Nevada","Carson City","NHPI_A",135,111,-24,-19.51,"undercount"
"7060",32510,"Nevada","Carson City","NHPI_AIC",280,343,63,20.22,"overcount"
"7061",33001,"New Hampshire","Belknap County","A_A",687,582,-105,-16.55,"undercount"
"7062",33001,"New Hampshire","Belknap County","A_AIC",950,916,-34,-3.64,"undercount"
"7063",33001,"New Hampshire","Belknap County","NHPI_A",7,11,4,44.44,"overcount"
"7064",33001,"New Hampshire","Belknap County","NHPI_AIC",46,62,16,29.63,"overcount"
"7065",33003,"New Hampshire","Carroll County","A_A",366,362,-4,-1.1,"undercount"
"7066",33003,"New Hampshire","Carroll County","A_AIC",469,576,107,20.48,"overcount"
"7067",33003,"New Hampshire","Carroll County","NHPI_A",11,6,-5,-58.82,"undercount"
"7068",33003,"New Hampshire","Carroll County","NHPI_AIC",38,50,12,27.27,"overcount"
"7069",33005,"New Hampshire","Cheshire County","A_A",1254,1087,-167,-14.27,"undercount"
"7070",33005,"New Hampshire","Cheshire County","A_AIC",1598,1565,-33,-2.09,"undercount"
"7071",33005,"New Hampshire","Cheshire County","NHPI_A",35,46,11,27.16,"overcount"
"7072",33005,"New Hampshire","Cheshire County","NHPI_AIC",81,136,55,50.69,"overcount"
"7073",33007,"New Hampshire","Coos County","A_A",214,193,-21,-10.32,"undercount"
"7074",33007,"New Hampshire","Coos County","A_AIC",298,322,24,7.74,"overcount"
"7075",33007,"New Hampshire","Coos County","NHPI_A",3,3,0,0,"equal"
"7076",33007,"New Hampshire","Coos County","NHPI_AIC",17,18,1,5.71,"overcount"
"7077",33009,"New Hampshire","Grafton County","A_A",3521,2885,-636,-19.86,"undercount"
"7078",33009,"New Hampshire","Grafton County","A_AIC",4113,3758,-355,-9.02,"undercount"
"7079",33009,"New Hampshire","Grafton County","NHPI_A",25,25,0,0,"equal"
"7080",33009,"New Hampshire","Grafton County","NHPI_AIC",81,87,6,7.14,"overcount"
"7081",33011,"New Hampshire","Hillsborough County","A_A",18940,16623,-2317,-13.03,"undercount"
"7082",33011,"New Hampshire","Hillsborough County","A_AIC",21648,20224,-1424,-6.8,"undercount"
"7083",33011,"New Hampshire","Hillsborough County","NHPI_A",102,116,14,12.84,"overcount"
"7084",33011,"New Hampshire","Hillsborough County","NHPI_AIC",378,445,67,16.28,"overcount"
"7085",33013,"New Hampshire","Merrimack County","A_A",3527,3072,-455,-13.79,"undercount"
"7086",33013,"New Hampshire","Merrimack County","A_AIC",4225,4020,-205,-4.97,"undercount"
"7087",33013,"New Hampshire","Merrimack County","NHPI_A",50,59,9,16.51,"overcount"
"7088",33013,"New Hampshire","Merrimack County","NHPI_AIC",119,191,72,46.45,"overcount"
"7089",33015,"New Hampshire","Rockingham County","A_A",7098,6300,-798,-11.91,"undercount"
"7090",33015,"New Hampshire","Rockingham County","A_AIC",8822,8569,-253,-2.91,"undercount"
"7091",33015,"New Hampshire","Rockingham County","NHPI_A",102,90,-12,-12.5,"undercount"
"7092",33015,"New Hampshire","Rockingham County","NHPI_AIC",240,307,67,24.5,"overcount"
"7093",33017,"New Hampshire","Strafford County","A_A",5096,4478,-618,-12.91,"undercount"
"7094",33017,"New Hampshire","Strafford County","A_AIC",5980,5691,-289,-4.95,"undercount"
"7095",33017,"New Hampshire","Strafford County","NHPI_A",52,42,-10,-21.28,"undercount"
"7096",33017,"New Hampshire","Strafford County","NHPI_AIC",165,203,38,20.65,"overcount"
"7097",33019,"New Hampshire","Sullivan County","A_A",465,435,-30,-6.67,"undercount"
"7098",33019,"New Hampshire","Sullivan County","A_AIC",607,639,32,5.14,"overcount"
"7099",33019,"New Hampshire","Sullivan County","NHPI_A",10,6,-4,-50,"undercount"
"7100",33019,"New Hampshire","Sullivan County","NHPI_AIC",47,53,6,12,"overcount"
"7101",34001,"New Jersey","Atlantic County","A_A",20743,21855,1112,5.22,"overcount"
"7102",34001,"New Jersey","Atlantic County","A_AIC",23126,24132,1006,4.26,"overcount"
"7103",34001,"New Jersey","Atlantic County","NHPI_A",88,85,-3,-3.47,"undercount"
"7104",34001,"New Jersey","Atlantic County","NHPI_AIC",369,362,-7,-1.92,"undercount"
"7105",34003,"New Jersey","Bergen County","A_A",157840,159022,1182,0.75,"overcount"
"7106",34003,"New Jersey","Bergen County","A_AIC",166541,169409,2868,1.71,"overcount"
"7107",34003,"New Jersey","Bergen County","NHPI_A",241,178,-63,-30.07,"undercount"
"7108",34003,"New Jersey","Bergen County","NHPI_AIC",1251,935,-316,-28.91,"undercount"
"7109",34005,"New Jersey","Burlington County","A_A",24650,26329,1679,6.59,"overcount"
"7110",34005,"New Jersey","Burlington County","A_AIC",29082,31726,2644,8.7,"overcount"
"7111",34005,"New Jersey","Burlington County","NHPI_A",249,271,22,8.46,"overcount"
"7112",34005,"New Jersey","Burlington County","NHPI_AIC",625,691,66,10.03,"overcount"
"7113",34007,"New Jersey","Camden County","A_A",30175,32767,2592,8.24,"overcount"
"7114",34007,"New Jersey","Camden County","A_AIC",33715,37039,3324,9.4,"overcount"
"7115",34007,"New Jersey","Camden County","NHPI_A",158,120,-38,-27.34,"undercount"
"7116",34007,"New Jersey","Camden County","NHPI_AIC",514,539,25,4.75,"overcount"
"7117",34009,"New Jersey","Cape May County","A_A",851,942,91,10.15,"overcount"
"7118",34009,"New Jersey","Cape May County","A_AIC",1248,1347,99,7.63,"overcount"
"7119",34009,"New Jersey","Cape May County","NHPI_A",45,24,-21,-60.87,"undercount"
"7120",34009,"New Jersey","Cape May County","NHPI_AIC",142,105,-37,-29.96,"undercount"
"7121",34011,"New Jersey","Cumberland County","A_A",1840,2115,275,13.91,"overcount"
"7122",34011,"New Jersey","Cumberland County","A_AIC",2467,2587,120,4.75,"overcount"
"7123",34011,"New Jersey","Cumberland County","NHPI_A",49,12,-37,-121.31,"undercount"
"7124",34011,"New Jersey","Cumberland County","NHPI_AIC",219,119,-100,-59.17,"undercount"
"7125",34013,"New Jersey","Essex County","A_A",47019,47991,972,2.05,"overcount"
"7126",34013,"New Jersey","Essex County","A_AIC",51795,54710,2915,5.47,"overcount"
"7127",34013,"New Jersey","Essex County","NHPI_A",326,341,15,4.5,"overcount"
"7128",34013,"New Jersey","Essex County","NHPI_AIC",1171,967,-204,-19.08,"undercount"
"7129",34015,"New Jersey","Gloucester County","A_A",9093,9541,448,4.81,"overcount"
"7130",34015,"New Jersey","Gloucester County","A_AIC",11085,11988,903,7.83,"overcount"
"7131",34015,"New Jersey","Gloucester County","NHPI_A",110,93,-17,-16.75,"undercount"
"7132",34015,"New Jersey","Gloucester County","NHPI_AIC",315,339,24,7.34,"overcount"
"7133",34017,"New Jersey","Hudson County","A_A",110712,126163,15451,13.05,"overcount"
"7134",34017,"New Jersey","Hudson County","A_AIC",115083,132906,17823,14.37,"overcount"
"7135",34017,"New Jersey","Hudson County","NHPI_A",379,406,27,6.88,"overcount"
"7136",34017,"New Jersey","Hudson County","NHPI_AIC",1024,1109,85,7.97,"overcount"
"7137",34019,"New Jersey","Hunterdon County","A_A",5615,5746,131,2.31,"overcount"
"7138",34019,"New Jersey","Hunterdon County","A_AIC",6564,6941,377,5.58,"overcount"
"7139",34019,"New Jersey","Hunterdon County","NHPI_A",138,11,-127,-170.47,"undercount"
"7140",34019,"New Jersey","Hunterdon County","NHPI_AIC",236,83,-153,-95.92,"undercount"
"7141",34021,"New Jersey","Mercer County","A_A",44658,48653,3995,8.56,"overcount"
"7142",34021,"New Jersey","Mercer County","A_AIC",48096,52321,4225,8.41,"overcount"
"7143",34021,"New Jersey","Mercer County","NHPI_A",216,127,-89,-51.9,"undercount"
"7144",34021,"New Jersey","Mercer County","NHPI_AIC",772,463,-309,-50.04,"undercount"
"7145",34023,"New Jersey","Middlesex County","A_A",207483,230341,22858,10.44,"overcount"
"7146",34023,"New Jersey","Middlesex County","A_AIC",214217,237490,23273,10.3,"overcount"
"7147",34023,"New Jersey","Middlesex County","NHPI_A",288,261,-27,-9.84,"undercount"
"7148",34023,"New Jersey","Middlesex County","NHPI_AIC",833,782,-51,-6.32,"undercount"
"7149",34025,"New Jersey","Monmouth County","A_A",34434,36447,2013,5.68,"overcount"
"7150",34025,"New Jersey","Monmouth County","A_AIC",38774,42094,3320,8.21,"overcount"
"7151",34025,"New Jersey","Monmouth County","NHPI_A",201,122,-79,-48.92,"undercount"
"7152",34025,"New Jersey","Monmouth County","NHPI_AIC",568,574,6,1.05,"overcount"
"7153",34027,"New Jersey","Morris County","A_A",54509,58161,3652,6.48,"overcount"
"7154",34027,"New Jersey","Morris County","A_AIC",59409,64148,4739,7.67,"overcount"
"7155",34027,"New Jersey","Morris County","NHPI_A",133,120,-13,-10.28,"undercount"
"7156",34027,"New Jersey","Morris County","NHPI_AIC",412,414,2,0.48,"overcount"
"7157",34029,"New Jersey","Ocean County","A_A",11953,11543,-410,-3.49,"undercount"
"7158",34029,"New Jersey","Ocean County","A_AIC",14839,14731,-108,-0.73,"undercount"
"7159",34029,"New Jersey","Ocean County","NHPI_A",140,122,-18,-13.74,"undercount"
"7160",34029,"New Jersey","Ocean County","NHPI_AIC",425,427,2,0.47,"overcount"
"7161",34031,"New Jersey","Passaic County","A_A",27587,30676,3089,10.6,"overcount"
"7162",34031,"New Jersey","Passaic County","A_AIC",29952,33855,3903,12.23,"overcount"
"7163",34031,"New Jersey","Passaic County","NHPI_A",123,74,-49,-49.75,"undercount"
"7164",34031,"New Jersey","Passaic County","NHPI_AIC",392,298,-94,-27.25,"undercount"
"7165",34033,"New Jersey","Salem County","A_A",634,649,15,2.34,"overcount"
"7166",34033,"New Jersey","Salem County","A_AIC",923,944,21,2.25,"overcount"
"7167",34033,"New Jersey","Salem County","NHPI_A",26,19,-7,-31.11,"undercount"
"7168",34033,"New Jersey","Salem County","NHPI_AIC",104,72,-32,-36.36,"undercount"
"7169",34035,"New Jersey","Somerset County","A_A",63942,67571,3629,5.52,"overcount"
"7170",34035,"New Jersey","Somerset County","A_AIC",67236,71636,4400,6.34,"overcount"
"7171",34035,"New Jersey","Somerset County","NHPI_A",117,74,-43,-45.03,"undercount"
"7172",34035,"New Jersey","Somerset County","NHPI_AIC",323,292,-31,-10.08,"undercount"
"7173",34037,"New Jersey","Sussex County","A_A",2853,2958,105,3.61,"overcount"
"7174",34037,"New Jersey","Sussex County","A_AIC",3795,3978,183,4.71,"overcount"
"7175",34037,"New Jersey","Sussex County","NHPI_A",34,18,-16,-61.54,"undercount"
"7176",34037,"New Jersey","Sussex County","NHPI_AIC",129,64,-65,-67.36,"undercount"
"7177",34039,"New Jersey","Union County","A_A",31524,32652,1128,3.52,"overcount"
"7178",34039,"New Jersey","Union County","A_AIC",34807,37089,2282,6.35,"overcount"
"7179",34039,"New Jersey","Union County","NHPI_A",192,111,-81,-53.47,"undercount"
"7180",34039,"New Jersey","Union County","NHPI_AIC",706,527,-179,-29.03,"undercount"
"7181",34041,"New Jersey","Warren County","A_A",3011,2928,-83,-2.8,"undercount"
"7182",34041,"New Jersey","Warren County","A_AIC",3575,3670,95,2.62,"overcount"
"7183",34041,"New Jersey","Warren County","NHPI_A",32,35,3,8.96,"overcount"
"7184",34041,"New Jersey","Warren County","NHPI_AIC",106,116,10,9.01,"overcount"
"7185",35001,"New Mexico","Bernalillo County","A_A",18424,19439,1015,5.36,"overcount"
"7186",35001,"New Mexico","Bernalillo County","A_AIC",24048,25490,1442,5.82,"overcount"
"7187",35001,"New Mexico","Bernalillo County","NHPI_A",379,581,202,42.08,"overcount"
"7188",35001,"New Mexico","Bernalillo County","NHPI_AIC",1267,1528,261,18.68,"overcount"
"7189",35003,"New Mexico","Catron County","A_A",10,8,-2,-22.22,"undercount"
"7190",35003,"New Mexico","Catron County","A_AIC",22,26,4,16.67,"overcount"
"7191",35003,"New Mexico","Catron County","NHPI_A",1,0,-1,-200,"undercount"
"7192",35003,"New Mexico","Catron County","NHPI_AIC",3,4,1,28.57,"overcount"
"7193",35005,"New Mexico","Chaves County","A_A",601,630,29,4.71,"overcount"
"7194",35005,"New Mexico","Chaves County","A_AIC",761,823,62,7.83,"overcount"
"7195",35005,"New Mexico","Chaves County","NHPI_A",58,30,-28,-63.64,"undercount"
"7196",35005,"New Mexico","Chaves County","NHPI_AIC",86,57,-29,-40.56,"undercount"
"7197",35006,"New Mexico","Cibola County","A_A",135,202,67,39.76,"overcount"
"7198",35006,"New Mexico","Cibola County","A_AIC",204,284,80,32.79,"overcount"
"7199",35006,"New Mexico","Cibola County","NHPI_A",18,7,-11,-88,"undercount"
"7200",35006,"New Mexico","Cibola County","NHPI_AIC",33,44,11,28.57,"overcount"
"7201",35007,"New Mexico","Colfax County","A_A",89,60,-29,-38.93,"undercount"
"7202",35007,"New Mexico","Colfax County","A_AIC",108,92,-16,-16,"undercount"
"7203",35007,"New Mexico","Colfax County","NHPI_A",10,11,1,9.52,"overcount"
"7204",35007,"New Mexico","Colfax County","NHPI_AIC",13,14,1,7.41,"overcount"
"7205",35009,"New Mexico","Curry County","A_A",782,743,-39,-5.11,"undercount"
"7206",35009,"New Mexico","Curry County","A_AIC",1166,1108,-58,-5.1,"undercount"
"7207",35009,"New Mexico","Curry County","NHPI_A",66,35,-31,-61.39,"undercount"
"7208",35009,"New Mexico","Curry County","NHPI_AIC",131,112,-19,-15.64,"undercount"
"7209",35011,"New Mexico","De Baca County","A_A",2,4,2,66.67,"overcount"
"7210",35011,"New Mexico","De Baca County","A_AIC",11,14,3,24,"overcount"
"7211",35011,"New Mexico","De Baca County","NHPI_A",0,4,4,200,"overcount"
"7212",35011,"New Mexico","De Baca County","NHPI_AIC",2,10,8,133.33,"overcount"
"7213",35013,"New Mexico","Dona Ana County","A_A",2450,2483,33,1.34,"overcount"
"7214",35013,"New Mexico","Dona Ana County","A_AIC",3206,3444,238,7.16,"overcount"
"7215",35013,"New Mexico","Dona Ana County","NHPI_A",146,123,-23,-17.1,"undercount"
"7216",35013,"New Mexico","Dona Ana County","NHPI_AIC",294,326,32,10.32,"overcount"
"7217",35015,"New Mexico","Eddy County","A_A",408,597,189,37.61,"overcount"
"7218",35015,"New Mexico","Eddy County","A_AIC",557,784,227,33.86,"overcount"
"7219",35015,"New Mexico","Eddy County","NHPI_A",38,43,5,12.35,"overcount"
"7220",35015,"New Mexico","Eddy County","NHPI_AIC",91,100,9,9.42,"overcount"
"7221",35017,"New Mexico","Grant County","A_A",208,193,-15,-7.48,"undercount"
"7222",35017,"New Mexico","Grant County","A_AIC",269,281,12,4.36,"overcount"
"7223",35017,"New Mexico","Grant County","NHPI_A",39,22,-17,-55.74,"undercount"
"7224",35017,"New Mexico","Grant County","NHPI_AIC",62,54,-8,-13.79,"undercount"
"7225",35019,"New Mexico","Guadalupe County","A_A",50,49,-1,-2.02,"undercount"
"7226",35019,"New Mexico","Guadalupe County","A_AIC",67,73,6,8.57,"overcount"
"7227",35019,"New Mexico","Guadalupe County","NHPI_A",0,0,0,0,"equal"
"7228",35019,"New Mexico","Guadalupe County","NHPI_AIC",2,1,-1,-66.67,"undercount"
"7229",35021,"New Mexico","Harding County","A_A",0,0,0,0,"equal"
"7230",35021,"New Mexico","Harding County","A_AIC",2,5,3,85.71,"overcount"
"7231",35021,"New Mexico","Harding County","NHPI_A",0,0,0,0,"equal"
"7232",35021,"New Mexico","Harding County","NHPI_AIC",0,0,0,0,"equal"
"7233",35023,"New Mexico","Hidalgo County","A_A",22,11,-11,-66.67,"undercount"
"7234",35023,"New Mexico","Hidalgo County","A_AIC",29,21,-8,-32,"undercount"
"7235",35023,"New Mexico","Hidalgo County","NHPI_A",2,5,3,85.71,"overcount"
"7236",35023,"New Mexico","Hidalgo County","NHPI_AIC",2,18,16,160,"overcount"
"7237",35025,"New Mexico","Lea County","A_A",378,639,261,51.33,"overcount"
"7238",35025,"New Mexico","Lea County","A_AIC",450,800,350,56,"overcount"
"7239",35025,"New Mexico","Lea County","NHPI_A",23,22,-1,-4.44,"undercount"
"7240",35025,"New Mexico","Lea County","NHPI_AIC",52,71,19,30.89,"overcount"
"7241",35027,"New Mexico","Lincoln County","A_A",117,138,21,16.47,"overcount"
"7242",35027,"New Mexico","Lincoln County","A_AIC",158,178,20,11.9,"overcount"
"7243",35027,"New Mexico","Lincoln County","NHPI_A",7,8,1,13.33,"overcount"
"7244",35027,"New Mexico","Lincoln County","NHPI_AIC",18,19,1,5.41,"overcount"
"7245",35028,"New Mexico","Los Alamos County","A_A",1327,1232,-95,-7.42,"undercount"
"7246",35028,"New Mexico","Los Alamos County","A_AIC",1500,1528,28,1.85,"overcount"
"7247",35028,"New Mexico","Los Alamos County","NHPI_A",11,15,4,30.77,"overcount"
"7248",35028,"New Mexico","Los Alamos County","NHPI_AIC",25,35,10,33.33,"overcount"
"7249",35029,"New Mexico","Luna County","A_A",248,160,-88,-43.14,"undercount"
"7250",35029,"New Mexico","Luna County","A_AIC",300,259,-41,-14.67,"undercount"
"7251",35029,"New Mexico","Luna County","NHPI_A",10,12,2,18.18,"overcount"
"7252",35029,"New Mexico","Luna County","NHPI_AIC",31,33,2,6.25,"overcount"
"7253",35031,"New Mexico","McKinley County","A_A",737,940,203,24.21,"overcount"
"7254",35031,"New Mexico","McKinley County","A_AIC",919,1132,213,20.77,"overcount"
"7255",35031,"New Mexico","McKinley County","NHPI_A",22,34,12,42.86,"overcount"
"7256",35031,"New Mexico","McKinley County","NHPI_AIC",94,93,-1,-1.07,"undercount"
"7257",35033,"New Mexico","Mora County","A_A",18,14,-4,-25,"undercount"
"7258",35033,"New Mexico","Mora County","A_AIC",24,29,5,18.87,"overcount"
"7259",35033,"New Mexico","Mora County","NHPI_A",1,0,-1,-200,"undercount"
"7260",35033,"New Mexico","Mora County","NHPI_AIC",1,11,10,166.67,"overcount"
"7261",35035,"New Mexico","Otero County","A_A",1020,1015,-5,-0.49,"undercount"
"7262",35035,"New Mexico","Otero County","A_AIC",1516,1649,133,8.4,"overcount"
"7263",35035,"New Mexico","Otero County","NHPI_A",106,160,54,40.6,"overcount"
"7264",35035,"New Mexico","Otero County","NHPI_AIC",200,296,96,38.71,"overcount"
"7265",35037,"New Mexico","Quay County","A_A",78,48,-30,-47.62,"undercount"
"7266",35037,"New Mexico","Quay County","A_AIC",105,88,-17,-17.62,"undercount"
"7267",35037,"New Mexico","Quay County","NHPI_A",9,6,-3,-40,"undercount"
"7268",35037,"New Mexico","Quay County","NHPI_AIC",17,14,-3,-19.35,"undercount"
"7269",35039,"New Mexico","Rio Arriba County","A_A",239,233,-6,-2.54,"undercount"
"7270",35039,"New Mexico","Rio Arriba County","A_AIC",279,311,32,10.85,"overcount"
"7271",35039,"New Mexico","Rio Arriba County","NHPI_A",16,10,-6,-46.15,"undercount"
"7272",35039,"New Mexico","Rio Arriba County","NHPI_AIC",22,37,15,50.85,"overcount"
"7273",35041,"New Mexico","Roosevelt County","A_A",224,173,-51,-25.69,"undercount"
"7274",35041,"New Mexico","Roosevelt County","A_AIC",297,270,-27,-9.52,"undercount"
"7275",35041,"New Mexico","Roosevelt County","NHPI_A",17,18,1,5.71,"overcount"
"7276",35041,"New Mexico","Roosevelt County","NHPI_AIC",31,54,23,54.12,"overcount"
"7277",35043,"New Mexico","Sandoval County","A_A",2344,2353,9,0.38,"overcount"
"7278",35043,"New Mexico","Sandoval County","A_AIC",3386,3584,198,5.68,"overcount"
"7279",35043,"New Mexico","Sandoval County","NHPI_A",159,173,14,8.43,"overcount"
"7280",35043,"New Mexico","Sandoval County","NHPI_AIC",345,448,103,25.98,"overcount"
"7281",35045,"New Mexico","San Juan County","A_A",620,897,277,36.52,"overcount"
"7282",35045,"New Mexico","San Juan County","A_AIC",1070,1305,235,19.79,"overcount"
"7283",35045,"New Mexico","San Juan County","NHPI_A",67,69,2,2.94,"overcount"
"7284",35045,"New Mexico","San Juan County","NHPI_AIC",146,187,41,24.62,"overcount"
"7285",35047,"New Mexico","San Miguel County","A_A",287,140,-147,-68.85,"undercount"
"7286",35047,"New Mexico","San Miguel County","A_AIC",338,198,-140,-52.24,"undercount"
"7287",35047,"New Mexico","San Miguel County","NHPI_A",17,2,-15,-157.89,"undercount"
"7288",35047,"New Mexico","San Miguel County","NHPI_AIC",21,34,13,47.27,"overcount"
"7289",35049,"New Mexico","Santa Fe County","A_A",2129,2274,145,6.59,"overcount"
"7290",35049,"New Mexico","Santa Fe County","A_AIC",2728,3235,507,17,"overcount"
"7291",35049,"New Mexico","Santa Fe County","NHPI_A",84,72,-12,-15.38,"undercount"
"7292",35049,"New Mexico","Santa Fe County","NHPI_AIC",184,254,70,31.96,"overcount"
"7293",35051,"New Mexico","Sierra County","A_A",90,123,33,30.99,"overcount"
"7294",35051,"New Mexico","Sierra County","A_AIC",119,145,26,19.7,"overcount"
"7295",35051,"New Mexico","Sierra County","NHPI_A",2,3,1,40,"overcount"
"7296",35051,"New Mexico","Sierra County","NHPI_AIC",10,13,3,26.09,"overcount"
"7297",35053,"New Mexico","Socorro County","A_A",355,303,-52,-15.81,"undercount"
"7298",35053,"New Mexico","Socorro County","A_AIC",423,367,-56,-14.18,"undercount"
"7299",35053,"New Mexico","Socorro County","NHPI_A",3,8,5,90.91,"overcount"
"7300",35053,"New Mexico","Socorro County","NHPI_AIC",16,29,13,57.78,"overcount"
"7301",35055,"New Mexico","Taos County","A_A",248,204,-44,-19.47,"undercount"
"7302",35055,"New Mexico","Taos County","A_AIC",319,356,37,10.96,"overcount"
"7303",35055,"New Mexico","Taos County","NHPI_A",7,7,0,0,"equal"
"7304",35055,"New Mexico","Taos County","NHPI_AIC",28,60,32,72.73,"overcount"
"7305",35057,"New Mexico","Torrance County","A_A",66,51,-15,-25.64,"undercount"
"7306",35057,"New Mexico","Torrance County","A_AIC",126,108,-18,-15.38,"undercount"
"7307",35057,"New Mexico","Torrance County","NHPI_A",22,2,-20,-166.67,"undercount"
"7308",35057,"New Mexico","Torrance County","NHPI_AIC",42,28,-14,-40,"undercount"
"7309",35059,"New Mexico","Union County","A_A",27,6,-21,-127.27,"undercount"
"7310",35059,"New Mexico","Union County","A_AIC",36,24,-12,-40,"undercount"
"7311",35059,"New Mexico","Union County","NHPI_A",1,4,3,120,"overcount"
"7312",35059,"New Mexico","Union County","NHPI_AIC",3,12,9,120,"overcount"
"7313",35061,"New Mexico","Valencia County","A_A",427,372,-55,-13.77,"undercount"
"7314",35061,"New Mexico","Valencia County","A_AIC",675,659,-16,-2.4,"undercount"
"7315",35061,"New Mexico","Valencia County","NHPI_A",44,33,-11,-28.57,"undercount"
"7316",35061,"New Mexico","Valencia County","NHPI_AIC",92,106,14,14.14,"overcount"
"7317",36001,"New York","Albany County","A_A",20935,24620,3685,16.18,"overcount"
"7318",36001,"New York","Albany County","A_AIC",24142,27580,3438,13.29,"overcount"
"7319",36001,"New York","Albany County","NHPI_A",143,179,36,22.36,"overcount"
"7320",36001,"New York","Albany County","NHPI_AIC",451,431,-20,-4.54,"undercount"
"7321",36003,"New York","Allegany County","A_A",563,403,-160,-33.13,"undercount"
"7322",36003,"New York","Allegany County","A_AIC",757,615,-142,-20.7,"undercount"
"7323",36003,"New York","Allegany County","NHPI_A",14,8,-6,-54.55,"undercount"
"7324",36003,"New York","Allegany County","NHPI_AIC",42,69,27,48.65,"overcount"
"7325",36005,"New York","Bronx County","A_A",58226,72154,13928,21.37,"overcount"
"7326",36005,"New York","Bronx County","A_AIC",61887,79090,17203,24.41,"overcount"
"7327",36005,"New York","Bronx County","NHPI_A",710,857,147,18.76,"overcount"
"7328",36005,"New York","Bronx County","NHPI_AIC",1720,1978,258,13.95,"overcount"
"7329",36007,"New York","Broome County","A_A",8380,9479,1099,12.31,"overcount"
"7330",36007,"New York","Broome County","A_AIC",10039,10905,866,8.27,"overcount"
"7331",36007,"New York","Broome County","NHPI_A",81,65,-16,-21.92,"undercount"
"7332",36007,"New York","Broome County","NHPI_AIC",282,257,-25,-9.28,"undercount"
"7333",36009,"New York","Cattaraugus County","A_A",577,566,-11,-1.92,"undercount"
"7334",36009,"New York","Cattaraugus County","A_AIC",854,798,-56,-6.78,"undercount"
"7335",36009,"New York","Cattaraugus County","NHPI_A",26,12,-14,-73.68,"undercount"
"7336",36009,"New York","Cattaraugus County","NHPI_AIC",87,61,-26,-35.14,"undercount"
"7337",36011,"New York","Cayuga County","A_A",495,379,-116,-26.54,"undercount"
"7338",36011,"New York","Cayuga County","A_AIC",756,632,-124,-17.87,"undercount"
"7339",36011,"New York","Cayuga County","NHPI_A",38,54,16,34.78,"overcount"
"7340",36011,"New York","Cayuga County","NHPI_AIC",93,116,23,22.01,"overcount"
"7341",36013,"New York","Chautauqua County","A_A",772,823,51,6.39,"overcount"
"7342",36013,"New York","Chautauqua County","A_AIC",1149,1208,59,5.01,"overcount"
"7343",36013,"New York","Chautauqua County","NHPI_A",32,50,18,43.9,"overcount"
"7344",36013,"New York","Chautauqua County","NHPI_AIC",92,116,24,23.08,"overcount"
"7345",36015,"New York","Chemung County","A_A",1158,1436,278,21.43,"overcount"
"7346",36015,"New York","Chemung County","A_AIC",1592,1829,237,13.86,"overcount"
"7347",36015,"New York","Chemung County","NHPI_A",15,17,2,12.5,"overcount"
"7348",36015,"New York","Chemung County","NHPI_AIC",83,63,-20,-27.4,"undercount"
"7349",36017,"New York","Chenango County","A_A",258,253,-5,-1.96,"undercount"
"7350",36017,"New York","Chenango County","A_AIC",414,393,-21,-5.2,"undercount"
"7351",36017,"New York","Chenango County","NHPI_A",6,15,9,85.71,"overcount"
"7352",36017,"New York","Chenango County","NHPI_AIC",25,43,18,52.94,"overcount"
"7353",36019,"New York","Clinton County","A_A",1114,982,-132,-12.6,"undercount"
"7354",36019,"New York","Clinton County","A_AIC",1452,1353,-99,-7.06,"undercount"
"7355",36019,"New York","Clinton County","NHPI_A",18,24,6,28.57,"overcount"
"7356",36019,"New York","Clinton County","NHPI_AIC",71,95,24,28.92,"overcount"
"7357",36021,"New York","Columbia County","A_A",1229,1430,201,15.12,"overcount"
"7358",36021,"New York","Columbia County","A_AIC",1499,1793,294,17.86,"overcount"
"7359",36021,"New York","Columbia County","NHPI_A",21,18,-3,-15.38,"undercount"
"7360",36021,"New York","Columbia County","NHPI_AIC",60,77,17,24.82,"overcount"
"7361",36023,"New York","Cortland County","A_A",532,1033,501,64.03,"overcount"
"7362",36023,"New York","Cortland County","A_AIC",753,1223,470,47.57,"overcount"
"7363",36023,"New York","Cortland County","NHPI_A",13,6,-7,-73.68,"undercount"
"7364",36023,"New York","Cortland County","NHPI_AIC",43,41,-2,-4.76,"undercount"
"7365",36025,"New York","Delaware County","A_A",464,483,19,4.01,"overcount"
"7366",36025,"New York","Delaware County","A_AIC",627,697,70,10.57,"overcount"
"7367",36025,"New York","Delaware County","NHPI_A",15,7,-8,-72.73,"undercount"
"7368",36025,"New York","Delaware County","NHPI_AIC",52,29,-23,-56.79,"undercount"
"7369",36027,"New York","Dutchess County","A_A",10558,10815,257,2.4,"overcount"
"7370",36027,"New York","Dutchess County","A_AIC",12825,13116,291,2.24,"overcount"
"7371",36027,"New York","Dutchess County","NHPI_A",109,83,-26,-27.08,"undercount"
"7372",36027,"New York","Dutchess County","NHPI_AIC",339,327,-12,-3.6,"undercount"
"7373",36029,"New York","Erie County","A_A",36534,46490,9956,23.98,"overcount"
"7374",36029,"New York","Erie County","A_AIC",42410,53003,10593,22.2,"overcount"
"7375",36029,"New York","Erie County","NHPI_A",267,208,-59,-24.84,"undercount"
"7376",36029,"New York","Erie County","NHPI_AIC",784,765,-19,-2.45,"undercount"
"7377",36031,"New York","Essex County","A_A",264,237,-27,-10.78,"undercount"
"7378",36031,"New York","Essex County","A_AIC",362,382,20,5.38,"overcount"
"7379",36031,"New York","Essex County","NHPI_A",17,7,-10,-83.33,"undercount"
"7380",36031,"New York","Essex County","NHPI_AIC",45,37,-8,-19.51,"undercount"
"7381",36033,"New York","Franklin County","A_A",246,199,-47,-21.12,"undercount"
"7382",36033,"New York","Franklin County","A_AIC",389,340,-49,-13.44,"undercount"
"7383",36033,"New York","Franklin County","NHPI_A",12,0,-12,-200,"undercount"
"7384",36033,"New York","Franklin County","NHPI_AIC",42,31,-11,-30.14,"undercount"
"7385",36035,"New York","Fulton County","A_A",373,368,-5,-1.35,"undercount"
"7386",36035,"New York","Fulton County","A_AIC",547,578,31,5.51,"overcount"
"7387",36035,"New York","Fulton County","NHPI_A",15,5,-10,-100,"undercount"
"7388",36035,"New York","Fulton County","NHPI_AIC",57,22,-35,-88.61,"undercount"
"7389",36037,"New York","Genesee County","A_A",367,412,45,11.55,"overcount"
"7390",36037,"New York","Genesee County","A_AIC",561,646,85,14.08,"overcount"
"7391",36037,"New York","Genesee County","NHPI_A",3,16,13,136.84,"overcount"
"7392",36037,"New York","Genesee County","NHPI_AIC",56,32,-24,-54.55,"undercount"
"7393",36039,"New York","Greene County","A_A",523,502,-21,-4.1,"undercount"
"7394",36039,"New York","Greene County","A_AIC",733,748,15,2.03,"overcount"
"7395",36039,"New York","Greene County","NHPI_A",16,3,-13,-136.84,"undercount"
"7396",36039,"New York","Greene County","NHPI_AIC",77,47,-30,-48.39,"undercount"
"7397",36041,"New York","Hamilton County","A_A",34,14,-20,-83.33,"undercount"
"7398",36041,"New York","Hamilton County","A_AIC",43,37,-6,-15,"undercount"
"7399",36041,"New York","Hamilton County","NHPI_A",4,1,-3,-120,"undercount"
"7400",36041,"New York","Hamilton County","NHPI_AIC",8,9,1,11.76,"overcount"
"7401",36043,"New York","Herkimer County","A_A",364,363,-1,-0.28,"undercount"
"7402",36043,"New York","Herkimer County","A_AIC",545,591,46,8.1,"overcount"
"7403",36043,"New York","Herkimer County","NHPI_A",16,32,16,66.67,"overcount"
"7404",36043,"New York","Herkimer County","NHPI_AIC",54,72,18,28.57,"overcount"
"7405",36045,"New York","Jefferson County","A_A",1739,2224,485,24.48,"overcount"
"7406",36045,"New York","Jefferson County","A_AIC",2753,3003,250,8.69,"overcount"
"7407",36045,"New York","Jefferson County","NHPI_A",241,300,59,21.81,"overcount"
"7408",36045,"New York","Jefferson County","NHPI_AIC",398,457,59,13.8,"overcount"
"7409",36047,"New York","Kings County","A_A",322772,378683,55911,15.94,"overcount"
"7410",36047,"New York","Kings County","A_AIC",348255,419208,70953,18.49,"overcount"
"7411",36047,"New York","Kings County","NHPI_A",844,1101,257,26.43,"overcount"
"7412",36047,"New York","Kings County","NHPI_AIC",4473,3852,-621,-14.92,"undercount"
"7413",36049,"New York","Lewis County","A_A",109,66,-43,-49.14,"undercount"
"7414",36049,"New York","Lewis County","A_AIC",163,134,-29,-19.53,"undercount"
"7415",36049,"New York","Lewis County","NHPI_A",32,13,-19,-84.44,"undercount"
"7416",36049,"New York","Lewis County","NHPI_AIC",51,41,-10,-21.74,"undercount"
"7417",36051,"New York","Livingston County","A_A",832,657,-175,-23.51,"undercount"
"7418",36051,"New York","Livingston County","A_AIC",1167,983,-184,-17.12,"undercount"
"7419",36051,"New York","Livingston County","NHPI_A",15,6,-9,-85.71,"undercount"
"7420",36051,"New York","Livingston County","NHPI_AIC",57,52,-5,-9.17,"undercount"
"7421",36053,"New York","Madison County","A_A",662,671,9,1.35,"overcount"
"7422",36053,"New York","Madison County","A_AIC",1003,998,-5,-0.5,"undercount"
"7423",36053,"New York","Madison County","NHPI_A",16,11,-5,-37.04,"undercount"
"7424",36053,"New York","Madison County","NHPI_AIC",60,51,-9,-16.22,"undercount"
"7425",36055,"New York","Monroe County","A_A",27071,32639,5568,18.65,"overcount"
"7426",36055,"New York","Monroe County","A_AIC",32904,39208,6304,17.48,"overcount"
"7427",36055,"New York","Monroe County","NHPI_A",262,206,-56,-23.93,"undercount"
"7428",36055,"New York","Monroe County","NHPI_AIC",749,733,-16,-2.16,"undercount"
"7429",36057,"New York","Montgomery County","A_A",435,494,59,12.7,"overcount"
"7430",36057,"New York","Montgomery County","A_AIC",566,695,129,20.46,"overcount"
"7431",36057,"New York","Montgomery County","NHPI_A",30,16,-14,-60.87,"undercount"
"7432",36057,"New York","Montgomery County","NHPI_AIC",62,44,-18,-33.96,"undercount"
"7433",36059,"New York","Nassau County","A_A",153947,166919,12972,8.09,"overcount"
"7434",36059,"New York","Nassau County","A_AIC",165570,180006,14436,8.35,"overcount"
"7435",36059,"New York","Nassau County","NHPI_A",562,437,-125,-25.03,"undercount"
"7436",36059,"New York","Nassau County","NHPI_AIC",1436,1291,-145,-10.63,"undercount"
"7437",36061,"New York","New York County","A_A",204630,222265,17635,8.26,"overcount"
"7438",36061,"New York","New York County","A_AIC",222556,250582,28026,11.85,"overcount"
"7439",36061,"New York","New York County","NHPI_A",656,929,273,34.45,"overcount"
"7440",36061,"New York","New York County","NHPI_AIC",2187,3426,1239,44.15,"overcount"
"7441",36063,"New York","Niagara County","A_A",2423,2514,91,3.69,"overcount"
"7442",36063,"New York","Niagara County","A_AIC",3389,3473,84,2.45,"overcount"
"7443",36063,"New York","Niagara County","NHPI_A",81,45,-36,-57.14,"undercount"
"7444",36063,"New York","Niagara County","NHPI_AIC",254,154,-100,-49.02,"undercount"
"7445",36065,"New York","Oneida County","A_A",9324,10598,1274,12.79,"overcount"
"7446",36065,"New York","Oneida County","A_AIC",10543,11943,1400,12.45,"overcount"
"7447",36065,"New York","Oneida County","NHPI_A",96,76,-20,-23.26,"undercount"
"7448",36065,"New York","Oneida County","NHPI_AIC",287,222,-65,-25.54,"undercount"
"7449",36067,"New York","Onondaga County","A_A",17438,20287,2849,15.1,"overcount"
"7450",36067,"New York","Onondaga County","A_AIC",21136,23838,2702,12.02,"overcount"
"7451",36067,"New York","Onondaga County","NHPI_A",139,117,-22,-17.19,"undercount"
"7452",36067,"New York","Onondaga County","NHPI_AIC",483,573,90,17.05,"overcount"
"7453",36069,"New York","Ontario County","A_A",1533,1392,-141,-9.64,"undercount"
"7454",36069,"New York","Ontario County","A_AIC",2081,2039,-42,-2.04,"undercount"
"7455",36069,"New York","Ontario County","NHPI_A",22,23,1,4.44,"overcount"
"7456",36069,"New York","Ontario County","NHPI_AIC",95,111,16,15.53,"overcount"
"7457",36071,"New York","Orange County","A_A",11111,12856,1745,14.56,"overcount"
"7458",36071,"New York","Orange County","A_AIC",13830,15767,1937,13.09,"overcount"
"7459",36071,"New York","Orange County","NHPI_A",130,158,28,19.44,"overcount"
"7460",36071,"New York","Orange County","NHPI_AIC",373,434,61,15.12,"overcount"
"7461",36073,"New York","Orleans County","A_A",230,168,-62,-31.16,"undercount"
"7462",36073,"New York","Orleans County","A_AIC",350,312,-38,-11.48,"undercount"
"7463",36073,"New York","Orleans County","NHPI_A",11,12,1,8.7,"overcount"
"7464",36073,"New York","Orleans County","NHPI_AIC",44,46,2,4.44,"overcount"
"7465",36075,"New York","Oswego County","A_A",806,885,79,9.34,"overcount"
"7466",36075,"New York","Oswego County","A_AIC",1296,1344,48,3.64,"overcount"
"7467",36075,"New York","Oswego County","NHPI_A",36,19,-17,-61.82,"undercount"
"7468",36075,"New York","Oswego County","NHPI_AIC",92,129,37,33.48,"overcount"
"7469",36077,"New York","Otsego County","A_A",820,848,28,3.36,"overcount"
"7470",36077,"New York","Otsego County","A_AIC",1070,1213,143,12.53,"overcount"
"7471",36077,"New York","Otsego County","NHPI_A",31,10,-21,-102.44,"undercount"
"7472",36077,"New York","Otsego County","NHPI_AIC",76,59,-17,-25.19,"undercount"
"7473",36079,"New York","Putnam County","A_A",2191,2213,22,1,"overcount"
"7474",36079,"New York","Putnam County","A_AIC",2817,2934,117,4.07,"overcount"
"7475",36079,"New York","Putnam County","NHPI_A",28,22,-6,-24,"undercount"
"7476",36079,"New York","Putnam County","NHPI_AIC",100,111,11,10.43,"overcount"
"7477",36081,"New York","Queens County","A_A",601159,687936,86777,13.46,"overcount"
"7478",36081,"New York","Queens County","A_AIC",631117,719333,88216,13.06,"overcount"
"7479",36081,"New York","Queens County","NHPI_A",2741,2801,60,2.17,"overcount"
"7480",36081,"New York","Queens County","NHPI_AIC",6508,6412,-96,-1.49,"undercount"
"7481",36083,"New York","Rensselaer County","A_A",4449,5757,1308,25.63,"overcount"
"7482",36083,"New York","Rensselaer County","A_AIC",5512,6963,1451,23.26,"overcount"
"7483",36083,"New York","Rensselaer County","NHPI_A",44,17,-27,-88.52,"undercount"
"7484",36083,"New York","Rensselaer County","NHPI_AIC",157,109,-48,-36.09,"undercount"
"7485",36085,"New York","Richmond County","A_A",54804,59280,4476,7.85,"overcount"
"7486",36085,"New York","Richmond County","A_AIC",58513,63309,4796,7.87,"overcount"
"7487",36085,"New York","Richmond County","NHPI_A",162,151,-11,-7.03,"undercount"
"7488",36085,"New York","Richmond County","NHPI_AIC",474,523,49,9.83,"overcount"
"7489",36087,"New York","Rockland County","A_A",19998,21059,1061,5.17,"overcount"
"7490",36087,"New York","Rockland County","A_AIC",22044,23171,1127,4.99,"overcount"
"7491",36087,"New York","Rockland County","NHPI_A",86,52,-34,-49.28,"undercount"
"7492",36087,"New York","Rockland County","NHPI_AIC",349,223,-126,-44.06,"undercount"
"7493",36089,"New York","St. Lawrence County","A_A",1165,1100,-65,-5.74,"undercount"
"7494",36089,"New York","St. Lawrence County","A_AIC",1599,1532,-67,-4.28,"undercount"
"7495",36089,"New York","St. Lawrence County","NHPI_A",40,19,-21,-71.19,"undercount"
"7496",36089,"New York","St. Lawrence County","NHPI_AIC",96,127,31,27.8,"overcount"
"7497",36091,"New York","Saratoga County","A_A",6504,7522,1018,14.52,"overcount"
"7498",36091,"New York","Saratoga County","A_AIC",8325,9481,1156,12.98,"overcount"
"7499",36091,"New York","Saratoga County","NHPI_A",75,60,-15,-22.22,"undercount"
"7500",36091,"New York","Saratoga County","NHPI_AIC",203,213,10,4.81,"overcount"
"7501",36093,"New York","Schenectady County","A_A",7876,10086,2210,24.61,"overcount"
"7502",36093,"New York","Schenectady County","A_AIC",9719,11855,2136,19.8,"overcount"
"7503",36093,"New York","Schenectady County","NHPI_A",286,397,111,32.5,"overcount"
"7504",36093,"New York","Schenectady County","NHPI_AIC",496,593,97,17.81,"overcount"
"7505",36095,"New York","Schoharie County","A_A",232,210,-22,-9.95,"undercount"
"7506",36095,"New York","Schoharie County","A_AIC",356,302,-54,-16.41,"undercount"
"7507",36095,"New York","Schoharie County","NHPI_A",3,3,0,0,"equal"
"7508",36095,"New York","Schoharie County","NHPI_AIC",27,18,-9,-40,"undercount"
"7509",36097,"New York","Schuyler County","A_A",118,110,-8,-7.02,"undercount"
"7510",36097,"New York","Schuyler County","A_AIC",185,174,-11,-6.13,"undercount"
"7511",36097,"New York","Schuyler County","NHPI_A",7,1,-6,-150,"undercount"
"7512",36097,"New York","Schuyler County","NHPI_AIC",19,11,-8,-53.33,"undercount"
"7513",36099,"New York","Seneca County","A_A",289,268,-21,-7.54,"undercount"
"7514",36099,"New York","Seneca County","A_AIC",387,395,8,2.05,"overcount"
"7515",36099,"New York","Seneca County","NHPI_A",3,3,0,0,"equal"
"7516",36099,"New York","Seneca County","NHPI_AIC",18,18,0,0,"equal"
"7517",36101,"New York","Steuben County","A_A",1544,1626,82,5.17,"overcount"
"7518",36101,"New York","Steuben County","A_AIC",1857,2013,156,8.06,"overcount"
"7519",36101,"New York","Steuben County","NHPI_A",17,12,-5,-34.48,"undercount"
"7520",36101,"New York","Steuben County","NHPI_AIC",74,63,-11,-16.06,"undercount"
"7521",36103,"New York","Suffolk County","A_A",62248,66498,4250,6.6,"overcount"
"7522",36103,"New York","Suffolk County","A_AIC",71534,77335,5801,7.79,"overcount"
"7523",36103,"New York","Suffolk County","NHPI_A",382,327,-55,-15.51,"undercount"
"7524",36103,"New York","Suffolk County","NHPI_AIC",1149,1221,72,6.08,"overcount"
"7525",36105,"New York","Sullivan County","A_A",1420,1611,191,12.6,"overcount"
"7526",36105,"New York","Sullivan County","A_AIC",1841,2061,220,11.28,"overcount"
"7527",36105,"New York","Sullivan County","NHPI_A",17,20,3,16.22,"overcount"
"7528",36105,"New York","Sullivan County","NHPI_AIC",94,90,-4,-4.35,"undercount"
"7529",36107,"New York","Tioga County","A_A",384,374,-10,-2.64,"undercount"
"7530",36107,"New York","Tioga County","A_AIC",555,575,20,3.54,"overcount"
"7531",36107,"New York","Tioga County","NHPI_A",12,23,11,62.86,"overcount"
"7532",36107,"New York","Tioga County","NHPI_AIC",36,63,27,54.55,"overcount"
"7533",36109,"New York","Tompkins County","A_A",10069,10598,529,5.12,"overcount"
"7534",36109,"New York","Tompkins County","A_AIC",11725,12397,672,5.57,"overcount"
"7535",36109,"New York","Tompkins County","NHPI_A",41,36,-5,-12.99,"undercount"
"7536",36109,"New York","Tompkins County","NHPI_AIC",185,162,-23,-13.26,"undercount"
"7537",36111,"New York","Ulster County","A_A",3626,3842,216,5.78,"overcount"
"7538",36111,"New York","Ulster County","A_AIC",4906,5109,203,4.05,"overcount"
"7539",36111,"New York","Ulster County","NHPI_A",47,45,-2,-4.35,"undercount"
"7540",36111,"New York","Ulster County","NHPI_AIC",239,189,-50,-23.36,"undercount"
"7541",36113,"New York","Warren County","A_A",584,730,146,22.22,"overcount"
"7542",36113,"New York","Warren County","A_AIC",835,1029,194,20.82,"overcount"
"7543",36113,"New York","Warren County","NHPI_A",11,3,-8,-114.29,"undercount"
"7544",36113,"New York","Warren County","NHPI_AIC",55,41,-14,-29.17,"undercount"
"7545",36115,"New York","Washington County","A_A",333,324,-9,-2.74,"undercount"
"7546",36115,"New York","Washington County","A_AIC",524,486,-38,-7.52,"undercount"
"7547",36115,"New York","Washington County","NHPI_A",18,23,5,24.39,"overcount"
"7548",36115,"New York","Washington County","NHPI_AIC",53,57,4,7.27,"overcount"
"7549",36117,"New York","Wayne County","A_A",594,514,-80,-14.44,"undercount"
"7550",36117,"New York","Wayne County","A_AIC",961,847,-114,-12.61,"undercount"
"7551",36117,"New York","Wayne County","NHPI_A",39,13,-26,-100,"undercount"
"7552",36117,"New York","Wayne County","NHPI_AIC",91,57,-34,-45.95,"undercount"
"7553",36119,"New York","Westchester County","A_A",61708,66267,4559,7.12,"overcount"
"7554",36119,"New York","Westchester County","A_AIC",69181,77129,7948,10.86,"overcount"
"7555",36119,"New York","Westchester County","NHPI_A",355,233,-122,-41.5,"undercount"
"7556",36119,"New York","Westchester County","NHPI_AIC",1001,817,-184,-20.24,"undercount"
"7557",36121,"New York","Wyoming County","A_A",199,217,18,8.65,"overcount"
"7558",36121,"New York","Wyoming County","A_AIC",288,336,48,15.38,"overcount"
"7559",36121,"New York","Wyoming County","NHPI_A",11,9,-2,-20,"undercount"
"7560",36121,"New York","Wyoming County","NHPI_AIC",24,15,-9,-46.15,"undercount"
"7561",36123,"New York","Yates County","A_A",197,93,-104,-71.72,"undercount"
"7562",36123,"New York","Yates County","A_AIC",244,151,-93,-47.09,"undercount"
"7563",36123,"New York","Yates County","NHPI_A",2,12,10,142.86,"overcount"
"7564",36123,"New York","Yates County","NHPI_AIC",21,18,-3,-15.38,"undercount"
"7565",37001,"North Carolina","Alamance County","A_A",3015,2879,-136,-4.61,"undercount"
"7566",37001,"North Carolina","Alamance County","A_AIC",3695,3753,58,1.56,"overcount"
"7567",37001,"North Carolina","Alamance County","NHPI_A",64,86,22,29.33,"overcount"
"7568",37001,"North Carolina","Alamance County","NHPI_AIC",192,199,7,3.58,"overcount"
"7569",37003,"North Carolina","Alexander County","A_A",368,394,26,6.82,"overcount"
"7570",37003,"North Carolina","Alexander County","A_AIC",440,482,42,9.11,"overcount"
"7571",37003,"North Carolina","Alexander County","NHPI_A",17,1,-16,-177.78,"undercount"
"7572",37003,"North Carolina","Alexander County","NHPI_AIC",29,6,-23,-131.43,"undercount"
"7573",37005,"North Carolina","Alleghany County","A_A",64,15,-49,-124.05,"undercount"
"7574",37005,"North Carolina","Alleghany County","A_AIC",85,47,-38,-57.58,"undercount"
"7575",37005,"North Carolina","Alleghany County","NHPI_A",5,6,1,18.18,"overcount"
"7576",37005,"North Carolina","Alleghany County","NHPI_AIC",11,24,13,74.29,"overcount"
"7577",37007,"North Carolina","Anson County","A_A",356,224,-132,-45.52,"undercount"
"7578",37007,"North Carolina","Anson County","A_AIC",402,272,-130,-38.58,"undercount"
"7579",37007,"North Carolina","Anson County","NHPI_A",3,4,1,28.57,"overcount"
"7580",37007,"North Carolina","Anson County","NHPI_AIC",17,13,-4,-26.67,"undercount"
"7581",37009,"North Carolina","Ashe County","A_A",124,102,-22,-19.47,"undercount"
"7582",37009,"North Carolina","Ashe County","A_AIC",160,138,-22,-14.77,"undercount"
"7583",37009,"North Carolina","Ashe County","NHPI_A",11,12,1,8.7,"overcount"
"7584",37009,"North Carolina","Ashe County","NHPI_AIC",20,20,0,0,"equal"
"7585",37011,"North Carolina","Avery County","A_A",96,56,-40,-52.63,"undercount"
"7586",37011,"North Carolina","Avery County","A_AIC",135,120,-15,-11.76,"undercount"
"7587",37011,"North Carolina","Avery County","NHPI_A",10,1,-9,-163.64,"undercount"
"7588",37011,"North Carolina","Avery County","NHPI_AIC",17,13,-4,-26.67,"undercount"
"7589",37013,"North Carolina","Beaufort County","A_A",204,183,-21,-10.85,"undercount"
"7590",37013,"North Carolina","Beaufort County","A_AIC",284,293,9,3.12,"overcount"
"7591",37013,"North Carolina","Beaufort County","NHPI_A",11,18,7,48.28,"overcount"
"7592",37013,"North Carolina","Beaufort County","NHPI_AIC",31,34,3,9.23,"overcount"
"7593",37015,"North Carolina","Bertie County","A_A",118,63,-55,-60.77,"undercount"
"7594",37015,"North Carolina","Bertie County","A_AIC",146,122,-24,-17.91,"undercount"
"7595",37015,"North Carolina","Bertie County","NHPI_A",1,0,-1,-200,"undercount"
"7596",37015,"North Carolina","Bertie County","NHPI_AIC",7,12,5,52.63,"overcount"
"7597",37017,"North Carolina","Bladen County","A_A",99,47,-52,-71.23,"undercount"
"7598",37017,"North Carolina","Bladen County","A_AIC",174,117,-57,-39.18,"undercount"
"7599",37017,"North Carolina","Bladen County","NHPI_A",9,8,-1,-11.76,"undercount"
"7600",37017,"North Carolina","Bladen County","NHPI_AIC",36,32,-4,-11.76,"undercount"
"7601",37019,"North Carolina","Brunswick County","A_A",1053,899,-154,-15.78,"undercount"
"7602",37019,"North Carolina","Brunswick County","A_AIC",1467,1405,-62,-4.32,"undercount"
"7603",37019,"North Carolina","Brunswick County","NHPI_A",115,75,-40,-42.11,"undercount"
"7604",37019,"North Carolina","Brunswick County","NHPI_AIC",188,147,-41,-24.48,"undercount"
"7605",37021,"North Carolina","Buncombe County","A_A",3652,3309,-343,-9.85,"undercount"
"7606",37021,"North Carolina","Buncombe County","A_AIC",4744,5197,453,9.11,"overcount"
"7607",37021,"North Carolina","Buncombe County","NHPI_A",353,467,114,27.8,"overcount"
"7608",37021,"North Carolina","Buncombe County","NHPI_AIC",498,689,191,32.18,"overcount"
"7609",37023,"North Carolina","Burke County","A_A",3246,3163,-83,-2.59,"undercount"
"7610",37023,"North Carolina","Burke County","A_AIC",3529,3460,-69,-1.97,"undercount"
"7611",37023,"North Carolina","Burke County","NHPI_A",157,65,-92,-82.88,"undercount"
"7612",37023,"North Carolina","Burke County","NHPI_AIC",210,135,-75,-43.48,"undercount"
"7613",37025,"North Carolina","Cabarrus County","A_A",11316,12053,737,6.31,"overcount"
"7614",37025,"North Carolina","Cabarrus County","A_AIC",12342,13648,1306,10.05,"overcount"
"7615",37025,"North Carolina","Cabarrus County","NHPI_A",112,124,12,10.17,"overcount"
"7616",37025,"North Carolina","Cabarrus County","NHPI_AIC",276,304,28,9.66,"overcount"
"7617",37027,"North Carolina","Caldwell County","A_A",587,530,-57,-10.21,"undercount"
"7618",37027,"North Carolina","Caldwell County","A_AIC",748,777,29,3.8,"overcount"
"7619",37027,"North Carolina","Caldwell County","NHPI_A",18,15,-3,-18.18,"undercount"
"7620",37027,"North Carolina","Caldwell County","NHPI_AIC",54,62,8,13.79,"overcount"
"7621",37029,"North Carolina","Camden County","A_A",195,122,-73,-46.06,"undercount"
"7622",37029,"North Carolina","Camden County","A_AIC",260,210,-50,-21.28,"undercount"
"7623",37029,"North Carolina","Camden County","NHPI_A",5,1,-4,-133.33,"undercount"
"7624",37029,"North Carolina","Camden County","NHPI_AIC",19,21,2,10,"overcount"
"7625",37031,"North Carolina","Carteret County","A_A",789,594,-195,-28.2,"undercount"
"7626",37031,"North Carolina","Carteret County","A_AIC",1152,1089,-63,-5.62,"undercount"
"7627",37031,"North Carolina","Carteret County","NHPI_A",95,63,-32,-40.51,"undercount"
"7628",37031,"North Carolina","Carteret County","NHPI_AIC",142,155,13,8.75,"overcount"
"7629",37033,"North Carolina","Caswell County","A_A",133,61,-72,-74.23,"undercount"
"7630",37033,"North Carolina","Caswell County","A_AIC",190,136,-54,-33.13,"undercount"
"7631",37033,"North Carolina","Caswell County","NHPI_A",6,17,11,95.65,"overcount"
"7632",37033,"North Carolina","Caswell County","NHPI_AIC",18,32,14,56,"overcount"
"7633",37035,"North Carolina","Catawba County","A_A",7511,6957,-554,-7.66,"undercount"
"7634",37035,"North Carolina","Catawba County","A_AIC",8063,7758,-305,-3.86,"undercount"
"7635",37035,"North Carolina","Catawba County","NHPI_A",107,78,-29,-31.35,"undercount"
"7636",37035,"North Carolina","Catawba County","NHPI_AIC",182,186,4,2.17,"overcount"
"7637",37037,"North Carolina","Chatham County","A_A",1648,1636,-12,-0.73,"undercount"
"7638",37037,"North Carolina","Chatham County","A_AIC",1938,2178,240,11.66,"overcount"
"7639",37037,"North Carolina","Chatham County","NHPI_A",36,34,-2,-5.71,"undercount"
"7640",37037,"North Carolina","Chatham County","NHPI_AIC",80,82,2,2.47,"overcount"
"7641",37039,"North Carolina","Cherokee County","A_A",194,158,-36,-20.45,"undercount"
"7642",37039,"North Carolina","Cherokee County","A_AIC",251,252,1,0.4,"overcount"
"7643",37039,"North Carolina","Cherokee County","NHPI_A",8,0,-8,-200,"undercount"
"7644",37039,"North Carolina","Cherokee County","NHPI_AIC",16,17,1,6.06,"overcount"
"7645",37041,"North Carolina","Chowan County","A_A",107,42,-65,-87.25,"undercount"
"7646",37041,"North Carolina","Chowan County","A_AIC",136,92,-44,-38.6,"undercount"
"7647",37041,"North Carolina","Chowan County","NHPI_A",2,1,-1,-66.67,"undercount"
"7648",37041,"North Carolina","Chowan County","NHPI_AIC",11,15,4,30.77,"overcount"
"7649",37043,"North Carolina","Clay County","A_A",47,46,-1,-2.15,"undercount"
"7650",37043,"North Carolina","Clay County","A_AIC",67,81,14,18.92,"overcount"
"7651",37043,"North Carolina","Clay County","NHPI_A",5,9,4,57.14,"overcount"
"7652",37043,"North Carolina","Clay County","NHPI_AIC",11,14,3,24,"overcount"
"7653",37045,"North Carolina","Cleveland County","A_A",1015,854,-161,-17.23,"undercount"
"7654",37045,"North Carolina","Cleveland County","A_AIC",1286,1200,-86,-6.92,"undercount"
"7655",37045,"North Carolina","Cleveland County","NHPI_A",22,23,1,4.44,"overcount"
"7656",37045,"North Carolina","Cleveland County","NHPI_AIC",85,58,-27,-37.76,"undercount"
"7657",37047,"North Carolina","Columbus County","A_A",198,157,-41,-23.1,"undercount"
"7658",37047,"North Carolina","Columbus County","A_AIC",316,231,-85,-31.08,"undercount"
"7659",37047,"North Carolina","Columbus County","NHPI_A",31,10,-21,-102.44,"undercount"
"7660",37047,"North Carolina","Columbus County","NHPI_AIC",77,52,-25,-38.76,"undercount"
"7661",37049,"North Carolina","Craven County","A_A",2912,3084,172,5.74,"overcount"
"7662",37049,"North Carolina","Craven County","A_AIC",3845,4027,182,4.62,"overcount"
"7663",37049,"North Carolina","Craven County","NHPI_A",157,154,-3,-1.93,"undercount"
"7664",37049,"North Carolina","Craven County","NHPI_AIC",314,266,-48,-16.55,"undercount"
"7665",37051,"North Carolina","Cumberland County","A_A",8676,9100,424,4.77,"overcount"
"7666",37051,"North Carolina","Cumberland County","A_AIC",12962,13582,620,4.67,"overcount"
"7667",37051,"North Carolina","Cumberland County","NHPI_A",1204,1368,164,12.75,"overcount"
"7668",37051,"North Carolina","Cumberland County","NHPI_AIC",2178,2433,255,11.06,"overcount"
"7669",37053,"North Carolina","Currituck County","A_A",240,265,25,9.9,"overcount"
"7670",37053,"North Carolina","Currituck County","A_AIC",394,496,102,22.92,"overcount"
"7671",37053,"North Carolina","Currituck County","NHPI_A",22,22,0,0,"equal"
"7672",37053,"North Carolina","Currituck County","NHPI_AIC",54,71,17,27.2,"overcount"
"7673",37055,"North Carolina","Dare County","A_A",314,260,-54,-18.82,"undercount"
"7674",37055,"North Carolina","Dare County","A_AIC",432,455,23,5.19,"overcount"
"7675",37055,"North Carolina","Dare County","NHPI_A",18,10,-8,-57.14,"undercount"
"7676",37055,"North Carolina","Dare County","NHPI_AIC",39,43,4,9.76,"overcount"
"7677",37057,"North Carolina","Davidson County","A_A",2724,2461,-263,-10.14,"undercount"
"7678",37057,"North Carolina","Davidson County","A_AIC",3311,3086,-225,-7.03,"undercount"
"7679",37057,"North Carolina","Davidson County","NHPI_A",57,43,-14,-28,"undercount"
"7680",37057,"North Carolina","Davidson County","NHPI_AIC",154,116,-38,-28.15,"undercount"
"7681",37059,"North Carolina","Davie County","A_A",325,285,-40,-13.11,"undercount"
"7682",37059,"North Carolina","Davie County","A_AIC",433,486,53,11.53,"overcount"
"7683",37059,"North Carolina","Davie County","NHPI_A",9,5,-4,-57.14,"undercount"
"7684",37059,"North Carolina","Davie County","NHPI_AIC",35,32,-3,-8.96,"undercount"
"7685",37061,"North Carolina","Duplin County","A_A",253,158,-95,-46.23,"undercount"
"7686",37061,"North Carolina","Duplin County","A_AIC",338,267,-71,-23.47,"undercount"
"7687",37061,"North Carolina","Duplin County","NHPI_A",30,4,-26,-152.94,"undercount"
"7688",37061,"North Carolina","Duplin County","NHPI_AIC",66,18,-48,-114.29,"undercount"
"7689",37063,"North Carolina","Durham County","A_A",18091,16867,-1224,-7,"undercount"
"7690",37063,"North Carolina","Durham County","A_AIC",20506,20343,-163,-0.8,"undercount"
"7691",37063,"North Carolina","Durham County","NHPI_A",162,96,-66,-51.16,"undercount"
"7692",37063,"North Carolina","Durham County","NHPI_AIC",413,318,-95,-25.99,"undercount"
"7693",37065,"North Carolina","Edgecombe County","A_A",146,115,-31,-23.75,"undercount"
"7694",37065,"North Carolina","Edgecombe County","A_AIC",246,187,-59,-27.25,"undercount"
"7695",37065,"North Carolina","Edgecombe County","NHPI_A",45,9,-36,-133.33,"undercount"
"7696",37065,"North Carolina","Edgecombe County","NHPI_AIC",92,23,-69,-120,"undercount"
"7697",37067,"North Carolina","Forsyth County","A_A",9813,9303,-510,-5.34,"undercount"
"7698",37067,"North Carolina","Forsyth County","A_AIC",11571,11550,-21,-0.18,"undercount"
"7699",37067,"North Carolina","Forsyth County","NHPI_A",275,241,-34,-13.18,"undercount"
"7700",37067,"North Carolina","Forsyth County","NHPI_AIC",507,543,36,6.86,"overcount"
"7701",37069,"North Carolina","Franklin County","A_A",474,454,-20,-4.31,"undercount"
"7702",37069,"North Carolina","Franklin County","A_AIC",758,780,22,2.86,"overcount"
"7703",37069,"North Carolina","Franklin County","NHPI_A",19,17,-2,-11.11,"undercount"
"7704",37069,"North Carolina","Franklin County","NHPI_AIC",87,60,-27,-36.73,"undercount"
"7705",37071,"North Carolina","Gaston County","A_A",3730,3550,-180,-4.95,"undercount"
"7706",37071,"North Carolina","Gaston County","A_AIC",4602,4657,55,1.19,"overcount"
"7707",37071,"North Carolina","Gaston County","NHPI_A",74,64,-10,-14.49,"undercount"
"7708",37071,"North Carolina","Gaston County","NHPI_AIC",211,237,26,11.61,"overcount"
"7709",37073,"North Carolina","Gates County","A_A",40,21,-19,-62.3,"undercount"
"7710",37073,"North Carolina","Gates County","A_AIC",90,51,-39,-55.32,"undercount"
"7711",37073,"North Carolina","Gates County","NHPI_A",6,11,5,58.82,"overcount"
"7712",37073,"North Carolina","Gates County","NHPI_AIC",22,36,14,48.28,"overcount"
"7713",37075,"North Carolina","Graham County","A_A",47,20,-27,-80.6,"undercount"
"7714",37075,"North Carolina","Graham County","A_AIC",59,37,-22,-45.83,"undercount"
"7715",37075,"North Carolina","Graham County","NHPI_A",4,5,1,22.22,"overcount"
"7716",37075,"North Carolina","Graham County","NHPI_AIC",9,8,-1,-11.76,"undercount"
"7717",37077,"North Carolina","Granville County","A_A",416,392,-24,-5.94,"undercount"
"7718",37077,"North Carolina","Granville County","A_AIC",610,603,-7,-1.15,"undercount"
"7719",37077,"North Carolina","Granville County","NHPI_A",28,24,-4,-15.38,"undercount"
"7720",37077,"North Carolina","Granville County","NHPI_AIC",78,57,-21,-31.11,"undercount"
"7721",37079,"North Carolina","Greene County","A_A",89,37,-52,-82.54,"undercount"
"7722",37079,"North Carolina","Greene County","A_AIC",118,73,-45,-47.12,"undercount"
"7723",37079,"North Carolina","Greene County","NHPI_A",14,0,-14,-200,"undercount"
"7724",37079,"North Carolina","Greene County","NHPI_AIC",24,14,-10,-52.63,"undercount"
"7725",37081,"North Carolina","Guilford County","A_A",28896,28990,94,0.32,"overcount"
"7726",37081,"North Carolina","Guilford County","A_AIC",32059,32634,575,1.78,"overcount"
"7727",37081,"North Carolina","Guilford County","NHPI_A",327,264,-63,-21.32,"undercount"
"7728",37081,"North Carolina","Guilford County","NHPI_AIC",795,658,-137,-18.86,"undercount"
"7729",37083,"North Carolina","Halifax County","A_A",385,288,-97,-28.83,"undercount"
"7730",37083,"North Carolina","Halifax County","A_AIC",495,423,-72,-15.69,"undercount"
"7731",37083,"North Carolina","Halifax County","NHPI_A",11,11,0,0,"equal"
"7732",37083,"North Carolina","Halifax County","NHPI_AIC",40,65,25,47.62,"overcount"
"7733",37085,"North Carolina","Harnett County","A_A",1620,1463,-157,-10.18,"undercount"
"7734",37085,"North Carolina","Harnett County","A_AIC",2724,2797,73,2.64,"overcount"
"7735",37085,"North Carolina","Harnett County","NHPI_A",211,242,31,13.69,"overcount"
"7736",37085,"North Carolina","Harnett County","NHPI_AIC",402,571,169,34.74,"overcount"
"7737",37087,"North Carolina","Haywood County","A_A",428,363,-65,-16.43,"undercount"
"7738",37087,"North Carolina","Haywood County","A_AIC",595,573,-22,-3.77,"undercount"
"7739",37087,"North Carolina","Haywood County","NHPI_A",19,1,-18,-180,"undercount"
"7740",37087,"North Carolina","Haywood County","NHPI_AIC",34,21,-13,-47.27,"undercount"
"7741",37089,"North Carolina","Henderson County","A_A",1524,1302,-222,-15.71,"undercount"
"7742",37089,"North Carolina","Henderson County","A_AIC",1908,1828,-80,-4.28,"undercount"
"7743",37089,"North Carolina","Henderson County","NHPI_A",219,241,22,9.57,"overcount"
"7744",37089,"North Carolina","Henderson County","NHPI_AIC",291,349,58,18.12,"overcount"
"7745",37091,"North Carolina","Hertford County","A_A",179,113,-66,-45.21,"undercount"
"7746",37091,"North Carolina","Hertford County","A_AIC",231,153,-78,-40.62,"undercount"
"7747",37091,"North Carolina","Hertford County","NHPI_A",3,4,1,28.57,"overcount"
"7748",37091,"North Carolina","Hertford County","NHPI_AIC",25,36,11,36.07,"overcount"
"7749",37093,"North Carolina","Hoke County","A_A",705,738,33,4.57,"overcount"
"7750",37093,"North Carolina","Hoke County","A_AIC",1239,1358,119,9.16,"overcount"
"7751",37093,"North Carolina","Hoke County","NHPI_A",119,189,70,45.45,"overcount"
"7752",37093,"North Carolina","Hoke County","NHPI_AIC",233,331,98,34.75,"overcount"
"7753",37095,"North Carolina","Hyde County","A_A",33,7,-26,-130,"undercount"
"7754",37095,"North Carolina","Hyde County","A_AIC",43,18,-25,-81.97,"undercount"
"7755",37095,"North Carolina","Hyde County","NHPI_A",1,2,1,66.67,"overcount"
"7756",37095,"North Carolina","Hyde County","NHPI_AIC",4,5,1,22.22,"overcount"
"7757",37097,"North Carolina","Iredell County","A_A",5064,4769,-295,-6,"undercount"
"7758",37097,"North Carolina","Iredell County","A_AIC",5859,5908,49,0.83,"overcount"
"7759",37097,"North Carolina","Iredell County","NHPI_A",61,58,-3,-5.04,"undercount"
"7760",37097,"North Carolina","Iredell County","NHPI_AIC",175,205,30,15.79,"overcount"
"7761",37099,"North Carolina","Jackson County","A_A",469,524,55,11.08,"overcount"
"7762",37099,"North Carolina","Jackson County","A_AIC",618,720,102,15.25,"overcount"
"7763",37099,"North Carolina","Jackson County","NHPI_A",17,10,-7,-51.85,"undercount"
"7764",37099,"North Carolina","Jackson County","NHPI_AIC",39,62,23,45.54,"overcount"
"7765",37101,"North Carolina","Johnston County","A_A",1872,1848,-24,-1.29,"undercount"
"7766",37101,"North Carolina","Johnston County","A_AIC",2821,3051,230,7.83,"overcount"
"7767",37101,"North Carolina","Johnston County","NHPI_A",69,71,2,2.86,"overcount"
"7768",37101,"North Carolina","Johnston County","NHPI_AIC",225,272,47,18.91,"overcount"
"7769",37103,"North Carolina","Jones County","A_A",56,32,-24,-54.55,"undercount"
"7770",37103,"North Carolina","Jones County","A_AIC",79,59,-20,-28.99,"undercount"
"7771",37103,"North Carolina","Jones County","NHPI_A",3,0,-3,-200,"undercount"
"7772",37103,"North Carolina","Jones County","NHPI_AIC",12,1,-11,-169.23,"undercount"
"7773",37105,"North Carolina","Lee County","A_A",787,678,-109,-14.88,"undercount"
"7774",37105,"North Carolina","Lee County","A_AIC",1080,989,-91,-8.8,"undercount"
"7775",37105,"North Carolina","Lee County","NHPI_A",32,48,16,40,"overcount"
"7776",37105,"North Carolina","Lee County","NHPI_AIC",101,118,17,15.53,"overcount"
"7777",37107,"North Carolina","Lenoir County","A_A",328,332,4,1.21,"overcount"
"7778",37107,"North Carolina","Lenoir County","A_AIC",505,512,7,1.38,"overcount"
"7779",37107,"North Carolina","Lenoir County","NHPI_A",35,26,-9,-29.51,"undercount"
"7780",37107,"North Carolina","Lenoir County","NHPI_AIC",92,65,-27,-34.39,"undercount"
"7781",37109,"North Carolina","Lincoln County","A_A",696,697,1,0.14,"overcount"
"7782",37109,"North Carolina","Lincoln County","A_AIC",928,1062,134,13.47,"overcount"
"7783",37109,"North Carolina","Lincoln County","NHPI_A",25,15,-10,-50,"undercount"
"7784",37109,"North Carolina","Lincoln County","NHPI_AIC",66,66,0,0,"equal"
"7785",37111,"North Carolina","McDowell County","A_A",436,388,-48,-11.65,"undercount"
"7786",37111,"North Carolina","McDowell County","A_AIC",516,489,-27,-5.37,"undercount"
"7787",37111,"North Carolina","McDowell County","NHPI_A",2,0,-2,-200,"undercount"
"7788",37111,"North Carolina","McDowell County","NHPI_AIC",20,19,-1,-5.13,"undercount"
"7789",37113,"North Carolina","Macon County","A_A",359,250,-109,-35.8,"undercount"
"7790",37113,"North Carolina","Macon County","A_AIC",428,357,-71,-18.09,"undercount"
"7791",37113,"North Carolina","Macon County","NHPI_A",6,7,1,15.38,"overcount"
"7792",37113,"North Carolina","Macon County","NHPI_AIC",22,42,20,62.5,"overcount"
"7793",37115,"North Carolina","Madison County","A_A",113,84,-29,-29.44,"undercount"
"7794",37115,"North Carolina","Madison County","A_AIC",163,156,-7,-4.39,"undercount"
"7795",37115,"North Carolina","Madison County","NHPI_A",10,3,-7,-107.69,"undercount"
"7796",37115,"North Carolina","Madison County","NHPI_AIC",25,13,-12,-63.16,"undercount"
"7797",37117,"North Carolina","Martin County","A_A",121,98,-23,-21,"undercount"
"7798",37117,"North Carolina","Martin County","A_AIC",166,133,-33,-22.07,"undercount"
"7799",37117,"North Carolina","Martin County","NHPI_A",11,5,-6,-75,"undercount"
"7800",37117,"North Carolina","Martin County","NHPI_AIC",24,17,-7,-34.15,"undercount"
"7801",37119,"North Carolina","Mecklenburg County","A_A",73120,72447,-673,-0.92,"undercount"
"7802",37119,"North Carolina","Mecklenburg County","A_AIC",80346,82051,1705,2.1,"overcount"
"7803",37119,"North Carolina","Mecklenburg County","NHPI_A",480,557,77,14.85,"overcount"
"7804",37119,"North Carolina","Mecklenburg County","NHPI_AIC",1327,1407,80,5.85,"overcount"
"7805",37121,"North Carolina","Mitchell County","A_A",83,52,-31,-45.93,"undercount"
"7806",37121,"North Carolina","Mitchell County","A_AIC",114,105,-9,-8.22,"undercount"
"7807",37121,"North Carolina","Mitchell County","NHPI_A",1,1,0,0,"equal"
"7808",37121,"North Carolina","Mitchell County","NHPI_AIC",7,10,3,35.29,"overcount"
"7809",37123,"North Carolina","Montgomery County","A_A",392,391,-1,-0.26,"undercount"
"7810",37123,"North Carolina","Montgomery County","A_AIC",470,447,-23,-5.02,"undercount"
"7811",37123,"North Carolina","Montgomery County","NHPI_A",6,2,-4,-100,"undercount"
"7812",37123,"North Carolina","Montgomery County","NHPI_AIC",27,36,9,28.57,"overcount"
"7813",37125,"North Carolina","Moore County","A_A",1606,1244,-362,-25.4,"undercount"
"7814",37125,"North Carolina","Moore County","A_AIC",2110,2120,10,0.47,"overcount"
"7815",37125,"North Carolina","Moore County","NHPI_A",58,59,1,1.71,"overcount"
"7816",37125,"North Carolina","Moore County","NHPI_AIC",125,183,58,37.66,"overcount"
"7817",37127,"North Carolina","Nash County","A_A",865,909,44,4.96,"overcount"
"7818",37127,"North Carolina","Nash County","A_AIC",1128,1188,60,5.18,"overcount"
"7819",37127,"North Carolina","Nash County","NHPI_A",25,30,5,18.18,"overcount"
"7820",37127,"North Carolina","Nash County","NHPI_AIC",95,76,-19,-22.22,"undercount"
"7821",37129,"North Carolina","New Hanover County","A_A",3406,3505,99,2.86,"overcount"
"7822",37129,"North Carolina","New Hanover County","A_AIC",4876,5269,393,7.75,"overcount"
"7823",37129,"North Carolina","New Hanover County","NHPI_A",153,152,-1,-0.66,"undercount"
"7824",37129,"North Carolina","New Hanover County","NHPI_AIC",366,458,92,22.33,"overcount"
"7825",37131,"North Carolina","Northampton County","A_A",50,28,-22,-56.41,"undercount"
"7826",37131,"North Carolina","Northampton County","A_AIC",91,70,-21,-26.09,"undercount"
"7827",37131,"North Carolina","Northampton County","NHPI_A",1,4,3,120,"overcount"
"7828",37131,"North Carolina","Northampton County","NHPI_AIC",12,17,5,34.48,"overcount"
"7829",37133,"North Carolina","Onslow County","A_A",4159,4585,426,9.74,"overcount"
"7830",37133,"North Carolina","Onslow County","A_AIC",7166,7812,646,8.63,"overcount"
"7831",37133,"North Carolina","Onslow County","NHPI_A",497,790,293,45.53,"overcount"
"7832",37133,"North Carolina","Onslow County","NHPI_AIC",1016,1589,573,43.99,"overcount"
"7833",37135,"North Carolina","Orange County","A_A",11812,12736,924,7.53,"overcount"
"7834",37135,"North Carolina","Orange County","A_AIC",13366,15120,1754,12.31,"overcount"
"7835",37135,"North Carolina","Orange County","NHPI_A",60,43,-17,-33.01,"undercount"
"7836",37135,"North Carolina","Orange County","NHPI_AIC",180,161,-19,-11.14,"undercount"
"7837",37137,"North Carolina","Pamlico County","A_A",76,50,-26,-41.27,"undercount"
"7838",37137,"North Carolina","Pamlico County","A_AIC",104,101,-3,-2.93,"undercount"
"7839",37137,"North Carolina","Pamlico County","NHPI_A",23,5,-18,-128.57,"undercount"
"7840",37137,"North Carolina","Pamlico County","NHPI_AIC",28,12,-16,-80,"undercount"
"7841",37139,"North Carolina","Pasquotank County","A_A",512,460,-52,-10.7,"undercount"
"7842",37139,"North Carolina","Pasquotank County","A_AIC",778,707,-71,-9.56,"undercount"
"7843",37139,"North Carolina","Pasquotank County","NHPI_A",25,28,3,11.32,"overcount"
"7844",37139,"North Carolina","Pasquotank County","NHPI_AIC",76,72,-4,-5.41,"undercount"
"7845",37141,"North Carolina","Pender County","A_A",345,325,-20,-5.97,"undercount"
"7846",37141,"North Carolina","Pender County","A_AIC",587,695,108,16.85,"overcount"
"7847",37141,"North Carolina","Pender County","NHPI_A",28,23,-5,-19.61,"undercount"
"7848",37141,"North Carolina","Pender County","NHPI_AIC",82,109,27,28.27,"overcount"
"7849",37143,"North Carolina","Perquimans County","A_A",57,38,-19,-40,"undercount"
"7850",37143,"North Carolina","Perquimans County","A_AIC",93,88,-5,-5.52,"undercount"
"7851",37143,"North Carolina","Perquimans County","NHPI_A",2,7,5,111.11,"overcount"
"7852",37143,"North Carolina","Perquimans County","NHPI_AIC",8,26,18,105.88,"overcount"
"7853",37145,"North Carolina","Person County","A_A",148,125,-23,-16.85,"undercount"
"7854",37145,"North Carolina","Person County","A_AIC",249,232,-17,-7.07,"undercount"
"7855",37145,"North Carolina","Person County","NHPI_A",5,8,3,46.15,"overcount"
"7856",37145,"North Carolina","Person County","NHPI_AIC",40,26,-14,-42.42,"undercount"
"7857",37147,"North Carolina","Pitt County","A_A",3548,3080,-468,-14.12,"undercount"
"7858",37147,"North Carolina","Pitt County","A_AIC",4598,4220,-378,-8.57,"undercount"
"7859",37147,"North Carolina","Pitt County","NHPI_A",122,94,-28,-25.93,"undercount"
"7860",37147,"North Carolina","Pitt County","NHPI_AIC",268,214,-54,-22.41,"undercount"
"7861",37149,"North Carolina","Polk County","A_A",155,64,-91,-83.11,"undercount"
"7862",37149,"North Carolina","Polk County","A_AIC",208,146,-62,-35.03,"undercount"
"7863",37149,"North Carolina","Polk County","NHPI_A",4,7,3,54.55,"overcount"
"7864",37149,"North Carolina","Polk County","NHPI_AIC",14,35,21,85.71,"overcount"
"7865",37151,"North Carolina","Randolph County","A_A",2166,2174,8,0.37,"overcount"
"7866",37151,"North Carolina","Randolph County","A_AIC",2512,2616,104,4.06,"overcount"
"7867",37151,"North Carolina","Randolph County","NHPI_A",38,10,-28,-116.67,"undercount"
"7868",37151,"North Carolina","Randolph County","NHPI_AIC",100,82,-18,-19.78,"undercount"
"7869",37153,"North Carolina","Richmond County","A_A",376,367,-9,-2.42,"undercount"
"7870",37153,"North Carolina","Richmond County","A_AIC",548,468,-80,-15.75,"undercount"
"7871",37153,"North Carolina","Richmond County","NHPI_A",21,7,-14,-100,"undercount"
"7872",37153,"North Carolina","Richmond County","NHPI_AIC",73,50,-23,-37.4,"undercount"
"7873",37155,"North Carolina","Robeson County","A_A",724,904,180,22.11,"overcount"
"7874",37155,"North Carolina","Robeson County","A_AIC",1130,1174,44,3.82,"overcount"
"7875",37155,"North Carolina","Robeson County","NHPI_A",110,64,-46,-52.87,"undercount"
"7876",37155,"North Carolina","Robeson County","NHPI_AIC",220,165,-55,-28.57,"undercount"
"7877",37157,"North Carolina","Rockingham County","A_A",583,495,-88,-16.33,"undercount"
"7878",37157,"North Carolina","Rockingham County","A_AIC",842,737,-105,-13.3,"undercount"
"7879",37157,"North Carolina","Rockingham County","NHPI_A",60,29,-31,-69.66,"undercount"
"7880",37157,"North Carolina","Rockingham County","NHPI_AIC",145,81,-64,-56.64,"undercount"
"7881",37159,"North Carolina","Rowan County","A_A",1493,1513,20,1.33,"overcount"
"7882",37159,"North Carolina","Rowan County","A_AIC",1924,1988,64,3.27,"overcount"
"7883",37159,"North Carolina","Rowan County","NHPI_A",65,71,6,8.82,"overcount"
"7884",37159,"North Carolina","Rowan County","NHPI_AIC",162,146,-16,-10.39,"undercount"
"7885",37161,"North Carolina","Rutherford County","A_A",396,343,-53,-14.34,"undercount"
"7886",37161,"North Carolina","Rutherford County","A_AIC",571,512,-59,-10.9,"undercount"
"7887",37161,"North Carolina","Rutherford County","NHPI_A",19,23,4,19.05,"overcount"
"7888",37161,"North Carolina","Rutherford County","NHPI_AIC",69,71,2,2.86,"overcount"
"7889",37163,"North Carolina","Sampson County","A_A",282,217,-65,-26.05,"undercount"
"7890",37163,"North Carolina","Sampson County","A_AIC",485,362,-123,-29.04,"undercount"
"7891",37163,"North Carolina","Sampson County","NHPI_A",55,18,-37,-101.37,"undercount"
"7892",37163,"North Carolina","Sampson County","NHPI_AIC",109,59,-50,-59.52,"undercount"
"7893",37165,"North Carolina","Scotland County","A_A",323,343,20,6.01,"overcount"
"7894",37165,"North Carolina","Scotland County","A_AIC",453,427,-26,-5.91,"undercount"
"7895",37165,"North Carolina","Scotland County","NHPI_A",18,15,-3,-18.18,"undercount"
"7896",37165,"North Carolina","Scotland County","NHPI_AIC",58,42,-16,-32,"undercount"
"7897",37167,"North Carolina","Stanly County","A_A",1192,1140,-52,-4.46,"undercount"
"7898",37167,"North Carolina","Stanly County","A_AIC",1333,1345,12,0.9,"overcount"
"7899",37167,"North Carolina","Stanly County","NHPI_A",17,9,-8,-61.54,"undercount"
"7900",37167,"North Carolina","Stanly County","NHPI_AIC",45,28,-17,-46.58,"undercount"
"7901",37169,"North Carolina","Stokes County","A_A",176,160,-16,-9.52,"undercount"
"7902",37169,"North Carolina","Stokes County","A_AIC",249,288,39,14.53,"overcount"
"7903",37169,"North Carolina","Stokes County","NHPI_A",14,11,-3,-24,"undercount"
"7904",37169,"North Carolina","Stokes County","NHPI_AIC",32,44,12,31.58,"overcount"
"7905",37171,"North Carolina","Surry County","A_A",409,379,-30,-7.61,"undercount"
"7906",37171,"North Carolina","Surry County","A_AIC",566,535,-31,-5.63,"undercount"
"7907",37171,"North Carolina","Surry County","NHPI_A",20,14,-6,-35.29,"undercount"
"7908",37171,"North Carolina","Surry County","NHPI_AIC",58,33,-25,-54.95,"undercount"
"7909",37173,"North Carolina","Swain County","A_A",93,53,-40,-54.79,"undercount"
"7910",37173,"North Carolina","Swain County","A_AIC",149,109,-40,-31.01,"undercount"
"7911",37173,"North Carolina","Swain County","NHPI_A",5,10,5,66.67,"overcount"
"7912",37173,"North Carolina","Swain County","NHPI_AIC",19,25,6,27.27,"overcount"
"7913",37175,"North Carolina","Transylvania County","A_A",212,178,-34,-17.44,"undercount"
"7914",37175,"North Carolina","Transylvania County","A_AIC",306,328,22,6.94,"overcount"
"7915",37175,"North Carolina","Transylvania County","NHPI_A",17,22,5,25.64,"overcount"
"7916",37175,"North Carolina","Transylvania County","NHPI_AIC",40,45,5,11.76,"overcount"
"7917",37177,"North Carolina","Tyrrell County","A_A",63,43,-20,-37.74,"undercount"
"7918",37177,"North Carolina","Tyrrell County","A_AIC",69,56,-13,-20.8,"undercount"
"7919",37177,"North Carolina","Tyrrell County","NHPI_A",0,3,3,200,"overcount"
"7920",37177,"North Carolina","Tyrrell County","NHPI_AIC",4,13,9,105.88,"overcount"
"7921",37179,"North Carolina","Union County","A_A",9360,9618,258,2.72,"overcount"
"7922",37179,"North Carolina","Union County","A_AIC",10631,11456,825,7.47,"overcount"
"7923",37179,"North Carolina","Union County","NHPI_A",100,98,-2,-2.02,"undercount"
"7924",37179,"North Carolina","Union County","NHPI_AIC",233,229,-4,-1.73,"undercount"
"7925",37181,"North Carolina","Vance County","A_A",343,288,-55,-17.43,"undercount"
"7926",37181,"North Carolina","Vance County","A_AIC",453,433,-20,-4.51,"undercount"
"7927",37181,"North Carolina","Vance County","NHPI_A",16,9,-7,-56,"undercount"
"7928",37181,"North Carolina","Vance County","NHPI_AIC",55,28,-27,-65.06,"undercount"
"7929",37183,"North Carolina","Wake County","A_A",90572,97633,7061,7.5,"overcount"
"7930",37183,"North Carolina","Wake County","A_AIC",100700,111289,10589,9.99,"overcount"
"7931",37183,"North Carolina","Wake County","NHPI_A",484,472,-12,-2.51,"undercount"
"7932",37183,"North Carolina","Wake County","NHPI_AIC",1372,1570,198,13.46,"overcount"
"7933",37185,"North Carolina","Warren County","A_A",67,68,1,1.48,"overcount"
"7934",37185,"North Carolina","Warren County","A_AIC",117,119,2,1.69,"overcount"
"7935",37185,"North Carolina","Warren County","NHPI_A",5,6,1,18.18,"overcount"
"7936",37185,"North Carolina","Warren County","NHPI_AIC",19,48,29,86.57,"overcount"
"7937",37187,"North Carolina","Washington County","A_A",46,37,-9,-21.69,"undercount"
"7938",37187,"North Carolina","Washington County","A_AIC",60,56,-4,-6.9,"undercount"
"7939",37187,"North Carolina","Washington County","NHPI_A",4,3,-1,-28.57,"undercount"
"7940",37187,"North Carolina","Washington County","NHPI_AIC",9,10,1,10.53,"overcount"
"7941",37189,"North Carolina","Watauga County","A_A",662,950,288,35.73,"overcount"
"7942",37189,"North Carolina","Watauga County","A_AIC",890,1372,482,42.62,"overcount"
"7943",37189,"North Carolina","Watauga County","NHPI_A",19,11,-8,-53.33,"undercount"
"7944",37189,"North Carolina","Watauga County","NHPI_AIC",53,178,125,108.23,"overcount"
"7945",37191,"North Carolina","Wayne County","A_A",1441,1547,106,7.1,"overcount"
"7946",37191,"North Carolina","Wayne County","A_AIC",2423,2387,-36,-1.5,"undercount"
"7947",37191,"North Carolina","Wayne County","NHPI_A",64,75,11,15.83,"overcount"
"7948",37191,"North Carolina","Wayne County","NHPI_AIC",197,218,21,10.12,"overcount"
"7949",37193,"North Carolina","Wilkes County","A_A",348,324,-24,-7.14,"undercount"
"7950",37193,"North Carolina","Wilkes County","A_AIC",478,459,-19,-4.06,"undercount"
"7951",37193,"North Carolina","Wilkes County","NHPI_A",16,5,-11,-104.76,"undercount"
"7952",37193,"North Carolina","Wilkes County","NHPI_AIC",46,30,-16,-42.11,"undercount"
"7953",37195,"North Carolina","Wilson County","A_A",892,905,13,1.45,"overcount"
"7954",37195,"North Carolina","Wilson County","A_AIC",1176,1231,55,4.57,"overcount"
"7955",37195,"North Carolina","Wilson County","NHPI_A",75,10,-65,-152.94,"undercount"
"7956",37195,"North Carolina","Wilson County","NHPI_AIC",132,75,-57,-55.07,"undercount"
"7957",37197,"North Carolina","Yadkin County","A_A",133,142,9,6.55,"overcount"
"7958",37197,"North Carolina","Yadkin County","A_AIC",186,212,26,13.07,"overcount"
"7959",37197,"North Carolina","Yadkin County","NHPI_A",6,0,-6,-200,"undercount"
"7960",37197,"North Carolina","Yadkin County","NHPI_AIC",14,24,10,52.63,"overcount"
"7961",37199,"North Carolina","Yancey County","A_A",52,45,-7,-14.43,"undercount"
"7962",37199,"North Carolina","Yancey County","A_AIC",78,83,5,6.21,"overcount"
"7963",37199,"North Carolina","Yancey County","NHPI_A",1,1,0,0,"equal"
"7964",37199,"North Carolina","Yancey County","NHPI_AIC",7,5,-2,-33.33,"undercount"
"7965",38001,"North Dakota","Adams County","A_A",72,39,-33,-59.46,"undercount"
"7966",38001,"North Dakota","Adams County","A_AIC",85,48,-37,-55.64,"undercount"
"7967",38001,"North Dakota","Adams County","NHPI_A",1,1,0,0,"equal"
"7968",38001,"North Dakota","Adams County","NHPI_AIC",2,9,7,127.27,"overcount"
"7969",38003,"North Dakota","Barnes County","A_A",102,69,-33,-38.6,"undercount"
"7970",38003,"North Dakota","Barnes County","A_AIC",135,130,-5,-3.77,"undercount"
"7971",38003,"North Dakota","Barnes County","NHPI_A",5,2,-3,-85.71,"undercount"
"7972",38003,"North Dakota","Barnes County","NHPI_AIC",12,20,8,50,"overcount"
"7973",38005,"North Dakota","Benson County","A_A",16,7,-9,-78.26,"undercount"
"7974",38005,"North Dakota","Benson County","A_AIC",29,22,-7,-27.45,"undercount"
"7975",38005,"North Dakota","Benson County","NHPI_A",1,0,-1,-200,"undercount"
"7976",38005,"North Dakota","Benson County","NHPI_AIC",3,6,3,66.67,"overcount"
"7977",38007,"North Dakota","Billings County","A_A",38,6,-32,-145.45,"undercount"
"7978",38007,"North Dakota","Billings County","A_AIC",40,8,-32,-133.33,"undercount"
"7979",38007,"North Dakota","Billings County","NHPI_A",0,0,0,0,"equal"
"7980",38007,"North Dakota","Billings County","NHPI_AIC",1,1,0,0,"equal"
"7981",38009,"North Dakota","Bottineau County","A_A",37,48,11,25.88,"overcount"
"7982",38009,"North Dakota","Bottineau County","A_AIC",62,66,4,6.25,"overcount"
"7983",38009,"North Dakota","Bottineau County","NHPI_A",0,1,1,200,"overcount"
"7984",38009,"North Dakota","Bottineau County","NHPI_AIC",8,5,-3,-46.15,"undercount"
"7985",38011,"North Dakota","Bowman County","A_A",3,17,14,140,"overcount"
"7986",38011,"North Dakota","Bowman County","A_AIC",7,17,10,83.33,"overcount"
"7987",38011,"North Dakota","Bowman County","NHPI_A",0,3,3,200,"overcount"
"7988",38011,"North Dakota","Bowman County","NHPI_AIC",1,3,2,100,"overcount"
"7989",38013,"North Dakota","Burke County","A_A",18,12,-6,-40,"undercount"
"7990",38013,"North Dakota","Burke County","A_AIC",24,22,-2,-8.7,"undercount"
"7991",38013,"North Dakota","Burke County","NHPI_A",2,0,-2,-200,"undercount"
"7992",38013,"North Dakota","Burke County","NHPI_AIC",2,2,0,0,"equal"
"7993",38015,"North Dakota","Burleigh County","A_A",818,1043,225,24.18,"overcount"
"7994",38015,"North Dakota","Burleigh County","A_AIC",1223,1537,314,22.75,"overcount"
"7995",38015,"North Dakota","Burleigh County","NHPI_A",111,320,209,96.98,"overcount"
"7996",38015,"North Dakota","Burleigh County","NHPI_AIC",178,419,241,80.74,"overcount"
"7997",38017,"North Dakota","Cass County","A_A",5992,6065,73,1.21,"overcount"
"7998",38017,"North Dakota","Cass County","A_AIC",7268,7517,249,3.37,"overcount"
"7999",38017,"North Dakota","Cass County","NHPI_A",77,79,2,2.56,"overcount"
"8000",38017,"North Dakota","Cass County","NHPI_AIC",221,215,-6,-2.75,"undercount"
"8001",38019,"North Dakota","Cavalier County","A_A",22,16,-6,-31.58,"undercount"
"8002",38019,"North Dakota","Cavalier County","A_AIC",31,23,-8,-29.63,"undercount"
"8003",38019,"North Dakota","Cavalier County","NHPI_A",0,0,0,0,"equal"
"8004",38019,"North Dakota","Cavalier County","NHPI_AIC",2,1,-1,-66.67,"undercount"
"8005",38021,"North Dakota","Dickey County","A_A",34,44,10,25.64,"overcount"
"8006",38021,"North Dakota","Dickey County","A_AIC",49,67,18,31.03,"overcount"
"8007",38021,"North Dakota","Dickey County","NHPI_A",1,0,-1,-200,"undercount"
"8008",38021,"North Dakota","Dickey County","NHPI_AIC",5,1,-4,-133.33,"undercount"
"8009",38023,"North Dakota","Divide County","A_A",43,12,-31,-112.73,"undercount"
"8010",38023,"North Dakota","Divide County","A_AIC",54,22,-32,-84.21,"undercount"
"8011",38023,"North Dakota","Divide County","NHPI_A",5,4,-1,-22.22,"undercount"
"8012",38023,"North Dakota","Divide County","NHPI_AIC",11,6,-5,-58.82,"undercount"
"8013",38025,"North Dakota","Dunn County","A_A",63,33,-30,-62.5,"undercount"
"8014",38025,"North Dakota","Dunn County","A_AIC",81,59,-22,-31.43,"undercount"
"8015",38025,"North Dakota","Dunn County","NHPI_A",0,0,0,0,"equal"
"8016",38025,"North Dakota","Dunn County","NHPI_AIC",5,15,10,100,"overcount"
"8017",38027,"North Dakota","Eddy County","A_A",10,0,-10,-200,"undercount"
"8018",38027,"North Dakota","Eddy County","A_AIC",16,4,-12,-120,"undercount"
"8019",38027,"North Dakota","Eddy County","NHPI_A",1,0,-1,-200,"undercount"
"8020",38027,"North Dakota","Eddy County","NHPI_AIC",3,4,1,28.57,"overcount"
"8021",38029,"North Dakota","Emmons County","A_A",24,12,-12,-66.67,"undercount"
"8022",38029,"North Dakota","Emmons County","A_AIC",28,21,-7,-28.57,"undercount"
"8023",38029,"North Dakota","Emmons County","NHPI_A",0,0,0,0,"equal"
"8024",38029,"North Dakota","Emmons County","NHPI_AIC",0,1,1,200,"overcount"
"8025",38031,"North Dakota","Foster County","A_A",16,13,-3,-20.69,"undercount"
"8026",38031,"North Dakota","Foster County","A_AIC",20,27,7,29.79,"overcount"
"8027",38031,"North Dakota","Foster County","NHPI_A",0,1,1,200,"overcount"
"8028",38031,"North Dakota","Foster County","NHPI_AIC",0,8,8,200,"overcount"
"8029",38033,"North Dakota","Golden Valley County","A_A",2,1,-1,-66.67,"undercount"
"8030",38033,"North Dakota","Golden Valley County","A_AIC",5,24,19,131.03,"overcount"
"8031",38033,"North Dakota","Golden Valley County","NHPI_A",2,1,-1,-66.67,"undercount"
"8032",38033,"North Dakota","Golden Valley County","NHPI_AIC",2,5,3,85.71,"overcount"
"8033",38035,"North Dakota","Grand Forks County","A_A",1999,2494,495,22.03,"overcount"
"8034",38035,"North Dakota","Grand Forks County","A_AIC",2612,3225,613,21,"overcount"
"8035",38035,"North Dakota","Grand Forks County","NHPI_A",43,52,9,18.95,"overcount"
"8036",38035,"North Dakota","Grand Forks County","NHPI_AIC",158,162,4,2.5,"overcount"
"8037",38037,"North Dakota","Grant County","A_A",5,11,6,75,"overcount"
"8038",38037,"North Dakota","Grant County","A_AIC",15,19,4,23.53,"overcount"
"8039",38037,"North Dakota","Grant County","NHPI_A",0,0,0,0,"equal"
"8040",38037,"North Dakota","Grant County","NHPI_AIC",3,6,3,66.67,"overcount"
"8041",38039,"North Dakota","Griggs County","A_A",3,7,4,80,"overcount"
"8042",38039,"North Dakota","Griggs County","A_AIC",3,11,8,114.29,"overcount"
"8043",38039,"North Dakota","Griggs County","NHPI_A",0,0,0,0,"equal"
"8044",38039,"North Dakota","Griggs County","NHPI_AIC",0,4,4,200,"overcount"
"8045",38041,"North Dakota","Hettinger County","A_A",7,5,-2,-33.33,"undercount"
"8046",38041,"North Dakota","Hettinger County","A_AIC",12,21,9,54.55,"overcount"
"8047",38041,"North Dakota","Hettinger County","NHPI_A",4,7,3,54.55,"overcount"
"8048",38041,"North Dakota","Hettinger County","NHPI_AIC",5,14,9,94.74,"overcount"
"8049",38043,"North Dakota","Kidder County","A_A",18,5,-13,-113.04,"undercount"
"8050",38043,"North Dakota","Kidder County","A_AIC",24,16,-8,-40,"undercount"
"8051",38043,"North Dakota","Kidder County","NHPI_A",0,5,5,200,"overcount"
"8052",38043,"North Dakota","Kidder County","NHPI_AIC",1,13,12,171.43,"overcount"
"8053",38045,"North Dakota","LaMoure County","A_A",5,7,2,33.33,"overcount"
"8054",38045,"North Dakota","LaMoure County","A_AIC",10,7,-3,-35.29,"undercount"
"8055",38045,"North Dakota","LaMoure County","NHPI_A",2,4,2,66.67,"overcount"
"8056",38045,"North Dakota","LaMoure County","NHPI_AIC",3,9,6,100,"overcount"
"8057",38047,"North Dakota","Logan County","A_A",9,0,-9,-200,"undercount"
"8058",38047,"North Dakota","Logan County","A_AIC",17,8,-9,-72,"undercount"
"8059",38047,"North Dakota","Logan County","NHPI_A",0,0,0,0,"equal"
"8060",38047,"North Dakota","Logan County","NHPI_AIC",1,3,2,100,"overcount"
"8061",38049,"North Dakota","McHenry County","A_A",18,12,-6,-40,"undercount"
"8062",38049,"North Dakota","McHenry County","A_AIC",28,23,-5,-19.61,"undercount"
"8063",38049,"North Dakota","McHenry County","NHPI_A",0,6,6,200,"overcount"
"8064",38049,"North Dakota","McHenry County","NHPI_AIC",2,10,8,133.33,"overcount"
"8065",38051,"North Dakota","McIntosh County","A_A",22,23,1,4.44,"overcount"
"8066",38051,"North Dakota","McIntosh County","A_AIC",23,38,15,49.18,"overcount"
"8067",38051,"North Dakota","McIntosh County","NHPI_A",0,0,0,0,"equal"
"8068",38051,"North Dakota","McIntosh County","NHPI_AIC",0,6,6,200,"overcount"
"8069",38053,"North Dakota","McKenzie County","A_A",134,171,37,24.26,"overcount"
"8070",38053,"North Dakota","McKenzie County","A_AIC",173,289,116,50.22,"overcount"
"8071",38053,"North Dakota","McKenzie County","NHPI_A",13,5,-8,-88.89,"undercount"
"8072",38053,"North Dakota","McKenzie County","NHPI_AIC",23,24,1,4.26,"overcount"
"8073",38055,"North Dakota","McLean County","A_A",30,48,18,46.15,"overcount"
"8074",38055,"North Dakota","McLean County","A_AIC",44,86,42,64.62,"overcount"
"8075",38055,"North Dakota","McLean County","NHPI_A",5,7,2,33.33,"overcount"
"8076",38055,"North Dakota","McLean County","NHPI_AIC",5,17,12,109.09,"overcount"
"8077",38057,"North Dakota","Mercer County","A_A",44,44,0,0,"equal"
"8078",38057,"North Dakota","Mercer County","A_AIC",61,78,17,24.46,"overcount"
"8079",38057,"North Dakota","Mercer County","NHPI_A",6,1,-5,-142.86,"undercount"
"8080",38057,"North Dakota","Mercer County","NHPI_AIC",7,6,-1,-15.38,"undercount"
"8081",38059,"North Dakota","Morton County","A_A",161,172,11,6.61,"overcount"
"8082",38059,"North Dakota","Morton County","A_AIC",272,313,41,14.02,"overcount"
"8083",38059,"North Dakota","Morton County","NHPI_A",30,39,9,26.09,"overcount"
"8084",38059,"North Dakota","Morton County","NHPI_AIC",55,74,19,29.46,"overcount"
"8085",38061,"North Dakota","Mountrail County","A_A",53,109,56,69.14,"overcount"
"8086",38061,"North Dakota","Mountrail County","A_AIC",95,150,55,44.9,"overcount"
"8087",38061,"North Dakota","Mountrail County","NHPI_A",4,3,-1,-28.57,"undercount"
"8088",38061,"North Dakota","Mountrail County","NHPI_AIC",13,16,3,20.69,"overcount"
"8089",38063,"North Dakota","Nelson County","A_A",4,9,5,76.92,"overcount"
"8090",38063,"North Dakota","Nelson County","A_AIC",11,16,5,37.04,"overcount"
"8091",38063,"North Dakota","Nelson County","NHPI_A",1,1,0,0,"equal"
"8092",38063,"North Dakota","Nelson County","NHPI_AIC",2,1,-1,-66.67,"undercount"
"8093",38065,"North Dakota","Oliver County","A_A",7,5,-2,-33.33,"undercount"
"8094",38065,"North Dakota","Oliver County","A_AIC",10,10,0,0,"equal"
"8095",38065,"North Dakota","Oliver County","NHPI_A",0,3,3,200,"overcount"
"8096",38065,"North Dakota","Oliver County","NHPI_AIC",1,10,9,163.64,"overcount"
"8097",38067,"North Dakota","Pembina County","A_A",28,27,-1,-3.64,"undercount"
"8098",38067,"North Dakota","Pembina County","A_AIC",45,44,-1,-2.25,"undercount"
"8099",38067,"North Dakota","Pembina County","NHPI_A",1,0,-1,-200,"undercount"
"8100",38067,"North Dakota","Pembina County","NHPI_AIC",5,0,-5,-200,"undercount"
"8101",38069,"North Dakota","Pierce County","A_A",47,17,-30,-93.75,"undercount"
"8102",38069,"North Dakota","Pierce County","A_AIC",53,20,-33,-90.41,"undercount"
"8103",38069,"North Dakota","Pierce County","NHPI_A",0,5,5,200,"overcount"
"8104",38069,"North Dakota","Pierce County","NHPI_AIC",0,9,9,200,"overcount"
"8105",38071,"North Dakota","Ramsey County","A_A",110,72,-38,-41.76,"undercount"
"8106",38071,"North Dakota","Ramsey County","A_AIC",140,124,-16,-12.12,"undercount"
"8107",38071,"North Dakota","Ramsey County","NHPI_A",4,12,8,100,"overcount"
"8108",38071,"North Dakota","Ramsey County","NHPI_AIC",15,34,19,77.55,"overcount"
"8109",38073,"North Dakota","Ransom County","A_A",51,24,-27,-72,"undercount"
"8110",38073,"North Dakota","Ransom County","A_AIC",64,50,-14,-24.56,"undercount"
"8111",38073,"North Dakota","Ransom County","NHPI_A",0,0,0,0,"equal"
"8112",38073,"North Dakota","Ransom County","NHPI_AIC",5,4,-1,-22.22,"undercount"
"8113",38075,"North Dakota","Renville County","A_A",7,0,-7,-200,"undercount"
"8114",38075,"North Dakota","Renville County","A_AIC",17,11,-6,-42.86,"undercount"
"8115",38075,"North Dakota","Renville County","NHPI_A",2,0,-2,-200,"undercount"
"8116",38075,"North Dakota","Renville County","NHPI_AIC",2,1,-1,-66.67,"undercount"
"8117",38077,"North Dakota","Richland County","A_A",108,126,18,15.38,"overcount"
"8118",38077,"North Dakota","Richland County","A_AIC",178,177,-1,-0.56,"undercount"
"8119",38077,"North Dakota","Richland County","NHPI_A",6,19,13,104,"overcount"
"8120",38077,"North Dakota","Richland County","NHPI_AIC",15,36,21,82.35,"overcount"
"8121",38079,"North Dakota","Rolette County","A_A",26,23,-3,-12.24,"undercount"
"8122",38079,"North Dakota","Rolette County","A_AIC",52,42,-10,-21.28,"undercount"
"8123",38079,"North Dakota","Rolette County","NHPI_A",1,8,7,155.56,"overcount"
"8124",38079,"North Dakota","Rolette County","NHPI_AIC",4,19,15,130.43,"overcount"
"8125",38081,"North Dakota","Sargent County","A_A",36,14,-22,-88,"undercount"
"8126",38081,"North Dakota","Sargent County","A_AIC",52,57,5,9.17,"overcount"
"8127",38081,"North Dakota","Sargent County","NHPI_A",3,0,-3,-200,"undercount"
"8128",38081,"North Dakota","Sargent County","NHPI_AIC",8,7,-1,-13.33,"undercount"
"8129",38083,"North Dakota","Sheridan County","A_A",7,6,-1,-15.38,"undercount"
"8130",38083,"North Dakota","Sheridan County","A_AIC",12,8,-4,-40,"undercount"
"8131",38083,"North Dakota","Sheridan County","NHPI_A",1,0,-1,-200,"undercount"
"8132",38083,"North Dakota","Sheridan County","NHPI_AIC",1,0,-1,-200,"undercount"
"8133",38085,"North Dakota","Sioux County","A_A",7,3,-4,-80,"undercount"
"8134",38085,"North Dakota","Sioux County","A_AIC",25,8,-17,-103.03,"undercount"
"8135",38085,"North Dakota","Sioux County","NHPI_A",1,0,-1,-200,"undercount"
"8136",38085,"North Dakota","Sioux County","NHPI_AIC",7,2,-5,-111.11,"undercount"
"8137",38087,"North Dakota","Slope County","A_A",0,0,0,0,"equal"
"8138",38087,"North Dakota","Slope County","A_AIC",0,3,3,200,"overcount"
"8139",38087,"North Dakota","Slope County","NHPI_A",0,0,0,0,"equal"
"8140",38087,"North Dakota","Slope County","NHPI_AIC",0,1,1,200,"overcount"
"8141",38089,"North Dakota","Stark County","A_A",493,344,-149,-35.6,"undercount"
"8142",38089,"North Dakota","Stark County","A_AIC",607,537,-70,-12.24,"undercount"
"8143",38089,"North Dakota","Stark County","NHPI_A",24,51,27,72,"overcount"
"8144",38089,"North Dakota","Stark County","NHPI_AIC",59,98,39,49.68,"overcount"
"8145",38091,"North Dakota","Steele County","A_A",4,0,-4,-200,"undercount"
"8146",38091,"North Dakota","Steele County","A_AIC",8,5,-3,-46.15,"undercount"
"8147",38091,"North Dakota","Steele County","NHPI_A",0,0,0,0,"equal"
"8148",38091,"North Dakota","Steele County","NHPI_AIC",1,6,5,142.86,"overcount"
"8149",38093,"North Dakota","Stutsman County","A_A",183,137,-46,-28.75,"undercount"
"8150",38093,"North Dakota","Stutsman County","A_AIC",246,210,-36,-15.79,"undercount"
"8151",38093,"North Dakota","Stutsman County","NHPI_A",11,4,-7,-93.33,"undercount"
"8152",38093,"North Dakota","Stutsman County","NHPI_AIC",35,25,-10,-33.33,"undercount"
"8153",38095,"North Dakota","Towner County","A_A",13,10,-3,-26.09,"undercount"
"8154",38095,"North Dakota","Towner County","A_AIC",19,13,-6,-37.5,"undercount"
"8155",38095,"North Dakota","Towner County","NHPI_A",0,2,2,200,"overcount"
"8156",38095,"North Dakota","Towner County","NHPI_AIC",1,7,6,150,"overcount"
"8157",38097,"North Dakota","Traill County","A_A",40,24,-16,-50,"undercount"
"8158",38097,"North Dakota","Traill County","A_AIC",76,45,-31,-51.24,"undercount"
"8159",38097,"North Dakota","Traill County","NHPI_A",2,7,5,111.11,"overcount"
"8160",38097,"North Dakota","Traill County","NHPI_AIC",13,19,6,37.5,"overcount"
"8161",38099,"North Dakota","Walsh County","A_A",89,45,-44,-65.67,"undercount"
"8162",38099,"North Dakota","Walsh County","A_AIC",118,66,-52,-56.52,"undercount"
"8163",38099,"North Dakota","Walsh County","NHPI_A",6,0,-6,-200,"undercount"
"8164",38099,"North Dakota","Walsh County","NHPI_AIC",9,5,-4,-57.14,"undercount"
"8165",38101,"North Dakota","Ward County","A_A",1190,1100,-90,-7.86,"undercount"
"8166",38101,"North Dakota","Ward County","A_AIC",1804,1912,108,5.81,"overcount"
"8167",38101,"North Dakota","Ward County","NHPI_A",100,138,38,31.93,"overcount"
"8168",38101,"North Dakota","Ward County","NHPI_AIC",215,301,86,33.33,"overcount"
"8169",38103,"North Dakota","Wells County","A_A",10,12,2,18.18,"overcount"
"8170",38103,"North Dakota","Wells County","A_AIC",17,19,2,11.11,"overcount"
"8171",38103,"North Dakota","Wells County","NHPI_A",2,0,-2,-200,"undercount"
"8172",38103,"North Dakota","Wells County","NHPI_AIC",3,4,1,28.57,"overcount"
"8173",38105,"North Dakota","Williams County","A_A",411,612,201,39.3,"overcount"
"8174",38105,"North Dakota","Williams County","A_AIC",589,876,287,39.18,"overcount"
"8175",38105,"North Dakota","Williams County","NHPI_A",70,98,28,33.33,"overcount"
"8176",38105,"North Dakota","Williams County","NHPI_AIC",103,164,61,45.69,"overcount"
"8177",39001,"Ohio","Adams County","A_A",95,45,-50,-71.43,"undercount"
"8178",39001,"Ohio","Adams County","A_AIC",142,93,-49,-41.7,"undercount"
"8179",39001,"Ohio","Adams County","NHPI_A",6,1,-5,-142.86,"undercount"
"8180",39001,"Ohio","Adams County","NHPI_AIC",14,26,12,60,"overcount"
"8181",39003,"Ohio","Allen County","A_A",832,852,20,2.38,"overcount"
"8182",39003,"Ohio","Allen County","A_AIC",1180,1253,73,6,"overcount"
"8183",39003,"Ohio","Allen County","NHPI_A",22,42,20,62.5,"overcount"
"8184",39003,"Ohio","Allen County","NHPI_AIC",100,90,-10,-10.53,"undercount"
"8185",39005,"Ohio","Ashland County","A_A",398,331,-67,-18.38,"undercount"
"8186",39005,"Ohio","Ashland County","A_AIC",555,488,-67,-12.85,"undercount"
"8187",39005,"Ohio","Ashland County","NHPI_A",34,33,-1,-2.99,"undercount"
"8188",39005,"Ohio","Ashland County","NHPI_AIC",55,62,7,11.97,"overcount"
"8189",39007,"Ohio","Ashtabula County","A_A",472,342,-130,-31.94,"undercount"
"8190",39007,"Ohio","Ashtabula County","A_AIC",714,638,-76,-11.24,"undercount"
"8191",39007,"Ohio","Ashtabula County","NHPI_A",25,12,-13,-70.27,"undercount"
"8192",39007,"Ohio","Ashtabula County","NHPI_AIC",81,82,1,1.23,"overcount"
"8193",39009,"Ohio","Athens County","A_A",1902,1216,-686,-44,"undercount"
"8194",39009,"Ohio","Athens County","A_AIC",2331,1618,-713,-36.11,"undercount"
"8195",39009,"Ohio","Athens County","NHPI_A",31,1,-30,-187.5,"undercount"
"8196",39009,"Ohio","Athens County","NHPI_AIC",95,50,-45,-62.07,"undercount"
"8197",39011,"Ohio","Auglaize County","A_A",246,251,5,2.01,"overcount"
"8198",39011,"Ohio","Auglaize County","A_AIC",366,375,9,2.43,"overcount"
"8199",39011,"Ohio","Auglaize County","NHPI_A",33,40,7,19.18,"overcount"
"8200",39011,"Ohio","Auglaize County","NHPI_AIC",50,64,14,24.56,"overcount"
"8201",39013,"Ohio","Belmont County","A_A",358,267,-91,-29.12,"undercount"
"8202",39013,"Ohio","Belmont County","A_AIC",494,400,-94,-21.03,"undercount"
"8203",39013,"Ohio","Belmont County","NHPI_A",12,12,0,0,"equal"
"8204",39013,"Ohio","Belmont County","NHPI_AIC",44,36,-8,-20,"undercount"
"8205",39015,"Ohio","Brown County","A_A",142,84,-58,-51.33,"undercount"
"8206",39015,"Ohio","Brown County","A_AIC",224,182,-42,-20.69,"undercount"
"8207",39015,"Ohio","Brown County","NHPI_A",6,2,-4,-100,"undercount"
"8208",39015,"Ohio","Brown County","NHPI_AIC",15,24,9,46.15,"overcount"
"8209",39017,"Ohio","Butler County","A_A",15614,15797,183,1.17,"overcount"
"8210",39017,"Ohio","Butler County","A_AIC",17898,18719,821,4.48,"overcount"
"8211",39017,"Ohio","Butler County","NHPI_A",396,481,85,19.38,"overcount"
"8212",39017,"Ohio","Butler County","NHPI_AIC",588,762,174,25.78,"overcount"
"8213",39019,"Ohio","Carroll County","A_A",88,52,-36,-51.43,"undercount"
"8214",39019,"Ohio","Carroll County","A_AIC",133,115,-18,-14.52,"undercount"
"8215",39019,"Ohio","Carroll County","NHPI_A",2,5,3,85.71,"overcount"
"8216",39019,"Ohio","Carroll County","NHPI_AIC",13,22,9,51.43,"overcount"
"8217",39021,"Ohio","Champaign County","A_A",192,129,-63,-39.25,"undercount"
"8218",39021,"Ohio","Champaign County","A_AIC",310,263,-47,-16.4,"undercount"
"8219",39021,"Ohio","Champaign County","NHPI_A",15,7,-8,-72.73,"undercount"
"8220",39021,"Ohio","Champaign County","NHPI_AIC",42,38,-4,-10,"undercount"
"8221",39023,"Ohio","Clark County","A_A",939,926,-13,-1.39,"undercount"
"8222",39023,"Ohio","Clark County","A_AIC",1459,1477,18,1.23,"overcount"
"8223",39023,"Ohio","Clark County","NHPI_A",68,91,23,28.93,"overcount"
"8224",39023,"Ohio","Clark County","NHPI_AIC",172,221,49,24.94,"overcount"
"8225",39025,"Ohio","Clermont County","A_A",2921,2541,-380,-13.91,"undercount"
"8226",39025,"Ohio","Clermont County","A_AIC",3783,3670,-113,-3.03,"undercount"
"8227",39025,"Ohio","Clermont County","NHPI_A",101,68,-33,-39.05,"undercount"
"8228",39025,"Ohio","Clermont County","NHPI_AIC",170,227,57,28.72,"overcount"
"8229",39027,"Ohio","Clinton County","A_A",235,207,-28,-12.67,"undercount"
"8230",39027,"Ohio","Clinton County","A_AIC",353,364,11,3.07,"overcount"
"8231",39027,"Ohio","Clinton County","NHPI_A",15,6,-9,-85.71,"undercount"
"8232",39027,"Ohio","Clinton County","NHPI_AIC",40,40,0,0,"equal"
"8233",39029,"Ohio","Columbiana County","A_A",321,349,28,8.36,"overcount"
"8234",39029,"Ohio","Columbiana County","A_AIC",544,608,64,11.11,"overcount"
"8235",39029,"Ohio","Columbiana County","NHPI_A",29,19,-10,-41.67,"undercount"
"8236",39029,"Ohio","Columbiana County","NHPI_AIC",69,72,3,4.26,"overcount"
"8237",39031,"Ohio","Coshocton County","A_A",125,101,-24,-21.24,"undercount"
"8238",39031,"Ohio","Coshocton County","A_AIC",188,175,-13,-7.16,"undercount"
"8239",39031,"Ohio","Coshocton County","NHPI_A",10,7,-3,-35.29,"undercount"
"8240",39031,"Ohio","Coshocton County","NHPI_AIC",19,29,10,41.67,"overcount"
"8241",39033,"Ohio","Crawford County","A_A",262,136,-126,-63.32,"undercount"
"8242",39033,"Ohio","Crawford County","A_AIC",321,232,-89,-32.19,"undercount"
"8243",39033,"Ohio","Crawford County","NHPI_A",51,12,-39,-123.81,"undercount"
"8244",39033,"Ohio","Crawford County","NHPI_AIC",58,20,-38,-97.44,"undercount"
"8245",39035,"Ohio","Cuyahoga County","A_A",41390,44251,2861,6.68,"overcount"
"8246",39035,"Ohio","Cuyahoga County","A_AIC",48292,53063,4771,9.41,"overcount"
"8247",39035,"Ohio","Cuyahoga County","NHPI_A",223,281,58,23.02,"overcount"
"8248",39035,"Ohio","Cuyahoga County","NHPI_AIC",997,1149,152,14.17,"overcount"
"8249",39037,"Ohio","Darke County","A_A",238,181,-57,-27.21,"undercount"
"8250",39037,"Ohio","Darke County","A_AIC",350,270,-80,-25.81,"undercount"
"8251",39037,"Ohio","Darke County","NHPI_A",21,26,5,21.28,"overcount"
"8252",39037,"Ohio","Darke County","NHPI_AIC",47,41,-6,-13.64,"undercount"
"8253",39039,"Ohio","Defiance County","A_A",173,144,-29,-18.3,"undercount"
"8254",39039,"Ohio","Defiance County","A_AIC",236,220,-16,-7.02,"undercount"
"8255",39039,"Ohio","Defiance County","NHPI_A",14,15,1,6.9,"overcount"
"8256",39039,"Ohio","Defiance County","NHPI_AIC",30,34,4,12.5,"overcount"
"8257",39041,"Ohio","Delaware County","A_A",17439,18246,807,4.52,"overcount"
"8258",39041,"Ohio","Delaware County","A_AIC",19168,20596,1428,7.18,"overcount"
"8259",39041,"Ohio","Delaware County","NHPI_A",96,60,-36,-46.15,"undercount"
"8260",39041,"Ohio","Delaware County","NHPI_AIC",220,226,6,2.69,"overcount"
"8261",39043,"Ohio","Erie County","A_A",559,481,-78,-15,"undercount"
"8262",39043,"Ohio","Erie County","A_AIC",749,771,22,2.89,"overcount"
"8263",39043,"Ohio","Erie County","NHPI_A",11,10,-1,-9.52,"undercount"
"8264",39043,"Ohio","Erie County","NHPI_AIC",62,36,-26,-53.06,"undercount"
"8265",39045,"Ohio","Fairfield County","A_A",3425,3074,-351,-10.8,"undercount"
"8266",39045,"Ohio","Fairfield County","A_AIC",4307,4123,-184,-4.37,"undercount"
"8267",39045,"Ohio","Fairfield County","NHPI_A",70,31,-39,-77.23,"undercount"
"8268",39045,"Ohio","Fairfield County","NHPI_AIC",197,148,-49,-28.41,"undercount"
"8269",39047,"Ohio","Fayette County","A_A",292,179,-113,-47.98,"undercount"
"8270",39047,"Ohio","Fayette County","A_AIC",359,263,-96,-30.87,"undercount"
"8271",39047,"Ohio","Fayette County","NHPI_A",14,11,-3,-24,"undercount"
"8272",39047,"Ohio","Fayette County","NHPI_AIC",40,46,6,13.95,"overcount"
"8273",39049,"Ohio","Franklin County","A_A",77676,74346,-3330,-4.38,"undercount"
"8274",39049,"Ohio","Franklin County","A_AIC",88355,87956,-399,-0.45,"undercount"
"8275",39049,"Ohio","Franklin County","NHPI_A",613,449,-164,-30.89,"undercount"
"8276",39049,"Ohio","Franklin County","NHPI_AIC",1738,1663,-75,-4.41,"undercount"
"8277",39051,"Ohio","Fulton County","A_A",187,154,-33,-19.35,"undercount"
"8278",39051,"Ohio","Fulton County","A_AIC",287,282,-5,-1.76,"undercount"
"8279",39051,"Ohio","Fulton County","NHPI_A",9,6,-3,-40,"undercount"
"8280",39051,"Ohio","Fulton County","NHPI_AIC",25,33,8,27.59,"overcount"
"8281",39053,"Ohio","Gallia County","A_A",204,153,-51,-28.57,"undercount"
"8282",39053,"Ohio","Gallia County","A_AIC",255,186,-69,-31.29,"undercount"
"8283",39053,"Ohio","Gallia County","NHPI_A",75,5,-70,-175,"undercount"
"8284",39053,"Ohio","Gallia County","NHPI_AIC",94,16,-78,-141.82,"undercount"
"8285",39055,"Ohio","Geauga County","A_A",633,682,49,7.45,"overcount"
"8286",39055,"Ohio","Geauga County","A_AIC",916,1137,221,21.53,"overcount"
"8287",39055,"Ohio","Geauga County","NHPI_A",13,9,-4,-36.36,"undercount"
"8288",39055,"Ohio","Geauga County","NHPI_AIC",41,60,19,37.62,"overcount"
"8289",39057,"Ohio","Greene County","A_A",5266,5582,316,5.83,"overcount"
"8290",39057,"Ohio","Greene County","A_AIC",6944,7724,780,10.64,"overcount"
"8291",39057,"Ohio","Greene County","NHPI_A",117,90,-27,-26.09,"undercount"
"8292",39057,"Ohio","Greene County","NHPI_AIC",307,308,1,0.33,"overcount"
"8293",39059,"Ohio","Guernsey County","A_A",165,152,-13,-8.2,"undercount"
"8294",39059,"Ohio","Guernsey County","A_AIC",262,246,-16,-6.3,"undercount"
"8295",39059,"Ohio","Guernsey County","NHPI_A",12,7,-5,-52.63,"undercount"
"8296",39059,"Ohio","Guernsey County","NHPI_AIC",37,19,-18,-64.29,"undercount"
"8297",39061,"Ohio","Hamilton County","A_A",23931,25408,1477,5.99,"overcount"
"8298",39061,"Ohio","Hamilton County","A_AIC",28729,31860,3131,10.34,"overcount"
"8299",39061,"Ohio","Hamilton County","NHPI_A",790,636,-154,-21.6,"undercount"
"8300",39061,"Ohio","Hamilton County","NHPI_AIC",1297,1310,13,1,"overcount"
"8301",39063,"Ohio","Hancock County","A_A",1608,1415,-193,-12.77,"undercount"
"8302",39063,"Ohio","Hancock County","A_AIC",1872,1774,-98,-5.38,"undercount"
"8303",39063,"Ohio","Hancock County","NHPI_A",12,26,14,73.68,"overcount"
"8304",39063,"Ohio","Hancock County","NHPI_AIC",47,45,-2,-4.35,"undercount"
"8305",39065,"Ohio","Hardin County","A_A",243,169,-74,-35.92,"undercount"
"8306",39065,"Ohio","Hardin County","A_AIC",340,270,-70,-22.95,"undercount"
"8307",39065,"Ohio","Hardin County","NHPI_A",8,19,11,81.48,"overcount"
"8308",39065,"Ohio","Hardin County","NHPI_AIC",27,57,30,71.43,"overcount"
"8309",39067,"Ohio","Harrison County","A_A",40,40,0,0,"equal"
"8310",39067,"Ohio","Harrison County","A_AIC",61,80,19,26.95,"overcount"
"8311",39067,"Ohio","Harrison County","NHPI_A",1,7,6,150,"overcount"
"8312",39067,"Ohio","Harrison County","NHPI_AIC",4,12,8,100,"overcount"
"8313",39069,"Ohio","Henry County","A_A",132,126,-6,-4.65,"undercount"
"8314",39069,"Ohio","Henry County","A_AIC",172,184,12,6.74,"overcount"
"8315",39069,"Ohio","Henry County","NHPI_A",4,4,0,0,"equal"
"8316",39069,"Ohio","Henry County","NHPI_AIC",12,8,-4,-40,"undercount"
"8317",39071,"Ohio","Highland County","A_A",187,110,-77,-51.85,"undercount"
"8318",39071,"Ohio","Highland County","A_AIC",262,209,-53,-22.51,"undercount"
"8319",39071,"Ohio","Highland County","NHPI_A",11,8,-3,-31.58,"undercount"
"8320",39071,"Ohio","Highland County","NHPI_AIC",28,37,9,27.69,"overcount"
"8321",39073,"Ohio","Hocking County","A_A",131,71,-60,-59.41,"undercount"
"8322",39073,"Ohio","Hocking County","A_AIC",183,135,-48,-30.19,"undercount"
"8323",39073,"Ohio","Hocking County","NHPI_A",5,0,-5,-200,"undercount"
"8324",39073,"Ohio","Hocking County","NHPI_AIC",13,13,0,0,"equal"
"8325",39075,"Ohio","Holmes County","A_A",107,66,-41,-47.4,"undercount"
"8326",39075,"Ohio","Holmes County","A_AIC",152,109,-43,-32.95,"undercount"
"8327",39075,"Ohio","Holmes County","NHPI_A",22,7,-15,-103.45,"undercount"
"8328",39075,"Ohio","Holmes County","NHPI_AIC",33,25,-8,-27.59,"undercount"
"8329",39077,"Ohio","Huron County","A_A",191,216,25,12.29,"overcount"
"8330",39077,"Ohio","Huron County","A_AIC",298,376,78,23.15,"overcount"
"8331",39077,"Ohio","Huron County","NHPI_A",13,12,-1,-8,"undercount"
"8332",39077,"Ohio","Huron County","NHPI_AIC",38,43,5,12.35,"overcount"
"8333",39079,"Ohio","Jackson County","A_A",124,103,-21,-18.5,"undercount"
"8334",39079,"Ohio","Jackson County","A_AIC",173,162,-11,-6.57,"undercount"
"8335",39079,"Ohio","Jackson County","NHPI_A",14,2,-12,-150,"undercount"
"8336",39079,"Ohio","Jackson County","NHPI_AIC",24,21,-3,-13.33,"undercount"
"8337",39081,"Ohio","Jefferson County","A_A",336,346,10,2.93,"overcount"
"8338",39081,"Ohio","Jefferson County","A_AIC",533,577,44,7.93,"overcount"
"8339",39081,"Ohio","Jefferson County","NHPI_A",22,29,7,27.45,"overcount"
"8340",39081,"Ohio","Jefferson County","NHPI_AIC",69,60,-9,-13.95,"undercount"
"8341",39083,"Ohio","Knox County","A_A",382,366,-16,-4.28,"undercount"
"8342",39083,"Ohio","Knox County","A_AIC",590,587,-3,-0.51,"undercount"
"8343",39083,"Ohio","Knox County","NHPI_A",23,17,-6,-30,"undercount"
"8344",39083,"Ohio","Knox County","NHPI_AIC",47,67,20,35.09,"overcount"
"8345",39085,"Ohio","Lake County","A_A",3550,3292,-258,-7.54,"undercount"
"8346",39085,"Ohio","Lake County","A_AIC",4474,4607,133,2.93,"overcount"
"8347",39085,"Ohio","Lake County","NHPI_A",41,38,-3,-7.59,"undercount"
"8348",39085,"Ohio","Lake County","NHPI_AIC",160,188,28,16.09,"overcount"
"8349",39087,"Ohio","Lawrence County","A_A",268,226,-42,-17,"undercount"
"8350",39087,"Ohio","Lawrence County","A_AIC",365,332,-33,-9.47,"undercount"
"8351",39087,"Ohio","Lawrence County","NHPI_A",7,7,0,0,"equal"
"8352",39087,"Ohio","Lawrence County","NHPI_AIC",40,25,-15,-46.15,"undercount"
"8353",39089,"Ohio","Licking County","A_A",4856,5035,179,3.62,"overcount"
"8354",39089,"Ohio","Licking County","A_AIC",5651,6033,382,6.54,"overcount"
"8355",39089,"Ohio","Licking County","NHPI_A",67,45,-22,-39.29,"undercount"
"8356",39089,"Ohio","Licking County","NHPI_AIC",182,189,7,3.77,"overcount"
"8357",39091,"Ohio","Logan County","A_A",395,339,-56,-15.26,"undercount"
"8358",39091,"Ohio","Logan County","A_AIC",536,575,39,7.02,"overcount"
"8359",39091,"Ohio","Logan County","NHPI_A",20,11,-9,-58.06,"undercount"
"8360",39091,"Ohio","Logan County","NHPI_AIC",51,59,8,14.55,"overcount"
"8361",39093,"Ohio","Lorain County","A_A",4228,3638,-590,-15,"undercount"
"8362",39093,"Ohio","Lorain County","A_AIC",5552,5302,-250,-4.61,"undercount"
"8363",39093,"Ohio","Lorain County","NHPI_A",64,50,-14,-24.56,"undercount"
"8364",39093,"Ohio","Lorain County","NHPI_AIC",219,237,18,7.89,"overcount"
"8365",39095,"Ohio","Lucas County","A_A",7318,7224,-94,-1.29,"undercount"
"8366",39095,"Ohio","Lucas County","A_AIC",9576,9662,86,0.89,"overcount"
"8367",39095,"Ohio","Lucas County","NHPI_A",144,115,-29,-22.39,"undercount"
"8368",39095,"Ohio","Lucas County","NHPI_AIC",371,339,-32,-9.01,"undercount"
"8369",39097,"Ohio","Madison County","A_A",636,267,-369,-81.73,"undercount"
"8370",39097,"Ohio","Madison County","A_AIC",736,456,-280,-46.98,"undercount"
"8371",39097,"Ohio","Madison County","NHPI_A",10,4,-6,-85.71,"undercount"
"8372",39097,"Ohio","Madison County","NHPI_AIC",37,29,-8,-24.24,"undercount"
"8373",39099,"Ohio","Mahoning County","A_A",1965,1972,7,0.36,"overcount"
"8374",39099,"Ohio","Mahoning County","A_AIC",2766,2865,99,3.52,"overcount"
"8375",39099,"Ohio","Mahoning County","NHPI_A",64,69,5,7.52,"overcount"
"8376",39099,"Ohio","Mahoning County","NHPI_AIC",196,184,-12,-6.32,"undercount"
"8377",39101,"Ohio","Marion County","A_A",359,370,11,3.02,"overcount"
"8378",39101,"Ohio","Marion County","A_AIC",494,544,50,9.63,"overcount"
"8379",39101,"Ohio","Marion County","NHPI_A",38,15,-23,-86.79,"undercount"
"8380",39101,"Ohio","Marion County","NHPI_AIC",69,65,-4,-5.97,"undercount"
"8381",39103,"Ohio","Medina County","A_A",2375,2205,-170,-7.42,"undercount"
"8382",39103,"Ohio","Medina County","A_AIC",3002,3233,231,7.41,"overcount"
"8383",39103,"Ohio","Medina County","NHPI_A",42,28,-14,-40,"undercount"
"8384",39103,"Ohio","Medina County","NHPI_AIC",92,133,41,36.44,"overcount"
"8385",39105,"Ohio","Meigs County","A_A",56,22,-34,-87.18,"undercount"
"8386",39105,"Ohio","Meigs County","A_AIC",92,46,-46,-66.67,"undercount"
"8387",39105,"Ohio","Meigs County","NHPI_A",3,0,-3,-200,"undercount"
"8388",39105,"Ohio","Meigs County","NHPI_AIC",12,12,0,0,"equal"
"8389",39107,"Ohio","Mercer County","A_A",243,189,-54,-25,"undercount"
"8390",39107,"Ohio","Mercer County","A_AIC",350,306,-44,-13.41,"undercount"
"8391",39107,"Ohio","Mercer County","NHPI_A",396,564,168,35,"overcount"
"8392",39107,"Ohio","Mercer County","NHPI_AIC",413,579,166,33.47,"overcount"
"8393",39109,"Ohio","Miami County","A_A",1904,1672,-232,-12.98,"undercount"
"8394",39109,"Ohio","Miami County","A_AIC",2278,2299,21,0.92,"overcount"
"8395",39109,"Ohio","Miami County","NHPI_A",30,21,-9,-35.29,"undercount"
"8396",39109,"Ohio","Miami County","NHPI_AIC",79,119,40,40.4,"overcount"
"8397",39111,"Ohio","Monroe County","A_A",29,22,-7,-27.45,"undercount"
"8398",39111,"Ohio","Monroe County","A_AIC",61,70,9,13.74,"overcount"
"8399",39111,"Ohio","Monroe County","NHPI_A",1,3,2,100,"overcount"
"8400",39111,"Ohio","Monroe County","NHPI_AIC",5,20,15,120,"overcount"
"8401",39113,"Ohio","Montgomery County","A_A",12599,12843,244,1.92,"overcount"
"8402",39113,"Ohio","Montgomery County","A_AIC",16333,17295,962,5.72,"overcount"
"8403",39113,"Ohio","Montgomery County","NHPI_A",241,244,3,1.24,"overcount"
"8404",39113,"Ohio","Montgomery County","NHPI_AIC",610,820,210,29.37,"overcount"
"8405",39115,"Ohio","Morgan County","A_A",17,24,7,34.15,"overcount"
"8406",39115,"Ohio","Morgan County","A_AIC",95,51,-44,-60.27,"undercount"
"8407",39115,"Ohio","Morgan County","NHPI_A",1,3,2,100,"overcount"
"8408",39115,"Ohio","Morgan County","NHPI_AIC",27,10,-17,-91.89,"undercount"
"8409",39117,"Ohio","Morrow County","A_A",154,90,-64,-52.46,"undercount"
"8410",39117,"Ohio","Morrow County","A_AIC",233,178,-55,-26.76,"undercount"
"8411",39117,"Ohio","Morrow County","NHPI_A",14,8,-6,-54.55,"undercount"
"8412",39117,"Ohio","Morrow County","NHPI_AIC",29,22,-7,-27.45,"undercount"
"8413",39119,"Ohio","Muskingum County","A_A",476,384,-92,-21.4,"undercount"
"8414",39119,"Ohio","Muskingum County","A_AIC",755,605,-150,-22.06,"undercount"
"8415",39119,"Ohio","Muskingum County","NHPI_A",22,8,-14,-93.33,"undercount"
"8416",39119,"Ohio","Muskingum County","NHPI_AIC",88,53,-35,-49.65,"undercount"
"8417",39121,"Ohio","Noble County","A_A",42,27,-15,-43.48,"undercount"
"8418",39121,"Ohio","Noble County","A_AIC",64,53,-11,-18.8,"undercount"
"8419",39121,"Ohio","Noble County","NHPI_A",3,0,-3,-200,"undercount"
"8420",39121,"Ohio","Noble County","NHPI_AIC",5,8,3,46.15,"overcount"
"8421",39123,"Ohio","Ottawa County","A_A",141,158,17,11.37,"overcount"
"8422",39123,"Ohio","Ottawa County","A_AIC",204,270,66,27.85,"overcount"
"8423",39123,"Ohio","Ottawa County","NHPI_A",15,6,-9,-85.71,"undercount"
"8424",39123,"Ohio","Ottawa County","NHPI_AIC",29,31,2,6.67,"overcount"
"8425",39125,"Ohio","Paulding County","A_A",65,30,-35,-73.68,"undercount"
"8426",39125,"Ohio","Paulding County","A_AIC",106,55,-51,-63.35,"undercount"
"8427",39125,"Ohio","Paulding County","NHPI_A",4,5,1,22.22,"overcount"
"8428",39125,"Ohio","Paulding County","NHPI_AIC",10,13,3,26.09,"overcount"
"8429",39127,"Ohio","Perry County","A_A",70,68,-2,-2.9,"undercount"
"8430",39127,"Ohio","Perry County","A_AIC",137,142,5,3.58,"overcount"
"8431",39127,"Ohio","Perry County","NHPI_A",47,0,-47,-200,"undercount"
"8432",39127,"Ohio","Perry County","NHPI_AIC",68,17,-51,-120,"undercount"
"8433",39129,"Ohio","Pickaway County","A_A",318,299,-19,-6.16,"undercount"
"8434",39129,"Ohio","Pickaway County","A_AIC",503,548,45,8.56,"overcount"
"8435",39129,"Ohio","Pickaway County","NHPI_A",15,12,-3,-22.22,"undercount"
"8436",39129,"Ohio","Pickaway County","NHPI_AIC",46,36,-10,-24.39,"undercount"
"8437",39131,"Ohio","Pike County","A_A",76,77,1,1.31,"overcount"
"8438",39131,"Ohio","Pike County","A_AIC",129,132,3,2.3,"overcount"
"8439",39131,"Ohio","Pike County","NHPI_A",20,6,-14,-107.69,"undercount"
"8440",39131,"Ohio","Pike County","NHPI_AIC",31,32,1,3.17,"overcount"
"8441",39133,"Ohio","Portage County","A_A",3394,3428,34,1,"overcount"
"8442",39133,"Ohio","Portage County","A_AIC",4162,4369,207,4.85,"overcount"
"8443",39133,"Ohio","Portage County","NHPI_A",67,45,-22,-39.29,"undercount"
"8444",39133,"Ohio","Portage County","NHPI_AIC",179,173,-6,-3.41,"undercount"
"8445",39135,"Ohio","Preble County","A_A",270,172,-98,-44.34,"undercount"
"8446",39135,"Ohio","Preble County","A_AIC",368,318,-50,-14.58,"undercount"
"8447",39135,"Ohio","Preble County","NHPI_A",8,4,-4,-66.67,"undercount"
"8448",39135,"Ohio","Preble County","NHPI_AIC",21,16,-5,-27.03,"undercount"
"8449",39137,"Ohio","Putnam County","A_A",85,61,-24,-32.88,"undercount"
"8450",39137,"Ohio","Putnam County","A_AIC",134,133,-1,-0.75,"undercount"
"8451",39137,"Ohio","Putnam County","NHPI_A",3,3,0,0,"equal"
"8452",39137,"Ohio","Putnam County","NHPI_AIC",16,33,17,69.39,"overcount"
"8453",39139,"Ohio","Richland County","A_A",1000,817,-183,-20.14,"undercount"
"8454",39139,"Ohio","Richland County","A_AIC",1387,1211,-176,-13.55,"undercount"
"8455",39139,"Ohio","Richland County","NHPI_A",54,59,5,8.85,"overcount"
"8456",39139,"Ohio","Richland County","NHPI_AIC",147,128,-19,-13.82,"undercount"
"8457",39141,"Ohio","Ross County","A_A",388,392,4,1.03,"overcount"
"8458",39141,"Ohio","Ross County","A_AIC",634,665,31,4.77,"overcount"
"8459",39141,"Ohio","Ross County","NHPI_A",19,20,1,5.13,"overcount"
"8460",39141,"Ohio","Ross County","NHPI_AIC",88,52,-36,-51.43,"undercount"
"8461",39143,"Ohio","Sandusky County","A_A",265,208,-57,-24.1,"undercount"
"8462",39143,"Ohio","Sandusky County","A_AIC",398,392,-6,-1.52,"undercount"
"8463",39143,"Ohio","Sandusky County","NHPI_A",8,7,-1,-13.33,"undercount"
"8464",39143,"Ohio","Sandusky County","NHPI_AIC",33,34,1,2.99,"overcount"
"8465",39145,"Ohio","Scioto County","A_A",293,279,-14,-4.9,"undercount"
"8466",39145,"Ohio","Scioto County","A_AIC",458,428,-30,-6.77,"undercount"
"8467",39145,"Ohio","Scioto County","NHPI_A",12,12,0,0,"equal"
"8468",39145,"Ohio","Scioto County","NHPI_AIC",53,52,-1,-1.9,"undercount"
"8469",39147,"Ohio","Seneca County","A_A",432,365,-67,-16.81,"undercount"
"8470",39147,"Ohio","Seneca County","A_AIC",567,570,3,0.53,"overcount"
"8471",39147,"Ohio","Seneca County","NHPI_A",11,36,25,106.38,"overcount"
"8472",39147,"Ohio","Seneca County","NHPI_AIC",43,60,17,33.01,"overcount"
"8473",39149,"Ohio","Shelby County","A_A",584,474,-110,-20.79,"undercount"
"8474",39149,"Ohio","Shelby County","A_AIC",721,604,-117,-17.66,"undercount"
"8475",39149,"Ohio","Shelby County","NHPI_A",53,29,-24,-58.54,"undercount"
"8476",39149,"Ohio","Shelby County","NHPI_AIC",81,100,19,20.99,"overcount"
"8477",39151,"Ohio","Stark County","A_A",3580,3221,-359,-10.56,"undercount"
"8478",39151,"Ohio","Stark County","A_AIC",4924,4926,2,0.04,"overcount"
"8479",39151,"Ohio","Stark County","NHPI_A",92,100,8,8.33,"overcount"
"8480",39151,"Ohio","Stark County","NHPI_AIC",258,316,58,20.21,"overcount"
"8481",39153,"Ohio","Summit County","A_A",22265,22682,417,1.86,"overcount"
"8482",39153,"Ohio","Summit County","A_AIC",25407,26294,887,3.43,"overcount"
"8483",39153,"Ohio","Summit County","NHPI_A",148,151,3,2.01,"overcount"
"8484",39153,"Ohio","Summit County","NHPI_AIC",415,517,102,21.89,"overcount"
"8485",39155,"Ohio","Trumbull County","A_A",1083,1124,41,3.72,"overcount"
"8486",39155,"Ohio","Trumbull County","A_AIC",1702,1823,121,6.87,"overcount"
"8487",39155,"Ohio","Trumbull County","NHPI_A",44,26,-18,-51.43,"undercount"
"8488",39155,"Ohio","Trumbull County","NHPI_AIC",150,155,5,3.28,"overcount"
"8489",39157,"Ohio","Tuscarawas County","A_A",391,306,-85,-24.39,"undercount"
"8490",39157,"Ohio","Tuscarawas County","A_AIC",568,518,-50,-9.21,"undercount"
"8491",39157,"Ohio","Tuscarawas County","NHPI_A",76,29,-47,-89.52,"undercount"
"8492",39157,"Ohio","Tuscarawas County","NHPI_AIC",105,53,-52,-65.82,"undercount"
"8493",39159,"Ohio","Union County","A_A",3227,4059,832,22.84,"overcount"
"8494",39159,"Ohio","Union County","A_AIC",3552,4584,1032,25.37,"overcount"
"8495",39159,"Ohio","Union County","NHPI_A",14,0,-14,-200,"undercount"
"8496",39159,"Ohio","Union County","NHPI_AIC",45,46,1,2.2,"overcount"
"8497",39161,"Ohio","Van Wert County","A_A",89,89,0,0,"equal"
"8498",39161,"Ohio","Van Wert County","A_AIC",137,185,48,29.81,"overcount"
"8499",39161,"Ohio","Van Wert County","NHPI_A",2,13,11,146.67,"overcount"
"8500",39161,"Ohio","Van Wert County","NHPI_AIC",11,39,28,112,"overcount"
"8501",39163,"Ohio","Vinton County","A_A",35,22,-13,-45.61,"undercount"
"8502",39163,"Ohio","Vinton County","A_AIC",62,38,-24,-48,"undercount"
"8503",39163,"Ohio","Vinton County","NHPI_A",0,0,0,0,"equal"
"8504",39163,"Ohio","Vinton County","NHPI_AIC",8,5,-3,-46.15,"undercount"
"8505",39165,"Ohio","Warren County","A_A",15861,17378,1517,9.13,"overcount"
"8506",39165,"Ohio","Warren County","A_AIC",17685,19863,2178,11.6,"overcount"
"8507",39165,"Ohio","Warren County","NHPI_A",156,161,5,3.15,"overcount"
"8508",39165,"Ohio","Warren County","NHPI_AIC",283,381,98,29.52,"overcount"
"8509",39167,"Ohio","Washington County","A_A",415,322,-93,-25.24,"undercount"
"8510",39167,"Ohio","Washington County","A_AIC",618,528,-90,-15.71,"undercount"
"8511",39167,"Ohio","Washington County","NHPI_A",8,8,0,0,"equal"
"8512",39167,"Ohio","Washington County","NHPI_AIC",42,50,8,17.39,"overcount"
"8513",39169,"Ohio","Wayne County","A_A",1221,961,-260,-23.83,"undercount"
"8514",39169,"Ohio","Wayne County","A_AIC",1563,1339,-224,-15.44,"undercount"
"8515",39169,"Ohio","Wayne County","NHPI_A",31,37,6,17.65,"overcount"
"8516",39169,"Ohio","Wayne County","NHPI_AIC",76,112,36,38.3,"overcount"
"8517",39171,"Ohio","Williams County","A_A",214,205,-9,-4.3,"undercount"
"8518",39171,"Ohio","Williams County","A_AIC",273,299,26,9.09,"overcount"
"8519",39171,"Ohio","Williams County","NHPI_A",10,0,-10,-200,"undercount"
"8520",39171,"Ohio","Williams County","NHPI_AIC",17,23,6,30,"overcount"
"8521",39173,"Ohio","Wood County","A_A",2485,2777,292,11.1,"overcount"
"8522",39173,"Ohio","Wood County","A_AIC",3134,3636,502,14.83,"overcount"
"8523",39173,"Ohio","Wood County","NHPI_A",33,9,-24,-114.29,"undercount"
"8524",39173,"Ohio","Wood County","NHPI_AIC",92,108,16,16,"overcount"
"8525",39175,"Ohio","Wyandot County","A_A",150,85,-65,-55.32,"undercount"
"8526",39175,"Ohio","Wyandot County","A_AIC",175,153,-22,-13.41,"undercount"
"8527",39175,"Ohio","Wyandot County","NHPI_A",8,3,-5,-90.91,"undercount"
"8528",39175,"Ohio","Wyandot County","NHPI_AIC",13,20,7,42.42,"overcount"
"8529",40001,"Oklahoma","Adair County","A_A",183,162,-21,-12.17,"undercount"
"8530",40001,"Oklahoma","Adair County","A_AIC",246,196,-50,-22.62,"undercount"
"8531",40001,"Oklahoma","Adair County","NHPI_A",11,12,1,8.7,"overcount"
"8532",40001,"Oklahoma","Adair County","NHPI_AIC",37,23,-14,-46.67,"undercount"
"8533",40003,"Oklahoma","Alfalfa County","A_A",20,7,-13,-96.3,"undercount"
"8534",40003,"Oklahoma","Alfalfa County","A_AIC",34,37,3,8.45,"overcount"
"8535",40003,"Oklahoma","Alfalfa County","NHPI_A",7,0,-7,-200,"undercount"
"8536",40003,"Oklahoma","Alfalfa County","NHPI_AIC",12,8,-4,-40,"undercount"
"8537",40005,"Oklahoma","Atoka County","A_A",90,49,-41,-58.99,"undercount"
"8538",40005,"Oklahoma","Atoka County","A_AIC",150,97,-53,-42.91,"undercount"
"8539",40005,"Oklahoma","Atoka County","NHPI_A",6,4,-2,-40,"undercount"
"8540",40005,"Oklahoma","Atoka County","NHPI_AIC",18,7,-11,-88,"undercount"
"8541",40007,"Oklahoma","Beaver County","A_A",11,11,0,0,"equal"
"8542",40007,"Oklahoma","Beaver County","A_AIC",25,28,3,11.32,"overcount"
"8543",40007,"Oklahoma","Beaver County","NHPI_A",0,6,6,200,"overcount"
"8544",40007,"Oklahoma","Beaver County","NHPI_AIC",4,12,8,100,"overcount"
"8545",40009,"Oklahoma","Beckham County","A_A",211,137,-74,-42.53,"undercount"
"8546",40009,"Oklahoma","Beckham County","A_AIC",258,205,-53,-22.89,"undercount"
"8547",40009,"Oklahoma","Beckham County","NHPI_A",3,12,9,120,"overcount"
"8548",40009,"Oklahoma","Beckham County","NHPI_AIC",14,25,11,56.41,"overcount"
"8549",40011,"Oklahoma","Blaine County","A_A",27,32,5,16.95,"overcount"
"8550",40011,"Oklahoma","Blaine County","A_AIC",73,58,-15,-22.9,"undercount"
"8551",40011,"Oklahoma","Blaine County","NHPI_A",7,5,-2,-33.33,"undercount"
"8552",40011,"Oklahoma","Blaine County","NHPI_AIC",20,14,-6,-35.29,"undercount"
"8553",40013,"Oklahoma","Bryan County","A_A",284,293,9,3.12,"overcount"
"8554",40013,"Oklahoma","Bryan County","A_AIC",414,454,40,9.22,"overcount"
"8555",40013,"Oklahoma","Bryan County","NHPI_A",42,14,-28,-100,"undercount"
"8556",40013,"Oklahoma","Bryan County","NHPI_AIC",90,58,-32,-43.24,"undercount"
"8557",40015,"Oklahoma","Caddo County","A_A",129,63,-66,-68.75,"undercount"
"8558",40015,"Oklahoma","Caddo County","A_AIC",223,119,-104,-60.82,"undercount"
"8559",40015,"Oklahoma","Caddo County","NHPI_A",20,13,-7,-42.42,"undercount"
"8560",40015,"Oklahoma","Caddo County","NHPI_AIC",57,46,-11,-21.36,"undercount"
"8561",40017,"Oklahoma","Canadian County","A_A",4986,4846,-140,-2.85,"undercount"
"8562",40017,"Oklahoma","Canadian County","A_AIC",6016,6198,182,2.98,"overcount"
"8563",40017,"Oklahoma","Canadian County","NHPI_A",134,120,-14,-11.02,"undercount"
"8564",40017,"Oklahoma","Canadian County","NHPI_AIC",283,340,57,18.3,"overcount"
"8565",40019,"Oklahoma","Carter County","A_A",645,593,-52,-8.4,"undercount"
"8566",40019,"Oklahoma","Carter County","A_AIC",820,754,-66,-8.39,"undercount"
"8567",40019,"Oklahoma","Carter County","NHPI_A",12,44,32,114.29,"overcount"
"8568",40019,"Oklahoma","Carter County","NHPI_AIC",55,104,49,61.64,"overcount"
"8569",40021,"Oklahoma","Cherokee County","A_A",488,311,-177,-44.31,"undercount"
"8570",40021,"Oklahoma","Cherokee County","A_AIC",631,498,-133,-23.56,"undercount"
"8571",40021,"Oklahoma","Cherokee County","NHPI_A",26,21,-5,-21.28,"undercount"
"8572",40021,"Oklahoma","Cherokee County","NHPI_AIC",72,54,-18,-28.57,"undercount"
"8573",40023,"Oklahoma","Choctaw County","A_A",66,29,-37,-77.89,"undercount"
"8574",40023,"Oklahoma","Choctaw County","A_AIC",131,47,-84,-94.38,"undercount"
"8575",40023,"Oklahoma","Choctaw County","NHPI_A",2,5,3,85.71,"overcount"
"8576",40023,"Oklahoma","Choctaw County","NHPI_AIC",26,15,-11,-53.66,"undercount"
"8577",40025,"Oklahoma","Cimarron County","A_A",10,1,-9,-163.64,"undercount"
"8578",40025,"Oklahoma","Cimarron County","A_AIC",19,14,-5,-30.3,"undercount"
"8579",40025,"Oklahoma","Cimarron County","NHPI_A",0,0,0,0,"equal"
"8580",40025,"Oklahoma","Cimarron County","NHPI_AIC",0,2,2,200,"overcount"
"8581",40027,"Oklahoma","Cleveland County","A_A",13220,12841,-379,-2.91,"undercount"
"8582",40027,"Oklahoma","Cleveland County","A_AIC",16494,16556,62,0.38,"overcount"
"8583",40027,"Oklahoma","Cleveland County","NHPI_A",230,244,14,5.91,"overcount"
"8584",40027,"Oklahoma","Cleveland County","NHPI_AIC",582,767,185,27.43,"overcount"
"8585",40029,"Oklahoma","Coal County","A_A",14,15,1,6.9,"overcount"
"8586",40029,"Oklahoma","Coal County","A_AIC",37,49,12,27.91,"overcount"
"8587",40029,"Oklahoma","Coal County","NHPI_A",0,0,0,0,"equal"
"8588",40029,"Oklahoma","Coal County","NHPI_AIC",8,6,-2,-28.57,"undercount"
"8589",40031,"Oklahoma","Comanche County","A_A",2975,3029,54,1.8,"overcount"
"8590",40031,"Oklahoma","Comanche County","A_AIC",5087,5059,-28,-0.55,"undercount"
"8591",40031,"Oklahoma","Comanche County","NHPI_A",684,803,119,16.01,"overcount"
"8592",40031,"Oklahoma","Comanche County","NHPI_AIC",1119,1278,159,13.27,"overcount"
"8593",40033,"Oklahoma","Cotton County","A_A",20,28,8,33.33,"overcount"
"8594",40033,"Oklahoma","Cotton County","A_AIC",47,77,30,48.39,"overcount"
"8595",40033,"Oklahoma","Cotton County","NHPI_A",12,9,-3,-28.57,"undercount"
"8596",40033,"Oklahoma","Cotton County","NHPI_AIC",17,16,-1,-6.06,"undercount"
"8597",40035,"Oklahoma","Craig County","A_A",106,78,-28,-30.43,"undercount"
"8598",40035,"Oklahoma","Craig County","A_AIC",171,136,-35,-22.8,"undercount"
"8599",40035,"Oklahoma","Craig County","NHPI_A",18,1,-17,-178.95,"undercount"
"8600",40035,"Oklahoma","Craig County","NHPI_AIC",41,21,-20,-64.52,"undercount"
"8601",40037,"Oklahoma","Creek County","A_A",487,294,-193,-49.42,"undercount"
"8602",40037,"Oklahoma","Creek County","A_AIC",746,575,-171,-25.89,"undercount"
"8603",40037,"Oklahoma","Creek County","NHPI_A",65,67,2,3.03,"overcount"
"8604",40037,"Oklahoma","Creek County","NHPI_AIC",124,120,-4,-3.28,"undercount"
"8605",40039,"Oklahoma","Custer County","A_A",361,296,-65,-19.79,"undercount"
"8606",40039,"Oklahoma","Custer County","A_AIC",476,433,-43,-9.46,"undercount"
"8607",40039,"Oklahoma","Custer County","NHPI_A",16,7,-9,-78.26,"undercount"
"8608",40039,"Oklahoma","Custer County","NHPI_AIC",43,39,-4,-9.76,"undercount"
"8609",40041,"Oklahoma","Delaware County","A_A",493,471,-22,-4.56,"undercount"
"8610",40041,"Oklahoma","Delaware County","A_AIC",570,609,39,6.62,"overcount"
"8611",40041,"Oklahoma","Delaware County","NHPI_A",60,36,-24,-50,"undercount"
"8612",40041,"Oklahoma","Delaware County","NHPI_AIC",86,58,-28,-38.89,"undercount"
"8613",40043,"Oklahoma","Dewey County","A_A",60,4,-56,-175,"undercount"
"8614",40043,"Oklahoma","Dewey County","A_AIC",73,22,-51,-107.37,"undercount"
"8615",40043,"Oklahoma","Dewey County","NHPI_A",0,2,2,200,"overcount"
"8616",40043,"Oklahoma","Dewey County","NHPI_AIC",6,8,2,28.57,"overcount"
"8617",40045,"Oklahoma","Ellis County","A_A",21,13,-8,-47.06,"undercount"
"8618",40045,"Oklahoma","Ellis County","A_AIC",29,25,-4,-14.81,"undercount"
"8619",40045,"Oklahoma","Ellis County","NHPI_A",2,0,-2,-200,"undercount"
"8620",40045,"Oklahoma","Ellis County","NHPI_AIC",10,6,-4,-50,"undercount"
"8621",40047,"Oklahoma","Garfield County","A_A",700,685,-15,-2.17,"undercount"
"8622",40047,"Oklahoma","Garfield County","A_AIC",1047,1223,176,15.51,"overcount"
"8623",40047,"Oklahoma","Garfield County","NHPI_A",2530,2972,442,16.07,"overcount"
"8624",40047,"Oklahoma","Garfield County","NHPI_AIC",2606,3140,534,18.59,"overcount"
"8625",40049,"Oklahoma","Garvin County","A_A",112,118,6,5.22,"overcount"
"8626",40049,"Oklahoma","Garvin County","A_AIC",203,177,-26,-13.68,"undercount"
"8627",40049,"Oklahoma","Garvin County","NHPI_A",12,8,-4,-40,"undercount"
"8628",40049,"Oklahoma","Garvin County","NHPI_AIC",48,32,-16,-40,"undercount"
"8629",40051,"Oklahoma","Grady County","A_A",245,205,-40,-17.78,"undercount"
"8630",40051,"Oklahoma","Grady County","A_AIC",443,459,16,3.55,"overcount"
"8631",40051,"Oklahoma","Grady County","NHPI_A",48,38,-10,-23.26,"undercount"
"8632",40051,"Oklahoma","Grady County","NHPI_AIC",109,97,-12,-11.65,"undercount"
"8633",40053,"Oklahoma","Grant County","A_A",13,12,-1,-8,"undercount"
"8634",40053,"Oklahoma","Grant County","A_AIC",30,16,-14,-60.87,"undercount"
"8635",40053,"Oklahoma","Grant County","NHPI_A",1,8,7,155.56,"overcount"
"8636",40053,"Oklahoma","Grant County","NHPI_AIC",7,14,7,66.67,"overcount"
"8637",40055,"Oklahoma","Greer County","A_A",13,7,-6,-60,"undercount"
"8638",40055,"Oklahoma","Greer County","A_AIC",25,15,-10,-50,"undercount"
"8639",40055,"Oklahoma","Greer County","NHPI_A",8,1,-7,-155.56,"undercount"
"8640",40055,"Oklahoma","Greer County","NHPI_AIC",12,10,-2,-18.18,"undercount"
"8641",40057,"Oklahoma","Harmon County","A_A",38,7,-31,-137.78,"undercount"
"8642",40057,"Oklahoma","Harmon County","A_AIC",46,21,-25,-74.63,"undercount"
"8643",40057,"Oklahoma","Harmon County","NHPI_A",0,0,0,0,"equal"
"8644",40057,"Oklahoma","Harmon County","NHPI_AIC",3,7,4,80,"overcount"
"8645",40059,"Oklahoma","Harper County","A_A",8,0,-8,-200,"undercount"
"8646",40059,"Oklahoma","Harper County","A_AIC",19,16,-3,-17.14,"undercount"
"8647",40059,"Oklahoma","Harper County","NHPI_A",1,0,-1,-200,"undercount"
"8648",40059,"Oklahoma","Harper County","NHPI_AIC",2,14,12,150,"overcount"
"8649",40061,"Oklahoma","Haskell County","A_A",113,24,-89,-129.93,"undercount"
"8650",40061,"Oklahoma","Haskell County","A_AIC",143,45,-98,-104.26,"undercount"
"8651",40061,"Oklahoma","Haskell County","NHPI_A",4,7,3,54.55,"overcount"
"8652",40061,"Oklahoma","Haskell County","NHPI_AIC",13,27,14,70,"overcount"
"8653",40063,"Oklahoma","Hughes County","A_A",37,38,1,2.67,"overcount"
"8654",40063,"Oklahoma","Hughes County","A_AIC",70,69,-1,-1.44,"undercount"
"8655",40063,"Oklahoma","Hughes County","NHPI_A",15,14,-1,-6.9,"undercount"
"8656",40063,"Oklahoma","Hughes County","NHPI_AIC",25,35,10,33.33,"overcount"
"8657",40065,"Oklahoma","Jackson County","A_A",351,320,-31,-9.24,"undercount"
"8658",40065,"Oklahoma","Jackson County","A_AIC",496,532,36,7,"overcount"
"8659",40065,"Oklahoma","Jackson County","NHPI_A",74,78,4,5.26,"overcount"
"8660",40065,"Oklahoma","Jackson County","NHPI_AIC",108,132,24,20,"overcount"
"8661",40067,"Oklahoma","Jefferson County","A_A",34,30,-4,-12.5,"undercount"
"8662",40067,"Oklahoma","Jefferson County","A_AIC",49,46,-3,-6.32,"undercount"
"8663",40067,"Oklahoma","Jefferson County","NHPI_A",0,5,5,200,"overcount"
"8664",40067,"Oklahoma","Jefferson County","NHPI_AIC",6,12,6,66.67,"overcount"
"8665",40069,"Oklahoma","Johnston County","A_A",61,52,-9,-15.93,"undercount"
"8666",40069,"Oklahoma","Johnston County","A_AIC",98,77,-21,-24,"undercount"
"8667",40069,"Oklahoma","Johnston County","NHPI_A",2,5,3,85.71,"overcount"
"8668",40069,"Oklahoma","Johnston County","NHPI_AIC",11,35,24,104.35,"overcount"
"8669",40071,"Oklahoma","Kay County","A_A",268,258,-10,-3.8,"undercount"
"8670",40071,"Oklahoma","Kay County","A_AIC",414,434,20,4.72,"overcount"
"8671",40071,"Oklahoma","Kay County","NHPI_A",195,274,79,33.69,"overcount"
"8672",40071,"Oklahoma","Kay County","NHPI_AIC",245,331,86,29.86,"overcount"
"8673",40073,"Oklahoma","Kingfisher County","A_A",60,46,-14,-26.42,"undercount"
"8674",40073,"Oklahoma","Kingfisher County","A_AIC",93,76,-17,-20.12,"undercount"
"8675",40073,"Oklahoma","Kingfisher County","NHPI_A",3,0,-3,-200,"undercount"
"8676",40073,"Oklahoma","Kingfisher County","NHPI_AIC",15,16,1,6.45,"overcount"
"8677",40075,"Oklahoma","Kiowa County","A_A",27,47,20,54.05,"overcount"
"8678",40075,"Oklahoma","Kiowa County","A_AIC",60,69,9,13.95,"overcount"
"8679",40075,"Oklahoma","Kiowa County","NHPI_A",9,3,-6,-100,"undercount"
"8680",40075,"Oklahoma","Kiowa County","NHPI_AIC",23,30,7,26.42,"overcount"
"8681",40077,"Oklahoma","Latimer County","A_A",67,68,1,1.48,"overcount"
"8682",40077,"Oklahoma","Latimer County","A_AIC",102,84,-18,-19.35,"undercount"
"8683",40077,"Oklahoma","Latimer County","NHPI_A",3,5,2,50,"overcount"
"8684",40077,"Oklahoma","Latimer County","NHPI_AIC",16,22,6,31.58,"overcount"
"8685",40079,"Oklahoma","Le Flore County","A_A",347,292,-55,-17.21,"undercount"
"8686",40079,"Oklahoma","Le Flore County","A_AIC",503,445,-58,-12.24,"undercount"
"8687",40079,"Oklahoma","Le Flore County","NHPI_A",63,32,-31,-65.26,"undercount"
"8688",40079,"Oklahoma","Le Flore County","NHPI_AIC",121,79,-42,-42,"undercount"
"8689",40081,"Oklahoma","Lincoln County","A_A",126,116,-10,-8.26,"undercount"
"8690",40081,"Oklahoma","Lincoln County","A_AIC",264,255,-9,-3.47,"undercount"
"8691",40081,"Oklahoma","Lincoln County","NHPI_A",26,14,-12,-60,"undercount"
"8692",40081,"Oklahoma","Lincoln County","NHPI_AIC",72,29,-43,-85.15,"undercount"
"8693",40083,"Oklahoma","Logan County","A_A",276,260,-16,-5.97,"undercount"
"8694",40083,"Oklahoma","Logan County","A_AIC",471,603,132,24.58,"overcount"
"8695",40083,"Oklahoma","Logan County","NHPI_A",25,31,6,21.43,"overcount"
"8696",40083,"Oklahoma","Logan County","NHPI_AIC",101,117,16,14.68,"overcount"
"8697",40085,"Oklahoma","Love County","A_A",58,74,16,24.24,"overcount"
"8698",40085,"Oklahoma","Love County","A_AIC",83,110,27,27.98,"overcount"
"8699",40085,"Oklahoma","Love County","NHPI_A",0,0,0,0,"equal"
"8700",40085,"Oklahoma","Love County","NHPI_AIC",7,19,12,92.31,"overcount"
"8701",40087,"Oklahoma","McClain County","A_A",215,209,-6,-2.83,"undercount"
"8702",40087,"Oklahoma","McClain County","A_AIC",362,392,30,7.96,"overcount"
"8703",40087,"Oklahoma","McClain County","NHPI_A",40,36,-4,-10.53,"undercount"
"8704",40087,"Oklahoma","McClain County","NHPI_AIC",68,84,16,21.05,"overcount"
"8705",40089,"Oklahoma","McCurtain County","A_A",320,124,-196,-88.29,"undercount"
"8706",40089,"Oklahoma","McCurtain County","A_AIC",417,195,-222,-72.55,"undercount"
"8707",40089,"Oklahoma","McCurtain County","NHPI_A",487,461,-26,-5.49,"undercount"
"8708",40089,"Oklahoma","McCurtain County","NHPI_AIC",523,473,-50,-10.04,"undercount"
"8709",40091,"Oklahoma","McIntosh County","A_A",95,68,-27,-33.13,"undercount"
"8710",40091,"Oklahoma","McIntosh County","A_AIC",167,89,-78,-60.94,"undercount"
"8711",40091,"Oklahoma","McIntosh County","NHPI_A",13,4,-9,-105.88,"undercount"
"8712",40091,"Oklahoma","McIntosh County","NHPI_AIC",44,23,-21,-62.69,"undercount"
"8713",40093,"Oklahoma","Major County","A_A",62,40,-22,-43.14,"undercount"
"8714",40093,"Oklahoma","Major County","A_AIC",92,58,-34,-45.33,"undercount"
"8715",40093,"Oklahoma","Major County","NHPI_A",3,0,-3,-200,"undercount"
"8716",40093,"Oklahoma","Major County","NHPI_AIC",9,3,-6,-100,"undercount"
"8717",40095,"Oklahoma","Marshall County","A_A",68,44,-24,-42.86,"undercount"
"8718",40095,"Oklahoma","Marshall County","A_AIC",116,101,-15,-13.82,"undercount"
"8719",40095,"Oklahoma","Marshall County","NHPI_A",1,4,3,120,"overcount"
"8720",40095,"Oklahoma","Marshall County","NHPI_AIC",16,10,-6,-46.15,"undercount"
"8721",40097,"Oklahoma","Mayes County","A_A",209,192,-17,-8.48,"undercount"
"8722",40097,"Oklahoma","Mayes County","A_AIC",312,343,31,9.47,"overcount"
"8723",40097,"Oklahoma","Mayes County","NHPI_A",21,27,6,25,"overcount"
"8724",40097,"Oklahoma","Mayes County","NHPI_AIC",55,54,-1,-1.83,"undercount"
"8725",40099,"Oklahoma","Murray County","A_A",79,45,-34,-54.84,"undercount"
"8726",40099,"Oklahoma","Murray County","A_AIC",125,88,-37,-34.74,"undercount"
"8727",40099,"Oklahoma","Murray County","NHPI_A",2,19,17,161.9,"overcount"
"8728",40099,"Oklahoma","Murray County","NHPI_AIC",13,37,24,96,"overcount"
"8729",40101,"Oklahoma","Muskogee County","A_A",444,512,68,14.23,"overcount"
"8730",40101,"Oklahoma","Muskogee County","A_AIC",643,766,123,17.46,"overcount"
"8731",40101,"Oklahoma","Muskogee County","NHPI_A",47,39,-8,-18.6,"undercount"
"8732",40101,"Oklahoma","Muskogee County","NHPI_AIC",116,104,-12,-10.91,"undercount"
"8733",40103,"Oklahoma","Noble County","A_A",57,48,-9,-17.14,"undercount"
"8734",40103,"Oklahoma","Noble County","A_AIC",97,76,-21,-24.28,"undercount"
"8735",40103,"Oklahoma","Noble County","NHPI_A",7,1,-6,-150,"undercount"
"8736",40103,"Oklahoma","Noble County","NHPI_AIC",12,22,10,58.82,"overcount"
"8737",40105,"Oklahoma","Nowata County","A_A",16,5,-11,-104.76,"undercount"
"8738",40105,"Oklahoma","Nowata County","A_AIC",61,38,-23,-46.46,"undercount"
"8739",40105,"Oklahoma","Nowata County","NHPI_A",3,5,2,50,"overcount"
"8740",40105,"Oklahoma","Nowata County","NHPI_AIC",14,16,2,13.33,"overcount"
"8741",40107,"Oklahoma","Okfuskee County","A_A",42,32,-10,-27.03,"undercount"
"8742",40107,"Oklahoma","Okfuskee County","A_AIC",97,50,-47,-63.95,"undercount"
"8743",40107,"Oklahoma","Okfuskee County","NHPI_A",14,0,-14,-200,"undercount"
"8744",40107,"Oklahoma","Okfuskee County","NHPI_AIC",27,9,-18,-100,"undercount"
"8745",40109,"Oklahoma","Oklahoma County","A_A",28560,28037,-523,-1.85,"undercount"
"8746",40109,"Oklahoma","Oklahoma County","A_AIC",35732,36077,345,0.96,"overcount"
"8747",40109,"Oklahoma","Oklahoma County","NHPI_A",815,1179,364,36.51,"overcount"
"8748",40109,"Oklahoma","Oklahoma County","NHPI_AIC",1779,2262,483,23.9,"overcount"
"8749",40111,"Oklahoma","Okmulgee County","A_A",174,160,-14,-8.38,"undercount"
"8750",40111,"Oklahoma","Okmulgee County","A_AIC",328,299,-29,-9.25,"undercount"
"8751",40111,"Oklahoma","Okmulgee County","NHPI_A",24,26,2,8,"overcount"
"8752",40111,"Oklahoma","Okmulgee County","NHPI_AIC",76,63,-13,-18.71,"undercount"
"8753",40113,"Oklahoma","Osage County","A_A",167,129,-38,-25.68,"undercount"
"8754",40113,"Oklahoma","Osage County","A_AIC",289,288,-1,-0.35,"undercount"
"8755",40113,"Oklahoma","Osage County","NHPI_A",28,19,-9,-38.3,"undercount"
"8756",40113,"Oklahoma","Osage County","NHPI_AIC",70,76,6,8.22,"overcount"
"8757",40115,"Oklahoma","Ottawa County","A_A",199,154,-45,-25.5,"undercount"
"8758",40115,"Oklahoma","Ottawa County","A_AIC",342,275,-67,-21.72,"undercount"
"8759",40115,"Oklahoma","Ottawa County","NHPI_A",256,239,-17,-6.87,"undercount"
"8760",40115,"Oklahoma","Ottawa County","NHPI_AIC",282,277,-5,-1.79,"undercount"
"8761",40117,"Oklahoma","Pawnee County","A_A",73,49,-24,-39.34,"undercount"
"8762",40117,"Oklahoma","Pawnee County","A_AIC",129,103,-26,-22.41,"undercount"
"8763",40117,"Oklahoma","Pawnee County","NHPI_A",12,0,-12,-200,"undercount"
"8764",40117,"Oklahoma","Pawnee County","NHPI_AIC",26,13,-13,-66.67,"undercount"
"8765",40119,"Oklahoma","Payne County","A_A",3553,2714,-839,-26.78,"undercount"
"8766",40119,"Oklahoma","Payne County","A_AIC",4260,3581,-679,-17.32,"undercount"
"8767",40119,"Oklahoma","Payne County","NHPI_A",69,53,-16,-26.23,"undercount"
"8768",40119,"Oklahoma","Payne County","NHPI_AIC",135,190,55,33.85,"overcount"
"8769",40121,"Oklahoma","Pittsburg County","A_A",191,280,89,37.79,"overcount"
"8770",40121,"Oklahoma","Pittsburg County","A_AIC",339,454,115,29,"overcount"
"8771",40121,"Oklahoma","Pittsburg County","NHPI_A",32,35,3,8.96,"overcount"
"8772",40121,"Oklahoma","Pittsburg County","NHPI_AIC",71,66,-5,-7.3,"undercount"
"8773",40123,"Oklahoma","Pontotoc County","A_A",375,391,16,4.18,"overcount"
"8774",40123,"Oklahoma","Pontotoc County","A_AIC",533,589,56,9.98,"overcount"
"8775",40123,"Oklahoma","Pontotoc County","NHPI_A",14,13,-1,-7.41,"undercount"
"8776",40123,"Oklahoma","Pontotoc County","NHPI_AIC",56,38,-18,-38.3,"undercount"
"8777",40125,"Oklahoma","Pottawatomie County","A_A",491,503,12,2.41,"overcount"
"8778",40125,"Oklahoma","Pottawatomie County","A_AIC",935,878,-57,-6.29,"undercount"
"8779",40125,"Oklahoma","Pottawatomie County","NHPI_A",73,39,-34,-60.71,"undercount"
"8780",40125,"Oklahoma","Pottawatomie County","NHPI_AIC",168,141,-27,-17.48,"undercount"
"8781",40127,"Oklahoma","Pushmataha County","A_A",43,52,9,18.95,"overcount"
"8782",40127,"Oklahoma","Pushmataha County","A_AIC",77,74,-3,-3.97,"undercount"
"8783",40127,"Oklahoma","Pushmataha County","NHPI_A",3,1,-2,-100,"undercount"
"8784",40127,"Oklahoma","Pushmataha County","NHPI_AIC",14,10,-4,-33.33,"undercount"
"8785",40129,"Oklahoma","Roger Mills County","A_A",15,5,-10,-100,"undercount"
"8786",40129,"Oklahoma","Roger Mills County","A_AIC",32,17,-15,-61.22,"undercount"
"8787",40129,"Oklahoma","Roger Mills County","NHPI_A",2,1,-1,-66.67,"undercount"
"8788",40129,"Oklahoma","Roger Mills County","NHPI_AIC",4,4,0,0,"equal"
"8789",40131,"Oklahoma","Rogers County","A_A",1457,1680,223,14.22,"overcount"
"8790",40131,"Oklahoma","Rogers County","A_AIC",1861,2230,369,18.04,"overcount"
"8791",40131,"Oklahoma","Rogers County","NHPI_A",83,39,-44,-72.13,"undercount"
"8792",40131,"Oklahoma","Rogers County","NHPI_AIC",172,167,-5,-2.95,"undercount"
"8793",40133,"Oklahoma","Seminole County","A_A",105,72,-33,-37.29,"undercount"
"8794",40133,"Oklahoma","Seminole County","A_AIC",221,152,-69,-37,"undercount"
"8795",40133,"Oklahoma","Seminole County","NHPI_A",30,8,-22,-115.79,"undercount"
"8796",40133,"Oklahoma","Seminole County","NHPI_AIC",63,20,-43,-103.61,"undercount"
"8797",40135,"Oklahoma","Sequoyah County","A_A",309,288,-21,-7.04,"undercount"
"8798",40135,"Oklahoma","Sequoyah County","A_AIC",485,431,-54,-11.79,"undercount"
"8799",40135,"Oklahoma","Sequoyah County","NHPI_A",15,14,-1,-6.9,"undercount"
"8800",40135,"Oklahoma","Sequoyah County","NHPI_AIC",48,26,-22,-59.46,"undercount"
"8801",40137,"Oklahoma","Stephens County","A_A",275,244,-31,-11.95,"undercount"
"8802",40137,"Oklahoma","Stephens County","A_AIC",429,423,-6,-1.41,"undercount"
"8803",40137,"Oklahoma","Stephens County","NHPI_A",17,13,-4,-26.67,"undercount"
"8804",40137,"Oklahoma","Stephens County","NHPI_AIC",49,31,-18,-45,"undercount"
"8805",40139,"Oklahoma","Texas County","A_A",627,448,-179,-33.3,"undercount"
"8806",40139,"Oklahoma","Texas County","A_AIC",668,524,-144,-24.16,"undercount"
"8807",40139,"Oklahoma","Texas County","NHPI_A",47,1,-46,-191.67,"undercount"
"8808",40139,"Oklahoma","Texas County","NHPI_AIC",54,30,-24,-57.14,"undercount"
"8809",40141,"Oklahoma","Tillman County","A_A",38,32,-6,-17.14,"undercount"
"8810",40141,"Oklahoma","Tillman County","A_AIC",59,50,-9,-16.51,"undercount"
"8811",40141,"Oklahoma","Tillman County","NHPI_A",3,0,-3,-200,"undercount"
"8812",40141,"Oklahoma","Tillman County","NHPI_AIC",9,8,-1,-11.76,"undercount"
"8813",40143,"Oklahoma","Tulsa County","A_A",23720,25029,1309,5.37,"overcount"
"8814",40143,"Oklahoma","Tulsa County","A_AIC",28646,30366,1720,5.83,"overcount"
"8815",40143,"Oklahoma","Tulsa County","NHPI_A",941,1047,106,10.66,"overcount"
"8816",40143,"Oklahoma","Tulsa County","NHPI_AIC",1560,1891,331,19.18,"overcount"
"8817",40145,"Oklahoma","Wagoner County","A_A",1525,1410,-115,-7.84,"undercount"
"8818",40145,"Oklahoma","Wagoner County","A_AIC",1973,1948,-25,-1.28,"undercount"
"8819",40145,"Oklahoma","Wagoner County","NHPI_A",56,29,-27,-63.53,"undercount"
"8820",40145,"Oklahoma","Wagoner County","NHPI_AIC",153,93,-60,-48.78,"undercount"
"8821",40147,"Oklahoma","Washington County","A_A",1156,975,-181,-16.99,"undercount"
"8822",40147,"Oklahoma","Washington County","A_AIC",1412,1295,-117,-8.64,"undercount"
"8823",40147,"Oklahoma","Washington County","NHPI_A",39,10,-29,-118.37,"undercount"
"8824",40147,"Oklahoma","Washington County","NHPI_AIC",92,87,-5,-5.59,"undercount"
"8825",40149,"Oklahoma","Washita County","A_A",49,22,-27,-76.06,"undercount"
"8826",40149,"Oklahoma","Washita County","A_AIC",66,36,-30,-58.82,"undercount"
"8827",40149,"Oklahoma","Washita County","NHPI_A",4,0,-4,-200,"undercount"
"8828",40149,"Oklahoma","Washita County","NHPI_AIC",7,0,-7,-200,"undercount"
"8829",40151,"Oklahoma","Woods County","A_A",105,74,-31,-34.64,"undercount"
"8830",40151,"Oklahoma","Woods County","A_AIC",134,108,-26,-21.49,"undercount"
"8831",40151,"Oklahoma","Woods County","NHPI_A",5,1,-4,-133.33,"undercount"
"8832",40151,"Oklahoma","Woods County","NHPI_AIC",10,16,6,46.15,"overcount"
"8833",40153,"Oklahoma","Woodward County","A_A",162,130,-32,-21.92,"undercount"
"8834",40153,"Oklahoma","Woodward County","A_AIC",199,203,4,1.99,"overcount"
"8835",40153,"Oklahoma","Woodward County","NHPI_A",6,0,-6,-200,"undercount"
"8836",40153,"Oklahoma","Woodward County","NHPI_AIC",16,35,19,74.51,"overcount"
"8837",41001,"Oregon","Baker County","A_A",121,64,-57,-61.62,"undercount"
"8838",41001,"Oregon","Baker County","A_AIC",224,142,-82,-44.81,"undercount"
"8839",41001,"Oregon","Baker County","NHPI_A",19,15,-4,-23.53,"undercount"
"8840",41001,"Oregon","Baker County","NHPI_AIC",47,53,6,12,"overcount"
"8841",41003,"Oregon","Benton County","A_A",6252,6422,170,2.68,"overcount"
"8842",41003,"Oregon","Benton County","A_AIC",8029,8363,334,4.08,"overcount"
"8843",41003,"Oregon","Benton County","NHPI_A",242,283,41,15.62,"overcount"
"8844",41003,"Oregon","Benton County","NHPI_AIC",613,695,82,12.54,"overcount"
"8845",41005,"Oregon","Clackamas County","A_A",20748,20600,-148,-0.72,"undercount"
"8846",41005,"Oregon","Clackamas County","A_AIC",27519,28820,1301,4.62,"overcount"
"8847",41005,"Oregon","Clackamas County","NHPI_A",1141,1073,-68,-6.14,"undercount"
"8848",41005,"Oregon","Clackamas County","NHPI_AIC",2592,2783,191,7.11,"overcount"
"8849",41007,"Oregon","Clatsop County","A_A",622,555,-67,-11.38,"undercount"
"8850",41007,"Oregon","Clatsop County","A_AIC",987,1023,36,3.58,"overcount"
"8851",41007,"Oregon","Clatsop County","NHPI_A",115,91,-24,-23.3,"undercount"
"8852",41007,"Oregon","Clatsop County","NHPI_AIC",218,245,27,11.66,"overcount"
"8853",41009,"Oregon","Columbia County","A_A",523,563,40,7.37,"overcount"
"8854",41009,"Oregon","Columbia County","A_AIC",1165,1255,90,7.44,"overcount"
"8855",41009,"Oregon","Columbia County","NHPI_A",129,117,-12,-9.76,"undercount"
"8856",41009,"Oregon","Columbia County","NHPI_AIC",272,298,26,9.12,"overcount"
"8857",41011,"Oregon","Coos County","A_A",748,739,-9,-1.21,"undercount"
"8858",41011,"Oregon","Coos County","A_AIC",1311,1325,14,1.06,"overcount"
"8859",41011,"Oregon","Coos County","NHPI_A",152,120,-32,-23.53,"undercount"
"8860",41011,"Oregon","Coos County","NHPI_AIC",337,345,8,2.35,"overcount"
"8861",41013,"Oregon","Crook County","A_A",148,114,-34,-25.95,"undercount"
"8862",41013,"Oregon","Crook County","A_AIC",245,260,15,5.94,"overcount"
"8863",41013,"Oregon","Crook County","NHPI_A",26,28,2,7.41,"overcount"
"8864",41013,"Oregon","Crook County","NHPI_AIC",58,79,21,30.66,"overcount"
"8865",41015,"Oregon","Curry County","A_A",216,218,2,0.92,"overcount"
"8866",41015,"Oregon","Curry County","A_AIC",333,407,74,20,"overcount"
"8867",41015,"Oregon","Curry County","NHPI_A",34,28,-6,-19.35,"undercount"
"8868",41015,"Oregon","Curry County","NHPI_AIC",91,74,-17,-20.61,"undercount"
"8869",41017,"Oregon","Deschutes County","A_A",2475,2466,-9,-0.36,"undercount"
"8870",41017,"Oregon","Deschutes County","A_AIC",4402,5137,735,15.41,"overcount"
"8871",41017,"Oregon","Deschutes County","NHPI_A",242,264,22,8.7,"overcount"
"8872",41017,"Oregon","Deschutes County","NHPI_AIC",793,1008,215,23.88,"overcount"
"8873",41019,"Oregon","Douglas County","A_A",1191,1217,26,2.16,"overcount"
"8874",41019,"Oregon","Douglas County","A_AIC",2110,2133,23,1.08,"overcount"
"8875",41019,"Oregon","Douglas County","NHPI_A",171,151,-20,-12.42,"undercount"
"8876",41019,"Oregon","Douglas County","NHPI_AIC",484,540,56,10.94,"overcount"
"8877",41021,"Oregon","Gilliam County","A_A",17,6,-11,-95.65,"undercount"
"8878",41021,"Oregon","Gilliam County","A_AIC",24,20,-4,-18.18,"undercount"
"8879",41021,"Oregon","Gilliam County","NHPI_A",10,9,-1,-10.53,"undercount"
"8880",41021,"Oregon","Gilliam County","NHPI_AIC",13,21,8,47.06,"overcount"
"8881",41023,"Oregon","Grant County","A_A",43,23,-20,-60.61,"undercount"
"8882",41023,"Oregon","Grant County","A_AIC",73,49,-24,-39.34,"undercount"
"8883",41023,"Oregon","Grant County","NHPI_A",9,10,1,10.53,"overcount"
"8884",41023,"Oregon","Grant County","NHPI_AIC",26,23,-3,-12.24,"undercount"
"8885",41025,"Oregon","Harney County","A_A",41,36,-5,-12.99,"undercount"
"8886",41025,"Oregon","Harney County","A_AIC",90,90,0,0,"equal"
"8887",41025,"Oregon","Harney County","NHPI_A",1,0,-1,-200,"undercount"
"8888",41025,"Oregon","Harney County","NHPI_AIC",17,24,7,34.15,"overcount"
"8889",41027,"Oregon","Hood River County","A_A",373,381,8,2.12,"overcount"
"8890",41027,"Oregon","Hood River County","A_AIC",577,712,135,20.95,"overcount"
"8891",41027,"Oregon","Hood River County","NHPI_A",38,35,-3,-8.22,"undercount"
"8892",41027,"Oregon","Hood River County","NHPI_AIC",89,103,14,14.58,"overcount"
"8893",41029,"Oregon","Jackson County","A_A",3277,3382,105,3.15,"overcount"
"8894",41029,"Oregon","Jackson County","A_AIC",5266,5927,661,11.81,"overcount"
"8895",41029,"Oregon","Jackson County","NHPI_A",618,812,194,27.13,"overcount"
"8896",41029,"Oregon","Jackson County","NHPI_AIC",1303,1587,284,19.65,"overcount"
"8897",41031,"Oregon","Jefferson County","A_A",175,136,-39,-25.08,"undercount"
"8898",41031,"Oregon","Jefferson County","A_AIC",304,314,10,3.24,"overcount"
"8899",41031,"Oregon","Jefferson County","NHPI_A",40,18,-22,-75.86,"undercount"
"8900",41031,"Oregon","Jefferson County","NHPI_AIC",116,94,-22,-20.95,"undercount"
"8901",41033,"Oregon","Josephine County","A_A",859,881,22,2.53,"overcount"
"8902",41033,"Oregon","Josephine County","A_AIC",1538,1812,274,16.36,"overcount"
"8903",41033,"Oregon","Josephine County","NHPI_A",176,124,-52,-34.67,"undercount"
"8904",41033,"Oregon","Josephine County","NHPI_AIC",402,477,75,17.06,"overcount"
"8905",41035,"Oregon","Klamath County","A_A",715,779,64,8.57,"overcount"
"8906",41035,"Oregon","Klamath County","A_AIC",1204,1451,247,18.61,"overcount"
"8907",41035,"Oregon","Klamath County","NHPI_A",108,104,-4,-3.77,"undercount"
"8908",41035,"Oregon","Klamath County","NHPI_AIC",277,338,61,19.84,"overcount"
"8909",41037,"Oregon","Lake County","A_A",86,65,-21,-27.81,"undercount"
"8910",41037,"Oregon","Lake County","A_AIC",129,129,0,0,"equal"
"8911",41037,"Oregon","Lake County","NHPI_A",9,10,1,10.53,"overcount"
"8912",41037,"Oregon","Lake County","NHPI_AIC",33,52,19,44.71,"overcount"
"8913",41039,"Oregon","Lane County","A_A",11599,9614,-1985,-18.71,"undercount"
"8914",41039,"Oregon","Lane County","A_AIC",17231,16052,-1179,-7.08,"undercount"
"8915",41039,"Oregon","Lane County","NHPI_A",869,972,103,11.19,"overcount"
"8916",41039,"Oregon","Lane County","NHPI_AIC",2170,2604,434,18.18,"overcount"
"8917",41041,"Oregon","Lincoln County","A_A",665,653,-12,-1.82,"undercount"
"8918",41041,"Oregon","Lincoln County","A_AIC",1067,1176,109,9.72,"overcount"
"8919",41041,"Oregon","Lincoln County","NHPI_A",93,96,3,3.17,"overcount"
"8920",41041,"Oregon","Lincoln County","NHPI_AIC",216,285,69,27.54,"overcount"
"8921",41043,"Oregon","Linn County","A_A",1533,1447,-86,-5.77,"undercount"
"8922",41043,"Oregon","Linn County","A_AIC",2705,2655,-50,-1.87,"undercount"
"8923",41043,"Oregon","Linn County","NHPI_A",241,280,39,14.97,"overcount"
"8924",41043,"Oregon","Linn County","NHPI_AIC",592,746,154,23.02,"overcount"
"8925",41045,"Oregon","Malheur County","A_A",417,397,-20,-4.91,"undercount"
"8926",41045,"Oregon","Malheur County","A_AIC",606,597,-9,-1.5,"undercount"
"8927",41045,"Oregon","Malheur County","NHPI_A",20,40,20,66.67,"overcount"
"8928",41045,"Oregon","Malheur County","NHPI_AIC",53,64,11,18.8,"overcount"
"8929",41047,"Oregon","Marion County","A_A",8046,7391,-655,-8.49,"undercount"
"8930",41047,"Oregon","Marion County","A_AIC",11512,11293,-219,-1.92,"undercount"
"8931",41047,"Oregon","Marion County","NHPI_A",3576,3678,102,2.81,"overcount"
"8932",41047,"Oregon","Marion County","NHPI_AIC",4683,4980,297,6.15,"overcount"
"8933",41049,"Oregon","Morrow County","A_A",72,30,-42,-82.35,"undercount"
"8934",41049,"Oregon","Morrow County","A_AIC",120,87,-33,-31.88,"undercount"
"8935",41049,"Oregon","Morrow County","NHPI_A",30,5,-25,-142.86,"undercount"
"8936",41049,"Oregon","Morrow County","NHPI_AIC",52,30,-22,-53.66,"undercount"
"8937",41051,"Oregon","Multnomah County","A_A",64879,61842,-3037,-4.79,"undercount"
"8938",41051,"Oregon","Multnomah County","A_AIC",79983,81285,1302,1.61,"overcount"
"8939",41051,"Oregon","Multnomah County","NHPI_A",5247,5339,92,1.74,"overcount"
"8940",41051,"Oregon","Multnomah County","NHPI_AIC",8465,8848,383,4.42,"overcount"
"8941",41053,"Oregon","Polk County","A_A",1747,1730,-17,-0.98,"undercount"
"8942",41053,"Oregon","Polk County","A_AIC",2899,2932,33,1.13,"overcount"
"8943",41053,"Oregon","Polk County","NHPI_A",378,345,-33,-9.13,"undercount"
"8944",41053,"Oregon","Polk County","NHPI_AIC",734,722,-12,-1.65,"undercount"
"8945",41055,"Oregon","Sherman County","A_A",14,11,-3,-24,"undercount"
"8946",41055,"Oregon","Sherman County","A_AIC",25,38,13,41.27,"overcount"
"8947",41055,"Oregon","Sherman County","NHPI_A",1,0,-1,-200,"undercount"
"8948",41055,"Oregon","Sherman County","NHPI_AIC",4,13,9,105.88,"overcount"
"8949",41057,"Oregon","Tillamook County","A_A",268,280,12,4.38,"overcount"
"8950",41057,"Oregon","Tillamook County","A_AIC",469,516,47,9.54,"overcount"
"8951",41057,"Oregon","Tillamook County","NHPI_A",83,89,6,6.98,"overcount"
"8952",41057,"Oregon","Tillamook County","NHPI_AIC",178,209,31,16.02,"overcount"
"8953",41059,"Oregon","Umatilla County","A_A",717,717,0,0,"equal"
"8954",41059,"Oregon","Umatilla County","A_AIC",1144,1187,43,3.69,"overcount"
"8955",41059,"Oregon","Umatilla County","NHPI_A",125,138,13,9.89,"overcount"
"8956",41059,"Oregon","Umatilla County","NHPI_AIC",250,293,43,15.84,"overcount"
"8957",41061,"Oregon","Union County","A_A",309,218,-91,-34.54,"undercount"
"8958",41061,"Oregon","Union County","A_AIC",502,412,-90,-19.69,"undercount"
"8959",41061,"Oregon","Union County","NHPI_A",383,496,113,25.71,"overcount"
"8960",41061,"Oregon","Union County","NHPI_AIC",447,597,150,28.74,"overcount"
"8961",41063,"Oregon","Wallowa County","A_A",32,32,0,0,"equal"
"8962",41063,"Oregon","Wallowa County","A_AIC",68,80,12,16.22,"overcount"
"8963",41063,"Oregon","Wallowa County","NHPI_A",9,4,-5,-76.92,"undercount"
"8964",41063,"Oregon","Wallowa County","NHPI_AIC",25,29,4,14.81,"overcount"
"8965",41065,"Oregon","Wasco County","A_A",258,248,-10,-3.95,"undercount"
"8966",41065,"Oregon","Wasco County","A_AIC",434,455,21,4.72,"overcount"
"8967",41065,"Oregon","Wasco County","NHPI_A",184,226,42,20.49,"overcount"
"8968",41065,"Oregon","Wasco County","NHPI_AIC",226,356,130,44.67,"overcount"
"8969",41067,"Oregon","Washington County","A_A",70801,69011,-1790,-2.56,"undercount"
"8970",41067,"Oregon","Washington County","A_AIC",84144,84606,462,0.55,"overcount"
"8971",41067,"Oregon","Washington County","NHPI_A",2953,3293,340,10.89,"overcount"
"8972",41067,"Oregon","Washington County","NHPI_AIC",5989,6741,752,11.81,"overcount"
"8973",41069,"Oregon","Wheeler County","A_A",11,8,-3,-31.58,"undercount"
"8974",41069,"Oregon","Wheeler County","A_AIC",19,28,9,38.3,"overcount"
"8975",41069,"Oregon","Wheeler County","NHPI_A",3,0,-3,-200,"undercount"
"8976",41069,"Oregon","Wheeler County","NHPI_AIC",6,14,8,80,"overcount"
"8977",41071,"Oregon","Yamhill County","A_A",1863,1545,-318,-18.66,"undercount"
"8978",41071,"Oregon","Yamhill County","A_AIC",3010,2926,-84,-2.83,"undercount"
"8979",41071,"Oregon","Yamhill County","NHPI_A",226,196,-30,-14.22,"undercount"
"8980",41071,"Oregon","Yamhill County","NHPI_AIC",521,593,72,12.93,"overcount"
"8981",42001,"Pennsylvania","Adams County","A_A",850,965,115,12.67,"overcount"
"8982",42001,"Pennsylvania","Adams County","A_AIC",1210,1427,217,16.46,"overcount"
"8983",42001,"Pennsylvania","Adams County","NHPI_A",41,33,-8,-21.62,"undercount"
"8984",42001,"Pennsylvania","Adams County","NHPI_AIC",85,107,22,22.92,"overcount"
"8985",42003,"Pennsylvania","Allegheny County","A_A",51843,58988,7145,12.89,"overcount"
"8986",42003,"Pennsylvania","Allegheny County","A_AIC",59204,68865,9661,15.09,"overcount"
"8987",42003,"Pennsylvania","Allegheny County","NHPI_A",312,328,16,5,"overcount"
"8988",42003,"Pennsylvania","Allegheny County","NHPI_AIC",929,1178,249,23.64,"overcount"
"8989",42005,"Pennsylvania","Armstrong County","A_A",176,150,-26,-15.95,"undercount"
"8990",42005,"Pennsylvania","Armstrong County","A_AIC",279,269,-10,-3.65,"undercount"
"8991",42005,"Pennsylvania","Armstrong County","NHPI_A",7,14,7,66.67,"overcount"
"8992",42005,"Pennsylvania","Armstrong County","NHPI_AIC",26,47,21,57.53,"overcount"
"8993",42007,"Pennsylvania","Beaver County","A_A",924,1025,101,10.36,"overcount"
"8994",42007,"Pennsylvania","Beaver County","A_AIC",1435,1639,204,13.27,"overcount"
"8995",42007,"Pennsylvania","Beaver County","NHPI_A",53,53,0,0,"equal"
"8996",42007,"Pennsylvania","Beaver County","NHPI_AIC",147,155,8,5.3,"overcount"
"8997",42009,"Pennsylvania","Bedford County","A_A",201,155,-46,-25.84,"undercount"
"8998",42009,"Pennsylvania","Bedford County","A_AIC",291,246,-45,-16.76,"undercount"
"8999",42009,"Pennsylvania","Bedford County","NHPI_A",5,0,-5,-200,"undercount"
"9000",42009,"Pennsylvania","Bedford County","NHPI_AIC",18,10,-8,-57.14,"undercount"
"9001",42011,"Pennsylvania","Berks County","A_A",6085,6323,238,3.84,"overcount"
"9002",42011,"Pennsylvania","Berks County","A_AIC",7425,8230,805,10.28,"overcount"
"9003",42011,"Pennsylvania","Berks County","NHPI_A",110,68,-42,-47.19,"undercount"
"9004",42011,"Pennsylvania","Berks County","NHPI_AIC",344,351,7,2.01,"overcount"
"9005",42013,"Pennsylvania","Blair County","A_A",809,868,59,7.04,"overcount"
"9006",42013,"Pennsylvania","Blair County","A_AIC",1169,1271,102,8.36,"overcount"
"9007",42013,"Pennsylvania","Blair County","NHPI_A",27,12,-15,-76.92,"undercount"
"9008",42013,"Pennsylvania","Blair County","NHPI_AIC",73,101,28,32.18,"overcount"
"9009",42015,"Pennsylvania","Bradford County","A_A",415,478,63,14.11,"overcount"
"9010",42015,"Pennsylvania","Bradford County","A_AIC",570,633,63,10.47,"overcount"
"9011",42015,"Pennsylvania","Bradford County","NHPI_A",12,13,1,8,"overcount"
"9012",42015,"Pennsylvania","Bradford County","NHPI_AIC",27,61,34,77.27,"overcount"
"9013",42017,"Pennsylvania","Bucks County","A_A",33572,35386,1814,5.26,"overcount"
"9014",42017,"Pennsylvania","Bucks County","A_AIC",37698,41093,3395,8.62,"overcount"
"9015",42017,"Pennsylvania","Bucks County","NHPI_A",216,162,-54,-28.57,"undercount"
"9016",42017,"Pennsylvania","Bucks County","NHPI_AIC",518,577,59,10.78,"overcount"
"9017",42019,"Pennsylvania","Butler County","A_A",2854,2822,-32,-1.13,"undercount"
"9018",42019,"Pennsylvania","Butler County","A_AIC",3587,3787,200,5.42,"overcount"
"9019",42019,"Pennsylvania","Butler County","NHPI_A",56,36,-20,-43.48,"undercount"
"9020",42019,"Pennsylvania","Butler County","NHPI_AIC",119,132,13,10.36,"overcount"
"9021",42021,"Pennsylvania","Cambria County","A_A",670,787,117,16.06,"overcount"
"9022",42021,"Pennsylvania","Cambria County","A_AIC",1004,1120,116,10.92,"overcount"
"9023",42021,"Pennsylvania","Cambria County","NHPI_A",67,35,-32,-62.75,"undercount"
"9024",42021,"Pennsylvania","Cambria County","NHPI_AIC",139,109,-30,-24.19,"undercount"
"9025",42023,"Pennsylvania","Cameron County","A_A",20,30,10,40,"overcount"
"9026",42023,"Pennsylvania","Cameron County","A_AIC",31,42,11,30.14,"overcount"
"9027",42023,"Pennsylvania","Cameron County","NHPI_A",0,0,0,0,"equal"
"9028",42023,"Pennsylvania","Cameron County","NHPI_AIC",1,5,4,133.33,"overcount"
"9029",42025,"Pennsylvania","Carbon County","A_A",360,367,7,1.93,"overcount"
"9030",42025,"Pennsylvania","Carbon County","A_AIC",520,592,72,12.95,"overcount"
"9031",42025,"Pennsylvania","Carbon County","NHPI_A",36,14,-22,-88,"undercount"
"9032",42025,"Pennsylvania","Carbon County","NHPI_AIC",62,42,-20,-38.46,"undercount"
"9033",42027,"Pennsylvania","Centre County","A_A",10037,11528,1491,13.83,"overcount"
"9034",42027,"Pennsylvania","Centre County","A_AIC",11245,13338,2093,17.03,"overcount"
"9035",42027,"Pennsylvania","Centre County","NHPI_A",110,39,-71,-95.3,"undercount"
"9036",42027,"Pennsylvania","Centre County","NHPI_AIC",213,325,112,41.64,"overcount"
"9037",42029,"Pennsylvania","Chester County","A_A",33987,35426,1439,4.15,"overcount"
"9038",42029,"Pennsylvania","Chester County","A_AIC",37247,40059,2812,7.27,"overcount"
"9039",42029,"Pennsylvania","Chester County","NHPI_A",175,132,-43,-28.01,"undercount"
"9040",42029,"Pennsylvania","Chester County","NHPI_AIC",457,468,11,2.38,"overcount"
"9041",42031,"Pennsylvania","Clarion County","A_A",273,175,-98,-43.75,"undercount"
"9042",42031,"Pennsylvania","Clarion County","A_AIC",364,276,-88,-27.5,"undercount"
"9043",42031,"Pennsylvania","Clarion County","NHPI_A",5,15,10,100,"overcount"
"9044",42031,"Pennsylvania","Clarion County","NHPI_AIC",28,29,1,3.51,"overcount"
"9045",42033,"Pennsylvania","Clearfield County","A_A",474,452,-22,-4.75,"undercount"
"9046",42033,"Pennsylvania","Clearfield County","A_AIC",667,638,-29,-4.44,"undercount"
"9047",42033,"Pennsylvania","Clearfield County","NHPI_A",13,0,-13,-200,"undercount"
"9048",42033,"Pennsylvania","Clearfield County","NHPI_AIC",52,25,-27,-70.13,"undercount"
"9049",42035,"Pennsylvania","Clinton County","A_A",264,215,-49,-20.46,"undercount"
"9050",42035,"Pennsylvania","Clinton County","A_AIC",354,367,13,3.61,"overcount"
"9051",42035,"Pennsylvania","Clinton County","NHPI_A",21,9,-12,-80,"undercount"
"9052",42035,"Pennsylvania","Clinton County","NHPI_AIC",31,43,12,32.43,"overcount"
"9053",42037,"Pennsylvania","Columbia County","A_A",715,770,55,7.41,"overcount"
"9054",42037,"Pennsylvania","Columbia County","A_AIC",870,1053,183,19.03,"overcount"
"9055",42037,"Pennsylvania","Columbia County","NHPI_A",14,17,3,19.35,"overcount"
"9056",42037,"Pennsylvania","Columbia County","NHPI_AIC",49,51,2,4,"overcount"
"9057",42039,"Pennsylvania","Crawford County","A_A",497,375,-122,-27.98,"undercount"
"9058",42039,"Pennsylvania","Crawford County","A_AIC",685,580,-105,-16.6,"undercount"
"9059",42039,"Pennsylvania","Crawford County","NHPI_A",19,32,13,50.98,"overcount"
"9060",42039,"Pennsylvania","Crawford County","NHPI_AIC",52,60,8,14.29,"overcount"
"9061",42041,"Pennsylvania","Cumberland County","A_A",12846,13985,1139,8.49,"overcount"
"9062",42041,"Pennsylvania","Cumberland County","A_AIC",14699,16233,1534,9.92,"overcount"
"9063",42041,"Pennsylvania","Cumberland County","NHPI_A",102,118,16,14.55,"overcount"
"9064",42041,"Pennsylvania","Cumberland County","NHPI_AIC",277,353,76,24.13,"overcount"
"9065",42043,"Pennsylvania","Dauphin County","A_A",16298,17341,1043,6.2,"overcount"
"9066",42043,"Pennsylvania","Dauphin County","A_AIC",17848,19329,1481,7.97,"overcount"
"9067",42043,"Pennsylvania","Dauphin County","NHPI_A",94,93,-1,-1.07,"undercount"
"9068",42043,"Pennsylvania","Dauphin County","NHPI_AIC",323,319,-4,-1.25,"undercount"
"9069",42045,"Pennsylvania","Delaware County","A_A",35885,36683,798,2.2,"overcount"
"9070",42045,"Pennsylvania","Delaware County","A_AIC",39890,41651,1761,4.32,"overcount"
"9071",42045,"Pennsylvania","Delaware County","NHPI_A",176,144,-32,-20,"undercount"
"9072",42045,"Pennsylvania","Delaware County","NHPI_AIC",589,567,-22,-3.81,"undercount"
"9073",42047,"Pennsylvania","Elk County","A_A",112,113,1,0.89,"overcount"
"9074",42047,"Pennsylvania","Elk County","A_AIC",177,184,7,3.88,"overcount"
"9075",42047,"Pennsylvania","Elk County","NHPI_A",6,12,6,66.67,"overcount"
"9076",42047,"Pennsylvania","Elk County","NHPI_AIC",22,34,12,42.86,"overcount"
"9077",42049,"Pennsylvania","Erie County","A_A",5399,6407,1008,17.08,"overcount"
"9078",42049,"Pennsylvania","Erie County","A_AIC",6532,7898,1366,18.93,"overcount"
"9079",42049,"Pennsylvania","Erie County","NHPI_A",96,62,-34,-43.04,"undercount"
"9080",42049,"Pennsylvania","Erie County","NHPI_AIC",272,211,-61,-25.26,"undercount"
"9081",42051,"Pennsylvania","Fayette County","A_A",509,383,-126,-28.25,"undercount"
"9082",42051,"Pennsylvania","Fayette County","A_AIC",768,662,-106,-14.83,"undercount"
"9083",42051,"Pennsylvania","Fayette County","NHPI_A",227,165,-62,-31.63,"undercount"
"9084",42051,"Pennsylvania","Fayette County","NHPI_AIC",284,229,-55,-21.44,"undercount"
"9085",42053,"Pennsylvania","Forest County","A_A",13,17,4,26.67,"overcount"
"9086",42053,"Pennsylvania","Forest County","A_AIC",18,37,19,69.09,"overcount"
"9087",42053,"Pennsylvania","Forest County","NHPI_A",1,0,-1,-200,"undercount"
"9088",42053,"Pennsylvania","Forest County","NHPI_AIC",4,11,7,93.33,"overcount"
"9089",42055,"Pennsylvania","Franklin County","A_A",1597,1434,-163,-10.76,"undercount"
"9090",42055,"Pennsylvania","Franklin County","A_AIC",2190,2054,-136,-6.41,"undercount"
"9091",42055,"Pennsylvania","Franklin County","NHPI_A",40,41,1,2.47,"overcount"
"9092",42055,"Pennsylvania","Franklin County","NHPI_AIC",138,130,-8,-5.97,"undercount"
"9093",42057,"Pennsylvania","Fulton County","A_A",35,41,6,15.79,"overcount"
"9094",42057,"Pennsylvania","Fulton County","A_AIC",56,88,32,44.44,"overcount"
"9095",42057,"Pennsylvania","Fulton County","NHPI_A",1,3,2,100,"overcount"
"9096",42057,"Pennsylvania","Fulton County","NHPI_AIC",6,23,17,117.24,"overcount"
"9097",42059,"Pennsylvania","Greene County","A_A",122,125,3,2.43,"overcount"
"9098",42059,"Pennsylvania","Greene County","A_AIC",192,271,79,34.13,"overcount"
"9099",42059,"Pennsylvania","Greene County","NHPI_A",8,6,-2,-28.57,"undercount"
"9100",42059,"Pennsylvania","Greene County","NHPI_AIC",23,42,19,58.46,"overcount"
"9101",42061,"Pennsylvania","Huntingdon County","A_A",330,241,-89,-31.17,"undercount"
"9102",42061,"Pennsylvania","Huntingdon County","A_AIC",434,328,-106,-27.82,"undercount"
"9103",42061,"Pennsylvania","Huntingdon County","NHPI_A",4,9,5,76.92,"overcount"
"9104",42061,"Pennsylvania","Huntingdon County","NHPI_AIC",24,24,0,0,"equal"
"9105",42063,"Pennsylvania","Indiana County","A_A",867,825,-42,-4.96,"undercount"
"9106",42063,"Pennsylvania","Indiana County","A_AIC",1086,1092,6,0.55,"overcount"
"9107",42063,"Pennsylvania","Indiana County","NHPI_A",9,7,-2,-25,"undercount"
"9108",42063,"Pennsylvania","Indiana County","NHPI_AIC",50,42,-8,-17.39,"undercount"
"9109",42065,"Pennsylvania","Jefferson County","A_A",124,100,-24,-21.43,"undercount"
"9110",42065,"Pennsylvania","Jefferson County","A_AIC",214,205,-9,-4.3,"undercount"
"9111",42065,"Pennsylvania","Jefferson County","NHPI_A",6,8,2,28.57,"overcount"
"9112",42065,"Pennsylvania","Jefferson County","NHPI_AIC",21,32,11,41.51,"overcount"
"9113",42067,"Pennsylvania","Juniata County","A_A",110,69,-41,-45.81,"undercount"
"9114",42067,"Pennsylvania","Juniata County","A_AIC",154,122,-32,-23.19,"undercount"
"9115",42067,"Pennsylvania","Juniata County","NHPI_A",0,4,4,200,"overcount"
"9116",42067,"Pennsylvania","Juniata County","NHPI_AIC",13,14,1,7.41,"overcount"
"9117",42069,"Pennsylvania","Lackawanna County","A_A",6444,6818,374,5.64,"overcount"
"9118",42069,"Pennsylvania","Lackawanna County","A_AIC",7297,7853,556,7.34,"overcount"
"9119",42069,"Pennsylvania","Lackawanna County","NHPI_A",62,37,-25,-50.51,"undercount"
"9120",42069,"Pennsylvania","Lackawanna County","NHPI_AIC",180,186,6,3.28,"overcount"
"9121",42071,"Pennsylvania","Lancaster County","A_A",13683,14123,440,3.16,"overcount"
"9122",42071,"Pennsylvania","Lancaster County","A_AIC",15635,17009,1374,8.42,"overcount"
"9123",42071,"Pennsylvania","Lancaster County","NHPI_A",163,136,-27,-18.06,"undercount"
"9124",42071,"Pennsylvania","Lancaster County","NHPI_AIC",411,454,43,9.94,"overcount"
"9125",42073,"Pennsylvania","Lawrence County","A_A",369,329,-40,-11.46,"undercount"
"9126",42073,"Pennsylvania","Lawrence County","A_AIC",641,629,-12,-1.89,"undercount"
"9127",42073,"Pennsylvania","Lawrence County","NHPI_A",16,4,-12,-120,"undercount"
"9128",42073,"Pennsylvania","Lawrence County","NHPI_AIC",72,31,-41,-79.61,"undercount"
"9129",42075,"Pennsylvania","Lebanon County","A_A",2268,2242,-26,-1.15,"undercount"
"9130",42075,"Pennsylvania","Lebanon County","A_AIC",2661,2833,172,6.26,"overcount"
"9131",42075,"Pennsylvania","Lebanon County","NHPI_A",70,43,-27,-47.79,"undercount"
"9132",42075,"Pennsylvania","Lebanon County","NHPI_AIC",134,125,-9,-6.95,"undercount"
"9133",42077,"Pennsylvania","Lehigh County","A_A",13650,13844,194,1.41,"overcount"
"9134",42077,"Pennsylvania","Lehigh County","A_AIC",15326,16028,702,4.48,"overcount"
"9135",42077,"Pennsylvania","Lehigh County","NHPI_A",118,101,-17,-15.53,"undercount"
"9136",42077,"Pennsylvania","Lehigh County","NHPI_AIC",351,239,-112,-37.97,"undercount"
"9137",42079,"Pennsylvania","Luzerne County","A_A",4063,3968,-95,-2.37,"undercount"
"9138",42079,"Pennsylvania","Luzerne County","A_AIC",5013,5147,134,2.64,"overcount"
"9139",42079,"Pennsylvania","Luzerne County","NHPI_A",68,69,1,1.46,"overcount"
"9140",42079,"Pennsylvania","Luzerne County","NHPI_AIC",218,261,43,17.95,"overcount"
"9141",42081,"Pennsylvania","Lycoming County","A_A",834,931,97,10.99,"overcount"
"9142",42081,"Pennsylvania","Lycoming County","A_AIC",1179,1396,217,16.85,"overcount"
"9143",42081,"Pennsylvania","Lycoming County","NHPI_A",38,27,-11,-33.85,"undercount"
"9144",42081,"Pennsylvania","Lycoming County","NHPI_AIC",106,107,1,0.94,"overcount"
"9145",42083,"Pennsylvania","McKean County","A_A",257,196,-61,-26.93,"undercount"
"9146",42083,"Pennsylvania","McKean County","A_AIC",369,322,-47,-13.6,"undercount"
"9147",42083,"Pennsylvania","McKean County","NHPI_A",3,2,-1,-40,"undercount"
"9148",42083,"Pennsylvania","McKean County","NHPI_AIC",21,30,9,35.29,"overcount"
"9149",42085,"Pennsylvania","Mercer County","A_A",805,686,-119,-15.96,"undercount"
"9150",42085,"Pennsylvania","Mercer County","A_AIC",1125,1044,-81,-7.47,"undercount"
"9151",42085,"Pennsylvania","Mercer County","NHPI_A",26,14,-12,-60,"undercount"
"9152",42085,"Pennsylvania","Mercer County","NHPI_AIC",90,90,0,0,"equal"
"9153",42087,"Pennsylvania","Mifflin County","A_A",245,163,-82,-40.2,"undercount"
"9154",42087,"Pennsylvania","Mifflin County","A_AIC",369,317,-52,-15.16,"undercount"
"9155",42087,"Pennsylvania","Mifflin County","NHPI_A",11,0,-11,-200,"undercount"
"9156",42087,"Pennsylvania","Mifflin County","NHPI_AIC",29,15,-14,-63.64,"undercount"
"9157",42089,"Pennsylvania","Monroe County","A_A",4287,4127,-160,-3.8,"undercount"
"9158",42089,"Pennsylvania","Monroe County","A_AIC",5245,5164,-81,-1.56,"undercount"
"9159",42089,"Pennsylvania","Monroe County","NHPI_A",95,97,2,2.08,"overcount"
"9160",42089,"Pennsylvania","Monroe County","NHPI_AIC",243,241,-2,-0.83,"undercount"
"9161",42091,"Pennsylvania","Montgomery County","A_A",67960,68278,318,0.47,"overcount"
"9162",42091,"Pennsylvania","Montgomery County","A_AIC",74433,77120,2687,3.55,"overcount"
"9163",42091,"Pennsylvania","Montgomery County","NHPI_A",308,191,-117,-46.89,"undercount"
"9164",42091,"Pennsylvania","Montgomery County","NHPI_AIC",772,788,16,2.05,"overcount"
"9165",42093,"Pennsylvania","Montour County","A_A",627,668,41,6.33,"overcount"
"9166",42093,"Pennsylvania","Montour County","A_AIC",664,770,106,14.78,"overcount"
"9167",42093,"Pennsylvania","Montour County","NHPI_A",6,1,-5,-142.86,"undercount"
"9168",42093,"Pennsylvania","Montour County","NHPI_AIC",18,29,11,46.81,"overcount"
"9169",42095,"Pennsylvania","Northampton County","A_A",9209,10096,887,9.19,"overcount"
"9170",42095,"Pennsylvania","Northampton County","A_AIC",10744,12120,1376,12.04,"overcount"
"9171",42095,"Pennsylvania","Northampton County","NHPI_A",125,77,-48,-47.52,"undercount"
"9172",42095,"Pennsylvania","Northampton County","NHPI_AIC",306,272,-34,-11.76,"undercount"
"9173",42097,"Pennsylvania","Northumberland County","A_A",400,448,48,11.32,"overcount"
"9174",42097,"Pennsylvania","Northumberland County","A_AIC",588,727,139,21.14,"overcount"
"9175",42097,"Pennsylvania","Northumberland County","NHPI_A",13,24,11,59.46,"overcount"
"9176",42097,"Pennsylvania","Northumberland County","NHPI_AIC",49,74,25,40.65,"overcount"
"9177",42099,"Pennsylvania","Perry County","A_A",231,143,-88,-47.06,"undercount"
"9178",42099,"Pennsylvania","Perry County","A_AIC",330,307,-23,-7.22,"undercount"
"9179",42099,"Pennsylvania","Perry County","NHPI_A",12,4,-8,-100,"undercount"
"9180",42099,"Pennsylvania","Perry County","NHPI_AIC",38,38,0,0,"equal"
"9181",42101,"Pennsylvania","Philadelphia County","A_A",121565,134078,12513,9.79,"overcount"
"9182",42101,"Pennsylvania","Philadelphia County","A_AIC",132034,148568,16534,11.78,"overcount"
"9183",42101,"Pennsylvania","Philadelphia County","NHPI_A",373,648,275,53.87,"overcount"
"9184",42101,"Pennsylvania","Philadelphia County","NHPI_AIC",2095,2046,-49,-2.37,"undercount"
"9185",42103,"Pennsylvania","Pike County","A_A",758,853,95,11.79,"overcount"
"9186",42103,"Pennsylvania","Pike County","A_AIC",980,1171,191,17.76,"overcount"
"9187",42103,"Pennsylvania","Pike County","NHPI_A",12,17,5,34.48,"overcount"
"9188",42103,"Pennsylvania","Pike County","NHPI_AIC",70,57,-13,-20.47,"undercount"
"9189",42105,"Pennsylvania","Potter County","A_A",70,69,-1,-1.44,"undercount"
"9190",42105,"Pennsylvania","Potter County","A_AIC",103,130,27,23.18,"overcount"
"9191",42105,"Pennsylvania","Potter County","NHPI_A",1,0,-1,-200,"undercount"
"9192",42105,"Pennsylvania","Potter County","NHPI_AIC",10,8,-2,-22.22,"undercount"
"9193",42107,"Pennsylvania","Schuylkill County","A_A",738,748,10,1.35,"overcount"
"9194",42107,"Pennsylvania","Schuylkill County","A_AIC",1118,1149,31,2.73,"overcount"
"9195",42107,"Pennsylvania","Schuylkill County","NHPI_A",27,13,-14,-70,"undercount"
"9196",42107,"Pennsylvania","Schuylkill County","NHPI_AIC",92,95,3,3.21,"overcount"
"9197",42109,"Pennsylvania","Snyder County","A_A",265,297,32,11.39,"overcount"
"9198",42109,"Pennsylvania","Snyder County","A_AIC",342,384,42,11.57,"overcount"
"9199",42109,"Pennsylvania","Snyder County","NHPI_A",26,18,-8,-36.36,"undercount"
"9200",42109,"Pennsylvania","Snyder County","NHPI_AIC",43,32,-11,-29.33,"undercount"
"9201",42111,"Pennsylvania","Somerset County","A_A",355,194,-161,-58.65,"undercount"
"9202",42111,"Pennsylvania","Somerset County","A_AIC",498,358,-140,-32.71,"undercount"
"9203",42111,"Pennsylvania","Somerset County","NHPI_A",20,7,-13,-96.3,"undercount"
"9204",42111,"Pennsylvania","Somerset County","NHPI_AIC",44,24,-20,-58.82,"undercount"
"9205",42113,"Pennsylvania","Sullivan County","A_A",26,19,-7,-31.11,"undercount"
"9206",42113,"Pennsylvania","Sullivan County","A_AIC",36,35,-1,-2.82,"undercount"
"9207",42113,"Pennsylvania","Sullivan County","NHPI_A",0,2,2,200,"overcount"
"9208",42113,"Pennsylvania","Sullivan County","NHPI_AIC",0,9,9,200,"overcount"
"9209",42115,"Pennsylvania","Susquehanna County","A_A",159,137,-22,-14.86,"undercount"
"9210",42115,"Pennsylvania","Susquehanna County","A_AIC",279,261,-18,-6.67,"undercount"
"9211",42115,"Pennsylvania","Susquehanna County","NHPI_A",13,0,-13,-200,"undercount"
"9212",42115,"Pennsylvania","Susquehanna County","NHPI_AIC",22,19,-3,-14.63,"undercount"
"9213",42117,"Pennsylvania","Tioga County","A_A",234,209,-25,-11.29,"undercount"
"9214",42117,"Pennsylvania","Tioga County","A_AIC",324,332,8,2.44,"overcount"
"9215",42117,"Pennsylvania","Tioga County","NHPI_A",7,7,0,0,"equal"
"9216",42117,"Pennsylvania","Tioga County","NHPI_AIC",18,38,20,71.43,"overcount"
"9217",42119,"Pennsylvania","Union County","A_A",721,818,97,12.61,"overcount"
"9218",42119,"Pennsylvania","Union County","A_AIC",906,1100,194,19.34,"overcount"
"9219",42119,"Pennsylvania","Union County","NHPI_A",21,8,-13,-89.66,"undercount"
"9220",42119,"Pennsylvania","Union County","NHPI_AIC",75,32,-43,-80.37,"undercount"
"9221",42121,"Pennsylvania","Venango County","A_A",237,176,-61,-29.54,"undercount"
"9222",42121,"Pennsylvania","Venango County","A_AIC",343,338,-5,-1.47,"undercount"
"9223",42121,"Pennsylvania","Venango County","NHPI_A",19,10,-9,-62.07,"undercount"
"9224",42121,"Pennsylvania","Venango County","NHPI_AIC",43,33,-10,-26.32,"undercount"
"9225",42123,"Pennsylvania","Warren County","A_A",183,158,-25,-14.66,"undercount"
"9226",42123,"Pennsylvania","Warren County","A_AIC",282,299,17,5.85,"overcount"
"9227",42123,"Pennsylvania","Warren County","NHPI_A",15,5,-10,-100,"undercount"
"9228",42123,"Pennsylvania","Warren County","NHPI_AIC",29,25,-4,-14.81,"undercount"
"9229",42125,"Pennsylvania","Washington County","A_A",2369,2035,-334,-15.17,"undercount"
"9230",42125,"Pennsylvania","Washington County","A_AIC",3026,2923,-103,-3.46,"undercount"
"9231",42125,"Pennsylvania","Washington County","NHPI_A",51,63,12,21.05,"overcount"
"9232",42125,"Pennsylvania","Washington County","NHPI_AIC",153,215,62,33.7,"overcount"
"9233",42127,"Pennsylvania","Wayne County","A_A",375,432,57,14.13,"overcount"
"9234",42127,"Pennsylvania","Wayne County","A_AIC",516,640,124,21.45,"overcount"
"9235",42127,"Pennsylvania","Wayne County","NHPI_A",14,0,-14,-200,"undercount"
"9236",42127,"Pennsylvania","Wayne County","NHPI_AIC",44,11,-33,-120,"undercount"
"9237",42129,"Pennsylvania","Westmoreland County","A_A",3433,3327,-106,-3.14,"undercount"
"9238",42129,"Pennsylvania","Westmoreland County","A_AIC",4426,4682,256,5.62,"overcount"
"9239",42129,"Pennsylvania","Westmoreland County","NHPI_A",69,36,-33,-62.86,"undercount"
"9240",42129,"Pennsylvania","Westmoreland County","NHPI_AIC",218,219,1,0.46,"overcount"
"9241",42131,"Pennsylvania","Wyoming County","A_A",142,120,-22,-16.79,"undercount"
"9242",42131,"Pennsylvania","Wyoming County","A_AIC",184,204,20,10.31,"overcount"
"9243",42131,"Pennsylvania","Wyoming County","NHPI_A",3,3,0,0,"equal"
"9244",42131,"Pennsylvania","Wyoming County","NHPI_AIC",10,22,12,75,"overcount"
"9245",42133,"Pennsylvania","York County","A_A",6696,6649,-47,-0.7,"undercount"
"9246",42133,"Pennsylvania","York County","A_AIC",8568,9185,617,6.95,"overcount"
"9247",42133,"Pennsylvania","York County","NHPI_A",169,118,-51,-35.54,"undercount"
"9248",42133,"Pennsylvania","York County","NHPI_AIC",390,404,14,3.53,"overcount"
"9249",44001,"Rhode Island","Bristol County","A_A",1213,1293,80,6.38,"overcount"
"9250",44001,"Rhode Island","Bristol County","A_AIC",1600,1787,187,11.04,"overcount"
"9251",44001,"Rhode Island","Bristol County","NHPI_A",12,8,-4,-40,"undercount"
"9252",44001,"Rhode Island","Bristol County","NHPI_AIC",81,51,-30,-45.45,"undercount"
"9253",44003,"Rhode Island","Kent County","A_A",4750,4898,148,3.07,"overcount"
"9254",44003,"Rhode Island","Kent County","A_AIC",5849,6181,332,5.52,"overcount"
"9255",44003,"Rhode Island","Kent County","NHPI_A",70,47,-23,-39.32,"undercount"
"9256",44003,"Rhode Island","Kent County","NHPI_AIC",201,198,-3,-1.5,"undercount"
"9257",44005,"Rhode Island","Newport County","A_A",1529,1551,22,1.43,"overcount"
"9258",44005,"Rhode Island","Newport County","A_AIC",2252,2506,254,10.68,"overcount"
"9259",44005,"Rhode Island","Newport County","NHPI_A",52,50,-2,-3.92,"undercount"
"9260",44005,"Rhode Island","Newport County","NHPI_AIC",169,210,41,21.64,"overcount"
"9261",44007,"Rhode Island","Providence County","A_A",27206,28500,1294,4.65,"overcount"
"9262",44007,"Rhode Island","Providence County","A_AIC",31056,33138,2082,6.49,"overcount"
"9263",44007,"Rhode Island","Providence County","NHPI_A",514,354,-160,-36.87,"undercount"
"9264",44007,"Rhode Island","Providence County","NHPI_AIC",1224,859,-365,-35.05,"undercount"
"9265",44009,"Rhode Island","Washington County","A_A",2561,2626,65,2.51,"overcount"
"9266",44009,"Rhode Island","Washington County","A_AIC",3320,3604,284,8.2,"overcount"
"9267",44009,"Rhode Island","Washington County","NHPI_A",26,49,23,61.33,"overcount"
"9268",44009,"Rhode Island","Washington County","NHPI_AIC",128,160,32,22.22,"overcount"
"9269",45001,"South Carolina","Abbeville County","A_A",86,74,-12,-15,"undercount"
"9270",45001,"South Carolina","Abbeville County","A_AIC",134,109,-25,-20.58,"undercount"
"9271",45001,"South Carolina","Abbeville County","NHPI_A",6,7,1,15.38,"overcount"
"9272",45001,"South Carolina","Abbeville County","NHPI_AIC",16,24,8,40,"overcount"
"9273",45003,"South Carolina","Aiken County","A_A",2021,1791,-230,-12.07,"undercount"
"9274",45003,"South Carolina","Aiken County","A_AIC",2754,2728,-26,-0.95,"undercount"
"9275",45003,"South Carolina","Aiken County","NHPI_A",77,96,19,21.97,"overcount"
"9276",45003,"South Carolina","Aiken County","NHPI_AIC",203,264,61,26.12,"overcount"
"9277",45005,"South Carolina","Allendale County","A_A",58,17,-41,-109.33,"undercount"
"9278",45005,"South Carolina","Allendale County","A_AIC",69,35,-34,-65.38,"undercount"
"9279",45005,"South Carolina","Allendale County","NHPI_A",3,1,-2,-100,"undercount"
"9280",45005,"South Carolina","Allendale County","NHPI_AIC",7,11,4,44.44,"overcount"
"9281",45007,"South Carolina","Anderson County","A_A",2199,2432,233,10.06,"overcount"
"9282",45007,"South Carolina","Anderson County","A_AIC",2768,3222,454,15.16,"overcount"
"9283",45007,"South Carolina","Anderson County","NHPI_A",54,46,-8,-16,"undercount"
"9284",45007,"South Carolina","Anderson County","NHPI_AIC",155,203,48,26.82,"overcount"
"9285",45009,"South Carolina","Bamberg County","A_A",92,72,-20,-24.39,"undercount"
"9286",45009,"South Carolina","Bamberg County","A_AIC",113,113,0,0,"equal"
"9287",45009,"South Carolina","Bamberg County","NHPI_A",6,2,-4,-100,"undercount"
"9288",45009,"South Carolina","Bamberg County","NHPI_AIC",8,20,12,85.71,"overcount"
"9289",45011,"South Carolina","Barnwell County","A_A",186,161,-25,-14.41,"undercount"
"9290",45011,"South Carolina","Barnwell County","A_AIC",230,196,-34,-15.96,"undercount"
"9291",45011,"South Carolina","Barnwell County","NHPI_A",3,14,11,129.41,"overcount"
"9292",45011,"South Carolina","Barnwell County","NHPI_AIC",14,21,7,40,"overcount"
"9293",45013,"South Carolina","Beaufort County","A_A",2659,2400,-259,-10.24,"undercount"
"9294",45013,"South Carolina","Beaufort County","A_AIC",3647,3516,-131,-3.66,"undercount"
"9295",45013,"South Carolina","Beaufort County","NHPI_A",107,122,15,13.1,"overcount"
"9296",45013,"South Carolina","Beaufort County","NHPI_AIC",290,321,31,10.15,"overcount"
"9297",45015,"South Carolina","Berkeley County","A_A",6213,5434,-779,-13.38,"undercount"
"9298",45015,"South Carolina","Berkeley County","A_AIC",8489,8131,-358,-4.31,"undercount"
"9299",45015,"South Carolina","Berkeley County","NHPI_A",208,181,-27,-13.88,"undercount"
"9300",45015,"South Carolina","Berkeley County","NHPI_AIC",480,569,89,16.97,"overcount"
"9301",45017,"South Carolina","Calhoun County","A_A",52,47,-5,-10.1,"undercount"
"9302",45017,"South Carolina","Calhoun County","A_AIC",85,105,20,21.05,"overcount"
"9303",45017,"South Carolina","Calhoun County","NHPI_A",9,6,-3,-40,"undercount"
"9304",45017,"South Carolina","Calhoun County","NHPI_AIC",15,20,5,28.57,"overcount"
"9305",45019,"South Carolina","Charleston County","A_A",7921,7582,-339,-4.37,"undercount"
"9306",45019,"South Carolina","Charleston County","A_AIC",10117,10775,658,6.3,"overcount"
"9307",45019,"South Carolina","Charleston County","NHPI_A",226,322,96,35.04,"overcount"
"9308",45019,"South Carolina","Charleston County","NHPI_AIC",494,676,182,31.11,"overcount"
"9309",45021,"South Carolina","Cherokee County","A_A",360,346,-14,-3.97,"undercount"
"9310",45021,"South Carolina","Cherokee County","A_AIC",436,434,-2,-0.46,"undercount"
"9311",45021,"South Carolina","Cherokee County","NHPI_A",25,14,-11,-56.41,"undercount"
"9312",45021,"South Carolina","Cherokee County","NHPI_AIC",51,37,-14,-31.82,"undercount"
"9313",45023,"South Carolina","Chester County","A_A",167,146,-21,-13.42,"undercount"
"9314",45023,"South Carolina","Chester County","A_AIC",229,217,-12,-5.38,"undercount"
"9315",45023,"South Carolina","Chester County","NHPI_A",11,14,3,24,"overcount"
"9316",45023,"South Carolina","Chester County","NHPI_AIC",46,32,-14,-35.9,"undercount"
"9317",45025,"South Carolina","Chesterfield County","A_A",259,269,10,3.79,"overcount"
"9318",45025,"South Carolina","Chesterfield County","A_AIC",353,375,22,6.04,"overcount"
"9319",45025,"South Carolina","Chesterfield County","NHPI_A",20,4,-16,-133.33,"undercount"
"9320",45025,"South Carolina","Chesterfield County","NHPI_AIC",66,29,-37,-77.89,"undercount"
"9321",45027,"South Carolina","Clarendon County","A_A",258,225,-33,-13.66,"undercount"
"9322",45027,"South Carolina","Clarendon County","A_AIC",296,271,-25,-8.82,"undercount"
"9323",45027,"South Carolina","Clarendon County","NHPI_A",6,8,2,28.57,"overcount"
"9324",45027,"South Carolina","Clarendon County","NHPI_AIC",21,16,-5,-27.03,"undercount"
"9325",45029,"South Carolina","Colleton County","A_A",162,207,45,24.39,"overcount"
"9326",45029,"South Carolina","Colleton County","A_AIC",246,295,49,18.11,"overcount"
"9327",45029,"South Carolina","Colleton County","NHPI_A",15,16,1,6.45,"overcount"
"9328",45029,"South Carolina","Colleton County","NHPI_AIC",54,44,-10,-20.41,"undercount"
"9329",45031,"South Carolina","Darlington County","A_A",344,297,-47,-14.66,"undercount"
"9330",45031,"South Carolina","Darlington County","A_AIC",459,407,-52,-12.01,"undercount"
"9331",45031,"South Carolina","Darlington County","NHPI_A",9,7,-2,-25,"undercount"
"9332",45031,"South Carolina","Darlington County","NHPI_AIC",57,30,-27,-62.07,"undercount"
"9333",45033,"South Carolina","Dillon County","A_A",153,64,-89,-82.03,"undercount"
"9334",45033,"South Carolina","Dillon County","A_AIC",218,116,-102,-61.08,"undercount"
"9335",45033,"South Carolina","Dillon County","NHPI_A",11,1,-10,-166.67,"undercount"
"9336",45033,"South Carolina","Dillon County","NHPI_AIC",39,43,4,9.76,"overcount"
"9337",45035,"South Carolina","Dorchester County","A_A",3613,3320,-293,-8.45,"undercount"
"9338",45035,"South Carolina","Dorchester County","A_AIC",5079,4982,-97,-1.93,"undercount"
"9339",45035,"South Carolina","Dorchester County","NHPI_A",192,199,7,3.58,"overcount"
"9340",45035,"South Carolina","Dorchester County","NHPI_AIC",381,434,53,13.01,"overcount"
"9341",45037,"South Carolina","Edgefield County","A_A",145,127,-18,-13.24,"undercount"
"9342",45037,"South Carolina","Edgefield County","A_AIC",202,266,64,27.35,"overcount"
"9343",45037,"South Carolina","Edgefield County","NHPI_A",12,6,-6,-66.67,"undercount"
"9344",45037,"South Carolina","Edgefield County","NHPI_AIC",28,26,-2,-7.41,"undercount"
"9345",45039,"South Carolina","Fairfield County","A_A",161,102,-59,-44.87,"undercount"
"9346",45039,"South Carolina","Fairfield County","A_AIC",202,173,-29,-15.47,"undercount"
"9347",45039,"South Carolina","Fairfield County","NHPI_A",2,7,5,111.11,"overcount"
"9348",45039,"South Carolina","Fairfield County","NHPI_AIC",18,47,29,89.23,"overcount"
"9349",45041,"South Carolina","Florence County","A_A",2128,2349,221,9.87,"overcount"
"9350",45041,"South Carolina","Florence County","A_AIC",2467,2775,308,11.75,"overcount"
"9351",45041,"South Carolina","Florence County","NHPI_A",80,48,-32,-50,"undercount"
"9352",45041,"South Carolina","Florence County","NHPI_AIC",158,121,-37,-26.52,"undercount"
"9353",45043,"South Carolina","Georgetown County","A_A",317,260,-57,-19.76,"undercount"
"9354",45043,"South Carolina","Georgetown County","A_AIC",418,392,-26,-6.42,"undercount"
"9355",45043,"South Carolina","Georgetown County","NHPI_A",33,27,-6,-20,"undercount"
"9356",45043,"South Carolina","Georgetown County","NHPI_AIC",71,57,-14,-21.88,"undercount"
"9357",45045,"South Carolina","Greenville County","A_A",14569,12995,-1574,-11.42,"undercount"
"9358",45045,"South Carolina","Greenville County","A_AIC",17378,16567,-811,-4.78,"undercount"
"9359",45045,"South Carolina","Greenville County","NHPI_A",232,402,170,53.63,"overcount"
"9360",45045,"South Carolina","Greenville County","NHPI_AIC",618,832,214,29.52,"overcount"
"9361",45047,"South Carolina","Greenwood County","A_A",864,678,-186,-24.12,"undercount"
"9362",45047,"South Carolina","Greenwood County","A_AIC",1037,945,-92,-9.28,"undercount"
"9363",45047,"South Carolina","Greenwood County","NHPI_A",30,41,11,30.99,"overcount"
"9364",45047,"South Carolina","Greenwood County","NHPI_AIC",73,83,10,12.82,"overcount"
"9365",45049,"South Carolina","Hampton County","A_A",110,100,-10,-9.52,"undercount"
"9366",45049,"South Carolina","Hampton County","A_AIC",157,139,-18,-12.16,"undercount"
"9367",45049,"South Carolina","Hampton County","NHPI_A",8,17,9,72,"overcount"
"9368",45049,"South Carolina","Hampton County","NHPI_AIC",30,33,3,9.52,"overcount"
"9369",45051,"South Carolina","Horry County","A_A",5280,4640,-640,-12.9,"undercount"
"9370",45051,"South Carolina","Horry County","A_AIC",6969,6617,-352,-5.18,"undercount"
"9371",45051,"South Carolina","Horry County","NHPI_A",312,303,-9,-2.93,"undercount"
"9372",45051,"South Carolina","Horry County","NHPI_AIC",528,590,62,11.09,"overcount"
"9373",45053,"South Carolina","Jasper County","A_A",246,187,-59,-27.25,"undercount"
"9374",45053,"South Carolina","Jasper County","A_AIC",312,260,-52,-18.18,"undercount"
"9375",45053,"South Carolina","Jasper County","NHPI_A",15,23,8,42.11,"overcount"
"9376",45053,"South Carolina","Jasper County","NHPI_AIC",49,38,-11,-25.29,"undercount"
"9377",45055,"South Carolina","Kershaw County","A_A",484,427,-57,-12.51,"undercount"
"9378",45055,"South Carolina","Kershaw County","A_AIC",702,725,23,3.22,"overcount"
"9379",45055,"South Carolina","Kershaw County","NHPI_A",33,29,-4,-12.9,"undercount"
"9380",45055,"South Carolina","Kershaw County","NHPI_AIC",95,71,-24,-28.92,"undercount"
"9381",45057,"South Carolina","Lancaster County","A_A",1772,1783,11,0.62,"overcount"
"9382",45057,"South Carolina","Lancaster County","A_AIC",2018,2239,221,10.38,"overcount"
"9383",45057,"South Carolina","Lancaster County","NHPI_A",25,16,-9,-43.9,"undercount"
"9384",45057,"South Carolina","Lancaster County","NHPI_AIC",71,56,-15,-23.62,"undercount"
"9385",45059,"South Carolina","Laurens County","A_A",395,295,-100,-28.99,"undercount"
"9386",45059,"South Carolina","Laurens County","A_AIC",546,481,-65,-12.66,"undercount"
"9387",45059,"South Carolina","Laurens County","NHPI_A",39,29,-10,-29.41,"undercount"
"9388",45059,"South Carolina","Laurens County","NHPI_AIC",77,64,-13,-18.44,"undercount"
"9389",45061,"South Carolina","Lee County","A_A",76,34,-42,-76.36,"undercount"
"9390",45061,"South Carolina","Lee County","A_AIC",113,64,-49,-55.37,"undercount"
"9391",45061,"South Carolina","Lee County","NHPI_A",3,0,-3,-200,"undercount"
"9392",45061,"South Carolina","Lee County","NHPI_AIC",13,17,4,26.67,"overcount"
"9393",45063,"South Carolina","Lexington County","A_A",6959,6705,-254,-3.72,"undercount"
"9394",45063,"South Carolina","Lexington County","A_AIC",8252,8689,437,5.16,"overcount"
"9395",45063,"South Carolina","Lexington County","NHPI_A",243,195,-48,-21.92,"undercount"
"9396",45063,"South Carolina","Lexington County","NHPI_AIC",432,418,-14,-3.29,"undercount"
"9397",45065,"South Carolina","McCormick County","A_A",56,36,-20,-43.48,"undercount"
"9398",45065,"South Carolina","McCormick County","A_AIC",69,60,-9,-13.95,"undercount"
"9399",45065,"South Carolina","McCormick County","NHPI_A",5,2,-3,-85.71,"undercount"
"9400",45065,"South Carolina","McCormick County","NHPI_AIC",6,13,7,73.68,"overcount"
"9401",45067,"South Carolina","Marion County","A_A",198,136,-62,-37.13,"undercount"
"9402",45067,"South Carolina","Marion County","A_AIC",277,184,-93,-40.35,"undercount"
"9403",45067,"South Carolina","Marion County","NHPI_A",3,3,0,0,"equal"
"9404",45067,"South Carolina","Marion County","NHPI_AIC",29,29,0,0,"equal"
"9405",45069,"South Carolina","Marlboro County","A_A",102,99,-3,-2.99,"undercount"
"9406",45069,"South Carolina","Marlboro County","A_AIC",173,117,-56,-38.62,"undercount"
"9407",45069,"South Carolina","Marlboro County","NHPI_A",3,8,5,90.91,"overcount"
"9408",45069,"South Carolina","Marlboro County","NHPI_AIC",29,9,-20,-105.26,"undercount"
"9409",45071,"South Carolina","Newberry County","A_A",236,135,-101,-54.45,"undercount"
"9410",45071,"South Carolina","Newberry County","A_AIC",296,214,-82,-32.16,"undercount"
"9411",45071,"South Carolina","Newberry County","NHPI_A",17,4,-13,-123.81,"undercount"
"9412",45071,"South Carolina","Newberry County","NHPI_AIC",30,17,-13,-55.32,"undercount"
"9413",45073,"South Carolina","Oconee County","A_A",664,603,-61,-9.63,"undercount"
"9414",45073,"South Carolina","Oconee County","A_AIC",889,919,30,3.32,"overcount"
"9415",45073,"South Carolina","Oconee County","NHPI_A",20,16,-4,-22.22,"undercount"
"9416",45073,"South Carolina","Oconee County","NHPI_AIC",77,79,2,2.56,"overcount"
"9417",45075,"South Carolina","Orangeburg County","A_A",782,918,136,16,"overcount"
"9418",45075,"South Carolina","Orangeburg County","A_AIC",987,1128,141,13.33,"overcount"
"9419",45075,"South Carolina","Orangeburg County","NHPI_A",31,41,10,27.78,"overcount"
"9420",45075,"South Carolina","Orangeburg County","NHPI_AIC",102,76,-26,-29.21,"undercount"
"9421",45077,"South Carolina","Pickens County","A_A",2431,2752,321,12.39,"overcount"
"9422",45077,"South Carolina","Pickens County","A_AIC",2973,3494,521,16.11,"overcount"
"9423",45077,"South Carolina","Pickens County","NHPI_A",31,40,9,25.35,"overcount"
"9424",45077,"South Carolina","Pickens County","NHPI_AIC",107,137,30,24.59,"overcount"
"9425",45079,"South Carolina","Richland County","A_A",12206,11420,-786,-6.65,"undercount"
"9426",45079,"South Carolina","Richland County","A_AIC",15284,14704,-580,-3.87,"undercount"
"9427",45079,"South Carolina","Richland County","NHPI_A",463,440,-23,-5.09,"undercount"
"9428",45079,"South Carolina","Richland County","NHPI_AIC",997,923,-74,-7.71,"undercount"
"9429",45081,"South Carolina","Saluda County","A_A",64,39,-25,-48.54,"undercount"
"9430",45081,"South Carolina","Saluda County","A_AIC",108,72,-36,-40,"undercount"
"9431",45081,"South Carolina","Saluda County","NHPI_A",12,0,-12,-200,"undercount"
"9432",45081,"South Carolina","Saluda County","NHPI_AIC",27,7,-20,-117.65,"undercount"
"9433",45083,"South Carolina","Spartanburg County","A_A",8360,8241,-119,-1.43,"undercount"
"9434",45083,"South Carolina","Spartanburg County","A_AIC",9693,9860,167,1.71,"overcount"
"9435",45083,"South Carolina","Spartanburg County","NHPI_A",175,190,15,8.22,"overcount"
"9436",45083,"South Carolina","Spartanburg County","NHPI_AIC",392,385,-7,-1.8,"undercount"
"9437",45085,"South Carolina","Sumter County","A_A",1478,1423,-55,-3.79,"undercount"
"9438",45085,"South Carolina","Sumter County","A_AIC",2242,2218,-24,-1.08,"undercount"
"9439",45085,"South Carolina","Sumter County","NHPI_A",106,87,-19,-19.69,"undercount"
"9440",45085,"South Carolina","Sumter County","NHPI_AIC",232,241,9,3.81,"overcount"
"9441",45087,"South Carolina","Union County","A_A",102,79,-23,-25.41,"undercount"
"9442",45087,"South Carolina","Union County","A_AIC",148,149,1,0.67,"overcount"
"9443",45087,"South Carolina","Union County","NHPI_A",11,3,-8,-114.29,"undercount"
"9444",45087,"South Carolina","Union County","NHPI_AIC",30,37,7,20.9,"overcount"
"9445",45089,"South Carolina","Williamsburg County","A_A",213,150,-63,-34.71,"undercount"
"9446",45089,"South Carolina","Williamsburg County","A_AIC",260,197,-63,-27.57,"undercount"
"9447",45089,"South Carolina","Williamsburg County","NHPI_A",8,1,-7,-155.56,"undercount"
"9448",45089,"South Carolina","Williamsburg County","NHPI_AIC",24,27,3,11.76,"overcount"
"9449",45091,"South Carolina","York County","A_A",8735,8822,87,0.99,"overcount"
"9450",45091,"South Carolina","York County","A_AIC",10061,10752,691,6.64,"overcount"
"9451",45091,"South Carolina","York County","NHPI_A",130,111,-19,-15.77,"undercount"
"9452",45091,"South Carolina","York County","NHPI_AIC",311,338,27,8.32,"overcount"
"9453",46003,"South Dakota","Aurora County","A_A",19,13,-6,-37.5,"undercount"
"9454",46003,"South Dakota","Aurora County","A_AIC",23,17,-6,-30,"undercount"
"9455",46003,"South Dakota","Aurora County","NHPI_A",0,0,0,0,"equal"
"9456",46003,"South Dakota","Aurora County","NHPI_AIC",1,6,5,142.86,"overcount"
"9457",46005,"South Dakota","Beadle County","A_A",1938,2068,130,6.49,"overcount"
"9458",46005,"South Dakota","Beadle County","A_AIC",1967,2134,167,8.14,"overcount"
"9459",46005,"South Dakota","Beadle County","NHPI_A",52,57,5,9.17,"overcount"
"9460",46005,"South Dakota","Beadle County","NHPI_AIC",59,77,18,26.47,"overcount"
"9461",46007,"South Dakota","Bennett County","A_A",18,7,-11,-88,"undercount"
"9462",46007,"South Dakota","Bennett County","A_AIC",30,7,-23,-124.32,"undercount"
"9463",46007,"South Dakota","Bennett County","NHPI_A",2,0,-2,-200,"undercount"
"9464",46007,"South Dakota","Bennett County","NHPI_AIC",3,3,0,0,"equal"
"9465",46009,"South Dakota","Bon Homme County","A_A",19,11,-8,-53.33,"undercount"
"9466",46009,"South Dakota","Bon Homme County","A_AIC",31,23,-8,-29.63,"undercount"
"9467",46009,"South Dakota","Bon Homme County","NHPI_A",3,5,2,50,"overcount"
"9468",46009,"South Dakota","Bon Homme County","NHPI_AIC",7,12,5,52.63,"overcount"
"9469",46011,"South Dakota","Brookings County","A_A",1043,927,-116,-11.78,"undercount"
"9470",46011,"South Dakota","Brookings County","A_AIC",1238,1131,-107,-9.03,"undercount"
"9471",46011,"South Dakota","Brookings County","NHPI_A",23,13,-10,-55.56,"undercount"
"9472",46011,"South Dakota","Brookings County","NHPI_AIC",47,25,-22,-61.11,"undercount"
"9473",46013,"South Dakota","Brown County","A_A",1365,919,-446,-39.05,"undercount"
"9474",46013,"South Dakota","Brown County","A_AIC",1507,1067,-440,-34.19,"undercount"
"9475",46013,"South Dakota","Brown County","NHPI_A",94,44,-50,-72.46,"undercount"
"9476",46013,"South Dakota","Brown County","NHPI_AIC",128,56,-72,-78.26,"undercount"
"9477",46015,"South Dakota","Brule County","A_A",24,26,2,8,"overcount"
"9478",46015,"South Dakota","Brule County","A_AIC",45,42,-3,-6.9,"undercount"
"9479",46015,"South Dakota","Brule County","NHPI_A",2,5,3,85.71,"overcount"
"9480",46015,"South Dakota","Brule County","NHPI_AIC",6,7,1,15.38,"overcount"
"9481",46017,"South Dakota","Buffalo County","A_A",2,1,-1,-66.67,"undercount"
"9482",46017,"South Dakota","Buffalo County","A_AIC",12,2,-10,-142.86,"undercount"
"9483",46017,"South Dakota","Buffalo County","NHPI_A",2,0,-2,-200,"undercount"
"9484",46017,"South Dakota","Buffalo County","NHPI_AIC",2,0,-2,-200,"undercount"
"9485",46019,"South Dakota","Butte County","A_A",50,30,-20,-50,"undercount"
"9486",46019,"South Dakota","Butte County","A_AIC",86,55,-31,-43.97,"undercount"
"9487",46019,"South Dakota","Butte County","NHPI_A",15,5,-10,-100,"undercount"
"9488",46019,"South Dakota","Butte County","NHPI_AIC",23,16,-7,-35.9,"undercount"
"9489",46021,"South Dakota","Campbell County","A_A",4,6,2,40,"overcount"
"9490",46021,"South Dakota","Campbell County","A_AIC",5,13,8,88.89,"overcount"
"9491",46021,"South Dakota","Campbell County","NHPI_A",0,0,0,0,"equal"
"9492",46021,"South Dakota","Campbell County","NHPI_AIC",0,1,1,200,"overcount"
"9493",46023,"South Dakota","Charles Mix County","A_A",23,32,9,32.73,"overcount"
"9494",46023,"South Dakota","Charles Mix County","A_AIC",68,46,-22,-38.6,"undercount"
"9495",46023,"South Dakota","Charles Mix County","NHPI_A",0,14,14,200,"overcount"
"9496",46023,"South Dakota","Charles Mix County","NHPI_AIC",11,28,17,87.18,"overcount"
"9497",46025,"South Dakota","Clark County","A_A",10,2,-8,-133.33,"undercount"
"9498",46025,"South Dakota","Clark County","A_AIC",13,6,-7,-73.68,"undercount"
"9499",46025,"South Dakota","Clark County","NHPI_A",0,2,2,200,"overcount"
"9500",46025,"South Dakota","Clark County","NHPI_AIC",0,7,7,200,"overcount"
"9501",46027,"South Dakota","Clay County","A_A",362,361,-1,-0.28,"undercount"
"9502",46027,"South Dakota","Clay County","A_AIC",435,456,21,4.71,"overcount"
"9503",46027,"South Dakota","Clay County","NHPI_A",12,4,-8,-100,"undercount"
"9504",46027,"South Dakota","Clay County","NHPI_AIC",26,11,-15,-81.08,"undercount"
"9505",46029,"South Dakota","Codington County","A_A",205,197,-8,-3.98,"undercount"
"9506",46029,"South Dakota","Codington County","A_AIC",321,318,-3,-0.94,"undercount"
"9507",46029,"South Dakota","Codington County","NHPI_A",3,3,0,0,"equal"
"9508",46029,"South Dakota","Codington County","NHPI_AIC",19,15,-4,-23.53,"undercount"
"9509",46031,"South Dakota","Corson County","A_A",18,21,3,15.38,"overcount"
"9510",46031,"South Dakota","Corson County","A_AIC",38,28,-10,-30.3,"undercount"
"9511",46031,"South Dakota","Corson County","NHPI_A",1,0,-1,-200,"undercount"
"9512",46031,"South Dakota","Corson County","NHPI_AIC",5,5,0,0,"equal"
"9513",46033,"South Dakota","Custer County","A_A",70,25,-45,-94.74,"undercount"
"9514",46033,"South Dakota","Custer County","A_AIC",86,48,-38,-56.72,"undercount"
"9515",46033,"South Dakota","Custer County","NHPI_A",2,0,-2,-200,"undercount"
"9516",46033,"South Dakota","Custer County","NHPI_AIC",4,6,2,40,"overcount"
"9517",46035,"South Dakota","Davison County","A_A",158,117,-41,-29.82,"undercount"
"9518",46035,"South Dakota","Davison County","A_AIC",235,190,-45,-21.18,"undercount"
"9519",46035,"South Dakota","Davison County","NHPI_A",12,0,-12,-200,"undercount"
"9520",46035,"South Dakota","Davison County","NHPI_AIC",30,13,-17,-79.07,"undercount"
"9521",46037,"South Dakota","Day County","A_A",35,21,-14,-50,"undercount"
"9522",46037,"South Dakota","Day County","A_AIC",49,34,-15,-36.14,"undercount"
"9523",46037,"South Dakota","Day County","NHPI_A",0,4,4,200,"overcount"
"9524",46037,"South Dakota","Day County","NHPI_AIC",6,8,2,28.57,"overcount"
"9525",46039,"South Dakota","Deuel County","A_A",7,2,-5,-111.11,"undercount"
"9526",46039,"South Dakota","Deuel County","A_AIC",15,12,-3,-22.22,"undercount"
"9527",46039,"South Dakota","Deuel County","NHPI_A",0,5,5,200,"overcount"
"9528",46039,"South Dakota","Deuel County","NHPI_AIC",7,6,-1,-15.38,"undercount"
"9529",46041,"South Dakota","Dewey County","A_A",14,6,-8,-80,"undercount"
"9530",46041,"South Dakota","Dewey County","A_AIC",35,15,-20,-80,"undercount"
"9531",46041,"South Dakota","Dewey County","NHPI_A",1,0,-1,-200,"undercount"
"9532",46041,"South Dakota","Dewey County","NHPI_AIC",9,5,-4,-57.14,"undercount"
"9533",46043,"South Dakota","Douglas County","A_A",4,3,-1,-28.57,"undercount"
"9534",46043,"South Dakota","Douglas County","A_AIC",9,9,0,0,"equal"
"9535",46043,"South Dakota","Douglas County","NHPI_A",0,1,1,200,"overcount"
"9536",46043,"South Dakota","Douglas County","NHPI_AIC",2,11,9,138.46,"overcount"
"9537",46045,"South Dakota","Edmunds County","A_A",15,23,8,42.11,"overcount"
"9538",46045,"South Dakota","Edmunds County","A_AIC",21,36,15,52.63,"overcount"
"9539",46045,"South Dakota","Edmunds County","NHPI_A",0,0,0,0,"equal"
"9540",46045,"South Dakota","Edmunds County","NHPI_AIC",1,2,1,66.67,"overcount"
"9541",46047,"South Dakota","Fall River County","A_A",111,49,-62,-77.5,"undercount"
"9542",46047,"South Dakota","Fall River County","A_AIC",136,70,-66,-64.08,"undercount"
"9543",46047,"South Dakota","Fall River County","NHPI_A",4,11,7,93.33,"overcount"
"9544",46047,"South Dakota","Fall River County","NHPI_AIC",10,26,16,88.89,"overcount"
"9545",46049,"South Dakota","Faulk County","A_A",10,3,-7,-107.69,"undercount"
"9546",46049,"South Dakota","Faulk County","A_AIC",14,7,-7,-66.67,"undercount"
"9547",46049,"South Dakota","Faulk County","NHPI_A",0,0,0,0,"equal"
"9548",46049,"South Dakota","Faulk County","NHPI_AIC",0,0,0,0,"equal"
"9549",46051,"South Dakota","Grant County","A_A",21,22,1,4.65,"overcount"
"9550",46051,"South Dakota","Grant County","A_AIC",43,51,8,17.02,"overcount"
"9551",46051,"South Dakota","Grant County","NHPI_A",2,3,1,40,"overcount"
"9552",46051,"South Dakota","Grant County","NHPI_AIC",2,5,3,85.71,"overcount"
"9553",46053,"South Dakota","Gregory County","A_A",22,21,-1,-4.65,"undercount"
"9554",46053,"South Dakota","Gregory County","A_AIC",36,52,16,36.36,"overcount"
"9555",46053,"South Dakota","Gregory County","NHPI_A",1,4,3,120,"overcount"
"9556",46053,"South Dakota","Gregory County","NHPI_AIC",2,7,5,111.11,"overcount"
"9557",46055,"South Dakota","Haakon County","A_A",8,17,9,72,"overcount"
"9558",46055,"South Dakota","Haakon County","A_AIC",21,21,0,0,"equal"
"9559",46055,"South Dakota","Haakon County","NHPI_A",2,2,0,0,"equal"
"9560",46055,"South Dakota","Haakon County","NHPI_AIC",8,6,-2,-28.57,"undercount"
"9561",46057,"South Dakota","Hamlin County","A_A",17,14,-3,-19.35,"undercount"
"9562",46057,"South Dakota","Hamlin County","A_AIC",36,26,-10,-32.26,"undercount"
"9563",46057,"South Dakota","Hamlin County","NHPI_A",0,6,6,200,"overcount"
"9564",46057,"South Dakota","Hamlin County","NHPI_AIC",3,9,6,100,"overcount"
"9565",46059,"South Dakota","Hand County","A_A",13,7,-6,-60,"undercount"
"9566",46059,"South Dakota","Hand County","A_AIC",21,20,-1,-4.88,"undercount"
"9567",46059,"South Dakota","Hand County","NHPI_A",1,0,-1,-200,"undercount"
"9568",46059,"South Dakota","Hand County","NHPI_AIC",2,3,1,40,"overcount"
"9569",46061,"South Dakota","Hanson County","A_A",13,0,-13,-200,"undercount"
"9570",46061,"South Dakota","Hanson County","A_AIC",30,14,-16,-72.73,"undercount"
"9571",46061,"South Dakota","Hanson County","NHPI_A",1,0,-1,-200,"undercount"
"9572",46061,"South Dakota","Hanson County","NHPI_AIC",2,3,1,40,"overcount"
"9573",46063,"South Dakota","Harding County","A_A",7,0,-7,-200,"undercount"
"9574",46063,"South Dakota","Harding County","A_AIC",9,1,-8,-160,"undercount"
"9575",46063,"South Dakota","Harding County","NHPI_A",0,0,0,0,"equal"
"9576",46063,"South Dakota","Harding County","NHPI_AIC",0,0,0,0,"equal"
"9577",46065,"South Dakota","Hughes County","A_A",135,128,-7,-5.32,"undercount"
"9578",46065,"South Dakota","Hughes County","A_AIC",198,202,4,2,"overcount"
"9579",46065,"South Dakota","Hughes County","NHPI_A",1,4,3,120,"overcount"
"9580",46065,"South Dakota","Hughes County","NHPI_AIC",11,13,2,16.67,"overcount"
"9581",46067,"South Dakota","Hutchinson County","A_A",25,21,-4,-17.39,"undercount"
"9582",46067,"South Dakota","Hutchinson County","A_AIC",33,31,-2,-6.25,"undercount"
"9583",46067,"South Dakota","Hutchinson County","NHPI_A",2,0,-2,-200,"undercount"
"9584",46067,"South Dakota","Hutchinson County","NHPI_AIC",5,12,7,82.35,"overcount"
"9585",46069,"South Dakota","Hyde County","A_A",3,5,2,50,"overcount"
"9586",46069,"South Dakota","Hyde County","A_AIC",7,16,9,78.26,"overcount"
"9587",46069,"South Dakota","Hyde County","NHPI_A",1,1,0,0,"equal"
"9588",46069,"South Dakota","Hyde County","NHPI_AIC",2,1,-1,-66.67,"undercount"
"9589",46071,"South Dakota","Jackson County","A_A",8,8,0,0,"equal"
"9590",46071,"South Dakota","Jackson County","A_AIC",20,15,-5,-28.57,"undercount"
"9591",46071,"South Dakota","Jackson County","NHPI_A",1,3,2,100,"overcount"
"9592",46071,"South Dakota","Jackson County","NHPI_AIC",2,10,8,133.33,"overcount"
"9593",46073,"South Dakota","Jerauld County","A_A",5,3,-2,-50,"undercount"
"9594",46073,"South Dakota","Jerauld County","A_AIC",6,5,-1,-18.18,"undercount"
"9595",46073,"South Dakota","Jerauld County","NHPI_A",3,0,-3,-200,"undercount"
"9596",46073,"South Dakota","Jerauld County","NHPI_AIC",3,6,3,66.67,"overcount"
"9597",46075,"South Dakota","Jones County","A_A",0,0,0,0,"equal"
"9598",46075,"South Dakota","Jones County","A_AIC",4,3,-1,-28.57,"undercount"
"9599",46075,"South Dakota","Jones County","NHPI_A",2,0,-2,-200,"undercount"
"9600",46075,"South Dakota","Jones County","NHPI_AIC",2,8,6,120,"overcount"
"9601",46077,"South Dakota","Kingsbury County","A_A",32,13,-19,-84.44,"undercount"
"9602",46077,"South Dakota","Kingsbury County","A_AIC",41,34,-7,-18.67,"undercount"
"9603",46077,"South Dakota","Kingsbury County","NHPI_A",0,7,7,200,"overcount"
"9604",46077,"South Dakota","Kingsbury County","NHPI_AIC",1,13,12,171.43,"overcount"
"9605",46079,"South Dakota","Lake County","A_A",109,66,-43,-49.14,"undercount"
"9606",46079,"South Dakota","Lake County","A_AIC",142,118,-24,-18.46,"undercount"
"9607",46079,"South Dakota","Lake County","NHPI_A",9,11,2,20,"overcount"
"9608",46079,"South Dakota","Lake County","NHPI_AIC",15,14,-1,-6.9,"undercount"
"9609",46081,"South Dakota","Lawrence County","A_A",379,197,-182,-63.19,"undercount"
"9610",46081,"South Dakota","Lawrence County","A_AIC",480,302,-178,-45.52,"undercount"
"9611",46081,"South Dakota","Lawrence County","NHPI_A",14,18,4,25,"overcount"
"9612",46081,"South Dakota","Lawrence County","NHPI_AIC",30,25,-5,-18.18,"undercount"
"9613",46083,"South Dakota","Lincoln County","A_A",949,996,47,4.83,"overcount"
"9614",46083,"South Dakota","Lincoln County","A_AIC",1233,1468,235,17.4,"overcount"
"9615",46083,"South Dakota","Lincoln County","NHPI_A",27,9,-18,-100,"undercount"
"9616",46083,"South Dakota","Lincoln County","NHPI_AIC",71,60,-11,-16.79,"undercount"
"9617",46085,"South Dakota","Lyman County","A_A",15,4,-11,-115.79,"undercount"
"9618",46085,"South Dakota","Lyman County","A_AIC",33,14,-19,-80.85,"undercount"
"9619",46085,"South Dakota","Lyman County","NHPI_A",2,0,-2,-200,"undercount"
"9620",46085,"South Dakota","Lyman County","NHPI_AIC",5,3,-2,-50,"undercount"
"9621",46087,"South Dakota","McCook County","A_A",12,6,-6,-66.67,"undercount"
"9622",46087,"South Dakota","McCook County","A_AIC",28,22,-6,-24,"undercount"
"9623",46087,"South Dakota","McCook County","NHPI_A",4,0,-4,-200,"undercount"
"9624",46087,"South Dakota","McCook County","NHPI_AIC",7,4,-3,-54.55,"undercount"
"9625",46089,"South Dakota","McPherson County","A_A",8,3,-5,-90.91,"undercount"
"9626",46089,"South Dakota","McPherson County","A_AIC",11,8,-3,-31.58,"undercount"
"9627",46089,"South Dakota","McPherson County","NHPI_A",2,3,1,40,"overcount"
"9628",46089,"South Dakota","McPherson County","NHPI_AIC",2,11,9,138.46,"overcount"
"9629",46091,"South Dakota","Marshall County","A_A",11,12,1,8.7,"overcount"
"9630",46091,"South Dakota","Marshall County","A_AIC",17,27,10,45.45,"overcount"
"9631",46091,"South Dakota","Marshall County","NHPI_A",0,1,1,200,"overcount"
"9632",46091,"South Dakota","Marshall County","NHPI_AIC",0,5,5,200,"overcount"
"9633",46093,"South Dakota","Meade County","A_A",366,275,-91,-28.39,"undercount"
"9634",46093,"South Dakota","Meade County","A_AIC",542,555,13,2.37,"overcount"
"9635",46093,"South Dakota","Meade County","NHPI_A",27,49,22,57.89,"overcount"
"9636",46093,"South Dakota","Meade County","NHPI_AIC",57,113,56,65.88,"overcount"
"9637",46095,"South Dakota","Mellette County","A_A",6,3,-3,-66.67,"undercount"
"9638",46095,"South Dakota","Mellette County","A_AIC",17,4,-13,-123.81,"undercount"
"9639",46095,"South Dakota","Mellette County","NHPI_A",0,0,0,0,"equal"
"9640",46095,"South Dakota","Mellette County","NHPI_AIC",0,0,0,0,"equal"
"9641",46097,"South Dakota","Miner County","A_A",12,6,-6,-66.67,"undercount"
"9642",46097,"South Dakota","Miner County","A_AIC",15,10,-5,-40,"undercount"
"9643",46097,"South Dakota","Miner County","NHPI_A",0,0,0,0,"equal"
"9644",46097,"South Dakota","Miner County","NHPI_AIC",2,3,1,40,"overcount"
"9645",46099,"South Dakota","Minnehaha County","A_A",4346,4597,251,5.61,"overcount"
"9646",46099,"South Dakota","Minnehaha County","A_AIC",5412,5841,429,7.62,"overcount"
"9647",46099,"South Dakota","Minnehaha County","NHPI_A",89,71,-18,-22.5,"undercount"
"9648",46099,"South Dakota","Minnehaha County","NHPI_AIC",261,281,20,7.38,"overcount"
"9649",46101,"South Dakota","Moody County","A_A",121,88,-33,-31.58,"undercount"
"9650",46101,"South Dakota","Moody County","A_AIC",150,108,-42,-32.56,"undercount"
"9651",46101,"South Dakota","Moody County","NHPI_A",0,0,0,0,"equal"
"9652",46101,"South Dakota","Moody County","NHPI_AIC",3,6,3,66.67,"overcount"
"9653",46102,"South Dakota","Oglala Lakota County","A_A",18,39,21,73.68,"overcount"
"9654",46102,"South Dakota","Oglala Lakota County","A_AIC",45,58,13,25.24,"overcount"
"9655",46102,"South Dakota","Oglala Lakota County","NHPI_A",4,0,-4,-200,"undercount"
"9656",46102,"South Dakota","Oglala Lakota County","NHPI_AIC",10,6,-4,-50,"undercount"
"9657",46103,"South Dakota","Pennington County","A_A",1471,1551,80,5.29,"overcount"
"9658",46103,"South Dakota","Pennington County","A_AIC",2300,2469,169,7.09,"overcount"
"9659",46103,"South Dakota","Pennington County","NHPI_A",90,82,-8,-9.3,"undercount"
"9660",46103,"South Dakota","Pennington County","NHPI_AIC",225,295,70,26.92,"overcount"
"9661",46105,"South Dakota","Perkins County","A_A",12,5,-7,-82.35,"undercount"
"9662",46105,"South Dakota","Perkins County","A_AIC",21,6,-15,-111.11,"undercount"
"9663",46105,"South Dakota","Perkins County","NHPI_A",2,4,2,66.67,"overcount"
"9664",46105,"South Dakota","Perkins County","NHPI_AIC",2,6,4,100,"overcount"
"9665",46107,"South Dakota","Potter County","A_A",23,14,-9,-48.65,"undercount"
"9666",46107,"South Dakota","Potter County","A_AIC",33,18,-15,-58.82,"undercount"
"9667",46107,"South Dakota","Potter County","NHPI_A",1,0,-1,-200,"undercount"
"9668",46107,"South Dakota","Potter County","NHPI_AIC",3,3,0,0,"equal"
"9669",46109,"South Dakota","Roberts County","A_A",36,27,-9,-28.57,"undercount"
"9670",46109,"South Dakota","Roberts County","A_AIC",77,53,-24,-36.92,"undercount"
"9671",46109,"South Dakota","Roberts County","NHPI_A",1,0,-1,-200,"undercount"
"9672",46109,"South Dakota","Roberts County","NHPI_AIC",14,1,-13,-173.33,"undercount"
"9673",46111,"South Dakota","Sanborn County","A_A",5,9,4,57.14,"overcount"
"9674",46111,"South Dakota","Sanborn County","A_AIC",12,13,1,8,"overcount"
"9675",46111,"South Dakota","Sanborn County","NHPI_A",0,0,0,0,"equal"
"9676",46111,"South Dakota","Sanborn County","NHPI_AIC",0,1,1,200,"overcount"
"9677",46115,"South Dakota","Spink County","A_A",10,2,-8,-133.33,"undercount"
"9678",46115,"South Dakota","Spink County","A_AIC",19,14,-5,-30.3,"undercount"
"9679",46115,"South Dakota","Spink County","NHPI_A",2,0,-2,-200,"undercount"
"9680",46115,"South Dakota","Spink County","NHPI_AIC",3,3,0,0,"equal"
"9681",46117,"South Dakota","Stanley County","A_A",8,5,-3,-46.15,"undercount"
"9682",46117,"South Dakota","Stanley County","A_AIC",15,11,-4,-30.77,"undercount"
"9683",46117,"South Dakota","Stanley County","NHPI_A",0,9,9,200,"overcount"
"9684",46117,"South Dakota","Stanley County","NHPI_AIC",2,15,13,152.94,"overcount"
"9685",46119,"South Dakota","Sully County","A_A",1,6,5,142.86,"overcount"
"9686",46119,"South Dakota","Sully County","A_AIC",3,10,7,107.69,"overcount"
"9687",46119,"South Dakota","Sully County","NHPI_A",0,0,0,0,"equal"
"9688",46119,"South Dakota","Sully County","NHPI_AIC",0,8,8,200,"overcount"
"9689",46121,"South Dakota","Todd County","A_A",341,45,-296,-153.37,"undercount"
"9690",46121,"South Dakota","Todd County","A_AIC",356,61,-295,-141.49,"undercount"
"9691",46121,"South Dakota","Todd County","NHPI_A",0,0,0,0,"equal"
"9692",46121,"South Dakota","Todd County","NHPI_AIC",6,2,-4,-100,"undercount"
"9693",46123,"South Dakota","Tripp County","A_A",21,5,-16,-123.08,"undercount"
"9694",46123,"South Dakota","Tripp County","A_AIC",27,13,-14,-70,"undercount"
"9695",46123,"South Dakota","Tripp County","NHPI_A",0,0,0,0,"equal"
"9696",46123,"South Dakota","Tripp County","NHPI_AIC",3,2,-1,-40,"undercount"
"9697",46125,"South Dakota","Turner County","A_A",21,15,-6,-33.33,"undercount"
"9698",46125,"South Dakota","Turner County","A_AIC",38,34,-4,-11.11,"undercount"
"9699",46125,"South Dakota","Turner County","NHPI_A",3,2,-1,-40,"undercount"
"9700",46125,"South Dakota","Turner County","NHPI_AIC",6,10,4,50,"overcount"
"9701",46127,"South Dakota","Union County","A_A",251,257,6,2.36,"overcount"
"9702",46127,"South Dakota","Union County","A_AIC",311,337,26,8.02,"overcount"
"9703",46127,"South Dakota","Union County","NHPI_A",18,27,9,40,"overcount"
"9704",46127,"South Dakota","Union County","NHPI_AIC",28,31,3,10.17,"overcount"
"9705",46129,"South Dakota","Walworth County","A_A",95,11,-84,-158.49,"undercount"
"9706",46129,"South Dakota","Walworth County","A_AIC",105,20,-85,-136,"undercount"
"9707",46129,"South Dakota","Walworth County","NHPI_A",0,0,0,0,"equal"
"9708",46129,"South Dakota","Walworth County","NHPI_AIC",2,5,3,85.71,"overcount"
"9709",46135,"South Dakota","Yankton County","A_A",158,130,-28,-19.44,"undercount"
"9710",46135,"South Dakota","Yankton County","A_AIC",214,189,-25,-12.41,"undercount"
"9711",46135,"South Dakota","Yankton County","NHPI_A",11,9,-2,-20,"undercount"
"9712",46135,"South Dakota","Yankton County","NHPI_AIC",25,19,-6,-27.27,"undercount"
"9713",46137,"South Dakota","Ziebach County","A_A",5,3,-2,-50,"undercount"
"9714",46137,"South Dakota","Ziebach County","A_AIC",11,7,-4,-44.44,"undercount"
"9715",46137,"South Dakota","Ziebach County","NHPI_A",1,3,2,100,"overcount"
"9716",46137,"South Dakota","Ziebach County","NHPI_AIC",2,5,3,85.71,"overcount"
"9717",47001,"Tennessee","Anderson County","A_A",1054,993,-61,-5.96,"undercount"
"9718",47001,"Tennessee","Anderson County","A_AIC",1329,1404,75,5.49,"overcount"
"9719",47001,"Tennessee","Anderson County","NHPI_A",37,53,16,35.56,"overcount"
"9720",47001,"Tennessee","Anderson County","NHPI_AIC",73,91,18,21.95,"overcount"
"9721",47003,"Tennessee","Bedford County","A_A",427,344,-83,-21.53,"undercount"
"9722",47003,"Tennessee","Bedford County","A_AIC",548,487,-61,-11.79,"undercount"
"9723",47003,"Tennessee","Bedford County","NHPI_A",30,13,-17,-79.07,"undercount"
"9724",47003,"Tennessee","Bedford County","NHPI_AIC",49,49,0,0,"equal"
"9725",47005,"Tennessee","Benton County","A_A",97,107,10,9.8,"overcount"
"9726",47005,"Tennessee","Benton County","A_AIC",129,150,21,15.05,"overcount"
"9727",47005,"Tennessee","Benton County","NHPI_A",2,4,2,66.67,"overcount"
"9728",47005,"Tennessee","Benton County","NHPI_AIC",8,18,10,76.92,"overcount"
"9729",47007,"Tennessee","Bledsoe County","A_A",43,37,-6,-15,"undercount"
"9730",47007,"Tennessee","Bledsoe County","A_AIC",61,65,4,6.35,"overcount"
"9731",47007,"Tennessee","Bledsoe County","NHPI_A",4,0,-4,-200,"undercount"
"9732",47007,"Tennessee","Bledsoe County","NHPI_AIC",9,8,-1,-11.76,"undercount"
"9733",47009,"Tennessee","Blount County","A_A",1194,1295,101,8.12,"overcount"
"9734",47009,"Tennessee","Blount County","A_AIC",1623,1900,277,15.73,"overcount"
"9735",47009,"Tennessee","Blount County","NHPI_A",96,23,-73,-122.69,"undercount"
"9736",47009,"Tennessee","Blount County","NHPI_AIC",154,99,-55,-43.48,"undercount"
"9737",47011,"Tennessee","Bradley County","A_A",1274,1210,-64,-5.15,"undercount"
"9738",47011,"Tennessee","Bradley County","A_AIC",1599,1699,100,6.06,"overcount"
"9739",47011,"Tennessee","Bradley County","NHPI_A",108,117,9,8,"overcount"
"9740",47011,"Tennessee","Bradley County","NHPI_AIC",164,200,36,19.78,"overcount"
"9741",47013,"Tennessee","Campbell County","A_A",145,97,-48,-39.67,"undercount"
"9742",47013,"Tennessee","Campbell County","A_AIC",198,171,-27,-14.63,"undercount"
"9743",47013,"Tennessee","Campbell County","NHPI_A",19,1,-18,-180,"undercount"
"9744",47013,"Tennessee","Campbell County","NHPI_AIC",30,19,-11,-44.9,"undercount"
"9745",47015,"Tennessee","Cannon County","A_A",38,39,1,2.6,"overcount"
"9746",47015,"Tennessee","Cannon County","A_AIC",63,93,30,38.46,"overcount"
"9747",47015,"Tennessee","Cannon County","NHPI_A",12,4,-8,-100,"undercount"
"9748",47015,"Tennessee","Cannon County","NHPI_AIC",19,13,-6,-37.5,"undercount"
"9749",47017,"Tennessee","Carroll County","A_A",123,124,1,0.81,"overcount"
"9750",47017,"Tennessee","Carroll County","A_AIC",165,189,24,13.56,"overcount"
"9751",47017,"Tennessee","Carroll County","NHPI_A",9,5,-4,-57.14,"undercount"
"9752",47017,"Tennessee","Carroll County","NHPI_AIC",16,37,21,79.25,"overcount"
"9753",47019,"Tennessee","Carter County","A_A",221,243,22,9.48,"overcount"
"9754",47019,"Tennessee","Carter County","A_AIC",321,397,76,21.17,"overcount"
"9755",47019,"Tennessee","Carter County","NHPI_A",17,9,-8,-61.54,"undercount"
"9756",47019,"Tennessee","Carter County","NHPI_AIC",39,38,-1,-2.6,"undercount"
"9757",47021,"Tennessee","Cheatham County","A_A",176,193,17,9.21,"overcount"
"9758",47021,"Tennessee","Cheatham County","A_AIC",327,353,26,7.65,"overcount"
"9759",47021,"Tennessee","Cheatham County","NHPI_A",18,25,7,32.56,"overcount"
"9760",47021,"Tennessee","Cheatham County","NHPI_AIC",41,59,18,36,"overcount"
"9761",47023,"Tennessee","Chester County","A_A",109,70,-39,-43.58,"undercount"
"9762",47023,"Tennessee","Chester County","A_AIC",156,126,-30,-21.28,"undercount"
"9763",47023,"Tennessee","Chester County","NHPI_A",2,1,-1,-66.67,"undercount"
"9764",47023,"Tennessee","Chester County","NHPI_AIC",11,13,2,16.67,"overcount"
"9765",47025,"Tennessee","Claiborne County","A_A",267,149,-118,-56.73,"undercount"
"9766",47025,"Tennessee","Claiborne County","A_AIC",328,226,-102,-36.82,"undercount"
"9767",47025,"Tennessee","Claiborne County","NHPI_A",7,11,4,44.44,"overcount"
"9768",47025,"Tennessee","Claiborne County","NHPI_AIC",26,20,-6,-26.09,"undercount"
"9769",47027,"Tennessee","Clay County","A_A",8,5,-3,-46.15,"undercount"
"9770",47027,"Tennessee","Clay County","A_AIC",20,22,2,9.52,"overcount"
"9771",47027,"Tennessee","Clay County","NHPI_A",2,1,-1,-66.67,"undercount"
"9772",47027,"Tennessee","Clay County","NHPI_AIC",3,12,9,120,"overcount"
"9773",47029,"Tennessee","Cocke County","A_A",157,150,-7,-4.56,"undercount"
"9774",47029,"Tennessee","Cocke County","A_AIC",211,239,28,12.44,"overcount"
"9775",47029,"Tennessee","Cocke County","NHPI_A",16,10,-6,-46.15,"undercount"
"9776",47029,"Tennessee","Cocke County","NHPI_AIC",26,24,-2,-8,"undercount"
"9777",47031,"Tennessee","Coffee County","A_A",619,611,-8,-1.3,"undercount"
"9778",47031,"Tennessee","Coffee County","A_AIC",803,821,18,2.22,"overcount"
"9779",47031,"Tennessee","Coffee County","NHPI_A",45,37,-8,-19.51,"undercount"
"9780",47031,"Tennessee","Coffee County","NHPI_AIC",84,64,-20,-27.03,"undercount"
"9781",47033,"Tennessee","Crockett County","A_A",37,51,14,31.82,"overcount"
"9782",47033,"Tennessee","Crockett County","A_AIC",65,72,7,10.22,"overcount"
"9783",47033,"Tennessee","Crockett County","NHPI_A",4,1,-3,-120,"undercount"
"9784",47033,"Tennessee","Crockett County","NHPI_AIC",10,9,-1,-10.53,"undercount"
"9785",47035,"Tennessee","Cumberland County","A_A",371,366,-5,-1.36,"undercount"
"9786",47035,"Tennessee","Cumberland County","A_AIC",469,528,59,11.84,"overcount"
"9787",47035,"Tennessee","Cumberland County","NHPI_A",32,14,-18,-78.26,"undercount"
"9788",47035,"Tennessee","Cumberland County","NHPI_AIC",49,42,-7,-15.38,"undercount"
"9789",47037,"Tennessee","Davidson County","A_A",26480,27905,1425,5.24,"overcount"
"9790",47037,"Tennessee","Davidson County","A_AIC",31912,34637,2725,8.19,"overcount"
"9791",47037,"Tennessee","Davidson County","NHPI_A",345,303,-42,-12.96,"undercount"
"9792",47037,"Tennessee","Davidson County","NHPI_AIC",1023,1011,-12,-1.18,"undercount"
"9793",47039,"Tennessee","Decatur County","A_A",67,42,-25,-45.87,"undercount"
"9794",47039,"Tennessee","Decatur County","A_AIC",94,46,-48,-68.57,"undercount"
"9795",47039,"Tennessee","Decatur County","NHPI_A",6,5,-1,-18.18,"undercount"
"9796",47039,"Tennessee","Decatur County","NHPI_AIC",11,11,0,0,"equal"
"9797",47041,"Tennessee","DeKalb County","A_A",202,76,-126,-90.65,"undercount"
"9798",47041,"Tennessee","DeKalb County","A_AIC",231,134,-97,-53.15,"undercount"
"9799",47041,"Tennessee","DeKalb County","NHPI_A",5,6,1,18.18,"overcount"
"9800",47041,"Tennessee","DeKalb County","NHPI_AIC",16,24,8,40,"overcount"
"9801",47043,"Tennessee","Dickson County","A_A",320,320,0,0,"equal"
"9802",47043,"Tennessee","Dickson County","A_AIC",440,469,29,6.38,"overcount"
"9803",47043,"Tennessee","Dickson County","NHPI_A",27,6,-21,-127.27,"undercount"
"9804",47043,"Tennessee","Dickson County","NHPI_AIC",53,20,-33,-90.41,"undercount"
"9805",47045,"Tennessee","Dyer County","A_A",235,213,-22,-9.82,"undercount"
"9806",47045,"Tennessee","Dyer County","A_AIC",288,278,-10,-3.53,"undercount"
"9807",47045,"Tennessee","Dyer County","NHPI_A",8,11,3,31.58,"overcount"
"9808",47045,"Tennessee","Dyer County","NHPI_AIC",34,41,7,18.67,"overcount"
"9809",47047,"Tennessee","Fayette County","A_A",298,269,-29,-10.23,"undercount"
"9810",47047,"Tennessee","Fayette County","A_AIC",400,405,5,1.24,"overcount"
"9811",47047,"Tennessee","Fayette County","NHPI_A",13,18,5,32.26,"overcount"
"9812",47047,"Tennessee","Fayette County","NHPI_AIC",38,55,17,36.56,"overcount"
"9813",47049,"Tennessee","Fentress County","A_A",93,33,-60,-95.24,"undercount"
"9814",47049,"Tennessee","Fentress County","A_AIC",116,74,-42,-44.21,"undercount"
"9815",47049,"Tennessee","Fentress County","NHPI_A",4,3,-1,-28.57,"undercount"
"9816",47049,"Tennessee","Fentress County","NHPI_AIC",14,11,-3,-24,"undercount"
"9817",47051,"Tennessee","Franklin County","A_A",380,352,-28,-7.65,"undercount"
"9818",47051,"Tennessee","Franklin County","A_AIC",488,501,13,2.63,"overcount"
"9819",47051,"Tennessee","Franklin County","NHPI_A",27,17,-10,-45.45,"undercount"
"9820",47051,"Tennessee","Franklin County","NHPI_AIC",54,44,-10,-20.41,"undercount"
"9821",47053,"Tennessee","Gibson County","A_A",183,200,17,8.88,"overcount"
"9822",47053,"Tennessee","Gibson County","A_AIC",266,317,51,17.5,"overcount"
"9823",47053,"Tennessee","Gibson County","NHPI_A",8,15,7,60.87,"overcount"
"9824",47053,"Tennessee","Gibson County","NHPI_AIC",38,44,6,14.63,"overcount"
"9825",47055,"Tennessee","Giles County","A_A",144,186,42,25.45,"overcount"
"9826",47055,"Tennessee","Giles County","A_AIC",199,271,72,30.64,"overcount"
"9827",47055,"Tennessee","Giles County","NHPI_A",9,9,0,0,"equal"
"9828",47055,"Tennessee","Giles County","NHPI_AIC",31,18,-13,-53.06,"undercount"
"9829",47057,"Tennessee","Grainger County","A_A",63,53,-10,-17.24,"undercount"
"9830",47057,"Tennessee","Grainger County","A_AIC",89,97,8,8.6,"overcount"
"9831",47057,"Tennessee","Grainger County","NHPI_A",7,3,-4,-80,"undercount"
"9832",47057,"Tennessee","Grainger County","NHPI_AIC",16,19,3,17.14,"overcount"
"9833",47059,"Tennessee","Greene County","A_A",395,299,-96,-27.67,"undercount"
"9834",47059,"Tennessee","Greene County","A_AIC",495,520,25,4.93,"overcount"
"9835",47059,"Tennessee","Greene County","NHPI_A",13,16,3,20.69,"overcount"
"9836",47059,"Tennessee","Greene County","NHPI_AIC",55,75,20,30.77,"overcount"
"9837",47061,"Tennessee","Grundy County","A_A",66,48,-18,-31.58,"undercount"
"9838",47061,"Tennessee","Grundy County","A_AIC",85,79,-6,-7.32,"undercount"
"9839",47061,"Tennessee","Grundy County","NHPI_A",1,0,-1,-200,"undercount"
"9840",47061,"Tennessee","Grundy County","NHPI_AIC",9,2,-7,-127.27,"undercount"
"9841",47063,"Tennessee","Hamblen County","A_A",607,718,111,16.75,"overcount"
"9842",47063,"Tennessee","Hamblen County","A_AIC",776,907,131,15.57,"overcount"
"9843",47063,"Tennessee","Hamblen County","NHPI_A",174,268,94,42.53,"overcount"
"9844",47063,"Tennessee","Hamblen County","NHPI_AIC",235,305,70,25.93,"overcount"
"9845",47065,"Tennessee","Hamilton County","A_A",7898,8238,340,4.21,"overcount"
"9846",47065,"Tennessee","Hamilton County","A_AIC",9518,10457,939,9.4,"overcount"
"9847",47065,"Tennessee","Hamilton County","NHPI_A",186,138,-48,-29.63,"undercount"
"9848",47065,"Tennessee","Hamilton County","NHPI_AIC",484,429,-55,-12.05,"undercount"
"9849",47067,"Tennessee","Hancock County","A_A",13,1,-12,-171.43,"undercount"
"9850",47067,"Tennessee","Hancock County","A_AIC",24,6,-18,-120,"undercount"
"9851",47067,"Tennessee","Hancock County","NHPI_A",3,0,-3,-200,"undercount"
"9852",47067,"Tennessee","Hancock County","NHPI_AIC",5,7,2,33.33,"overcount"
"9853",47069,"Tennessee","Hardeman County","A_A",206,173,-33,-17.41,"undercount"
"9854",47069,"Tennessee","Hardeman County","A_AIC",247,200,-47,-21.03,"undercount"
"9855",47069,"Tennessee","Hardeman County","NHPI_A",4,6,2,40,"overcount"
"9856",47069,"Tennessee","Hardeman County","NHPI_AIC",19,30,11,44.9,"overcount"
"9857",47071,"Tennessee","Hardin County","A_A",144,150,6,4.08,"overcount"
"9858",47071,"Tennessee","Hardin County","A_AIC",173,198,25,13.48,"overcount"
"9859",47071,"Tennessee","Hardin County","NHPI_A",10,0,-10,-200,"undercount"
"9860",47071,"Tennessee","Hardin County","NHPI_AIC",15,13,-2,-14.29,"undercount"
"9861",47073,"Tennessee","Hawkins County","A_A",316,277,-39,-13.15,"undercount"
"9862",47073,"Tennessee","Hawkins County","A_AIC",395,384,-11,-2.82,"undercount"
"9863",47073,"Tennessee","Hawkins County","NHPI_A",61,13,-48,-129.73,"undercount"
"9864",47073,"Tennessee","Hawkins County","NHPI_AIC",83,43,-40,-63.49,"undercount"
"9865",47075,"Tennessee","Haywood County","A_A",39,30,-9,-26.09,"undercount"
"9866",47075,"Tennessee","Haywood County","A_AIC",56,49,-7,-13.33,"undercount"
"9867",47075,"Tennessee","Haywood County","NHPI_A",0,8,8,200,"overcount"
"9868",47075,"Tennessee","Haywood County","NHPI_AIC",5,13,8,88.89,"overcount"
"9869",47077,"Tennessee","Henderson County","A_A",104,92,-12,-12.24,"undercount"
"9870",47077,"Tennessee","Henderson County","A_AIC",137,123,-14,-10.77,"undercount"
"9871",47077,"Tennessee","Henderson County","NHPI_A",5,2,-3,-85.71,"undercount"
"9872",47077,"Tennessee","Henderson County","NHPI_AIC",14,15,1,6.9,"overcount"
"9873",47079,"Tennessee","Henry County","A_A",194,202,8,4.04,"overcount"
"9874",47079,"Tennessee","Henry County","A_AIC",242,308,66,24,"overcount"
"9875",47079,"Tennessee","Henry County","NHPI_A",9,7,-2,-25,"undercount"
"9876",47079,"Tennessee","Henry County","NHPI_AIC",22,14,-8,-44.44,"undercount"
"9877",47081,"Tennessee","Hickman County","A_A",101,72,-29,-33.53,"undercount"
"9878",47081,"Tennessee","Hickman County","A_AIC",148,135,-13,-9.19,"undercount"
"9879",47081,"Tennessee","Hickman County","NHPI_A",3,1,-2,-100,"undercount"
"9880",47081,"Tennessee","Hickman County","NHPI_AIC",17,14,-3,-19.35,"undercount"
"9881",47083,"Tennessee","Houston County","A_A",41,17,-24,-82.76,"undercount"
"9882",47083,"Tennessee","Houston County","A_AIC",60,21,-39,-96.3,"undercount"
"9883",47083,"Tennessee","Houston County","NHPI_A",5,8,3,46.15,"overcount"
"9884",47083,"Tennessee","Houston County","NHPI_AIC",10,11,1,9.52,"overcount"
"9885",47085,"Tennessee","Humphreys County","A_A",125,59,-66,-71.74,"undercount"
"9886",47085,"Tennessee","Humphreys County","A_AIC",158,121,-37,-26.52,"undercount"
"9887",47085,"Tennessee","Humphreys County","NHPI_A",8,0,-8,-200,"undercount"
"9888",47085,"Tennessee","Humphreys County","NHPI_AIC",19,29,10,41.67,"overcount"
"9889",47087,"Tennessee","Jackson County","A_A",16,17,1,6.06,"overcount"
"9890",47087,"Tennessee","Jackson County","A_AIC",39,68,29,54.21,"overcount"
"9891",47087,"Tennessee","Jackson County","NHPI_A",3,0,-3,-200,"undercount"
"9892",47087,"Tennessee","Jackson County","NHPI_AIC",10,10,0,0,"equal"
"9893",47089,"Tennessee","Jefferson County","A_A",356,260,-96,-31.17,"undercount"
"9894",47089,"Tennessee","Jefferson County","A_AIC",468,406,-62,-14.19,"undercount"
"9895",47089,"Tennessee","Jefferson County","NHPI_A",35,20,-15,-54.55,"undercount"
"9896",47089,"Tennessee","Jefferson County","NHPI_AIC",68,35,-33,-64.08,"undercount"
"9897",47091,"Tennessee","Johnson County","A_A",42,32,-10,-27.03,"undercount"
"9898",47091,"Tennessee","Johnson County","A_AIC",69,64,-5,-7.52,"undercount"
"9899",47091,"Tennessee","Johnson County","NHPI_A",5,9,4,57.14,"overcount"
"9900",47091,"Tennessee","Johnson County","NHPI_AIC",12,21,9,54.55,"overcount"
"9901",47093,"Tennessee","Knox County","A_A",11507,11973,466,3.97,"overcount"
"9902",47093,"Tennessee","Knox County","A_AIC",14111,15167,1056,7.21,"overcount"
"9903",47093,"Tennessee","Knox County","NHPI_A",309,310,1,0.32,"overcount"
"9904",47093,"Tennessee","Knox County","NHPI_AIC",639,713,74,10.95,"overcount"
"9905",47095,"Tennessee","Lake County","A_A",17,12,-5,-34.48,"undercount"
"9906",47095,"Tennessee","Lake County","A_AIC",33,31,-2,-6.25,"undercount"
"9907",47095,"Tennessee","Lake County","NHPI_A",1,5,4,133.33,"overcount"
"9908",47095,"Tennessee","Lake County","NHPI_AIC",4,13,9,105.88,"overcount"
"9909",47097,"Tennessee","Lauderdale County","A_A",129,53,-76,-83.52,"undercount"
"9910",47097,"Tennessee","Lauderdale County","A_AIC",184,131,-53,-33.65,"undercount"
"9911",47097,"Tennessee","Lauderdale County","NHPI_A",0,0,0,0,"equal"
"9912",47097,"Tennessee","Lauderdale County","NHPI_AIC",18,22,4,20,"overcount"
"9913",47099,"Tennessee","Lawrence County","A_A",211,168,-43,-22.69,"undercount"
"9914",47099,"Tennessee","Lawrence County","A_AIC",301,293,-8,-2.69,"undercount"
"9915",47099,"Tennessee","Lawrence County","NHPI_A",3,1,-2,-100,"undercount"
"9916",47099,"Tennessee","Lawrence County","NHPI_AIC",30,41,11,30.99,"overcount"
"9917",47101,"Tennessee","Lewis County","A_A",72,55,-17,-26.77,"undercount"
"9918",47101,"Tennessee","Lewis County","A_AIC",100,107,7,6.76,"overcount"
"9919",47101,"Tennessee","Lewis County","NHPI_A",7,5,-2,-33.33,"undercount"
"9920",47101,"Tennessee","Lewis County","NHPI_AIC",15,25,10,50,"overcount"
"9921",47103,"Tennessee","Lincoln County","A_A",217,178,-39,-19.75,"undercount"
"9922",47103,"Tennessee","Lincoln County","A_AIC",275,302,27,9.36,"overcount"
"9923",47103,"Tennessee","Lincoln County","NHPI_A",24,16,-8,-40,"undercount"
"9924",47103,"Tennessee","Lincoln County","NHPI_AIC",53,53,0,0,"equal"
"9925",47105,"Tennessee","Loudon County","A_A",453,485,32,6.82,"overcount"
"9926",47105,"Tennessee","Loudon County","A_AIC",556,637,81,13.58,"overcount"
"9927",47105,"Tennessee","Loudon County","NHPI_A",33,21,-12,-44.44,"undercount"
"9928",47105,"Tennessee","Loudon County","NHPI_AIC",57,54,-3,-5.41,"undercount"
"9929",47107,"Tennessee","McMinn County","A_A",369,430,61,15.27,"overcount"
"9930",47107,"Tennessee","McMinn County","A_AIC",475,601,126,23.42,"overcount"
"9931",47107,"Tennessee","McMinn County","NHPI_A",10,18,8,57.14,"overcount"
"9932",47107,"Tennessee","McMinn County","NHPI_AIC",36,55,19,41.76,"overcount"
"9933",47109,"Tennessee","McNairy County","A_A",97,78,-19,-21.71,"undercount"
"9934",47109,"Tennessee","McNairy County","A_AIC",136,113,-23,-18.47,"undercount"
"9935",47109,"Tennessee","McNairy County","NHPI_A",1,0,-1,-200,"undercount"
"9936",47109,"Tennessee","McNairy County","NHPI_AIC",10,2,-8,-133.33,"undercount"
"9937",47111,"Tennessee","Macon County","A_A",230,49,-181,-129.75,"undercount"
"9938",47111,"Tennessee","Macon County","A_AIC",270,85,-185,-104.23,"undercount"
"9939",47111,"Tennessee","Macon County","NHPI_A",7,11,4,44.44,"overcount"
"9940",47111,"Tennessee","Macon County","NHPI_AIC",19,21,2,10,"overcount"
"9941",47113,"Tennessee","Madison County","A_A",1069,1236,167,14.49,"overcount"
"9942",47113,"Tennessee","Madison County","A_AIC",1411,1623,212,13.97,"overcount"
"9943",47113,"Tennessee","Madison County","NHPI_A",34,13,-21,-89.36,"undercount"
"9944",47113,"Tennessee","Madison County","NHPI_AIC",127,53,-74,-82.22,"undercount"
"9945",47115,"Tennessee","Marion County","A_A",185,149,-36,-21.56,"undercount"
"9946",47115,"Tennessee","Marion County","A_AIC",234,220,-14,-6.17,"undercount"
"9947",47115,"Tennessee","Marion County","NHPI_A",5,2,-3,-85.71,"undercount"
"9948",47115,"Tennessee","Marion County","NHPI_AIC",20,20,0,0,"equal"
"9949",47117,"Tennessee","Marshall County","A_A",206,143,-63,-36.1,"undercount"
"9950",47117,"Tennessee","Marshall County","A_AIC",304,221,-83,-31.62,"undercount"
"9951",47117,"Tennessee","Marshall County","NHPI_A",12,7,-5,-52.63,"undercount"
"9952",47117,"Tennessee","Marshall County","NHPI_AIC",39,27,-12,-36.36,"undercount"
"9953",47119,"Tennessee","Maury County","A_A",918,942,24,2.58,"overcount"
"9954",47119,"Tennessee","Maury County","A_AIC",1240,1404,164,12.41,"overcount"
"9955",47119,"Tennessee","Maury County","NHPI_A",52,45,-7,-14.43,"undercount"
"9956",47119,"Tennessee","Maury County","NHPI_AIC",117,116,-1,-0.86,"undercount"
"9957",47121,"Tennessee","Meigs County","A_A",40,26,-14,-42.42,"undercount"
"9958",47121,"Tennessee","Meigs County","A_AIC",68,43,-25,-45.05,"undercount"
"9959",47121,"Tennessee","Meigs County","NHPI_A",7,1,-6,-150,"undercount"
"9960",47121,"Tennessee","Meigs County","NHPI_AIC",14,13,-1,-7.41,"undercount"
"9961",47123,"Tennessee","Monroe County","A_A",229,194,-35,-16.55,"undercount"
"9962",47123,"Tennessee","Monroe County","A_AIC",325,312,-13,-4.08,"undercount"
"9963",47123,"Tennessee","Monroe County","NHPI_A",19,2,-17,-161.9,"undercount"
"9964",47123,"Tennessee","Monroe County","NHPI_AIC",37,32,-5,-14.49,"undercount"
"9965",47125,"Tennessee","Montgomery County","A_A",4568,5148,580,11.94,"overcount"
"9966",47125,"Tennessee","Montgomery County","A_AIC",7630,8520,890,11.02,"overcount"
"9967",47125,"Tennessee","Montgomery County","NHPI_A",730,936,206,24.73,"overcount"
"9968",47125,"Tennessee","Montgomery County","NHPI_AIC",1288,1775,487,31.8,"overcount"
"9969",47127,"Tennessee","Moore County","A_A",108,33,-75,-106.38,"undercount"
"9970",47127,"Tennessee","Moore County","A_AIC",119,66,-53,-57.3,"undercount"
"9971",47127,"Tennessee","Moore County","NHPI_A",1,2,1,66.67,"overcount"
"9972",47127,"Tennessee","Moore County","NHPI_AIC",2,11,9,138.46,"overcount"
"9973",47129,"Tennessee","Morgan County","A_A",51,45,-6,-12.5,"undercount"
"9974",47129,"Tennessee","Morgan County","A_AIC",87,99,12,12.9,"overcount"
"9975",47129,"Tennessee","Morgan County","NHPI_A",13,8,-5,-47.62,"undercount"
"9976",47129,"Tennessee","Morgan County","NHPI_AIC",18,26,8,36.36,"overcount"
"9977",47131,"Tennessee","Obion County","A_A",119,103,-16,-14.41,"undercount"
"9978",47131,"Tennessee","Obion County","A_AIC",169,161,-8,-4.85,"undercount"
"9979",47131,"Tennessee","Obion County","NHPI_A",9,0,-9,-200,"undercount"
"9980",47131,"Tennessee","Obion County","NHPI_AIC",24,19,-5,-23.26,"undercount"
"9981",47133,"Tennessee","Overton County","A_A",79,62,-17,-24.11,"undercount"
"9982",47133,"Tennessee","Overton County","A_AIC",112,115,3,2.64,"overcount"
"9983",47133,"Tennessee","Overton County","NHPI_A",2,0,-2,-200,"undercount"
"9984",47133,"Tennessee","Overton County","NHPI_AIC",7,10,3,35.29,"overcount"
"9985",47135,"Tennessee","Perry County","A_A",75,26,-49,-97.03,"undercount"
"9986",47135,"Tennessee","Perry County","A_AIC",96,47,-49,-68.53,"undercount"
"9987",47135,"Tennessee","Perry County","NHPI_A",2,1,-1,-66.67,"undercount"
"9988",47135,"Tennessee","Perry County","NHPI_AIC",4,3,-1,-28.57,"undercount"
"9989",47137,"Tennessee","Pickett County","A_A",4,15,11,115.79,"overcount"
"9990",47137,"Tennessee","Pickett County","A_AIC",12,25,13,70.27,"overcount"
"9991",47137,"Tennessee","Pickett County","NHPI_A",4,1,-3,-120,"undercount"
"9992",47137,"Tennessee","Pickett County","NHPI_AIC",4,4,0,0,"equal"
"9993",47139,"Tennessee","Polk County","A_A",63,34,-29,-59.79,"undercount"
"9994",47139,"Tennessee","Polk County","A_AIC",90,56,-34,-46.58,"undercount"
"9995",47139,"Tennessee","Polk County","NHPI_A",1,10,9,163.64,"overcount"
"9996",47139,"Tennessee","Polk County","NHPI_AIC",4,11,7,93.33,"overcount"
"9997",47141,"Tennessee","Putnam County","A_A",1076,1095,19,1.75,"overcount"
"9998",47141,"Tennessee","Putnam County","A_AIC",1368,1526,158,10.92,"overcount"
"9999",47141,"Tennessee","Putnam County","NHPI_A",34,35,1,2.9,"overcount"
"10000",47141,"Tennessee","Putnam County","NHPI_AIC",87,102,15,15.87,"overcount"
"10001",47143,"Tennessee","Rhea County","A_A",184,195,11,5.8,"overcount"
"10002",47143,"Tennessee","Rhea County","A_AIC",231,291,60,22.99,"overcount"
"10003",47143,"Tennessee","Rhea County","NHPI_A",18,6,-12,-100,"undercount"
"10004",47143,"Tennessee","Rhea County","NHPI_AIC",39,16,-23,-83.64,"undercount"
"10005",47145,"Tennessee","Roane County","A_A",354,343,-11,-3.16,"undercount"
"10006",47145,"Tennessee","Roane County","A_AIC",479,568,89,17,"overcount"
"10007",47145,"Tennessee","Roane County","NHPI_A",25,19,-6,-27.27,"undercount"
"10008",47145,"Tennessee","Roane County","NHPI_AIC",48,65,17,30.09,"overcount"
"10009",47147,"Tennessee","Robertson County","A_A",506,462,-44,-9.09,"undercount"
"10010",47147,"Tennessee","Robertson County","A_AIC",685,759,74,10.25,"overcount"
"10011",47147,"Tennessee","Robertson County","NHPI_A",31,23,-8,-29.63,"undercount"
"10012",47147,"Tennessee","Robertson County","NHPI_AIC",63,72,9,13.33,"overcount"
"10013",47149,"Tennessee","Rutherford County","A_A",12290,12579,289,2.32,"overcount"
"10014",47149,"Tennessee","Rutherford County","A_AIC",14787,15857,1070,6.98,"overcount"
"10015",47149,"Tennessee","Rutherford County","NHPI_A",243,235,-8,-3.35,"undercount"
"10016",47149,"Tennessee","Rutherford County","NHPI_AIC",505,556,51,9.61,"overcount"
"10017",47151,"Tennessee","Scott County","A_A",74,51,-23,-36.8,"undercount"
"10018",47151,"Tennessee","Scott County","A_AIC",106,96,-10,-9.9,"undercount"
"10019",47151,"Tennessee","Scott County","NHPI_A",1,0,-1,-200,"undercount"
"10020",47151,"Tennessee","Scott County","NHPI_AIC",8,13,5,47.62,"overcount"
"10021",47153,"Tennessee","Sequatchie County","A_A",60,65,5,8,"overcount"
"10022",47153,"Tennessee","Sequatchie County","A_AIC",85,107,22,22.92,"overcount"
"10023",47153,"Tennessee","Sequatchie County","NHPI_A",8,5,-3,-46.15,"undercount"
"10024",47153,"Tennessee","Sequatchie County","NHPI_AIC",16,17,1,6.06,"overcount"
"10025",47155,"Tennessee","Sevier County","A_A",1168,1121,-47,-4.11,"undercount"
"10026",47155,"Tennessee","Sevier County","A_AIC",1530,1497,-33,-2.18,"undercount"
"10027",47155,"Tennessee","Sevier County","NHPI_A",39,24,-15,-47.62,"undercount"
"10028",47155,"Tennessee","Sevier County","NHPI_AIC",87,78,-9,-10.91,"undercount"
"10029",47157,"Tennessee","Shelby County","A_A",26292,28288,1996,7.31,"overcount"
"10030",47157,"Tennessee","Shelby County","A_AIC",30798,33537,2739,8.51,"overcount"
"10031",47157,"Tennessee","Shelby County","NHPI_A",144,264,120,58.82,"overcount"
"10032",47157,"Tennessee","Shelby County","NHPI_AIC",767,919,152,18.03,"overcount"
"10033",47159,"Tennessee","Smith County","A_A",89,85,-4,-4.6,"undercount"
"10034",47159,"Tennessee","Smith County","A_AIC",123,140,17,12.93,"overcount"
"10035",47159,"Tennessee","Smith County","NHPI_A",5,0,-5,-200,"undercount"
"10036",47159,"Tennessee","Smith County","NHPI_AIC",9,14,5,43.48,"overcount"
"10037",47161,"Tennessee","Stewart County","A_A",136,76,-60,-56.6,"undercount"
"10038",47161,"Tennessee","Stewart County","A_AIC",189,134,-55,-34.06,"undercount"
"10039",47161,"Tennessee","Stewart County","NHPI_A",9,5,-4,-57.14,"undercount"
"10040",47161,"Tennessee","Stewart County","NHPI_AIC",17,26,9,41.86,"overcount"
"10041",47163,"Tennessee","Sullivan County","A_A",1228,1270,42,3.36,"overcount"
"10042",47163,"Tennessee","Sullivan County","A_AIC",1642,1821,179,10.34,"overcount"
"10043",47163,"Tennessee","Sullivan County","NHPI_A",53,38,-15,-32.97,"undercount"
"10044",47163,"Tennessee","Sullivan County","NHPI_AIC",116,114,-2,-1.74,"undercount"
"10045",47165,"Tennessee","Sumner County","A_A",3000,2976,-24,-0.8,"undercount"
"10046",47165,"Tennessee","Sumner County","A_AIC",3966,4167,201,4.94,"overcount"
"10047",47165,"Tennessee","Sumner County","NHPI_A",130,117,-13,-10.53,"undercount"
"10048",47165,"Tennessee","Sumner County","NHPI_AIC",250,268,18,6.95,"overcount"
"10049",47167,"Tennessee","Tipton County","A_A",449,398,-51,-12.04,"undercount"
"10050",47167,"Tennessee","Tipton County","A_AIC",747,788,41,5.34,"overcount"
"10051",47167,"Tennessee","Tipton County","NHPI_A",79,39,-40,-67.8,"undercount"
"10052",47167,"Tennessee","Tipton County","NHPI_AIC",132,121,-11,-8.7,"undercount"
"10053",47169,"Tennessee","Trousdale County","A_A",50,27,-23,-59.74,"undercount"
"10054",47169,"Tennessee","Trousdale County","A_AIC",63,85,22,29.73,"overcount"
"10055",47169,"Tennessee","Trousdale County","NHPI_A",3,0,-3,-200,"undercount"
"10056",47169,"Tennessee","Trousdale County","NHPI_AIC",5,22,17,125.93,"overcount"
"10057",47171,"Tennessee","Unicoi County","A_A",64,37,-27,-53.47,"undercount"
"10058",47171,"Tennessee","Unicoi County","A_AIC",83,75,-8,-10.13,"undercount"
"10059",47171,"Tennessee","Unicoi County","NHPI_A",5,0,-5,-200,"undercount"
"10060",47171,"Tennessee","Unicoi County","NHPI_AIC",8,10,2,22.22,"overcount"
"10061",47173,"Tennessee","Union County","A_A",41,36,-5,-12.99,"undercount"
"10062",47173,"Tennessee","Union County","A_AIC",62,63,1,1.6,"overcount"
"10063",47173,"Tennessee","Union County","NHPI_A",3,5,2,50,"overcount"
"10064",47173,"Tennessee","Union County","NHPI_AIC",5,22,17,125.93,"overcount"
"10065",47175,"Tennessee","Van Buren County","A_A",15,10,-5,-40,"undercount"
"10066",47175,"Tennessee","Van Buren County","A_AIC",23,32,9,32.73,"overcount"
"10067",47175,"Tennessee","Van Buren County","NHPI_A",0,1,1,200,"overcount"
"10068",47175,"Tennessee","Van Buren County","NHPI_AIC",1,3,2,100,"overcount"
"10069",47177,"Tennessee","Warren County","A_A",327,263,-64,-21.69,"undercount"
"10070",47177,"Tennessee","Warren County","A_AIC",395,362,-33,-8.72,"undercount"
"10071",47177,"Tennessee","Warren County","NHPI_A",15,10,-5,-40,"undercount"
"10072",47177,"Tennessee","Warren County","NHPI_AIC",28,42,14,40,"overcount"
"10073",47179,"Tennessee","Washington County","A_A",2149,1990,-159,-7.68,"undercount"
"10074",47179,"Tennessee","Washington County","A_AIC",2686,2664,-22,-0.82,"undercount"
"10075",47179,"Tennessee","Washington County","NHPI_A",47,58,11,20.95,"overcount"
"10076",47179,"Tennessee","Washington County","NHPI_AIC",136,138,2,1.46,"overcount"
"10077",47181,"Tennessee","Wayne County","A_A",45,27,-18,-50,"undercount"
"10078",47181,"Tennessee","Wayne County","A_AIC",65,45,-20,-36.36,"undercount"
"10079",47181,"Tennessee","Wayne County","NHPI_A",2,1,-1,-66.67,"undercount"
"10080",47181,"Tennessee","Wayne County","NHPI_AIC",6,17,11,95.65,"overcount"
"10081",47183,"Tennessee","Weakley County","A_A",388,196,-192,-65.75,"undercount"
"10082",47183,"Tennessee","Weakley County","A_AIC",471,316,-155,-39.39,"undercount"
"10083",47183,"Tennessee","Weakley County","NHPI_A",16,3,-13,-136.84,"undercount"
"10084",47183,"Tennessee","Weakley County","NHPI_AIC",35,40,5,13.33,"overcount"
"10085",47185,"Tennessee","White County","A_A",121,132,11,8.7,"overcount"
"10086",47185,"Tennessee","White County","A_AIC",166,205,39,21.02,"overcount"
"10087",47185,"Tennessee","White County","NHPI_A",22,10,-12,-75,"undercount"
"10088",47185,"Tennessee","White County","NHPI_AIC",35,26,-9,-29.51,"undercount"
"10089",47187,"Tennessee","Williamson County","A_A",12912,12947,35,0.27,"overcount"
"10090",47187,"Tennessee","Williamson County","A_AIC",14793,15328,535,3.55,"overcount"
"10091",47187,"Tennessee","Williamson County","NHPI_A",104,121,17,15.11,"overcount"
"10092",47187,"Tennessee","Williamson County","NHPI_AIC",258,360,102,33.01,"overcount"
"10093",47189,"Tennessee","Wilson County","A_A",2773,3132,359,12.16,"overcount"
"10094",47189,"Tennessee","Wilson County","A_AIC",3487,4173,686,17.91,"overcount"
"10095",47189,"Tennessee","Wilson County","NHPI_A",78,48,-30,-47.62,"undercount"
"10096",47189,"Tennessee","Wilson County","NHPI_AIC",186,174,-12,-6.67,"undercount"
"10097",48001,"Texas","Anderson County","A_A",388,381,-7,-1.82,"undercount"
"10098",48001,"Texas","Anderson County","A_AIC",531,500,-31,-6.01,"undercount"
"10099",48001,"Texas","Anderson County","NHPI_A",38,13,-25,-98.04,"undercount"
"10100",48001,"Texas","Anderson County","NHPI_AIC",85,45,-40,-61.54,"undercount"
"10101",48003,"Texas","Andrews County","A_A",110,106,-4,-3.7,"undercount"
"10102",48003,"Texas","Andrews County","A_AIC",132,127,-5,-3.86,"undercount"
"10103",48003,"Texas","Andrews County","NHPI_A",1,0,-1,-200,"undercount"
"10104",48003,"Texas","Andrews County","NHPI_AIC",5,12,7,82.35,"overcount"
"10105",48005,"Texas","Angelina County","A_A",803,897,94,11.06,"overcount"
"10106",48005,"Texas","Angelina County","A_AIC",1003,1092,89,8.5,"overcount"
"10107",48005,"Texas","Angelina County","NHPI_A",22,31,9,33.96,"overcount"
"10108",48005,"Texas","Angelina County","NHPI_AIC",61,56,-5,-8.55,"undercount"
"10109",48007,"Texas","Aransas County","A_A",423,481,58,12.83,"overcount"
"10110",48007,"Texas","Aransas County","A_AIC",479,598,119,22.1,"overcount"
"10111",48007,"Texas","Aransas County","NHPI_A",13,15,2,14.29,"overcount"
"10112",48007,"Texas","Aransas County","NHPI_AIC",19,42,23,75.41,"overcount"
"10113",48009,"Texas","Archer County","A_A",43,20,-23,-73.02,"undercount"
"10114",48009,"Texas","Archer County","A_AIC",72,57,-15,-23.26,"undercount"
"10115",48009,"Texas","Archer County","NHPI_A",5,0,-5,-200,"undercount"
"10116",48009,"Texas","Archer County","NHPI_AIC",10,13,3,26.09,"overcount"
"10117",48011,"Texas","Armstrong County","A_A",1,10,9,163.64,"overcount"
"10118",48011,"Texas","Armstrong County","A_AIC",5,14,9,94.74,"overcount"
"10119",48011,"Texas","Armstrong County","NHPI_A",0,0,0,0,"equal"
"10120",48011,"Texas","Armstrong County","NHPI_AIC",0,2,2,200,"overcount"
"10121",48013,"Texas","Atascosa County","A_A",223,172,-51,-25.82,"undercount"
"10122",48013,"Texas","Atascosa County","A_AIC",296,291,-5,-1.7,"undercount"
"10123",48013,"Texas","Atascosa County","NHPI_A",29,16,-13,-57.78,"undercount"
"10124",48013,"Texas","Atascosa County","NHPI_AIC",41,54,13,27.37,"overcount"
"10125",48015,"Texas","Austin County","A_A",228,201,-27,-12.59,"undercount"
"10126",48015,"Texas","Austin County","A_AIC",283,272,-11,-3.96,"undercount"
"10127",48015,"Texas","Austin County","NHPI_A",5,8,3,46.15,"overcount"
"10128",48015,"Texas","Austin County","NHPI_AIC",20,16,-4,-22.22,"undercount"
"10129",48017,"Texas","Bailey County","A_A",49,8,-41,-143.86,"undercount"
"10130",48017,"Texas","Bailey County","A_AIC",58,13,-45,-126.76,"undercount"
"10131",48017,"Texas","Bailey County","NHPI_A",0,0,0,0,"equal"
"10132",48017,"Texas","Bailey County","NHPI_AIC",3,0,-3,-200,"undercount"
"10133",48019,"Texas","Bandera County","A_A",129,95,-34,-30.36,"undercount"
"10134",48019,"Texas","Bandera County","A_AIC",176,187,11,6.06,"overcount"
"10135",48019,"Texas","Bandera County","NHPI_A",1,11,10,166.67,"overcount"
"10136",48019,"Texas","Bandera County","NHPI_AIC",10,47,37,129.82,"overcount"
"10137",48021,"Texas","Bastrop County","A_A",670,718,48,6.92,"overcount"
"10138",48021,"Texas","Bastrop County","A_AIC",939,1106,167,16.33,"overcount"
"10139",48021,"Texas","Bastrop County","NHPI_A",67,67,0,0,"equal"
"10140",48021,"Texas","Bastrop County","NHPI_AIC",128,131,3,2.32,"overcount"
"10141",48023,"Texas","Baylor County","A_A",13,9,-4,-36.36,"undercount"
"10142",48023,"Texas","Baylor County","A_AIC",23,22,-1,-4.44,"undercount"
"10143",48023,"Texas","Baylor County","NHPI_A",3,0,-3,-200,"undercount"
"10144",48023,"Texas","Baylor County","NHPI_AIC",6,6,0,0,"equal"
"10145",48025,"Texas","Bee County","A_A",196,213,17,8.31,"overcount"
"10146",48025,"Texas","Bee County","A_AIC",242,262,20,7.94,"overcount"
"10147",48025,"Texas","Bee County","NHPI_A",13,3,-10,-125,"undercount"
"10148",48025,"Texas","Bee County","NHPI_AIC",24,25,1,4.08,"overcount"
"10149",48027,"Texas","Bell County","A_A",10709,11095,386,3.54,"overcount"
"10150",48027,"Texas","Bell County","A_AIC",15730,16570,840,5.2,"overcount"
"10151",48027,"Texas","Bell County","NHPI_A",2639,3477,838,27.4,"overcount"
"10152",48027,"Texas","Bell County","NHPI_AIC",3852,5163,1311,29.08,"overcount"
"10153",48029,"Texas","Bexar County","A_A",61440,65951,4511,7.08,"overcount"
"10154",48029,"Texas","Bexar County","A_AIC",76075,83798,7723,9.66,"overcount"
"10155",48029,"Texas","Bexar County","NHPI_A",2577,2818,241,8.93,"overcount"
"10156",48029,"Texas","Bexar County","NHPI_AIC",4748,5908,1160,21.77,"overcount"
"10157",48031,"Texas","Blanco County","A_A",95,47,-48,-67.61,"undercount"
"10158",48031,"Texas","Blanco County","A_AIC",118,85,-33,-32.51,"undercount"
"10159",48031,"Texas","Blanco County","NHPI_A",6,0,-6,-200,"undercount"
"10160",48031,"Texas","Blanco County","NHPI_AIC",11,13,2,16.67,"overcount"
"10161",48033,"Texas","Borden County","A_A",1,1,0,0,"equal"
"10162",48033,"Texas","Borden County","A_AIC",1,10,9,163.64,"overcount"
"10163",48033,"Texas","Borden County","NHPI_A",0,0,0,0,"equal"
"10164",48033,"Texas","Borden County","NHPI_AIC",0,4,4,200,"overcount"
"10165",48035,"Texas","Bosque County","A_A",97,86,-11,-12.02,"undercount"
"10166",48035,"Texas","Bosque County","A_AIC",126,145,19,14.02,"overcount"
"10167",48035,"Texas","Bosque County","NHPI_A",3,3,0,0,"equal"
"10168",48035,"Texas","Bosque County","NHPI_AIC",11,11,0,0,"equal"
"10169",48037,"Texas","Bowie County","A_A",1137,1086,-51,-4.59,"undercount"
"10170",48037,"Texas","Bowie County","A_AIC",1469,1448,-21,-1.44,"undercount"
"10171",48037,"Texas","Bowie County","NHPI_A",81,69,-12,-16,"undercount"
"10172",48037,"Texas","Bowie County","NHPI_AIC",168,140,-28,-18.18,"undercount"
"10173",48039,"Texas","Brazoria County","A_A",26671,26389,-282,-1.06,"undercount"
"10174",48039,"Texas","Brazoria County","A_AIC",28936,29110,174,0.6,"overcount"
"10175",48039,"Texas","Brazoria County","NHPI_A",162,129,-33,-22.68,"undercount"
"10176",48039,"Texas","Brazoria County","NHPI_AIC",421,460,39,8.85,"overcount"
"10177",48041,"Texas","Brazos County","A_A",13917,14723,806,5.63,"overcount"
"10178",48041,"Texas","Brazos County","A_AIC",15573,16563,990,6.16,"overcount"
"10179",48041,"Texas","Brazos County","NHPI_A",141,211,70,39.77,"overcount"
"10180",48041,"Texas","Brazos County","NHPI_AIC",305,429,124,33.79,"overcount"
"10181",48043,"Texas","Brewster County","A_A",136,94,-42,-36.52,"undercount"
"10182",48043,"Texas","Brewster County","A_AIC",166,143,-23,-14.89,"undercount"
"10183",48043,"Texas","Brewster County","NHPI_A",7,11,4,44.44,"overcount"
"10184",48043,"Texas","Brewster County","NHPI_AIC",12,17,5,34.48,"overcount"
"10185",48045,"Texas","Briscoe County","A_A",4,0,-4,-200,"undercount"
"10186",48045,"Texas","Briscoe County","A_AIC",10,5,-5,-66.67,"undercount"
"10187",48045,"Texas","Briscoe County","NHPI_A",0,0,0,0,"equal"
"10188",48045,"Texas","Briscoe County","NHPI_AIC",1,0,-1,-200,"undercount"
"10189",48047,"Texas","Brooks County","A_A",64,29,-35,-75.27,"undercount"
"10190",48047,"Texas","Brooks County","A_AIC",69,37,-32,-60.38,"undercount"
"10191",48047,"Texas","Brooks County","NHPI_A",0,0,0,0,"equal"
"10192",48047,"Texas","Brooks County","NHPI_AIC",2,7,5,111.11,"overcount"
"10193",48049,"Texas","Brown County","A_A",257,269,12,4.56,"overcount"
"10194",48049,"Texas","Brown County","A_AIC",321,357,36,10.62,"overcount"
"10195",48049,"Texas","Brown County","NHPI_A",18,27,9,40,"overcount"
"10196",48049,"Texas","Brown County","NHPI_AIC",32,61,29,62.37,"overcount"
"10197",48051,"Texas","Burleson County","A_A",88,70,-18,-22.78,"undercount"
"10198",48051,"Texas","Burleson County","A_AIC",122,105,-17,-14.98,"undercount"
"10199",48051,"Texas","Burleson County","NHPI_A",6,0,-6,-200,"undercount"
"10200",48051,"Texas","Burleson County","NHPI_AIC",14,29,15,69.77,"overcount"
"10201",48053,"Texas","Burnet County","A_A",429,424,-5,-1.17,"undercount"
"10202",48053,"Texas","Burnet County","A_AIC",550,592,42,7.36,"overcount"
"10203",48053,"Texas","Burnet County","NHPI_A",30,15,-15,-66.67,"undercount"
"10204",48053,"Texas","Burnet County","NHPI_AIC",50,43,-7,-15.05,"undercount"
"10205",48055,"Texas","Caldwell County","A_A",404,232,-172,-54.09,"undercount"
"10206",48055,"Texas","Caldwell County","A_AIC",487,339,-148,-35.84,"undercount"
"10207",48055,"Texas","Caldwell County","NHPI_A",16,4,-12,-120,"undercount"
"10208",48055,"Texas","Caldwell County","NHPI_AIC",33,19,-14,-53.85,"undercount"
"10209",48057,"Texas","Calhoun County","A_A",1146,1127,-19,-1.67,"undercount"
"10210",48057,"Texas","Calhoun County","A_AIC",1179,1157,-22,-1.88,"undercount"
"10211",48057,"Texas","Calhoun County","NHPI_A",6,0,-6,-200,"undercount"
"10212",48057,"Texas","Calhoun County","NHPI_AIC",10,18,8,57.14,"overcount"
"10213",48059,"Texas","Callahan County","A_A",95,57,-38,-50,"undercount"
"10214",48059,"Texas","Callahan County","A_AIC",139,100,-39,-32.64,"undercount"
"10215",48059,"Texas","Callahan County","NHPI_A",9,7,-2,-25,"undercount"
"10216",48059,"Texas","Callahan County","NHPI_AIC",22,22,0,0,"equal"
"10217",48061,"Texas","Cameron County","A_A",2831,2640,-191,-6.98,"undercount"
"10218",48061,"Texas","Cameron County","A_AIC",3186,2965,-221,-7.19,"undercount"
"10219",48061,"Texas","Cameron County","NHPI_A",131,83,-48,-44.86,"undercount"
"10220",48061,"Texas","Cameron County","NHPI_AIC",180,167,-13,-7.49,"undercount"
"10221",48063,"Texas","Camp County","A_A",122,106,-16,-14.04,"undercount"
"10222",48063,"Texas","Camp County","A_AIC",156,131,-25,-17.42,"undercount"
"10223",48063,"Texas","Camp County","NHPI_A",17,8,-9,-72,"undercount"
"10224",48063,"Texas","Camp County","NHPI_AIC",23,24,1,4.26,"overcount"
"10225",48065,"Texas","Carson County","A_A",27,20,-7,-29.79,"undercount"
"10226",48065,"Texas","Carson County","A_AIC",54,30,-24,-57.14,"undercount"
"10227",48065,"Texas","Carson County","NHPI_A",3,2,-1,-40,"undercount"
"10228",48065,"Texas","Carson County","NHPI_AIC",8,6,-2,-28.57,"undercount"
"10229",48067,"Texas","Cass County","A_A",170,126,-44,-29.73,"undercount"
"10230",48067,"Texas","Cass County","A_AIC",249,195,-54,-24.32,"undercount"
"10231",48067,"Texas","Cass County","NHPI_A",7,10,3,35.29,"overcount"
"10232",48067,"Texas","Cass County","NHPI_AIC",32,48,16,40,"overcount"
"10233",48069,"Texas","Castro County","A_A",49,29,-20,-51.28,"undercount"
"10234",48069,"Texas","Castro County","A_AIC",56,45,-11,-21.78,"undercount"
"10235",48069,"Texas","Castro County","NHPI_A",0,4,4,200,"overcount"
"10236",48069,"Texas","Castro County","NHPI_AIC",2,12,10,142.86,"overcount"
"10237",48071,"Texas","Chambers County","A_A",583,631,48,7.91,"overcount"
"10238",48071,"Texas","Chambers County","A_AIC",709,827,118,15.36,"overcount"
"10239",48071,"Texas","Chambers County","NHPI_A",33,0,-33,-200,"undercount"
"10240",48071,"Texas","Chambers County","NHPI_AIC",55,28,-27,-65.06,"undercount"
"10241",48073,"Texas","Cherokee County","A_A",268,266,-2,-0.75,"undercount"
"10242",48073,"Texas","Cherokee County","A_AIC",381,385,4,1.04,"overcount"
"10243",48073,"Texas","Cherokee County","NHPI_A",15,18,3,18.18,"overcount"
"10244",48073,"Texas","Cherokee County","NHPI_AIC",44,36,-8,-20,"undercount"
"10245",48075,"Texas","Childress County","A_A",54,53,-1,-1.87,"undercount"
"10246",48075,"Texas","Childress County","A_AIC",74,74,0,0,"equal"
"10247",48075,"Texas","Childress County","NHPI_A",4,2,-2,-66.67,"undercount"
"10248",48075,"Texas","Childress County","NHPI_AIC",8,23,15,96.77,"overcount"
"10249",48077,"Texas","Clay County","A_A",80,56,-24,-35.29,"undercount"
"10250",48077,"Texas","Clay County","A_AIC",119,79,-40,-40.4,"undercount"
"10251",48077,"Texas","Clay County","NHPI_A",1,0,-1,-200,"undercount"
"10252",48077,"Texas","Clay County","NHPI_AIC",10,4,-6,-85.71,"undercount"
"10253",48079,"Texas","Cochran County","A_A",11,0,-11,-200,"undercount"
"10254",48079,"Texas","Cochran County","A_AIC",18,3,-15,-142.86,"undercount"
"10255",48079,"Texas","Cochran County","NHPI_A",3,0,-3,-200,"undercount"
"10256",48079,"Texas","Cochran County","NHPI_AIC",4,0,-4,-200,"undercount"
"10257",48081,"Texas","Coke County","A_A",5,2,-3,-85.71,"undercount"
"10258",48081,"Texas","Coke County","A_AIC",13,11,-2,-16.67,"undercount"
"10259",48081,"Texas","Coke County","NHPI_A",1,6,5,142.86,"overcount"
"10260",48081,"Texas","Coke County","NHPI_AIC",1,9,8,160,"overcount"
"10261",48083,"Texas","Coleman County","A_A",87,32,-55,-92.44,"undercount"
"10262",48083,"Texas","Coleman County","A_AIC",111,44,-67,-86.45,"undercount"
"10263",48083,"Texas","Coleman County","NHPI_A",1,0,-1,-200,"undercount"
"10264",48083,"Texas","Coleman County","NHPI_AIC",4,7,3,54.55,"overcount"
"10265",48085,"Texas","Collin County","A_A",181535,189375,7840,4.23,"overcount"
"10266",48085,"Texas","Collin County","A_AIC",195373,204746,9373,4.69,"overcount"
"10267",48085,"Texas","Collin County","NHPI_A",796,647,-149,-20.65,"undercount"
"10268",48085,"Texas","Collin County","NHPI_AIC",1927,2042,115,5.79,"overcount"
"10269",48087,"Texas","Collingsworth County","A_A",3,7,4,80,"overcount"
"10270",48087,"Texas","Collingsworth County","A_AIC",15,20,5,28.57,"overcount"
"10271",48087,"Texas","Collingsworth County","NHPI_A",0,1,1,200,"overcount"
"10272",48087,"Texas","Collingsworth County","NHPI_AIC",0,14,14,200,"overcount"
"10273",48089,"Texas","Colorado County","A_A",126,80,-46,-44.66,"undercount"
"10274",48089,"Texas","Colorado County","A_AIC",172,126,-46,-30.87,"undercount"
"10275",48089,"Texas","Colorado County","NHPI_A",12,0,-12,-200,"undercount"
"10276",48089,"Texas","Colorado County","NHPI_AIC",23,11,-12,-70.59,"undercount"
"10277",48091,"Texas","Comal County","A_A",2091,1858,-233,-11.8,"undercount"
"10278",48091,"Texas","Comal County","A_AIC",2899,3056,157,5.27,"overcount"
"10279",48091,"Texas","Comal County","NHPI_A",133,137,4,2.96,"overcount"
"10280",48091,"Texas","Comal County","NHPI_AIC",207,328,121,45.23,"overcount"
"10281",48093,"Texas","Comanche County","A_A",73,41,-32,-56.14,"undercount"
"10282",48093,"Texas","Comanche County","A_AIC",98,60,-38,-48.1,"undercount"
"10283",48093,"Texas","Comanche County","NHPI_A",5,3,-2,-50,"undercount"
"10284",48093,"Texas","Comanche County","NHPI_AIC",9,13,4,36.36,"overcount"
"10285",48095,"Texas","Concho County","A_A",54,27,-27,-66.67,"undercount"
"10286",48095,"Texas","Concho County","A_AIC",59,42,-17,-33.66,"undercount"
"10287",48095,"Texas","Concho County","NHPI_A",1,1,0,0,"equal"
"10288",48095,"Texas","Concho County","NHPI_AIC",2,9,7,127.27,"overcount"
"10289",48097,"Texas","Cooke County","A_A",381,308,-73,-21.19,"undercount"
"10290",48097,"Texas","Cooke County","A_AIC",454,426,-28,-6.36,"undercount"
"10291",48097,"Texas","Cooke County","NHPI_A",18,14,-4,-25,"undercount"
"10292",48097,"Texas","Cooke County","NHPI_AIC",44,31,-13,-34.67,"undercount"
"10293",48099,"Texas","Coryell County","A_A",1581,1821,240,14.11,"overcount"
"10294",48099,"Texas","Coryell County","A_AIC",2557,2946,389,14.14,"overcount"
"10295",48099,"Texas","Coryell County","NHPI_A",638,1051,413,48.9,"overcount"
"10296",48099,"Texas","Coryell County","NHPI_AIC",855,1389,534,47.59,"overcount"
"10297",48101,"Texas","Cottle County","A_A",2,0,-2,-200,"undercount"
"10298",48101,"Texas","Cottle County","A_AIC",5,15,10,100,"overcount"
"10299",48101,"Texas","Cottle County","NHPI_A",1,1,0,0,"equal"
"10300",48101,"Texas","Cottle County","NHPI_AIC",2,11,9,138.46,"overcount"
"10301",48103,"Texas","Crane County","A_A",27,22,-5,-20.41,"undercount"
"10302",48103,"Texas","Crane County","A_AIC",34,30,-4,-12.5,"undercount"
"10303",48103,"Texas","Crane County","NHPI_A",7,0,-7,-200,"undercount"
"10304",48103,"Texas","Crane County","NHPI_AIC",7,5,-2,-33.33,"undercount"
"10305",48105,"Texas","Crockett County","A_A",34,11,-23,-102.22,"undercount"
"10306",48105,"Texas","Crockett County","A_AIC",36,15,-21,-82.35,"undercount"
"10307",48105,"Texas","Crockett County","NHPI_A",0,0,0,0,"equal"
"10308",48105,"Texas","Crockett County","NHPI_AIC",0,4,4,200,"overcount"
"10309",48107,"Texas","Crosby County","A_A",13,12,-1,-8,"undercount"
"10310",48107,"Texas","Crosby County","A_AIC",25,20,-5,-22.22,"undercount"
"10311",48107,"Texas","Crosby County","NHPI_A",2,0,-2,-200,"undercount"
"10312",48107,"Texas","Crosby County","NHPI_AIC",3,9,6,100,"overcount"
"10313",48109,"Texas","Culberson County","A_A",38,28,-10,-30.3,"undercount"
"10314",48109,"Texas","Culberson County","A_AIC",45,44,-1,-2.25,"undercount"
"10315",48109,"Texas","Culberson County","NHPI_A",1,0,-1,-200,"undercount"
"10316",48109,"Texas","Culberson County","NHPI_AIC",2,3,1,40,"overcount"
"10317",48111,"Texas","Dallam County","A_A",60,10,-50,-142.86,"undercount"
"10318",48111,"Texas","Dallam County","A_AIC",69,16,-53,-124.71,"undercount"
"10319",48111,"Texas","Dallam County","NHPI_A",6,3,-3,-66.67,"undercount"
"10320",48111,"Texas","Dallam County","NHPI_AIC",9,10,1,10.53,"overcount"
"10321",48113,"Texas","Dallas County","A_A",177684,182873,5189,2.88,"overcount"
"10322",48113,"Texas","Dallas County","A_AIC",191563,199036,7473,3.83,"overcount"
"10323",48113,"Texas","Dallas County","NHPI_A",1154,1200,46,3.91,"overcount"
"10324",48113,"Texas","Dallas County","NHPI_AIC",3002,3086,84,2.76,"overcount"
"10325",48115,"Texas","Dawson County","A_A",95,57,-38,-50,"undercount"
"10326",48115,"Texas","Dawson County","A_AIC",115,75,-40,-42.11,"undercount"
"10327",48115,"Texas","Dawson County","NHPI_A",6,4,-2,-40,"undercount"
"10328",48115,"Texas","Dawson County","NHPI_AIC",11,11,0,0,"equal"
"10329",48117,"Texas","Deaf Smith County","A_A",84,44,-40,-62.5,"undercount"
"10330",48117,"Texas","Deaf Smith County","A_AIC",109,57,-52,-62.65,"undercount"
"10331",48117,"Texas","Deaf Smith County","NHPI_A",2,0,-2,-200,"undercount"
"10332",48117,"Texas","Deaf Smith County","NHPI_AIC",8,3,-5,-90.91,"undercount"
"10333",48119,"Texas","Delta County","A_A",35,37,2,5.56,"overcount"
"10334",48119,"Texas","Delta County","A_AIC",60,48,-12,-22.22,"undercount"
"10335",48119,"Texas","Delta County","NHPI_A",1,5,4,133.33,"overcount"
"10336",48119,"Texas","Delta County","NHPI_AIC",4,10,6,85.71,"overcount"
"10337",48121,"Texas","Denton County","A_A",91564,93339,1775,1.92,"overcount"
"10338",48121,"Texas","Denton County","A_AIC",100437,104224,3787,3.7,"overcount"
"10339",48121,"Texas","Denton County","NHPI_A",746,669,-77,-10.88,"undercount"
"10340",48121,"Texas","Denton County","NHPI_AIC",1784,1952,168,8.99,"overcount"
"10341",48123,"Texas","DeWitt County","A_A",79,70,-9,-12.08,"undercount"
"10342",48123,"Texas","DeWitt County","A_AIC",96,94,-2,-2.11,"undercount"
"10343",48123,"Texas","DeWitt County","NHPI_A",4,2,-2,-66.67,"undercount"
"10344",48123,"Texas","DeWitt County","NHPI_AIC",10,11,1,9.52,"overcount"
"10345",48125,"Texas","Dickens County","A_A",24,2,-22,-169.23,"undercount"
"10346",48125,"Texas","Dickens County","A_AIC",28,9,-19,-102.7,"undercount"
"10347",48125,"Texas","Dickens County","NHPI_A",0,3,3,200,"overcount"
"10348",48125,"Texas","Dickens County","NHPI_AIC",1,9,8,160,"overcount"
"10349",48127,"Texas","Dimmit County","A_A",64,68,4,6.06,"overcount"
"10350",48127,"Texas","Dimmit County","A_AIC",68,76,8,11.11,"overcount"
"10351",48127,"Texas","Dimmit County","NHPI_A",1,10,9,163.64,"overcount"
"10352",48127,"Texas","Dimmit County","NHPI_AIC",3,13,10,125,"overcount"
"10353",48129,"Texas","Donley County","A_A",23,11,-12,-70.59,"undercount"
"10354",48129,"Texas","Donley County","A_AIC",35,30,-5,-15.38,"undercount"
"10355",48129,"Texas","Donley County","NHPI_A",2,1,-1,-66.67,"undercount"
"10356",48129,"Texas","Donley County","NHPI_AIC",6,9,3,40,"overcount"
"10357",48131,"Texas","Duval County","A_A",36,46,10,24.39,"overcount"
"10358",48131,"Texas","Duval County","A_AIC",41,60,19,37.62,"overcount"
"10359",48131,"Texas","Duval County","NHPI_A",7,0,-7,-200,"undercount"
"10360",48131,"Texas","Duval County","NHPI_AIC",7,3,-4,-80,"undercount"
"10361",48133,"Texas","Eastland County","A_A",134,98,-36,-31.03,"undercount"
"10362",48133,"Texas","Eastland County","A_AIC",168,149,-19,-11.99,"undercount"
"10363",48133,"Texas","Eastland County","NHPI_A",9,16,7,56,"overcount"
"10364",48133,"Texas","Eastland County","NHPI_AIC",17,25,8,38.1,"overcount"
"10365",48135,"Texas","Ector County","A_A",1897,2279,382,18.3,"overcount"
"10366",48135,"Texas","Ector County","A_AIC",2204,2677,473,19.38,"overcount"
"10367",48135,"Texas","Ector County","NHPI_A",301,327,26,8.28,"overcount"
"10368",48135,"Texas","Ector County","NHPI_AIC",347,377,30,8.29,"overcount"
"10369",48137,"Texas","Edwards County","A_A",6,11,5,58.82,"overcount"
"10370",48137,"Texas","Edwards County","A_AIC",10,19,9,62.07,"overcount"
"10371",48137,"Texas","Edwards County","NHPI_A",0,1,1,200,"overcount"
"10372",48137,"Texas","Edwards County","NHPI_AIC",0,6,6,200,"overcount"
"10373",48139,"Texas","Ellis County","A_A",1554,1536,-18,-1.17,"undercount"
"10374",48139,"Texas","Ellis County","A_AIC",2267,2402,135,5.78,"overcount"
"10375",48139,"Texas","Ellis County","NHPI_A",164,202,38,20.77,"overcount"
"10376",48139,"Texas","Ellis County","NHPI_AIC",296,370,74,22.22,"overcount"
"10377",48141,"Texas","El Paso County","A_A",9910,10826,916,8.83,"overcount"
"10378",48141,"Texas","El Paso County","A_AIC",13116,14296,1180,8.61,"overcount"
"10379",48141,"Texas","El Paso County","NHPI_A",1271,1544,273,19.4,"overcount"
"10380",48141,"Texas","El Paso County","NHPI_AIC",1752,2265,513,25.54,"overcount"
"10381",48143,"Texas","Erath County","A_A",429,349,-80,-20.57,"undercount"
"10382",48143,"Texas","Erath County","A_AIC",525,511,-14,-2.7,"undercount"
"10383",48143,"Texas","Erath County","NHPI_A",40,13,-27,-101.89,"undercount"
"10384",48143,"Texas","Erath County","NHPI_AIC",66,66,0,0,"equal"
"10385",48145,"Texas","Falls County","A_A",82,51,-31,-46.62,"undercount"
"10386",48145,"Texas","Falls County","A_AIC",115,79,-36,-37.11,"undercount"
"10387",48145,"Texas","Falls County","NHPI_A",19,8,-11,-81.48,"undercount"
"10388",48145,"Texas","Falls County","NHPI_AIC",28,12,-16,-80,"undercount"
"10389",48147,"Texas","Fannin County","A_A",274,145,-129,-61.58,"undercount"
"10390",48147,"Texas","Fannin County","A_AIC",346,284,-62,-19.68,"undercount"
"10391",48147,"Texas","Fannin County","NHPI_A",16,20,4,22.22,"overcount"
"10392",48147,"Texas","Fannin County","NHPI_AIC",41,29,-12,-34.29,"undercount"
"10393",48149,"Texas","Fayette County","A_A",99,68,-31,-37.13,"undercount"
"10394",48149,"Texas","Fayette County","A_AIC",123,109,-14,-12.07,"undercount"
"10395",48149,"Texas","Fayette County","NHPI_A",10,6,-4,-50,"undercount"
"10396",48149,"Texas","Fayette County","NHPI_AIC",23,17,-6,-30,"undercount"
"10397",48151,"Texas","Fisher County","A_A",15,13,-2,-14.29,"undercount"
"10398",48151,"Texas","Fisher County","A_AIC",21,18,-3,-15.38,"undercount"
"10399",48151,"Texas","Fisher County","NHPI_A",0,2,2,200,"overcount"
"10400",48151,"Texas","Fisher County","NHPI_AIC",3,7,4,80,"overcount"
"10401",48153,"Texas","Floyd County","A_A",21,12,-9,-54.55,"undercount"
"10402",48153,"Texas","Floyd County","A_AIC",28,33,5,16.39,"overcount"
"10403",48153,"Texas","Floyd County","NHPI_A",3,1,-2,-100,"undercount"
"10404",48153,"Texas","Floyd County","NHPI_AIC",7,6,-1,-15.38,"undercount"
"10405",48155,"Texas","Foard County","A_A",9,3,-6,-100,"undercount"
"10406",48155,"Texas","Foard County","A_AIC",11,5,-6,-75,"undercount"
"10407",48155,"Texas","Foard County","NHPI_A",0,1,1,200,"overcount"
"10408",48155,"Texas","Foard County","NHPI_AIC",1,4,3,120,"overcount"
"10409",48157,"Texas","Fort Bend County","A_A",178128,182977,4849,2.69,"overcount"
"10410",48157,"Texas","Fort Bend County","A_AIC",186721,192533,5812,3.06,"overcount"
"10411",48157,"Texas","Fort Bend County","NHPI_A",416,299,-117,-32.73,"undercount"
"10412",48157,"Texas","Fort Bend County","NHPI_AIC",1160,1083,-77,-6.87,"undercount"
"10413",48159,"Texas","Franklin County","A_A",104,68,-36,-41.86,"undercount"
"10414",48159,"Texas","Franklin County","A_AIC",130,93,-37,-33.18,"undercount"
"10415",48159,"Texas","Franklin County","NHPI_A",5,6,1,18.18,"overcount"
"10416",48159,"Texas","Franklin County","NHPI_AIC",17,24,7,34.15,"overcount"
"10417",48161,"Texas","Freestone County","A_A",115,66,-49,-54.14,"undercount"
"10418",48161,"Texas","Freestone County","A_AIC",152,110,-42,-32.06,"undercount"
"10419",48161,"Texas","Freestone County","NHPI_A",12,11,-1,-8.7,"undercount"
"10420",48161,"Texas","Freestone County","NHPI_AIC",32,23,-9,-32.73,"undercount"
"10421",48163,"Texas","Frio County","A_A",506,224,-282,-77.26,"undercount"
"10422",48163,"Texas","Frio County","A_AIC",520,227,-293,-78.45,"undercount"
"10423",48163,"Texas","Frio County","NHPI_A",4,9,5,76.92,"overcount"
"10424",48163,"Texas","Frio County","NHPI_AIC",10,9,-1,-10.53,"undercount"
"10425",48165,"Texas","Gaines County","A_A",90,72,-18,-22.22,"undercount"
"10426",48165,"Texas","Gaines County","A_AIC",122,105,-17,-14.98,"undercount"
"10427",48165,"Texas","Gaines County","NHPI_A",0,3,3,200,"overcount"
"10428",48165,"Texas","Gaines County","NHPI_AIC",11,12,1,8.7,"overcount"
"10429",48167,"Texas","Galveston County","A_A",11697,12303,606,5.05,"overcount"
"10430",48167,"Texas","Galveston County","A_AIC",13806,14862,1056,7.37,"overcount"
"10431",48167,"Texas","Galveston County","NHPI_A",185,247,62,28.7,"overcount"
"10432",48167,"Texas","Galveston County","NHPI_AIC",463,619,156,28.84,"overcount"
"10433",48169,"Texas","Garza County","A_A",20,25,5,22.22,"overcount"
"10434",48169,"Texas","Garza County","A_AIC",25,39,14,43.75,"overcount"
"10435",48169,"Texas","Garza County","NHPI_A",3,0,-3,-200,"undercount"
"10436",48169,"Texas","Garza County","NHPI_AIC",4,8,4,66.67,"overcount"
"10437",48171,"Texas","Gillespie County","A_A",144,131,-13,-9.45,"undercount"
"10438",48171,"Texas","Gillespie County","A_AIC",174,195,21,11.38,"overcount"
"10439",48171,"Texas","Gillespie County","NHPI_A",23,1,-22,-183.33,"undercount"
"10440",48171,"Texas","Gillespie County","NHPI_AIC",34,18,-16,-61.54,"undercount"
"10441",48173,"Texas","Glasscock County","A_A",2,0,-2,-200,"undercount"
"10442",48173,"Texas","Glasscock County","A_AIC",2,0,-2,-200,"undercount"
"10443",48173,"Texas","Glasscock County","NHPI_A",2,3,1,40,"overcount"
"10444",48173,"Texas","Glasscock County","NHPI_AIC",2,3,1,40,"overcount"
"10445",48175,"Texas","Goliad County","A_A",40,27,-13,-38.81,"undercount"
"10446",48175,"Texas","Goliad County","A_AIC",54,50,-4,-7.69,"undercount"
"10447",48175,"Texas","Goliad County","NHPI_A",0,0,0,0,"equal"
"10448",48175,"Texas","Goliad County","NHPI_AIC",5,7,2,33.33,"overcount"
"10449",48177,"Texas","Gonzales County","A_A",103,70,-33,-38.15,"undercount"
"10450",48177,"Texas","Gonzales County","A_AIC",123,105,-18,-15.79,"undercount"
"10451",48177,"Texas","Gonzales County","NHPI_A",9,6,-3,-40,"undercount"
"10452",48177,"Texas","Gonzales County","NHPI_AIC",18,19,1,5.41,"overcount"
"10453",48179,"Texas","Gray County","A_A",127,127,0,0,"equal"
"10454",48179,"Texas","Gray County","A_AIC",177,173,-4,-2.29,"undercount"
"10455",48179,"Texas","Gray County","NHPI_A",1,0,-1,-200,"undercount"
"10456",48179,"Texas","Gray County","NHPI_AIC",17,12,-5,-34.48,"undercount"
"10457",48181,"Texas","Grayson County","A_A",1994,1970,-24,-1.21,"undercount"
"10458",48181,"Texas","Grayson County","A_AIC",2655,2565,-90,-3.45,"undercount"
"10459",48181,"Texas","Grayson County","NHPI_A",78,59,-19,-27.74,"undercount"
"10460",48181,"Texas","Grayson County","NHPI_AIC",192,177,-15,-8.13,"undercount"
"10461",48183,"Texas","Gregg County","A_A",1617,1633,16,0.98,"overcount"
"10462",48183,"Texas","Gregg County","A_AIC",2097,2068,-29,-1.39,"undercount"
"10463",48183,"Texas","Gregg County","NHPI_A",50,50,0,0,"equal"
"10464",48183,"Texas","Gregg County","NHPI_AIC",177,114,-63,-43.3,"undercount"
"10465",48185,"Texas","Grimes County","A_A",113,126,13,10.88,"overcount"
"10466",48185,"Texas","Grimes County","A_AIC",161,197,36,20.11,"overcount"
"10467",48185,"Texas","Grimes County","NHPI_A",17,8,-9,-72,"undercount"
"10468",48185,"Texas","Grimes County","NHPI_AIC",33,18,-15,-58.82,"undercount"
"10469",48187,"Texas","Guadalupe County","A_A",3140,3164,24,0.76,"overcount"
"10470",48187,"Texas","Guadalupe County","A_AIC",4647,4947,300,6.25,"overcount"
"10471",48187,"Texas","Guadalupe County","NHPI_A",296,369,73,21.95,"overcount"
"10472",48187,"Texas","Guadalupe County","NHPI_AIC",549,656,107,17.76,"overcount"
"10473",48189,"Texas","Hale County","A_A",151,153,2,1.32,"overcount"
"10474",48189,"Texas","Hale County","A_AIC",216,211,-5,-2.34,"undercount"
"10475",48189,"Texas","Hale County","NHPI_A",29,30,1,3.39,"overcount"
"10476",48189,"Texas","Hale County","NHPI_AIC",48,49,1,2.06,"overcount"
"10477",48191,"Texas","Hall County","A_A",6,9,3,40,"overcount"
"10478",48191,"Texas","Hall County","A_AIC",11,19,8,53.33,"overcount"
"10479",48191,"Texas","Hall County","NHPI_A",1,0,-1,-200,"undercount"
"10480",48191,"Texas","Hall County","NHPI_AIC",1,4,3,120,"overcount"
"10481",48193,"Texas","Hamilton County","A_A",59,37,-22,-45.83,"undercount"
"10482",48193,"Texas","Hamilton County","A_AIC",79,48,-31,-48.82,"undercount"
"10483",48193,"Texas","Hamilton County","NHPI_A",2,2,0,0,"equal"
"10484",48193,"Texas","Hamilton County","NHPI_AIC",6,6,0,0,"equal"
"10485",48195,"Texas","Hansford County","A_A",19,9,-10,-71.43,"undercount"
"10486",48195,"Texas","Hansford County","A_AIC",30,10,-20,-100,"undercount"
"10487",48195,"Texas","Hansford County","NHPI_A",3,3,0,0,"equal"
"10488",48195,"Texas","Hansford County","NHPI_AIC",3,4,1,28.57,"overcount"
"10489",48197,"Texas","Hardeman County","A_A",22,18,-4,-20,"undercount"
"10490",48197,"Texas","Hardeman County","A_AIC",37,26,-11,-34.92,"undercount"
"10491",48197,"Texas","Hardeman County","NHPI_A",0,1,1,200,"overcount"
"10492",48197,"Texas","Hardeman County","NHPI_AIC",6,6,0,0,"equal"
"10493",48199,"Texas","Hardin County","A_A",443,411,-32,-7.49,"undercount"
"10494",48199,"Texas","Hardin County","A_AIC",615,597,-18,-2.97,"undercount"
"10495",48199,"Texas","Hardin County","NHPI_A",10,37,27,114.89,"overcount"
"10496",48199,"Texas","Hardin County","NHPI_AIC",40,81,41,67.77,"overcount"
"10497",48201,"Texas","Harris County","A_A",342302,348281,5979,1.73,"overcount"
"10498",48201,"Texas","Harris County","A_AIC",371482,382276,10794,2.86,"overcount"
"10499",48201,"Texas","Harris County","NHPI_A",2296,3374,1078,38.02,"overcount"
"10500",48201,"Texas","Harris County","NHPI_AIC",6082,7573,1491,21.84,"overcount"
"10501",48203,"Texas","Harrison County","A_A",453,489,36,7.64,"overcount"
"10502",48203,"Texas","Harrison County","A_AIC",607,694,87,13.37,"overcount"
"10503",48203,"Texas","Harrison County","NHPI_A",29,33,4,12.9,"overcount"
"10504",48203,"Texas","Harrison County","NHPI_AIC",70,80,10,13.33,"overcount"
"10505",48205,"Texas","Hartley County","A_A",40,24,-16,-50,"undercount"
"10506",48205,"Texas","Hartley County","A_AIC",47,28,-19,-50.67,"undercount"
"10507",48205,"Texas","Hartley County","NHPI_A",2,5,3,85.71,"overcount"
"10508",48205,"Texas","Hartley County","NHPI_AIC",4,10,6,85.71,"overcount"
"10509",48207,"Texas","Haskell County","A_A",50,22,-28,-77.78,"undercount"
"10510",48207,"Texas","Haskell County","A_AIC",71,30,-41,-81.19,"undercount"
"10511",48207,"Texas","Haskell County","NHPI_A",0,5,5,200,"overcount"
"10512",48207,"Texas","Haskell County","NHPI_AIC",10,6,-4,-50,"undercount"
"10513",48209,"Texas","Hays County","A_A",3997,4890,893,20.1,"overcount"
"10514",48209,"Texas","Hays County","A_AIC",5567,9409,3842,51.31,"overcount"
"10515",48209,"Texas","Hays County","NHPI_A",188,146,-42,-25.15,"undercount"
"10516",48209,"Texas","Hays County","NHPI_AIC",372,2790,2418,152.94,"overcount"
"10517",48211,"Texas","Hemphill County","A_A",43,10,-33,-124.53,"undercount"
"10518",48211,"Texas","Hemphill County","A_AIC",54,31,-23,-54.12,"undercount"
"10519",48211,"Texas","Hemphill County","NHPI_A",3,0,-3,-200,"undercount"
"10520",48211,"Texas","Hemphill County","NHPI_AIC",5,3,-2,-50,"undercount"
"10521",48213,"Texas","Henderson County","A_A",526,510,-16,-3.09,"undercount"
"10522",48213,"Texas","Henderson County","A_AIC",670,733,63,8.98,"overcount"
"10523",48213,"Texas","Henderson County","NHPI_A",43,31,-12,-32.43,"undercount"
"10524",48213,"Texas","Henderson County","NHPI_AIC",82,106,24,25.53,"overcount"
"10525",48215,"Texas","Hidalgo County","A_A",8187,8831,644,7.57,"overcount"
"10526",48215,"Texas","Hidalgo County","A_AIC",8770,9395,625,6.88,"overcount"
"10527",48215,"Texas","Hidalgo County","NHPI_A",118,78,-40,-40.82,"undercount"
"10528",48215,"Texas","Hidalgo County","NHPI_AIC",214,173,-41,-21.19,"undercount"
"10529",48217,"Texas","Hill County","A_A",225,188,-37,-17.92,"undercount"
"10530",48217,"Texas","Hill County","A_AIC",299,260,-39,-13.95,"undercount"
"10531",48217,"Texas","Hill County","NHPI_A",37,15,-22,-84.62,"undercount"
"10532",48217,"Texas","Hill County","NHPI_AIC",61,38,-23,-46.46,"undercount"
"10533",48219,"Texas","Hockley County","A_A",82,52,-30,-44.78,"undercount"
"10534",48219,"Texas","Hockley County","A_AIC",117,70,-47,-50.27,"undercount"
"10535",48219,"Texas","Hockley County","NHPI_A",7,4,-3,-54.55,"undercount"
"10536",48219,"Texas","Hockley County","NHPI_AIC",13,13,0,0,"equal"
"10537",48221,"Texas","Hood County","A_A",495,471,-24,-4.97,"undercount"
"10538",48221,"Texas","Hood County","A_AIC",634,713,79,11.73,"overcount"
"10539",48221,"Texas","Hood County","NHPI_A",46,53,7,14.14,"overcount"
"10540",48221,"Texas","Hood County","NHPI_AIC",76,109,33,35.68,"overcount"
"10541",48223,"Texas","Hopkins County","A_A",243,284,41,15.56,"overcount"
"10542",48223,"Texas","Hopkins County","A_AIC",335,376,41,11.53,"overcount"
"10543",48223,"Texas","Hopkins County","NHPI_A",32,4,-28,-155.56,"undercount"
"10544",48223,"Texas","Hopkins County","NHPI_AIC",48,56,8,15.38,"overcount"
"10545",48225,"Texas","Houston County","A_A",158,143,-15,-9.97,"undercount"
"10546",48225,"Texas","Houston County","A_AIC",203,174,-29,-15.38,"undercount"
"10547",48225,"Texas","Houston County","NHPI_A",2,8,6,120,"overcount"
"10548",48225,"Texas","Houston County","NHPI_AIC",15,18,3,18.18,"overcount"
"10549",48227,"Texas","Howard County","A_A",397,397,0,0,"equal"
"10550",48227,"Texas","Howard County","A_AIC",485,485,0,0,"equal"
"10551",48227,"Texas","Howard County","NHPI_A",19,12,-7,-45.16,"undercount"
"10552",48227,"Texas","Howard County","NHPI_AIC",49,22,-27,-76.06,"undercount"
"10553",48229,"Texas","Hudspeth County","A_A",53,10,-43,-136.51,"undercount"
"10554",48229,"Texas","Hudspeth County","A_AIC",60,16,-44,-115.79,"undercount"
"10555",48229,"Texas","Hudspeth County","NHPI_A",3,0,-3,-200,"undercount"
"10556",48229,"Texas","Hudspeth County","NHPI_AIC",4,2,-2,-66.67,"undercount"
"10557",48231,"Texas","Hunt County","A_A",1408,1019,-389,-32.06,"undercount"
"10558",48231,"Texas","Hunt County","A_AIC",1708,1439,-269,-17.1,"undercount"
"10559",48231,"Texas","Hunt County","NHPI_A",144,154,10,6.71,"overcount"
"10560",48231,"Texas","Hunt County","NHPI_AIC",220,270,50,20.41,"overcount"
"10561",48233,"Texas","Hutchinson County","A_A",137,111,-26,-20.97,"undercount"
"10562",48233,"Texas","Hutchinson County","A_AIC",183,180,-3,-1.65,"undercount"
"10563",48233,"Texas","Hutchinson County","NHPI_A",4,2,-2,-66.67,"undercount"
"10564",48233,"Texas","Hutchinson County","NHPI_AIC",19,11,-8,-53.33,"undercount"
"10565",48235,"Texas","Irion County","A_A",8,2,-6,-120,"undercount"
"10566",48235,"Texas","Irion County","A_AIC",15,13,-2,-14.29,"undercount"
"10567",48235,"Texas","Irion County","NHPI_A",0,1,1,200,"overcount"
"10568",48235,"Texas","Irion County","NHPI_AIC",2,14,12,150,"overcount"
"10569",48237,"Texas","Jack County","A_A",50,41,-9,-19.78,"undercount"
"10570",48237,"Texas","Jack County","A_AIC",63,62,-1,-1.6,"undercount"
"10571",48237,"Texas","Jack County","NHPI_A",4,5,1,22.22,"overcount"
"10572",48237,"Texas","Jack County","NHPI_AIC",10,11,1,9.52,"overcount"
"10573",48239,"Texas","Jackson County","A_A",166,158,-8,-4.94,"undercount"
"10574",48239,"Texas","Jackson County","A_AIC",189,200,11,5.66,"overcount"
"10575",48239,"Texas","Jackson County","NHPI_A",1,5,4,133.33,"overcount"
"10576",48239,"Texas","Jackson County","NHPI_AIC",6,19,13,104,"overcount"
"10577",48241,"Texas","Jasper County","A_A",201,121,-80,-49.69,"undercount"
"10578",48241,"Texas","Jasper County","A_AIC",269,182,-87,-38.58,"undercount"
"10579",48241,"Texas","Jasper County","NHPI_A",20,16,-4,-22.22,"undercount"
"10580",48241,"Texas","Jasper County","NHPI_AIC",44,34,-10,-25.64,"undercount"
"10581",48243,"Texas","Jeff Davis County","A_A",36,14,-22,-88,"undercount"
"10582",48243,"Texas","Jeff Davis County","A_AIC",43,25,-18,-52.94,"undercount"
"10583",48243,"Texas","Jeff Davis County","NHPI_A",2,0,-2,-200,"undercount"
"10584",48243,"Texas","Jeff Davis County","NHPI_AIC",3,16,13,136.84,"overcount"
"10585",48245,"Texas","Jefferson County","A_A",9590,10059,469,4.77,"overcount"
"10586",48245,"Texas","Jefferson County","A_AIC",10462,10981,519,4.84,"overcount"
"10587",48245,"Texas","Jefferson County","NHPI_A",103,84,-19,-20.32,"undercount"
"10588",48245,"Texas","Jefferson County","NHPI_AIC",333,196,-137,-51.8,"undercount"
"10589",48247,"Texas","Jim Hogg County","A_A",28,27,-1,-3.64,"undercount"
"10590",48247,"Texas","Jim Hogg County","A_AIC",30,31,1,3.28,"overcount"
"10591",48247,"Texas","Jim Hogg County","NHPI_A",0,5,5,200,"overcount"
"10592",48247,"Texas","Jim Hogg County","NHPI_AIC",0,14,14,200,"overcount"
"10593",48249,"Texas","Jim Wells County","A_A",203,143,-60,-34.68,"undercount"
"10594",48249,"Texas","Jim Wells County","A_AIC",238,173,-65,-31.63,"undercount"
"10595",48249,"Texas","Jim Wells County","NHPI_A",10,15,5,40,"overcount"
"10596",48249,"Texas","Jim Wells County","NHPI_AIC",21,20,-1,-4.88,"undercount"
"10597",48251,"Texas","Johnson County","A_A",1747,1737,-10,-0.57,"undercount"
"10598",48251,"Texas","Johnson County","A_AIC",2518,2597,79,3.09,"overcount"
"10599",48251,"Texas","Johnson County","NHPI_A",823,929,106,12.1,"overcount"
"10600",48251,"Texas","Johnson County","NHPI_AIC",967,1130,163,15.55,"overcount"
"10601",48253,"Texas","Jones County","A_A",108,111,3,2.74,"overcount"
"10602",48253,"Texas","Jones County","A_AIC",153,147,-6,-4,"undercount"
"10603",48253,"Texas","Jones County","NHPI_A",4,4,0,0,"equal"
"10604",48253,"Texas","Jones County","NHPI_AIC",19,23,4,19.05,"overcount"
"10605",48255,"Texas","Karnes County","A_A",59,145,86,84.31,"overcount"
"10606",48255,"Texas","Karnes County","A_AIC",76,177,101,79.84,"overcount"
"10607",48255,"Texas","Karnes County","NHPI_A",3,1,-2,-100,"undercount"
"10608",48255,"Texas","Karnes County","NHPI_AIC",7,13,6,60,"overcount"
"10609",48257,"Texas","Kaufman County","A_A",2144,2111,-33,-1.55,"undercount"
"10610",48257,"Texas","Kaufman County","A_AIC",2630,2774,144,5.33,"overcount"
"10611",48257,"Texas","Kaufman County","NHPI_A",101,70,-31,-36.26,"undercount"
"10612",48257,"Texas","Kaufman County","NHPI_AIC",226,211,-15,-6.86,"undercount"
"10613",48259,"Texas","Kendall County","A_A",608,380,-228,-46.15,"undercount"
"10614",48259,"Texas","Kendall County","A_AIC",817,685,-132,-17.58,"undercount"
"10615",48259,"Texas","Kendall County","NHPI_A",27,36,9,28.57,"overcount"
"10616",48259,"Texas","Kendall County","NHPI_AIC",62,85,23,31.29,"overcount"
"10617",48261,"Texas","Kenedy County","A_A",3,0,-3,-200,"undercount"
"10618",48261,"Texas","Kenedy County","A_AIC",3,3,0,0,"equal"
"10619",48261,"Texas","Kenedy County","NHPI_A",0,1,1,200,"overcount"
"10620",48261,"Texas","Kenedy County","NHPI_AIC",0,5,5,200,"overcount"
"10621",48263,"Texas","Kent County","A_A",0,2,2,200,"overcount"
"10622",48263,"Texas","Kent County","A_AIC",2,6,4,100,"overcount"
"10623",48263,"Texas","Kent County","NHPI_A",1,0,-1,-200,"undercount"
"10624",48263,"Texas","Kent County","NHPI_AIC",1,4,3,120,"overcount"
"10625",48265,"Texas","Kerr County","A_A",607,576,-31,-5.24,"undercount"
"10626",48265,"Texas","Kerr County","A_AIC",729,754,25,3.37,"overcount"
"10627",48265,"Texas","Kerr County","NHPI_A",34,41,7,18.67,"overcount"
"10628",48265,"Texas","Kerr County","NHPI_AIC",69,86,17,21.94,"overcount"
"10629",48267,"Texas","Kimble County","A_A",38,33,-5,-14.08,"undercount"
"10630",48267,"Texas","Kimble County","A_AIC",44,49,5,10.75,"overcount"
"10631",48267,"Texas","Kimble County","NHPI_A",3,3,0,0,"equal"
"10632",48267,"Texas","Kimble County","NHPI_AIC",4,15,11,115.79,"overcount"
"10633",48269,"Texas","King County","A_A",0,0,0,0,"equal"
"10634",48269,"Texas","King County","A_AIC",1,0,-1,-200,"undercount"
"10635",48269,"Texas","King County","NHPI_A",1,4,3,120,"overcount"
"10636",48269,"Texas","King County","NHPI_AIC",1,4,3,120,"overcount"
"10637",48271,"Texas","Kinney County","A_A",9,10,1,10.53,"overcount"
"10638",48271,"Texas","Kinney County","A_AIC",19,35,16,59.26,"overcount"
"10639",48271,"Texas","Kinney County","NHPI_A",0,2,2,200,"overcount"
"10640",48271,"Texas","Kinney County","NHPI_AIC",1,14,13,173.33,"overcount"
"10641",48273,"Texas","Kleberg County","A_A",681,807,126,16.94,"overcount"
"10642",48273,"Texas","Kleberg County","A_AIC",755,890,135,16.41,"overcount"
"10643",48273,"Texas","Kleberg County","NHPI_A",32,1,-31,-187.88,"undercount"
"10644",48273,"Texas","Kleberg County","NHPI_AIC",47,9,-38,-135.71,"undercount"
"10645",48275,"Texas","Knox County","A_A",10,24,14,82.35,"overcount"
"10646",48275,"Texas","Knox County","A_AIC",21,29,8,32,"overcount"
"10647",48275,"Texas","Knox County","NHPI_A",1,3,2,100,"overcount"
"10648",48275,"Texas","Knox County","NHPI_AIC",4,5,1,22.22,"overcount"
"10649",48277,"Texas","Lamar County","A_A",394,474,80,18.43,"overcount"
"10650",48277,"Texas","Lamar County","A_AIC",569,599,30,5.14,"overcount"
"10651",48277,"Texas","Lamar County","NHPI_A",31,26,-5,-17.54,"undercount"
"10652",48277,"Texas","Lamar County","NHPI_AIC",110,50,-60,-75,"undercount"
"10653",48279,"Texas","Lamb County","A_A",39,5,-34,-154.55,"undercount"
"10654",48279,"Texas","Lamb County","A_AIC",57,30,-27,-62.07,"undercount"
"10655",48279,"Texas","Lamb County","NHPI_A",4,5,1,22.22,"overcount"
"10656",48279,"Texas","Lamb County","NHPI_AIC",7,22,15,103.45,"overcount"
"10657",48281,"Texas","Lampasas County","A_A",262,254,-8,-3.1,"undercount"
"10658",48281,"Texas","Lampasas County","A_AIC",424,469,45,10.08,"overcount"
"10659",48281,"Texas","Lampasas County","NHPI_A",94,86,-8,-8.89,"undercount"
"10660",48281,"Texas","Lampasas County","NHPI_AIC",132,156,24,16.67,"overcount"
"10661",48283,"Texas","La Salle County","A_A",25,4,-21,-144.83,"undercount"
"10662",48283,"Texas","La Salle County","A_AIC",32,18,-14,-56,"undercount"
"10663",48283,"Texas","La Salle County","NHPI_A",0,0,0,0,"equal"
"10664",48283,"Texas","La Salle County","NHPI_AIC",1,0,-1,-200,"undercount"
"10665",48285,"Texas","Lavaca County","A_A",103,77,-26,-28.89,"undercount"
"10666",48285,"Texas","Lavaca County","A_AIC",131,105,-26,-22.03,"undercount"
"10667",48285,"Texas","Lavaca County","NHPI_A",18,5,-13,-113.04,"undercount"
"10668",48285,"Texas","Lavaca County","NHPI_AIC",24,12,-12,-66.67,"undercount"
"10669",48287,"Texas","Lee County","A_A",76,57,-19,-28.57,"undercount"
"10670",48287,"Texas","Lee County","A_AIC",116,102,-14,-12.84,"undercount"
"10671",48287,"Texas","Lee County","NHPI_A",21,1,-20,-181.82,"undercount"
"10672",48287,"Texas","Lee County","NHPI_AIC",34,10,-24,-109.09,"undercount"
"10673",48289,"Texas","Leon County","A_A",127,112,-15,-12.55,"undercount"
"10674",48289,"Texas","Leon County","A_AIC",159,145,-14,-9.21,"undercount"
"10675",48289,"Texas","Leon County","NHPI_A",2,7,5,111.11,"overcount"
"10676",48289,"Texas","Leon County","NHPI_AIC",6,15,9,85.71,"overcount"
"10677",48291,"Texas","Liberty County","A_A",523,487,-36,-7.13,"undercount"
"10678",48291,"Texas","Liberty County","A_AIC",714,639,-75,-11.09,"undercount"
"10679",48291,"Texas","Liberty County","NHPI_A",46,13,-33,-111.86,"undercount"
"10680",48291,"Texas","Liberty County","NHPI_AIC",113,82,-31,-31.79,"undercount"
"10681",48293,"Texas","Limestone County","A_A",201,160,-41,-22.71,"undercount"
"10682",48293,"Texas","Limestone County","A_AIC",245,205,-40,-17.78,"undercount"
"10683",48293,"Texas","Limestone County","NHPI_A",9,18,9,66.67,"overcount"
"10684",48293,"Texas","Limestone County","NHPI_AIC",20,32,12,46.15,"overcount"
"10685",48295,"Texas","Lipscomb County","A_A",22,2,-20,-166.67,"undercount"
"10686",48295,"Texas","Lipscomb County","A_AIC",37,7,-30,-136.36,"undercount"
"10687",48295,"Texas","Lipscomb County","NHPI_A",0,0,0,0,"equal"
"10688",48295,"Texas","Lipscomb County","NHPI_AIC",3,4,1,28.57,"overcount"
"10689",48297,"Texas","Live Oak County","A_A",86,35,-51,-84.3,"undercount"
"10690",48297,"Texas","Live Oak County","A_AIC",110,49,-61,-76.73,"undercount"
"10691",48297,"Texas","Live Oak County","NHPI_A",7,6,-1,-15.38,"undercount"
"10692",48297,"Texas","Live Oak County","NHPI_AIC",15,16,1,6.45,"overcount"
"10693",48299,"Texas","Llano County","A_A",129,121,-8,-6.4,"undercount"
"10694",48299,"Texas","Llano County","A_AIC",169,175,6,3.49,"overcount"
"10695",48299,"Texas","Llano County","NHPI_A",8,4,-4,-66.67,"undercount"
"10696",48299,"Texas","Llano County","NHPI_AIC",18,12,-6,-40,"undercount"
"10697",48301,"Texas","Loving County","A_A",0,0,0,0,"equal"
"10698",48301,"Texas","Loving County","A_AIC",0,2,2,200,"overcount"
"10699",48301,"Texas","Loving County","NHPI_A",0,0,0,0,"equal"
"10700",48301,"Texas","Loving County","NHPI_AIC",0,2,2,200,"overcount"
"10701",48303,"Texas","Lubbock County","A_A",7053,9544,2491,30.02,"overcount"
"10702",48303,"Texas","Lubbock County","A_AIC",8436,10953,2517,25.96,"overcount"
"10703",48303,"Texas","Lubbock County","NHPI_A",247,186,-61,-28.18,"undercount"
"10704",48303,"Texas","Lubbock County","NHPI_AIC",600,378,-222,-45.4,"undercount"
"10705",48305,"Texas","Lynn County","A_A",9,10,1,10.53,"overcount"
"10706",48305,"Texas","Lynn County","A_AIC",22,28,6,24,"overcount"
"10707",48305,"Texas","Lynn County","NHPI_A",1,4,3,120,"overcount"
"10708",48305,"Texas","Lynn County","NHPI_AIC",2,16,14,155.56,"overcount"
"10709",48307,"Texas","McCulloch County","A_A",48,39,-9,-20.69,"undercount"
"10710",48307,"Texas","McCulloch County","A_AIC",64,51,-13,-22.61,"undercount"
"10711",48307,"Texas","McCulloch County","NHPI_A",4,0,-4,-200,"undercount"
"10712",48307,"Texas","McCulloch County","NHPI_AIC",8,8,0,0,"equal"
"10713",48309,"Texas","McLennan County","A_A",4319,4911,592,12.83,"overcount"
"10714",48309,"Texas","McLennan County","A_AIC",5673,6386,713,11.83,"overcount"
"10715",48309,"Texas","McLennan County","NHPI_A",148,150,2,1.34,"overcount"
"10716",48309,"Texas","McLennan County","NHPI_AIC",356,378,22,5.99,"overcount"
"10717",48311,"Texas","McMullen County","A_A",3,3,0,0,"equal"
"10718",48311,"Texas","McMullen County","A_AIC",3,10,7,107.69,"overcount"
"10719",48311,"Texas","McMullen County","NHPI_A",0,5,5,200,"overcount"
"10720",48311,"Texas","McMullen County","NHPI_AIC",0,7,7,200,"overcount"
"10721",48313,"Texas","Madison County","A_A",152,101,-51,-40.32,"undercount"
"10722",48313,"Texas","Madison County","A_AIC",185,117,-68,-45.03,"undercount"
"10723",48313,"Texas","Madison County","NHPI_A",7,0,-7,-200,"undercount"
"10724",48313,"Texas","Madison County","NHPI_AIC",22,4,-18,-138.46,"undercount"
"10725",48315,"Texas","Marion County","A_A",92,48,-44,-62.86,"undercount"
"10726",48315,"Texas","Marion County","A_AIC",123,78,-45,-44.78,"undercount"
"10727",48315,"Texas","Marion County","NHPI_A",3,0,-3,-200,"undercount"
"10728",48315,"Texas","Marion County","NHPI_AIC",9,9,0,0,"equal"
"10729",48317,"Texas","Martin County","A_A",29,9,-20,-105.26,"undercount"
"10730",48317,"Texas","Martin County","A_AIC",39,21,-18,-60,"undercount"
"10731",48317,"Texas","Martin County","NHPI_A",3,1,-2,-100,"undercount"
"10732",48317,"Texas","Martin County","NHPI_AIC",3,9,6,100,"overcount"
"10733",48319,"Texas","Mason County","A_A",10,2,-8,-133.33,"undercount"
"10734",48319,"Texas","Mason County","A_AIC",17,15,-2,-12.5,"undercount"
"10735",48319,"Texas","Mason County","NHPI_A",0,0,0,0,"equal"
"10736",48319,"Texas","Mason County","NHPI_AIC",1,10,9,163.64,"overcount"
"10737",48321,"Texas","Matagorda County","A_A",603,705,102,15.6,"overcount"
"10738",48321,"Texas","Matagorda County","A_AIC",688,795,107,14.43,"overcount"
"10739",48321,"Texas","Matagorda County","NHPI_A",15,7,-8,-72.73,"undercount"
"10740",48321,"Texas","Matagorda County","NHPI_AIC",36,22,-14,-48.28,"undercount"
"10741",48323,"Texas","Maverick County","A_A",297,186,-111,-45.96,"undercount"
"10742",48323,"Texas","Maverick County","A_AIC",325,199,-126,-48.09,"undercount"
"10743",48323,"Texas","Maverick County","NHPI_A",6,4,-2,-40,"undercount"
"10744",48323,"Texas","Maverick County","NHPI_AIC",12,16,4,28.57,"overcount"
"10745",48325,"Texas","Medina County","A_A",308,216,-92,-35.11,"undercount"
"10746",48325,"Texas","Medina County","A_AIC",451,392,-59,-14,"undercount"
"10747",48325,"Texas","Medina County","NHPI_A",61,38,-23,-46.46,"undercount"
"10748",48325,"Texas","Medina County","NHPI_AIC",86,68,-18,-23.38,"undercount"
"10749",48327,"Texas","Menard County","A_A",6,6,0,0,"equal"
"10750",48327,"Texas","Menard County","A_AIC",11,8,-3,-31.58,"undercount"
"10751",48327,"Texas","Menard County","NHPI_A",0,3,3,200,"overcount"
"10752",48327,"Texas","Menard County","NHPI_AIC",1,5,4,133.33,"overcount"
"10753",48329,"Texas","Midland County","A_A",3854,3946,92,2.36,"overcount"
"10754",48329,"Texas","Midland County","A_AIC",4321,4551,230,5.18,"overcount"
"10755",48329,"Texas","Midland County","NHPI_A",117,152,35,26.02,"overcount"
"10756",48329,"Texas","Midland County","NHPI_AIC",193,230,37,17.49,"overcount"
"10757",48331,"Texas","Milam County","A_A",194,111,-83,-54.43,"undercount"
"10758",48331,"Texas","Milam County","A_AIC",242,166,-76,-37.25,"undercount"
"10759",48331,"Texas","Milam County","NHPI_A",9,11,2,20,"overcount"
"10760",48331,"Texas","Milam County","NHPI_AIC",19,33,14,53.85,"overcount"
"10761",48333,"Texas","Mills County","A_A",21,8,-13,-89.66,"undercount"
"10762",48333,"Texas","Mills County","A_AIC",35,24,-11,-37.29,"undercount"
"10763",48333,"Texas","Mills County","NHPI_A",1,0,-1,-200,"undercount"
"10764",48333,"Texas","Mills County","NHPI_AIC",4,3,-1,-28.57,"undercount"
"10765",48335,"Texas","Mitchell County","A_A",47,55,8,15.69,"overcount"
"10766",48335,"Texas","Mitchell County","A_AIC",70,62,-8,-12.12,"undercount"
"10767",48335,"Texas","Mitchell County","NHPI_A",6,1,-5,-142.86,"undercount"
"10768",48335,"Texas","Mitchell County","NHPI_AIC",11,9,-2,-20,"undercount"
"10769",48337,"Texas","Montague County","A_A",80,85,5,6.06,"overcount"
"10770",48337,"Texas","Montague County","A_AIC",119,125,6,4.92,"overcount"
"10771",48337,"Texas","Montague County","NHPI_A",9,8,-1,-11.76,"undercount"
"10772",48337,"Texas","Montague County","NHPI_AIC",18,17,-1,-5.71,"undercount"
"10773",48339,"Texas","Montgomery County","A_A",20714,21719,1005,4.74,"overcount"
"10774",48339,"Texas","Montgomery County","A_AIC",24585,26623,2038,7.96,"overcount"
"10775",48339,"Texas","Montgomery County","NHPI_A",410,634,224,42.91,"overcount"
"10776",48339,"Texas","Montgomery County","NHPI_AIC",1004,1379,375,31.47,"overcount"
"10777",48341,"Texas","Moore County","A_A",1104,1004,-100,-9.49,"undercount"
"10778",48341,"Texas","Moore County","A_AIC",1159,1048,-111,-10.06,"undercount"
"10779",48341,"Texas","Moore County","NHPI_A",36,13,-23,-93.88,"undercount"
"10780",48341,"Texas","Moore County","NHPI_AIC",48,23,-25,-70.42,"undercount"
"10781",48343,"Texas","Morris County","A_A",78,37,-41,-71.3,"undercount"
"10782",48343,"Texas","Morris County","A_AIC",123,77,-46,-46,"undercount"
"10783",48343,"Texas","Morris County","NHPI_A",4,9,5,76.92,"overcount"
"10784",48343,"Texas","Morris County","NHPI_AIC",14,25,11,56.41,"overcount"
"10785",48345,"Texas","Motley County","A_A",0,0,0,0,"equal"
"10786",48345,"Texas","Motley County","A_AIC",2,12,10,142.86,"overcount"
"10787",48345,"Texas","Motley County","NHPI_A",0,0,0,0,"equal"
"10788",48345,"Texas","Motley County","NHPI_AIC",0,8,8,200,"overcount"
"10789",48347,"Texas","Nacogdoches County","A_A",783,764,-19,-2.46,"undercount"
"10790",48347,"Texas","Nacogdoches County","A_AIC",985,1034,49,4.85,"overcount"
"10791",48347,"Texas","Nacogdoches County","NHPI_A",19,10,-9,-62.07,"undercount"
"10792",48347,"Texas","Nacogdoches County","NHPI_AIC",63,47,-16,-29.09,"undercount"
"10793",48349,"Texas","Navarro County","A_A",296,394,98,28.41,"overcount"
"10794",48349,"Texas","Navarro County","A_AIC",433,527,94,19.58,"overcount"
"10795",48349,"Texas","Navarro County","NHPI_A",911,735,-176,-21.39,"undercount"
"10796",48349,"Texas","Navarro County","NHPI_AIC",954,793,-161,-18.43,"undercount"
"10797",48351,"Texas","Newton County","A_A",71,31,-40,-78.43,"undercount"
"10798",48351,"Texas","Newton County","A_AIC",107,48,-59,-76.13,"undercount"
"10799",48351,"Texas","Newton County","NHPI_A",2,0,-2,-200,"undercount"
"10800",48351,"Texas","Newton County","NHPI_AIC",15,13,-2,-14.29,"undercount"
"10801",48353,"Texas","Nolan County","A_A",110,103,-7,-6.57,"undercount"
"10802",48353,"Texas","Nolan County","A_AIC",134,116,-18,-14.4,"undercount"
"10803",48353,"Texas","Nolan County","NHPI_A",11,2,-9,-138.46,"undercount"
"10804",48353,"Texas","Nolan County","NHPI_AIC",17,10,-7,-51.85,"undercount"
"10805",48355,"Texas","Nueces County","A_A",7568,7778,210,2.74,"overcount"
"10806",48355,"Texas","Nueces County","A_AIC",8951,9471,520,5.65,"overcount"
"10807",48355,"Texas","Nueces County","NHPI_A",318,281,-37,-12.35,"undercount"
"10808",48355,"Texas","Nueces County","NHPI_AIC",543,548,5,0.92,"overcount"
"10809",48357,"Texas","Ochiltree County","A_A",41,30,-11,-30.99,"undercount"
"10810",48357,"Texas","Ochiltree County","A_AIC",58,42,-16,-32,"undercount"
"10811",48357,"Texas","Ochiltree County","NHPI_A",7,3,-4,-80,"undercount"
"10812",48357,"Texas","Ochiltree County","NHPI_AIC",11,12,1,8.7,"overcount"
"10813",48359,"Texas","Oldham County","A_A",34,10,-24,-109.09,"undercount"
"10814",48359,"Texas","Oldham County","A_AIC",43,29,-14,-38.89,"undercount"
"10815",48359,"Texas","Oldham County","NHPI_A",1,0,-1,-200,"undercount"
"10816",48359,"Texas","Oldham County","NHPI_AIC",1,11,10,166.67,"overcount"
"10817",48361,"Texas","Orange County","A_A",968,1111,143,13.76,"overcount"
"10818",48361,"Texas","Orange County","A_AIC",1275,1403,128,9.56,"overcount"
"10819",48361,"Texas","Orange County","NHPI_A",63,13,-50,-131.58,"undercount"
"10820",48361,"Texas","Orange County","NHPI_AIC",100,54,-46,-59.74,"undercount"
"10821",48363,"Texas","Palo Pinto County","A_A",278,212,-66,-26.94,"undercount"
"10822",48363,"Texas","Palo Pinto County","A_AIC",341,317,-24,-7.29,"undercount"
"10823",48363,"Texas","Palo Pinto County","NHPI_A",16,14,-2,-13.33,"undercount"
"10824",48363,"Texas","Palo Pinto County","NHPI_AIC",36,43,7,17.72,"overcount"
"10825",48365,"Texas","Panola County","A_A",133,99,-34,-29.31,"undercount"
"10826",48365,"Texas","Panola County","A_AIC",184,143,-41,-25.08,"undercount"
"10827",48365,"Texas","Panola County","NHPI_A",5,7,2,33.33,"overcount"
"10828",48365,"Texas","Panola County","NHPI_AIC",24,24,0,0,"equal"
"10829",48367,"Texas","Parker County","A_A",972,990,18,1.83,"overcount"
"10830",48367,"Texas","Parker County","A_AIC",1576,1810,234,13.82,"overcount"
"10831",48367,"Texas","Parker County","NHPI_A",97,97,0,0,"equal"
"10832",48367,"Texas","Parker County","NHPI_AIC",197,253,56,24.89,"overcount"
"10833",48369,"Texas","Parmer County","A_A",63,14,-49,-127.27,"undercount"
"10834",48369,"Texas","Parmer County","A_AIC",71,21,-50,-108.7,"undercount"
"10835",48369,"Texas","Parmer County","NHPI_A",7,0,-7,-200,"undercount"
"10836",48369,"Texas","Parmer County","NHPI_AIC",7,3,-4,-80,"undercount"
"10837",48371,"Texas","Pecos County","A_A",170,143,-27,-17.25,"undercount"
"10838",48371,"Texas","Pecos County","A_AIC",194,171,-23,-12.6,"undercount"
"10839",48371,"Texas","Pecos County","NHPI_A",7,0,-7,-200,"undercount"
"10840",48371,"Texas","Pecos County","NHPI_AIC",15,4,-11,-115.79,"undercount"
"10841",48373,"Texas","Polk County","A_A",395,342,-53,-14.38,"undercount"
"10842",48373,"Texas","Polk County","A_AIC",509,453,-56,-11.64,"undercount"
"10843",48373,"Texas","Polk County","NHPI_A",30,1,-29,-187.1,"undercount"
"10844",48373,"Texas","Polk County","NHPI_AIC",70,46,-24,-41.38,"undercount"
"10845",48375,"Texas","Potter County","A_A",5837,6079,242,4.06,"overcount"
"10846",48375,"Texas","Potter County","A_AIC",6269,6482,213,3.34,"overcount"
"10847",48375,"Texas","Potter County","NHPI_A",67,20,-47,-108.05,"undercount"
"10848",48375,"Texas","Potter County","NHPI_AIC",167,83,-84,-67.2,"undercount"
"10849",48377,"Texas","Presidio County","A_A",122,85,-37,-35.75,"undercount"
"10850",48377,"Texas","Presidio County","A_AIC",133,99,-34,-29.31,"undercount"
"10851",48377,"Texas","Presidio County","NHPI_A",1,0,-1,-200,"undercount"
"10852",48377,"Texas","Presidio County","NHPI_AIC",2,11,9,138.46,"overcount"
"10853",48379,"Texas","Rains County","A_A",103,58,-45,-55.9,"undercount"
"10854",48379,"Texas","Rains County","A_AIC",155,105,-50,-38.46,"undercount"
"10855",48379,"Texas","Rains County","NHPI_A",2,1,-1,-66.67,"undercount"
"10856",48379,"Texas","Rains County","NHPI_AIC",12,10,-2,-18.18,"undercount"
"10857",48381,"Texas","Randall County","A_A",2511,2649,138,5.35,"overcount"
"10858",48381,"Texas","Randall County","A_AIC",3115,3289,174,5.43,"overcount"
"10859",48381,"Texas","Randall County","NHPI_A",69,60,-9,-13.95,"undercount"
"10860",48381,"Texas","Randall County","NHPI_AIC",136,162,26,17.45,"overcount"
"10861",48383,"Texas","Reagan County","A_A",11,22,11,66.67,"overcount"
"10862",48383,"Texas","Reagan County","A_AIC",19,31,12,48,"overcount"
"10863",48383,"Texas","Reagan County","NHPI_A",1,2,1,66.67,"overcount"
"10864",48383,"Texas","Reagan County","NHPI_AIC",3,11,8,114.29,"overcount"
"10865",48385,"Texas","Real County","A_A",8,12,4,40,"overcount"
"10866",48385,"Texas","Real County","A_AIC",16,20,4,22.22,"overcount"
"10867",48385,"Texas","Real County","NHPI_A",12,3,-9,-120,"undercount"
"10868",48385,"Texas","Real County","NHPI_AIC",15,6,-9,-85.71,"undercount"
"10869",48387,"Texas","Red River County","A_A",40,53,13,27.96,"overcount"
"10870",48387,"Texas","Red River County","A_AIC",65,85,20,26.67,"overcount"
"10871",48387,"Texas","Red River County","NHPI_A",3,0,-3,-200,"undercount"
"10872",48387,"Texas","Red River County","NHPI_AIC",13,15,2,14.29,"overcount"
"10873",48389,"Texas","Reeves County","A_A",237,165,-72,-35.82,"undercount"
"10874",48389,"Texas","Reeves County","A_AIC",249,186,-63,-28.97,"undercount"
"10875",48389,"Texas","Reeves County","NHPI_A",4,3,-1,-28.57,"undercount"
"10876",48389,"Texas","Reeves County","NHPI_AIC",5,8,3,46.15,"overcount"
"10877",48391,"Texas","Refugio County","A_A",50,30,-20,-50,"undercount"
"10878",48391,"Texas","Refugio County","A_AIC",64,47,-17,-30.63,"undercount"
"10879",48391,"Texas","Refugio County","NHPI_A",0,1,1,200,"overcount"
"10880",48391,"Texas","Refugio County","NHPI_AIC",0,13,13,200,"overcount"
"10881",48393,"Texas","Roberts County","A_A",2,0,-2,-200,"undercount"
"10882",48393,"Texas","Roberts County","A_AIC",6,7,1,15.38,"overcount"
"10883",48393,"Texas","Roberts County","NHPI_A",0,0,0,0,"equal"
"10884",48393,"Texas","Roberts County","NHPI_AIC",2,5,3,85.71,"overcount"
"10885",48395,"Texas","Robertson County","A_A",141,104,-37,-30.2,"undercount"
"10886",48395,"Texas","Robertson County","A_AIC",182,128,-54,-34.84,"undercount"
"10887",48395,"Texas","Robertson County","NHPI_A",9,21,12,80,"overcount"
"10888",48395,"Texas","Robertson County","NHPI_AIC",16,24,8,40,"overcount"
"10889",48397,"Texas","Rockwall County","A_A",3496,3335,-161,-4.71,"undercount"
"10890",48397,"Texas","Rockwall County","A_AIC",4311,4313,2,0.05,"overcount"
"10891",48397,"Texas","Rockwall County","NHPI_A",87,75,-12,-14.81,"undercount"
"10892",48397,"Texas","Rockwall County","NHPI_AIC",192,171,-21,-11.57,"undercount"
"10893",48399,"Texas","Runnels County","A_A",86,29,-57,-99.13,"undercount"
"10894",48399,"Texas","Runnels County","A_AIC",104,61,-43,-52.12,"undercount"
"10895",48399,"Texas","Runnels County","NHPI_A",0,6,6,200,"overcount"
"10896",48399,"Texas","Runnels County","NHPI_AIC",3,38,35,170.73,"overcount"
"10897",48401,"Texas","Rusk County","A_A",306,254,-52,-18.57,"undercount"
"10898",48401,"Texas","Rusk County","A_AIC",429,358,-71,-18.04,"undercount"
"10899",48401,"Texas","Rusk County","NHPI_A",21,18,-3,-15.38,"undercount"
"10900",48401,"Texas","Rusk County","NHPI_AIC",51,42,-9,-19.35,"undercount"
"10901",48403,"Texas","Sabine County","A_A",46,52,6,12.24,"overcount"
"10902",48403,"Texas","Sabine County","A_AIC",78,75,-3,-3.92,"undercount"
"10903",48403,"Texas","Sabine County","NHPI_A",1,0,-1,-200,"undercount"
"10904",48403,"Texas","Sabine County","NHPI_AIC",9,14,5,43.48,"overcount"
"10905",48405,"Texas","San Augustine County","A_A",28,36,8,25,"overcount"
"10906",48405,"Texas","San Augustine County","A_AIC",45,49,4,8.51,"overcount"
"10907",48405,"Texas","San Augustine County","NHPI_A",0,0,0,0,"equal"
"10908",48405,"Texas","San Augustine County","NHPI_AIC",4,6,2,40,"overcount"
"10909",48407,"Texas","San Jacinto County","A_A",145,100,-45,-36.73,"undercount"
"10910",48407,"Texas","San Jacinto County","A_AIC",233,165,-68,-34.17,"undercount"
"10911",48407,"Texas","San Jacinto County","NHPI_A",21,15,-6,-33.33,"undercount"
"10912",48407,"Texas","San Jacinto County","NHPI_AIC",53,34,-19,-43.68,"undercount"
"10913",48409,"Texas","San Patricio County","A_A",720,855,135,17.14,"overcount"
"10914",48409,"Texas","San Patricio County","A_AIC",909,1124,215,21.15,"overcount"
"10915",48409,"Texas","San Patricio County","NHPI_A",75,66,-9,-12.77,"undercount"
"10916",48409,"Texas","San Patricio County","NHPI_AIC",120,138,18,13.95,"overcount"
"10917",48411,"Texas","San Saba County","A_A",35,16,-19,-74.51,"undercount"
"10918",48411,"Texas","San Saba County","A_AIC",49,46,-3,-6.32,"undercount"
"10919",48411,"Texas","San Saba County","NHPI_A",0,3,3,200,"overcount"
"10920",48411,"Texas","San Saba County","NHPI_AIC",5,7,2,33.33,"overcount"
"10921",48413,"Texas","Schleicher County","A_A",10,11,1,9.52,"overcount"
"10922",48413,"Texas","Schleicher County","A_AIC",13,19,6,37.5,"overcount"
"10923",48413,"Texas","Schleicher County","NHPI_A",0,3,3,200,"overcount"
"10924",48413,"Texas","Schleicher County","NHPI_AIC",1,4,3,120,"overcount"
"10925",48415,"Texas","Scurry County","A_A",92,85,-7,-7.91,"undercount"
"10926",48415,"Texas","Scurry County","A_AIC",125,122,-3,-2.43,"undercount"
"10927",48415,"Texas","Scurry County","NHPI_A",4,5,1,22.22,"overcount"
"10928",48415,"Texas","Scurry County","NHPI_AIC",14,10,-4,-33.33,"undercount"
"10929",48417,"Texas","Shackelford County","A_A",16,14,-2,-13.33,"undercount"
"10930",48417,"Texas","Shackelford County","A_AIC",21,25,4,17.39,"overcount"
"10931",48417,"Texas","Shackelford County","NHPI_A",2,0,-2,-200,"undercount"
"10932",48417,"Texas","Shackelford County","NHPI_AIC",4,7,3,54.55,"overcount"
"10933",48419,"Texas","Shelby County","A_A",343,364,21,5.94,"overcount"
"10934",48419,"Texas","Shelby County","A_AIC",405,426,21,5.05,"overcount"
"10935",48419,"Texas","Shelby County","NHPI_A",10,14,4,33.33,"overcount"
"10936",48419,"Texas","Shelby County","NHPI_AIC",25,34,9,30.51,"overcount"
"10937",48421,"Texas","Sherman County","A_A",14,2,-12,-150,"undercount"
"10938",48421,"Texas","Sherman County","A_AIC",18,9,-9,-66.67,"undercount"
"10939",48421,"Texas","Sherman County","NHPI_A",0,0,0,0,"equal"
"10940",48421,"Texas","Sherman County","NHPI_AIC",0,5,5,200,"overcount"
"10941",48423,"Texas","Smith County","A_A",3721,4153,432,10.97,"overcount"
"10942",48423,"Texas","Smith County","A_AIC",4561,5192,631,12.94,"overcount"
"10943",48423,"Texas","Smith County","NHPI_A",174,77,-97,-77.29,"undercount"
"10944",48423,"Texas","Smith County","NHPI_AIC",348,239,-109,-37.14,"undercount"
"10945",48425,"Texas","Somervell County","A_A",74,55,-19,-29.46,"undercount"
"10946",48425,"Texas","Somervell County","A_AIC",107,75,-32,-35.16,"undercount"
"10947",48425,"Texas","Somervell County","NHPI_A",1,0,-1,-200,"undercount"
"10948",48425,"Texas","Somervell County","NHPI_AIC",6,12,6,66.67,"overcount"
"10949",48427,"Texas","Starr County","A_A",119,164,45,31.8,"overcount"
"10950",48427,"Texas","Starr County","A_AIC",128,175,47,31.02,"overcount"
"10951",48427,"Texas","Starr County","NHPI_A",5,0,-5,-200,"undercount"
"10952",48427,"Texas","Starr County","NHPI_AIC",10,14,4,33.33,"overcount"
"10953",48429,"Texas","Stephens County","A_A",73,67,-6,-8.57,"undercount"
"10954",48429,"Texas","Stephens County","A_AIC",94,86,-8,-8.89,"undercount"
"10955",48429,"Texas","Stephens County","NHPI_A",6,1,-5,-142.86,"undercount"
"10956",48429,"Texas","Stephens County","NHPI_AIC",13,23,10,55.56,"overcount"
"10957",48431,"Texas","Sterling County","A_A",3,3,0,0,"equal"
"10958",48431,"Texas","Sterling County","A_AIC",8,17,9,72,"overcount"
"10959",48431,"Texas","Sterling County","NHPI_A",1,2,1,66.67,"overcount"
"10960",48431,"Texas","Sterling County","NHPI_AIC",1,6,5,142.86,"overcount"
"10961",48433,"Texas","Stonewall County","A_A",17,5,-12,-109.09,"undercount"
"10962",48433,"Texas","Stonewall County","A_AIC",20,7,-13,-96.3,"undercount"
"10963",48433,"Texas","Stonewall County","NHPI_A",0,0,0,0,"equal"
"10964",48433,"Texas","Stonewall County","NHPI_AIC",0,3,3,200,"overcount"
"10965",48435,"Texas","Sutton County","A_A",15,6,-9,-85.71,"undercount"
"10966",48435,"Texas","Sutton County","A_AIC",18,17,-1,-5.71,"undercount"
"10967",48435,"Texas","Sutton County","NHPI_A",0,0,0,0,"equal"
"10968",48435,"Texas","Sutton County","NHPI_AIC",0,8,8,200,"overcount"
"10969",48437,"Texas","Swisher County","A_A",29,13,-16,-76.19,"undercount"
"10970",48437,"Texas","Swisher County","A_AIC",40,24,-16,-50,"undercount"
"10971",48437,"Texas","Swisher County","NHPI_A",3,0,-3,-200,"undercount"
"10972",48437,"Texas","Swisher County","NHPI_AIC",6,7,1,15.38,"overcount"
"10973",48439,"Texas","Tarrant County","A_A",122950,128780,5830,4.63,"overcount"
"10974",48439,"Texas","Tarrant County","A_AIC",139429,147369,7940,5.54,"overcount"
"10975",48439,"Texas","Tarrant County","NHPI_A",4012,4293,281,6.77,"overcount"
"10976",48439,"Texas","Tarrant County","NHPI_AIC",6337,7029,692,10.35,"overcount"
"10977",48441,"Texas","Taylor County","A_A",2918,2839,-79,-2.74,"undercount"
"10978",48441,"Texas","Taylor County","A_AIC",3934,3950,16,0.41,"overcount"
"10979",48441,"Texas","Taylor County","NHPI_A",132,165,33,22.22,"overcount"
"10980",48441,"Texas","Taylor County","NHPI_AIC",285,350,65,20.47,"overcount"
"10981",48443,"Texas","Terrell County","A_A",9,5,-4,-57.14,"undercount"
"10982",48443,"Texas","Terrell County","A_AIC",13,10,-3,-26.09,"undercount"
"10983",48443,"Texas","Terrell County","NHPI_A",0,0,0,0,"equal"
"10984",48443,"Texas","Terrell County","NHPI_AIC",0,7,7,200,"overcount"
"10985",48445,"Texas","Terry County","A_A",41,41,0,0,"equal"
"10986",48445,"Texas","Terry County","A_AIC",61,58,-3,-5.04,"undercount"
"10987",48445,"Texas","Terry County","NHPI_A",2,0,-2,-200,"undercount"
"10988",48445,"Texas","Terry County","NHPI_AIC",7,30,23,124.32,"overcount"
"10989",48447,"Texas","Throckmorton County","A_A",8,3,-5,-90.91,"undercount"
"10990",48447,"Texas","Throckmorton County","A_AIC",12,5,-7,-82.35,"undercount"
"10991",48447,"Texas","Throckmorton County","NHPI_A",0,0,0,0,"equal"
"10992",48447,"Texas","Throckmorton County","NHPI_AIC",0,4,4,200,"overcount"
"10993",48449,"Texas","Titus County","A_A",350,262,-88,-28.76,"undercount"
"10994",48449,"Texas","Titus County","A_AIC",420,303,-117,-32.37,"undercount"
"10995",48449,"Texas","Titus County","NHPI_A",16,5,-11,-104.76,"undercount"
"10996",48449,"Texas","Titus County","NHPI_AIC",29,13,-16,-76.19,"undercount"
"10997",48451,"Texas","Tom Green County","A_A",1500,1738,238,14.7,"overcount"
"10998",48451,"Texas","Tom Green County","A_AIC",2153,2446,293,12.74,"overcount"
"10999",48451,"Texas","Tom Green County","NHPI_A",157,143,-14,-9.33,"undercount"
"11000",48451,"Texas","Tom Green County","NHPI_AIC",293,265,-28,-10.04,"undercount"
"11001",48453,"Texas","Travis County","A_A",97019,100492,3473,3.52,"overcount"
"11002",48453,"Texas","Travis County","A_AIC",109998,118616,8618,7.54,"overcount"
"11003",48453,"Texas","Travis County","NHPI_A",942,801,-141,-16.18,"undercount"
"11004",48453,"Texas","Travis County","NHPI_AIC",2190,2578,388,16.28,"overcount"
"11005",48455,"Texas","Trinity County","A_A",60,34,-26,-55.32,"undercount"
"11006",48455,"Texas","Trinity County","A_AIC",90,87,-3,-3.39,"undercount"
"11007",48455,"Texas","Trinity County","NHPI_A",6,4,-2,-40,"undercount"
"11008",48455,"Texas","Trinity County","NHPI_AIC",17,24,7,34.15,"overcount"
"11009",48457,"Texas","Tyler County","A_A",124,104,-20,-17.54,"undercount"
"11010",48457,"Texas","Tyler County","A_AIC",158,124,-34,-24.11,"undercount"
"11011",48457,"Texas","Tyler County","NHPI_A",14,3,-11,-129.41,"undercount"
"11012",48457,"Texas","Tyler County","NHPI_AIC",24,12,-12,-66.67,"undercount"
"11013",48459,"Texas","Upshur County","A_A",264,177,-87,-39.46,"undercount"
"11014",48459,"Texas","Upshur County","A_AIC",355,302,-53,-16.13,"undercount"
"11015",48459,"Texas","Upshur County","NHPI_A",15,9,-6,-50,"undercount"
"11016",48459,"Texas","Upshur County","NHPI_AIC",46,69,23,40,"overcount"
"11017",48461,"Texas","Upton County","A_A",15,4,-11,-115.79,"undercount"
"11018",48461,"Texas","Upton County","A_AIC",18,21,3,15.38,"overcount"
"11019",48461,"Texas","Upton County","NHPI_A",0,0,0,0,"equal"
"11020",48461,"Texas","Upton County","NHPI_AIC",1,8,7,155.56,"overcount"
"11021",48463,"Texas","Uvalde County","A_A",257,159,-98,-47.12,"undercount"
"11022",48463,"Texas","Uvalde County","A_AIC",294,181,-113,-47.58,"undercount"
"11023",48463,"Texas","Uvalde County","NHPI_A",8,6,-2,-28.57,"undercount"
"11024",48463,"Texas","Uvalde County","NHPI_AIC",15,25,10,50,"overcount"
"11025",48465,"Texas","Val Verde County","A_A",341,351,10,2.89,"overcount"
"11026",48465,"Texas","Val Verde County","A_AIC",446,466,20,4.39,"overcount"
"11027",48465,"Texas","Val Verde County","NHPI_A",47,40,-7,-16.09,"undercount"
"11028",48465,"Texas","Val Verde County","NHPI_AIC",72,67,-5,-7.19,"undercount"
"11029",48467,"Texas","Van Zandt County","A_A",255,273,18,6.82,"overcount"
"11030",48467,"Texas","Van Zandt County","A_AIC",347,445,98,24.75,"overcount"
"11031",48467,"Texas","Van Zandt County","NHPI_A",79,30,-49,-89.91,"undercount"
"11032",48467,"Texas","Van Zandt County","NHPI_AIC",107,57,-50,-60.98,"undercount"
"11033",48469,"Texas","Victoria County","A_A",1169,1395,226,17.63,"overcount"
"11034",48469,"Texas","Victoria County","A_AIC",1376,1606,230,15.43,"overcount"
"11035",48469,"Texas","Victoria County","NHPI_A",25,35,10,33.33,"overcount"
"11036",48469,"Texas","Victoria County","NHPI_AIC",75,63,-12,-17.39,"undercount"
"11037",48471,"Texas","Walker County","A_A",793,1126,333,34.71,"overcount"
"11038",48471,"Texas","Walker County","A_AIC",1012,1294,282,24.46,"overcount"
"11039",48471,"Texas","Walker County","NHPI_A",56,39,-17,-35.79,"undercount"
"11040",48471,"Texas","Walker County","NHPI_AIC",111,98,-13,-12.44,"undercount"
"11041",48473,"Texas","Waller County","A_A",872,787,-85,-10.25,"undercount"
"11042",48473,"Texas","Waller County","A_AIC",986,986,0,0,"equal"
"11043",48473,"Texas","Waller County","NHPI_A",29,13,-16,-76.19,"undercount"
"11044",48473,"Texas","Waller County","NHPI_AIC",74,48,-26,-42.62,"undercount"
"11045",48475,"Texas","Ward County","A_A",55,69,14,22.58,"overcount"
"11046",48475,"Texas","Ward County","A_AIC",75,105,30,33.33,"overcount"
"11047",48475,"Texas","Ward County","NHPI_A",0,3,3,200,"overcount"
"11048",48475,"Texas","Ward County","NHPI_AIC",12,28,16,80,"overcount"
"11049",48477,"Texas","Washington County","A_A",537,547,10,1.85,"overcount"
"11050",48477,"Texas","Washington County","A_AIC",612,641,29,4.63,"overcount"
"11051",48477,"Texas","Washington County","NHPI_A",13,14,1,7.41,"overcount"
"11052",48477,"Texas","Washington County","NHPI_AIC",37,31,-6,-17.65,"undercount"
"11053",48479,"Texas","Webb County","A_A",1285,1359,74,5.6,"overcount"
"11054",48479,"Texas","Webb County","A_AIC",1411,1461,50,3.48,"overcount"
"11055",48479,"Texas","Webb County","NHPI_A",34,44,10,25.64,"overcount"
"11056",48479,"Texas","Webb County","NHPI_AIC",61,77,16,23.19,"overcount"
"11057",48481,"Texas","Wharton County","A_A",204,164,-40,-21.74,"undercount"
"11058",48481,"Texas","Wharton County","A_AIC",238,211,-27,-12.03,"undercount"
"11059",48481,"Texas","Wharton County","NHPI_A",15,0,-15,-200,"undercount"
"11060",48481,"Texas","Wharton County","NHPI_AIC",27,16,-11,-51.16,"undercount"
"11061",48483,"Texas","Wheeler County","A_A",37,24,-13,-42.62,"undercount"
"11062",48483,"Texas","Wheeler County","A_AIC",45,38,-7,-16.87,"undercount"
"11063",48483,"Texas","Wheeler County","NHPI_A",0,2,2,200,"overcount"
"11064",48483,"Texas","Wheeler County","NHPI_AIC",2,6,4,100,"overcount"
"11065",48485,"Texas","Wichita County","A_A",2725,2665,-60,-2.23,"undercount"
"11066",48485,"Texas","Wichita County","A_AIC",3754,3656,-98,-2.65,"undercount"
"11067",48485,"Texas","Wichita County","NHPI_A",119,140,21,16.22,"overcount"
"11068",48485,"Texas","Wichita County","NHPI_AIC",324,337,13,3.93,"overcount"
"11069",48487,"Texas","Wilbarger County","A_A",452,578,126,24.47,"overcount"
"11070",48487,"Texas","Wilbarger County","A_AIC",497,605,108,19.6,"overcount"
"11071",48487,"Texas","Wilbarger County","NHPI_A",7,0,-7,-200,"undercount"
"11072",48487,"Texas","Wilbarger County","NHPI_AIC",18,9,-9,-66.67,"undercount"
"11073",48489,"Texas","Willacy County","A_A",146,160,14,9.15,"overcount"
"11074",48489,"Texas","Willacy County","A_AIC",156,182,26,15.38,"overcount"
"11075",48489,"Texas","Willacy County","NHPI_A",2,2,0,0,"equal"
"11076",48489,"Texas","Willacy County","NHPI_AIC",4,9,5,76.92,"overcount"
"11077",48491,"Texas","Williamson County","A_A",51925,54263,2338,4.4,"overcount"
"11078",48491,"Texas","Williamson County","A_AIC",58418,62534,4116,6.81,"overcount"
"11079",48491,"Texas","Williamson County","NHPI_A",668,599,-69,-10.89,"undercount"
"11080",48491,"Texas","Williamson County","NHPI_AIC",1572,1659,87,5.39,"overcount"
"11081",48493,"Texas","Wilson County","A_A",264,236,-28,-11.2,"undercount"
"11082",48493,"Texas","Wilson County","A_AIC",395,452,57,13.46,"overcount"
"11083",48493,"Texas","Wilson County","NHPI_A",35,24,-11,-37.29,"undercount"
"11084",48493,"Texas","Wilson County","NHPI_AIC",51,61,10,17.86,"overcount"
"11085",48495,"Texas","Winkler County","A_A",50,80,30,46.15,"overcount"
"11086",48495,"Texas","Winkler County","A_AIC",59,93,34,44.74,"overcount"
"11087",48495,"Texas","Winkler County","NHPI_A",1,0,-1,-200,"undercount"
"11088",48495,"Texas","Winkler County","NHPI_AIC",4,8,4,66.67,"overcount"
"11089",48497,"Texas","Wise County","A_A",379,372,-7,-1.86,"undercount"
"11090",48497,"Texas","Wise County","A_AIC",634,585,-49,-8.04,"undercount"
"11091",48497,"Texas","Wise County","NHPI_A",35,12,-23,-97.87,"undercount"
"11092",48497,"Texas","Wise County","NHPI_AIC",59,52,-7,-12.61,"undercount"
"11093",48499,"Texas","Wood County","A_A",267,231,-36,-14.46,"undercount"
"11094",48499,"Texas","Wood County","A_AIC",351,344,-7,-2.01,"undercount"
"11095",48499,"Texas","Wood County","NHPI_A",20,1,-19,-180.95,"undercount"
"11096",48499,"Texas","Wood County","NHPI_AIC",35,16,-19,-74.51,"undercount"
"11097",48501,"Texas","Yoakum County","A_A",46,49,3,6.32,"overcount"
"11098",48501,"Texas","Yoakum County","A_AIC",54,61,7,12.17,"overcount"
"11099",48501,"Texas","Yoakum County","NHPI_A",1,0,-1,-200,"undercount"
"11100",48501,"Texas","Yoakum County","NHPI_AIC",1,0,-1,-200,"undercount"
"11101",48503,"Texas","Young County","A_A",112,86,-26,-26.26,"undercount"
"11102",48503,"Texas","Young County","A_AIC",155,120,-35,-25.45,"undercount"
"11103",48503,"Texas","Young County","NHPI_A",7,1,-6,-150,"undercount"
"11104",48503,"Texas","Young County","NHPI_AIC",17,13,-4,-26.67,"undercount"
"11105",48505,"Texas","Zapata County","A_A",24,16,-8,-40,"undercount"
"11106",48505,"Texas","Zapata County","A_AIC",25,26,1,3.92,"overcount"
"11107",48505,"Texas","Zapata County","NHPI_A",1,0,-1,-200,"undercount"
"11108",48505,"Texas","Zapata County","NHPI_AIC",2,7,5,111.11,"overcount"
"11109",48507,"Texas","Zavala County","A_A",18,19,1,5.41,"overcount"
"11110",48507,"Texas","Zavala County","A_AIC",21,27,6,25,"overcount"
"11111",48507,"Texas","Zavala County","NHPI_A",5,1,-4,-133.33,"undercount"
"11112",48507,"Texas","Zavala County","NHPI_AIC",6,12,6,66.67,"overcount"
"11113",49001,"Utah","Beaver County","A_A",62,33,-29,-61.05,"undercount"
"11114",49001,"Utah","Beaver County","A_AIC",99,60,-39,-49.06,"undercount"
"11115",49001,"Utah","Beaver County","NHPI_A",21,21,0,0,"equal"
"11116",49001,"Utah","Beaver County","NHPI_AIC",32,50,18,43.9,"overcount"
"11117",49003,"Utah","Box Elder County","A_A",425,445,20,4.6,"overcount"
"11118",49003,"Utah","Box Elder County","A_AIC",848,868,20,2.33,"overcount"
"11119",49003,"Utah","Box Elder County","NHPI_A",104,98,-6,-5.94,"undercount"
"11120",49003,"Utah","Box Elder County","NHPI_AIC",177,207,30,15.62,"overcount"
"11121",49005,"Utah","Cache County","A_A",2818,2332,-486,-18.87,"undercount"
"11122",49005,"Utah","Cache County","A_AIC",3768,3461,-307,-8.49,"undercount"
"11123",49005,"Utah","Cache County","NHPI_A",544,660,116,19.27,"overcount"
"11124",49005,"Utah","Cache County","NHPI_AIC",912,1123,211,20.74,"overcount"
"11125",49007,"Utah","Carbon County","A_A",141,71,-70,-66.04,"undercount"
"11126",49007,"Utah","Carbon County","A_AIC",208,175,-33,-17.23,"undercount"
"11127",49007,"Utah","Carbon County","NHPI_A",33,29,-4,-12.9,"undercount"
"11128",49007,"Utah","Carbon County","NHPI_AIC",73,46,-27,-45.38,"undercount"
"11129",49009,"Utah","Daggett County","A_A",4,1,-3,-120,"undercount"
"11130",49009,"Utah","Daggett County","A_AIC",11,5,-6,-75,"undercount"
"11131",49009,"Utah","Daggett County","NHPI_A",1,3,2,100,"overcount"
"11132",49009,"Utah","Daggett County","NHPI_AIC",4,4,0,0,"equal"
"11133",49011,"Utah","Davis County","A_A",7160,7013,-147,-2.07,"undercount"
"11134",49011,"Utah","Davis County","A_AIC",11723,12393,670,5.56,"overcount"
"11135",49011,"Utah","Davis County","NHPI_A",2767,3241,474,15.78,"overcount"
"11136",49011,"Utah","Davis County","NHPI_AIC",4285,5354,1069,22.18,"overcount"
"11137",49013,"Utah","Duchesne County","A_A",74,68,-6,-8.45,"undercount"
"11138",49013,"Utah","Duchesne County","A_AIC",152,142,-10,-6.8,"undercount"
"11139",49013,"Utah","Duchesne County","NHPI_A",62,39,-23,-45.54,"undercount"
"11140",49013,"Utah","Duchesne County","NHPI_AIC",131,75,-56,-54.37,"undercount"
"11141",49015,"Utah","Emery County","A_A",49,36,-13,-30.59,"undercount"
"11142",49015,"Utah","Emery County","A_AIC",76,75,-1,-1.32,"undercount"
"11143",49015,"Utah","Emery County","NHPI_A",10,7,-3,-35.29,"undercount"
"11144",49015,"Utah","Emery County","NHPI_AIC",35,16,-19,-74.51,"undercount"
"11145",49017,"Utah","Garfield County","A_A",50,30,-20,-50,"undercount"
"11146",49017,"Utah","Garfield County","A_AIC",66,56,-10,-16.39,"undercount"
"11147",49017,"Utah","Garfield County","NHPI_A",17,7,-10,-83.33,"undercount"
"11148",49017,"Utah","Garfield County","NHPI_AIC",39,26,-13,-40,"undercount"
"11149",49019,"Utah","Grand County","A_A",210,81,-129,-88.66,"undercount"
"11150",49019,"Utah","Grand County","A_AIC",247,166,-81,-39.23,"undercount"
"11151",49019,"Utah","Grand County","NHPI_A",10,12,2,18.18,"overcount"
"11152",49019,"Utah","Grand County","NHPI_AIC",39,16,-23,-83.64,"undercount"
"11153",49021,"Utah","Iron County","A_A",478,621,143,26.02,"overcount"
"11154",49021,"Utah","Iron County","A_AIC",840,1087,247,25.64,"overcount"
"11155",49021,"Utah","Iron County","NHPI_A",169,237,68,33.5,"overcount"
"11156",49021,"Utah","Iron County","NHPI_AIC",375,454,79,19.06,"overcount"
"11157",49023,"Utah","Juab County","A_A",52,34,-18,-41.86,"undercount"
"11158",49023,"Utah","Juab County","A_AIC",75,99,24,27.59,"overcount"
"11159",49023,"Utah","Juab County","NHPI_A",34,41,7,18.67,"overcount"
"11160",49023,"Utah","Juab County","NHPI_AIC",60,94,34,44.16,"overcount"
"11161",49025,"Utah","Kane County","A_A",57,59,2,3.45,"overcount"
"11162",49025,"Utah","Kane County","A_AIC",84,111,27,27.69,"overcount"
"11163",49025,"Utah","Kane County","NHPI_A",6,1,-5,-142.86,"undercount"
"11164",49025,"Utah","Kane County","NHPI_AIC",21,23,2,9.09,"overcount"
"11165",49027,"Utah","Millard County","A_A",189,145,-44,-26.35,"undercount"
"11166",49027,"Utah","Millard County","A_AIC",242,193,-49,-22.53,"undercount"
"11167",49027,"Utah","Millard County","NHPI_A",20,14,-6,-35.29,"undercount"
"11168",49027,"Utah","Millard County","NHPI_AIC",38,34,-4,-11.11,"undercount"
"11169",49029,"Utah","Morgan County","A_A",72,57,-15,-23.26,"undercount"
"11170",49029,"Utah","Morgan County","A_AIC",105,144,39,31.33,"overcount"
"11171",49029,"Utah","Morgan County","NHPI_A",25,0,-25,-200,"undercount"
"11172",49029,"Utah","Morgan County","NHPI_AIC",41,20,-21,-68.85,"undercount"
"11173",49031,"Utah","Piute County","A_A",8,0,-8,-200,"undercount"
"11174",49031,"Utah","Piute County","A_AIC",11,5,-6,-75,"undercount"
"11175",49031,"Utah","Piute County","NHPI_A",3,0,-3,-200,"undercount"
"11176",49031,"Utah","Piute County","NHPI_AIC",4,5,1,22.22,"overcount"
"11177",49033,"Utah","Rich County","A_A",2,2,0,0,"equal"
"11178",49033,"Utah","Rich County","A_AIC",7,12,5,52.63,"overcount"
"11179",49033,"Utah","Rich County","NHPI_A",3,4,1,28.57,"overcount"
"11180",49033,"Utah","Rich County","NHPI_AIC",4,22,18,138.46,"overcount"
"11181",49035,"Utah","Salt Lake County","A_A",51134,50763,-371,-0.73,"undercount"
"11182",49035,"Utah","Salt Lake County","A_AIC",63637,66719,3082,4.73,"overcount"
"11183",49035,"Utah","Salt Lake County","NHPI_A",20324,21314,990,4.76,"overcount"
"11184",49035,"Utah","Salt Lake County","NHPI_AIC",26310,28610,2300,8.38,"overcount"
"11185",49037,"Utah","San Juan County","A_A",86,38,-48,-77.42,"undercount"
"11186",49037,"Utah","San Juan County","A_AIC",133,101,-32,-27.35,"undercount"
"11187",49037,"Utah","San Juan County","NHPI_A",11,51,40,129.03,"overcount"
"11188",49037,"Utah","San Juan County","NHPI_AIC",44,75,31,52.1,"overcount"
"11189",49039,"Utah","Sanpete County","A_A",210,171,-39,-20.47,"undercount"
"11190",49039,"Utah","Sanpete County","A_AIC",362,357,-5,-1.39,"undercount"
"11191",49039,"Utah","Sanpete County","NHPI_A",176,247,71,33.57,"overcount"
"11192",49039,"Utah","Sanpete County","NHPI_AIC",299,367,68,20.42,"overcount"
"11193",49041,"Utah","Sevier County","A_A",69,40,-29,-53.21,"undercount"
"11194",49041,"Utah","Sevier County","A_AIC",132,120,-12,-9.52,"undercount"
"11195",49041,"Utah","Sevier County","NHPI_A",44,49,5,10.75,"overcount"
"11196",49041,"Utah","Sevier County","NHPI_AIC",70,123,53,54.92,"overcount"
"11197",49043,"Utah","Summit County","A_A",779,726,-53,-7.04,"undercount"
"11198",49043,"Utah","Summit County","A_AIC",1110,1173,63,5.52,"overcount"
"11199",49043,"Utah","Summit County","NHPI_A",51,45,-6,-12.5,"undercount"
"11200",49043,"Utah","Summit County","NHPI_AIC",101,128,27,23.58,"overcount"
"11201",49045,"Utah","Tooele County","A_A",513,523,10,1.93,"overcount"
"11202",49045,"Utah","Tooele County","A_AIC",1004,1102,98,9.31,"overcount"
"11203",49045,"Utah","Tooele County","NHPI_A",554,639,85,14.25,"overcount"
"11204",49045,"Utah","Tooele County","NHPI_AIC",754,944,190,22.38,"overcount"
"11205",49047,"Utah","Uintah County","A_A",208,157,-51,-27.95,"undercount"
"11206",49047,"Utah","Uintah County","A_AIC",406,347,-59,-15.67,"undercount"
"11207",49047,"Utah","Uintah County","NHPI_A",100,97,-3,-3.05,"undercount"
"11208",49047,"Utah","Uintah County","NHPI_AIC",181,194,13,6.93,"overcount"
"11209",49049,"Utah","Utah County","A_A",11595,10235,-1360,-12.46,"undercount"
"11210",49049,"Utah","Utah County","A_AIC",19323,19871,548,2.8,"overcount"
"11211",49049,"Utah","Utah County","NHPI_A",6053,6652,599,9.43,"overcount"
"11212",49049,"Utah","Utah County","NHPI_AIC",11214,13138,1924,15.8,"overcount"
"11213",49051,"Utah","Wasatch County","A_A",342,354,12,3.45,"overcount"
"11214",49051,"Utah","Wasatch County","A_AIC",499,566,67,12.58,"overcount"
"11215",49051,"Utah","Wasatch County","NHPI_A",77,42,-35,-58.82,"undercount"
"11216",49051,"Utah","Wasatch County","NHPI_AIC",137,129,-8,-6.02,"undercount"
"11217",49053,"Utah","Washington County","A_A",1798,1832,34,1.87,"overcount"
"11218",49053,"Utah","Washington County","A_AIC",3089,3287,198,6.21,"overcount"
"11219",49053,"Utah","Washington County","NHPI_A",1536,1613,77,4.89,"overcount"
"11220",49053,"Utah","Washington County","NHPI_AIC",2488,2802,314,11.87,"overcount"
"11221",49055,"Utah","Wayne County","A_A",20,18,-2,-10.53,"undercount"
"11222",49055,"Utah","Wayne County","A_AIC",30,33,3,9.52,"overcount"
"11223",49055,"Utah","Wayne County","NHPI_A",5,3,-2,-50,"undercount"
"11224",49055,"Utah","Wayne County","NHPI_AIC",9,15,6,50,"overcount"
"11225",49057,"Utah","Weber County","A_A",3826,3675,-151,-4.03,"undercount"
"11226",49057,"Utah","Weber County","A_AIC",6370,6482,112,1.74,"overcount"
"11227",49057,"Utah","Weber County","NHPI_A",859,953,94,10.38,"overcount"
"11228",49057,"Utah","Weber County","NHPI_AIC",1665,1951,286,15.82,"overcount"
"11229",50001,"Vermont","Addison County","A_A",646,600,-46,-7.38,"undercount"
"11230",50001,"Vermont","Addison County","A_AIC",921,893,-28,-3.09,"undercount"
"11231",50001,"Vermont","Addison County","NHPI_A",13,10,-3,-26.09,"undercount"
"11232",50001,"Vermont","Addison County","NHPI_AIC",50,36,-14,-32.56,"undercount"
"11233",50003,"Vermont","Bennington County","A_A",452,415,-37,-8.54,"undercount"
"11234",50003,"Vermont","Bennington County","A_AIC",575,610,35,5.91,"overcount"
"11235",50003,"Vermont","Bennington County","NHPI_A",14,5,-9,-94.74,"undercount"
"11236",50003,"Vermont","Bennington County","NHPI_AIC",27,25,-2,-7.69,"undercount"
"11237",50005,"Vermont","Caledonia County","A_A",268,365,97,30.65,"overcount"
"11238",50005,"Vermont","Caledonia County","A_AIC",347,503,156,36.71,"overcount"
"11239",50005,"Vermont","Caledonia County","NHPI_A",6,17,11,95.65,"overcount"
"11240",50005,"Vermont","Caledonia County","NHPI_AIC",16,31,15,63.83,"overcount"
"11241",50007,"Vermont","Chittenden County","A_A",7881,7256,-625,-8.26,"undercount"
"11242",50007,"Vermont","Chittenden County","A_AIC",9307,9096,-211,-2.29,"undercount"
"11243",50007,"Vermont","Chittenden County","NHPI_A",42,54,12,25,"overcount"
"11244",50007,"Vermont","Chittenden County","NHPI_AIC",151,162,11,7.03,"overcount"
"11245",50009,"Vermont","Essex County","A_A",41,18,-23,-77.97,"undercount"
"11246",50009,"Vermont","Essex County","A_AIC",58,38,-20,-41.67,"undercount"
"11247",50009,"Vermont","Essex County","NHPI_A",0,5,5,200,"overcount"
"11248",50009,"Vermont","Essex County","NHPI_AIC",3,12,9,120,"overcount"
"11249",50011,"Vermont","Franklin County","A_A",447,324,-123,-31.91,"undercount"
"11250",50011,"Vermont","Franklin County","A_AIC",601,543,-58,-10.14,"undercount"
"11251",50011,"Vermont","Franklin County","NHPI_A",11,16,5,37.04,"overcount"
"11252",50011,"Vermont","Franklin County","NHPI_AIC",38,57,19,40,"overcount"
"11253",50013,"Vermont","Grand Isle County","A_A",51,31,-20,-48.78,"undercount"
"11254",50013,"Vermont","Grand Isle County","A_AIC",76,65,-11,-15.6,"undercount"
"11255",50013,"Vermont","Grand Isle County","NHPI_A",4,0,-4,-200,"undercount"
"11256",50013,"Vermont","Grand Isle County","NHPI_AIC",11,19,8,53.33,"overcount"
"11257",50015,"Vermont","Lamoille County","A_A",159,162,3,1.87,"overcount"
"11258",50015,"Vermont","Lamoille County","A_AIC",235,288,53,20.27,"overcount"
"11259",50015,"Vermont","Lamoille County","NHPI_A",12,1,-11,-169.23,"undercount"
"11260",50015,"Vermont","Lamoille County","NHPI_AIC",27,43,16,45.71,"overcount"
"11261",50017,"Vermont","Orange County","A_A",161,160,-1,-0.62,"undercount"
"11262",50017,"Vermont","Orange County","A_AIC",232,325,93,33.39,"overcount"
"11263",50017,"Vermont","Orange County","NHPI_A",5,5,0,0,"equal"
"11264",50017,"Vermont","Orange County","NHPI_AIC",17,24,7,34.15,"overcount"
"11265",50019,"Vermont","Orleans County","A_A",133,119,-14,-11.11,"undercount"
"11266",50019,"Vermont","Orleans County","A_AIC",222,233,11,4.84,"overcount"
"11267",50019,"Vermont","Orleans County","NHPI_A",8,1,-7,-155.56,"undercount"
"11268",50019,"Vermont","Orleans County","NHPI_AIC",24,27,3,11.76,"overcount"
"11269",50021,"Vermont","Rutland County","A_A",501,465,-36,-7.45,"undercount"
"11270",50021,"Vermont","Rutland County","A_AIC",679,733,54,7.65,"overcount"
"11271",50021,"Vermont","Rutland County","NHPI_A",12,14,2,15.38,"overcount"
"11272",50021,"Vermont","Rutland County","NHPI_AIC",39,52,13,28.57,"overcount"
"11273",50023,"Vermont","Washington County","A_A",541,644,103,17.38,"overcount"
"11274",50023,"Vermont","Washington County","A_AIC",840,989,149,16.29,"overcount"
"11275",50023,"Vermont","Washington County","NHPI_A",20,23,3,13.95,"overcount"
"11276",50023,"Vermont","Washington County","NHPI_AIC",63,62,-1,-1.6,"undercount"
"11277",50025,"Vermont","Windham County","A_A",518,499,-19,-3.74,"undercount"
"11278",50025,"Vermont","Windham County","A_AIC",693,764,71,9.75,"overcount"
"11279",50025,"Vermont","Windham County","NHPI_A",16,12,-4,-28.57,"undercount"
"11280",50025,"Vermont","Windham County","NHPI_AIC",40,53,13,27.96,"overcount"
"11281",50027,"Vermont","Windsor County","A_A",552,555,3,0.54,"overcount"
"11282",50027,"Vermont","Windsor County","A_AIC",784,922,138,16.18,"overcount"
"11283",50027,"Vermont","Windsor County","NHPI_A",16,16,0,0,"equal"
"11284",50027,"Vermont","Windsor County","NHPI_AIC",43,58,15,29.7,"overcount"
"11285",51001,"Virginia","Accomack County","A_A",239,249,10,4.1,"overcount"
"11286",51001,"Virginia","Accomack County","A_AIC",321,362,41,12.01,"overcount"
"11287",51001,"Virginia","Accomack County","NHPI_A",36,11,-25,-106.38,"undercount"
"11288",51001,"Virginia","Accomack County","NHPI_AIC",57,34,-23,-50.55,"undercount"
"11289",51003,"Virginia","Albemarle County","A_A",6203,8277,2074,28.65,"overcount"
"11290",51003,"Virginia","Albemarle County","A_AIC",7383,9786,2403,27.99,"overcount"
"11291",51003,"Virginia","Albemarle County","NHPI_A",66,44,-22,-40,"undercount"
"11292",51003,"Virginia","Albemarle County","NHPI_AIC",160,171,11,6.65,"overcount"
"11293",51005,"Virginia","Alleghany County","A_A",56,63,7,11.76,"overcount"
"11294",51005,"Virginia","Alleghany County","A_AIC",82,95,13,14.69,"overcount"
"11295",51005,"Virginia","Alleghany County","NHPI_A",12,7,-5,-52.63,"undercount"
"11296",51005,"Virginia","Alleghany County","NHPI_AIC",16,17,1,6.06,"overcount"
"11297",51007,"Virginia","Amelia County","A_A",61,63,2,3.23,"overcount"
"11298",51007,"Virginia","Amelia County","A_AIC",99,116,17,15.81,"overcount"
"11299",51007,"Virginia","Amelia County","NHPI_A",0,0,0,0,"equal"
"11300",51007,"Virginia","Amelia County","NHPI_AIC",5,4,-1,-22.22,"undercount"
"11301",51009,"Virginia","Amherst County","A_A",159,185,26,15.12,"overcount"
"11302",51009,"Virginia","Amherst County","A_AIC",299,259,-40,-14.34,"undercount"
"11303",51009,"Virginia","Amherst County","NHPI_A",13,26,13,66.67,"overcount"
"11304",51009,"Virginia","Amherst County","NHPI_AIC",34,34,0,0,"equal"
"11305",51011,"Virginia","Appomattox County","A_A",67,45,-22,-39.29,"undercount"
"11306",51011,"Virginia","Appomattox County","A_AIC",108,82,-26,-27.37,"undercount"
"11307",51011,"Virginia","Appomattox County","NHPI_A",7,3,-4,-80,"undercount"
"11308",51011,"Virginia","Appomattox County","NHPI_AIC",11,9,-2,-20,"undercount"
"11309",51013,"Virginia","Arlington County","A_A",26357,27517,1160,4.31,"overcount"
"11310",51013,"Virginia","Arlington County","A_AIC",31136,33720,2584,7.97,"overcount"
"11311",51013,"Virginia","Arlington County","NHPI_A",179,118,-61,-41.08,"undercount"
"11312",51013,"Virginia","Arlington County","NHPI_AIC",530,472,-58,-11.58,"undercount"
"11313",51015,"Virginia","Augusta County","A_A",494,495,1,0.2,"overcount"
"11314",51015,"Virginia","Augusta County","A_AIC",717,768,51,6.87,"overcount"
"11315",51015,"Virginia","Augusta County","NHPI_A",19,29,10,41.67,"overcount"
"11316",51015,"Virginia","Augusta County","NHPI_AIC",32,71,39,75.73,"overcount"
"11317",51017,"Virginia","Bath County","A_A",17,17,0,0,"equal"
"11318",51017,"Virginia","Bath County","A_AIC",29,37,8,24.24,"overcount"
"11319",51017,"Virginia","Bath County","NHPI_A",0,1,1,200,"overcount"
"11320",51017,"Virginia","Bath County","NHPI_AIC",0,6,6,200,"overcount"
"11321",51019,"Virginia","Bedford County","A_A",1016,967,-49,-4.94,"undercount"
"11322",51019,"Virginia","Bedford County","A_AIC",1321,1373,52,3.86,"overcount"
"11323",51019,"Virginia","Bedford County","NHPI_A",21,33,12,44.44,"overcount"
"11324",51019,"Virginia","Bedford County","NHPI_AIC",55,74,19,29.46,"overcount"
"11325",51021,"Virginia","Bland County","A_A",32,5,-27,-145.95,"undercount"
"11326",51021,"Virginia","Bland County","A_AIC",42,42,0,0,"equal"
"11327",51021,"Virginia","Bland County","NHPI_A",1,0,-1,-200,"undercount"
"11328",51021,"Virginia","Bland County","NHPI_AIC",1,14,13,173.33,"overcount"
"11329",51023,"Virginia","Botetourt County","A_A",270,234,-36,-14.29,"undercount"
"11330",51023,"Virginia","Botetourt County","A_AIC",386,413,27,6.76,"overcount"
"11331",51023,"Virginia","Botetourt County","NHPI_A",5,3,-2,-50,"undercount"
"11332",51023,"Virginia","Botetourt County","NHPI_AIC",12,10,-2,-18.18,"undercount"
"11333",51025,"Virginia","Brunswick County","A_A",162,42,-120,-117.65,"undercount"
"11334",51025,"Virginia","Brunswick County","A_AIC",195,76,-119,-87.82,"undercount"
"11335",51025,"Virginia","Brunswick County","NHPI_A",6,5,-1,-18.18,"undercount"
"11336",51025,"Virginia","Brunswick County","NHPI_AIC",11,23,12,70.59,"overcount"
"11337",51027,"Virginia","Buchanan County","A_A",93,51,-42,-58.33,"undercount"
"11338",51027,"Virginia","Buchanan County","A_AIC",119,69,-50,-53.19,"undercount"
"11339",51027,"Virginia","Buchanan County","NHPI_A",3,1,-2,-100,"undercount"
"11340",51027,"Virginia","Buchanan County","NHPI_AIC",5,11,6,75,"overcount"
"11341",51029,"Virginia","Buckingham County","A_A",73,59,-14,-21.21,"undercount"
"11342",51029,"Virginia","Buckingham County","A_AIC",113,87,-26,-26,"undercount"
"11343",51029,"Virginia","Buckingham County","NHPI_A",2,0,-2,-200,"undercount"
"11344",51029,"Virginia","Buckingham County","NHPI_AIC",6,13,7,73.68,"overcount"
"11345",51031,"Virginia","Campbell County","A_A",590,608,18,3.01,"overcount"
"11346",51031,"Virginia","Campbell County","A_AIC",788,838,50,6.15,"overcount"
"11347",51031,"Virginia","Campbell County","NHPI_A",15,8,-7,-60.87,"undercount"
"11348",51031,"Virginia","Campbell County","NHPI_AIC",58,39,-19,-39.18,"undercount"
"11349",51033,"Virginia","Caroline County","A_A",276,304,28,9.66,"overcount"
"11350",51033,"Virginia","Caroline County","A_AIC",470,544,74,14.6,"overcount"
"11351",51033,"Virginia","Caroline County","NHPI_A",27,18,-9,-40,"undercount"
"11352",51033,"Virginia","Caroline County","NHPI_AIC",86,81,-5,-5.99,"undercount"
"11353",51035,"Virginia","Carroll County","A_A",68,81,13,17.45,"overcount"
"11354",51035,"Virginia","Carroll County","A_AIC",121,129,8,6.4,"overcount"
"11355",51035,"Virginia","Carroll County","NHPI_A",5,4,-1,-22.22,"undercount"
"11356",51035,"Virginia","Carroll County","NHPI_AIC",9,24,15,90.91,"overcount"
"11357",51036,"Virginia","Charles City County","A_A",36,34,-2,-5.71,"undercount"
"11358",51036,"Virginia","Charles City County","A_AIC",81,70,-11,-14.57,"undercount"
"11359",51036,"Virginia","Charles City County","NHPI_A",6,6,0,0,"equal"
"11360",51036,"Virginia","Charles City County","NHPI_AIC",15,19,4,23.53,"overcount"
"11361",51037,"Virginia","Charlotte County","A_A",33,23,-10,-35.71,"undercount"
"11362",51037,"Virginia","Charlotte County","A_AIC",61,56,-5,-8.55,"undercount"
"11363",51037,"Virginia","Charlotte County","NHPI_A",0,6,6,200,"overcount"
"11364",51037,"Virginia","Charlotte County","NHPI_AIC",6,11,5,58.82,"overcount"
"11365",51041,"Virginia","Chesterfield County","A_A",13085,13268,183,1.39,"overcount"
"11366",51041,"Virginia","Chesterfield County","A_AIC",16222,17104,882,5.29,"overcount"
"11367",51041,"Virginia","Chesterfield County","NHPI_A",243,194,-49,-22.43,"undercount"
"11368",51041,"Virginia","Chesterfield County","NHPI_AIC",545,567,22,3.96,"overcount"
"11369",51043,"Virginia","Clarke County","A_A",179,211,32,16.41,"overcount"
"11370",51043,"Virginia","Clarke County","A_AIC",266,312,46,15.92,"overcount"
"11371",51043,"Virginia","Clarke County","NHPI_A",8,15,7,60.87,"overcount"
"11372",51043,"Virginia","Clarke County","NHPI_AIC",20,23,3,13.95,"overcount"
"11373",51045,"Virginia","Craig County","A_A",14,11,-3,-24,"undercount"
"11374",51045,"Virginia","Craig County","A_AIC",23,29,6,23.08,"overcount"
"11375",51045,"Virginia","Craig County","NHPI_A",0,3,3,200,"overcount"
"11376",51045,"Virginia","Craig County","NHPI_AIC",0,5,5,200,"overcount"
"11377",51047,"Virginia","Culpeper County","A_A",896,767,-129,-15.51,"undercount"
"11378",51047,"Virginia","Culpeper County","A_AIC",1264,1186,-78,-6.37,"undercount"
"11379",51047,"Virginia","Culpeper County","NHPI_A",16,22,6,31.58,"overcount"
"11380",51047,"Virginia","Culpeper County","NHPI_AIC",61,97,36,45.57,"overcount"
"11381",51049,"Virginia","Cumberland County","A_A",43,36,-7,-17.72,"undercount"
"11382",51049,"Virginia","Cumberland County","A_AIC",81,73,-8,-10.39,"undercount"
"11383",51049,"Virginia","Cumberland County","NHPI_A",0,8,8,200,"overcount"
"11384",51049,"Virginia","Cumberland County","NHPI_AIC",10,12,2,18.18,"overcount"
"11385",51051,"Virginia","Dickenson County","A_A",29,14,-15,-69.77,"undercount"
"11386",51051,"Virginia","Dickenson County","A_AIC",49,26,-23,-61.33,"undercount"
"11387",51051,"Virginia","Dickenson County","NHPI_A",0,2,2,200,"overcount"
"11388",51051,"Virginia","Dickenson County","NHPI_AIC",2,16,14,155.56,"overcount"
"11389",51053,"Virginia","Dinwiddie County","A_A",246,119,-127,-69.59,"undercount"
"11390",51053,"Virginia","Dinwiddie County","A_AIC",351,233,-118,-40.41,"undercount"
"11391",51053,"Virginia","Dinwiddie County","NHPI_A",16,9,-7,-56,"undercount"
"11392",51053,"Virginia","Dinwiddie County","NHPI_AIC",43,39,-4,-9.76,"undercount"
"11393",51057,"Virginia","Essex County","A_A",126,65,-61,-63.87,"undercount"
"11394",51057,"Virginia","Essex County","A_AIC",176,118,-58,-39.46,"undercount"
"11395",51057,"Virginia","Essex County","NHPI_A",2,3,1,40,"overcount"
"11396",51057,"Virginia","Essex County","NHPI_AIC",15,20,5,28.57,"overcount"
"11397",51059,"Virginia","Fairfax County","A_A",233808,235984,2176,0.93,"overcount"
"11398",51059,"Virginia","Fairfax County","A_AIC",260802,267098,6296,2.39,"overcount"
"11399",51059,"Virginia","Fairfax County","NHPI_A",508,808,300,45.59,"overcount"
"11400",51059,"Virginia","Fairfax County","NHPI_AIC",2135,2629,494,20.74,"overcount"
"11401",51061,"Virginia","Fauquier County","A_A",1198,1219,21,1.74,"overcount"
"11402",51061,"Virginia","Fauquier County","A_AIC",1737,1993,256,13.73,"overcount"
"11403",51061,"Virginia","Fauquier County","NHPI_A",44,54,10,20.41,"overcount"
"11404",51061,"Virginia","Fauquier County","NHPI_AIC",120,154,34,24.82,"overcount"
"11405",51063,"Virginia","Floyd County","A_A",77,51,-26,-40.62,"undercount"
"11406",51063,"Virginia","Floyd County","A_AIC",131,118,-13,-10.44,"undercount"
"11407",51063,"Virginia","Floyd County","NHPI_A",4,0,-4,-200,"undercount"
"11408",51063,"Virginia","Floyd County","NHPI_AIC",17,19,2,11.11,"overcount"
"11409",51065,"Virginia","Fluvanna County","A_A",231,220,-11,-4.88,"undercount"
"11410",51065,"Virginia","Fluvanna County","A_AIC",378,414,36,9.09,"overcount"
"11411",51065,"Virginia","Fluvanna County","NHPI_A",22,7,-15,-103.45,"undercount"
"11412",51065,"Virginia","Fluvanna County","NHPI_AIC",52,47,-5,-10.1,"undercount"
"11413",51067,"Virginia","Franklin County","A_A",282,311,29,9.78,"overcount"
"11414",51067,"Virginia","Franklin County","A_AIC",404,466,62,14.25,"overcount"
"11415",51067,"Virginia","Franklin County","NHPI_A",15,20,5,28.57,"overcount"
"11416",51067,"Virginia","Franklin County","NHPI_AIC",37,44,7,17.28,"overcount"
"11417",51069,"Virginia","Frederick County","A_A",1651,1673,22,1.32,"overcount"
"11418",51069,"Virginia","Frederick County","A_AIC",2143,2357,214,9.51,"overcount"
"11419",51069,"Virginia","Frederick County","NHPI_A",51,39,-12,-26.67,"undercount"
"11420",51069,"Virginia","Frederick County","NHPI_AIC",136,128,-8,-6.06,"undercount"
"11421",51071,"Virginia","Giles County","A_A",95,69,-26,-31.71,"undercount"
"11422",51071,"Virginia","Giles County","A_AIC",124,99,-25,-22.42,"undercount"
"11423",51071,"Virginia","Giles County","NHPI_A",4,0,-4,-200,"undercount"
"11424",51071,"Virginia","Giles County","NHPI_AIC",13,12,-1,-8,"undercount"
"11425",51073,"Virginia","Gloucester County","A_A",307,312,5,1.62,"overcount"
"11426",51073,"Virginia","Gloucester County","A_AIC",555,695,140,22.4,"overcount"
"11427",51073,"Virginia","Gloucester County","NHPI_A",23,21,-2,-9.09,"undercount"
"11428",51073,"Virginia","Gloucester County","NHPI_AIC",71,86,15,19.11,"overcount"
"11429",51075,"Virginia","Goochland County","A_A",478,522,44,8.8,"overcount"
"11430",51075,"Virginia","Goochland County","A_AIC",603,701,98,15.03,"overcount"
"11431",51075,"Virginia","Goochland County","NHPI_A",14,3,-11,-129.41,"undercount"
"11432",51075,"Virginia","Goochland County","NHPI_AIC",34,23,-11,-38.6,"undercount"
"11433",51077,"Virginia","Grayson County","A_A",24,26,2,8,"overcount"
"11434",51077,"Virginia","Grayson County","A_AIC",44,56,12,24,"overcount"
"11435",51077,"Virginia","Grayson County","NHPI_A",1,2,1,66.67,"overcount"
"11436",51077,"Virginia","Grayson County","NHPI_AIC",5,8,3,46.15,"overcount"
"11437",51079,"Virginia","Greene County","A_A",457,457,0,0,"equal"
"11438",51079,"Virginia","Greene County","A_AIC",554,620,66,11.24,"overcount"
"11439",51079,"Virginia","Greene County","NHPI_A",9,4,-5,-76.92,"undercount"
"11440",51079,"Virginia","Greene County","NHPI_AIC",29,32,3,9.84,"overcount"
"11441",51081,"Virginia","Greensville County","A_A",80,32,-48,-85.71,"undercount"
"11442",51081,"Virginia","Greensville County","A_AIC",100,104,4,3.92,"overcount"
"11443",51081,"Virginia","Greensville County","NHPI_A",1,0,-1,-200,"undercount"
"11444",51081,"Virginia","Greensville County","NHPI_AIC",12,30,18,85.71,"overcount"
"11445",51083,"Virginia","Halifax County","A_A",219,225,6,2.7,"overcount"
"11446",51083,"Virginia","Halifax County","A_AIC",284,251,-33,-12.34,"undercount"
"11447",51083,"Virginia","Halifax County","NHPI_A",3,3,0,0,"equal"
"11448",51083,"Virginia","Halifax County","NHPI_AIC",33,24,-9,-31.58,"undercount"
"11449",51085,"Virginia","Hanover County","A_A",2122,2077,-45,-2.14,"undercount"
"11450",51085,"Virginia","Hanover County","A_AIC",2840,3074,234,7.91,"overcount"
"11451",51085,"Virginia","Hanover County","NHPI_A",68,36,-32,-61.54,"undercount"
"11452",51085,"Virginia","Hanover County","NHPI_AIC",159,115,-44,-32.12,"undercount"
"11453",51087,"Virginia","Henrico County","A_A",31750,32459,709,2.21,"overcount"
"11454",51087,"Virginia","Henrico County","A_AIC",34720,36199,1479,4.17,"overcount"
"11455",51087,"Virginia","Henrico County","NHPI_A",167,132,-35,-23.41,"undercount"
"11456",51087,"Virginia","Henrico County","NHPI_AIC",430,391,-39,-9.5,"undercount"
"11457",51089,"Virginia","Henry County","A_A",247,294,47,17.38,"overcount"
"11458",51089,"Virginia","Henry County","A_AIC",341,399,58,15.68,"overcount"
"11459",51089,"Virginia","Henry County","NHPI_A",23,6,-17,-117.24,"undercount"
"11460",51089,"Virginia","Henry County","NHPI_AIC",52,20,-32,-88.89,"undercount"
"11461",51091,"Virginia","Highland County","A_A",17,7,-10,-83.33,"undercount"
"11462",51091,"Virginia","Highland County","A_AIC",19,12,-7,-45.16,"undercount"
"11463",51091,"Virginia","Highland County","NHPI_A",0,1,1,200,"overcount"
"11464",51091,"Virginia","Highland County","NHPI_AIC",1,11,10,166.67,"overcount"
"11465",51093,"Virginia","Isle of Wight County","A_A",368,391,23,6.06,"overcount"
"11466",51093,"Virginia","Isle of Wight County","A_AIC",674,717,43,6.18,"overcount"
"11467",51093,"Virginia","Isle of Wight County","NHPI_A",21,31,10,38.46,"overcount"
"11468",51093,"Virginia","Isle of Wight County","NHPI_AIC",77,60,-17,-24.82,"undercount"
"11469",51095,"Virginia","James City County","A_A",2075,2263,188,8.67,"overcount"
"11470",51095,"Virginia","James City County","A_AIC",2902,3329,427,13.71,"overcount"
"11471",51095,"Virginia","James City County","NHPI_A",68,48,-20,-34.48,"undercount"
"11472",51095,"Virginia","James City County","NHPI_AIC",187,177,-10,-5.49,"undercount"
"11473",51097,"Virginia","King and Queen County","A_A",35,23,-12,-41.38,"undercount"
"11474",51097,"Virginia","King and Queen County","A_AIC",67,50,-17,-29.06,"undercount"
"11475",51097,"Virginia","King and Queen County","NHPI_A",2,3,1,40,"overcount"
"11476",51097,"Virginia","King and Queen County","NHPI_AIC",8,8,0,0,"equal"
"11477",51099,"Virginia","King George County","A_A",426,406,-20,-4.81,"undercount"
"11478",51099,"Virginia","King George County","A_AIC",701,782,81,10.92,"overcount"
"11479",51099,"Virginia","King George County","NHPI_A",26,17,-9,-41.86,"undercount"
"11480",51099,"Virginia","King George County","NHPI_AIC",80,60,-20,-28.57,"undercount"
"11481",51101,"Virginia","King William County","A_A",222,135,-87,-48.74,"undercount"
"11482",51101,"Virginia","King William County","A_AIC",308,254,-54,-19.22,"undercount"
"11483",51101,"Virginia","King William County","NHPI_A",2,9,7,127.27,"overcount"
"11484",51101,"Virginia","King William County","NHPI_AIC",21,35,14,50,"overcount"
"11485",51103,"Virginia","Lancaster County","A_A",89,77,-12,-14.46,"undercount"
"11486",51103,"Virginia","Lancaster County","A_AIC",100,122,22,19.82,"overcount"
"11487",51103,"Virginia","Lancaster County","NHPI_A",0,1,1,200,"overcount"
"11488",51103,"Virginia","Lancaster County","NHPI_AIC",0,21,21,200,"overcount"
"11489",51105,"Virginia","Lee County","A_A",64,42,-22,-41.51,"undercount"
"11490",51105,"Virginia","Lee County","A_AIC",118,73,-45,-47.12,"undercount"
"11491",51105,"Virginia","Lee County","NHPI_A",9,0,-9,-200,"undercount"
"11492",51105,"Virginia","Lee County","NHPI_AIC",25,9,-16,-94.12,"undercount"
"11493",51107,"Virginia","Loudoun County","A_A",88151,89933,1782,2,"overcount"
"11494",51107,"Virginia","Loudoun County","A_AIC",97629,101139,3510,3.53,"overcount"
"11495",51107,"Virginia","Loudoun County","NHPI_A",240,238,-2,-0.84,"undercount"
"11496",51107,"Virginia","Loudoun County","NHPI_AIC",793,878,85,10.17,"overcount"
"11497",51109,"Virginia","Louisa County","A_A",247,253,6,2.4,"overcount"
"11498",51109,"Virginia","Louisa County","A_AIC",388,445,57,13.69,"overcount"
"11499",51109,"Virginia","Louisa County","NHPI_A",21,18,-3,-15.38,"undercount"
"11500",51109,"Virginia","Louisa County","NHPI_AIC",51,53,2,3.85,"overcount"
"11501",51111,"Virginia","Lunenburg County","A_A",60,25,-35,-82.35,"undercount"
"11502",51111,"Virginia","Lunenburg County","A_AIC",99,74,-25,-28.9,"undercount"
"11503",51111,"Virginia","Lunenburg County","NHPI_A",7,5,-2,-33.33,"undercount"
"11504",51111,"Virginia","Lunenburg County","NHPI_AIC",14,32,18,78.26,"overcount"
"11505",51113,"Virginia","Madison County","A_A",94,86,-8,-8.89,"undercount"
"11506",51113,"Virginia","Madison County","A_AIC",138,144,6,4.26,"overcount"
"11507",51113,"Virginia","Madison County","NHPI_A",4,1,-3,-120,"undercount"
"11508",51113,"Virginia","Madison County","NHPI_AIC",13,20,7,42.42,"overcount"
"11509",51115,"Virginia","Mathews County","A_A",74,49,-25,-40.65,"undercount"
"11510",51115,"Virginia","Mathews County","A_AIC",109,95,-14,-13.73,"undercount"
"11511",51115,"Virginia","Mathews County","NHPI_A",12,15,3,22.22,"overcount"
"11512",51115,"Virginia","Mathews County","NHPI_AIC",19,15,-4,-23.53,"undercount"
"11513",51117,"Virginia","Mecklenburg County","A_A",245,211,-34,-14.91,"undercount"
"11514",51117,"Virginia","Mecklenburg County","A_AIC",324,281,-43,-14.21,"undercount"
"11515",51117,"Virginia","Mecklenburg County","NHPI_A",15,0,-15,-200,"undercount"
"11516",51117,"Virginia","Mecklenburg County","NHPI_AIC",39,12,-27,-105.88,"undercount"
"11517",51119,"Virginia","Middlesex County","A_A",51,30,-21,-51.85,"undercount"
"11518",51119,"Virginia","Middlesex County","A_AIC",85,73,-12,-15.19,"undercount"
"11519",51119,"Virginia","Middlesex County","NHPI_A",1,3,2,100,"overcount"
"11520",51119,"Virginia","Middlesex County","NHPI_AIC",8,14,6,54.55,"overcount"
"11521",51121,"Virginia","Montgomery County","A_A",5993,8346,2353,32.82,"overcount"
"11522",51121,"Virginia","Montgomery County","A_AIC",7212,9777,2565,30.2,"overcount"
"11523",51121,"Virginia","Montgomery County","NHPI_A",42,45,3,6.9,"overcount"
"11524",51121,"Virginia","Montgomery County","NHPI_AIC",144,99,-45,-37.04,"undercount"
"11525",51125,"Virginia","Nelson County","A_A",115,67,-48,-52.75,"undercount"
"11526",51125,"Virginia","Nelson County","A_AIC",155,121,-34,-24.64,"undercount"
"11527",51125,"Virginia","Nelson County","NHPI_A",6,2,-4,-100,"undercount"
"11528",51125,"Virginia","Nelson County","NHPI_AIC",14,18,4,25,"overcount"
"11529",51127,"Virginia","New Kent County","A_A",267,227,-40,-16.19,"undercount"
"11530",51127,"Virginia","New Kent County","A_AIC",469,416,-53,-11.98,"undercount"
"11531",51127,"Virginia","New Kent County","NHPI_A",11,9,-2,-20,"undercount"
"11532",51127,"Virginia","New Kent County","NHPI_AIC",39,55,16,34.04,"overcount"
"11533",51131,"Virginia","Northampton County","A_A",120,80,-40,-40,"undercount"
"11534",51131,"Virginia","Northampton County","A_AIC",152,136,-16,-11.11,"undercount"
"11535",51131,"Virginia","Northampton County","NHPI_A",5,8,3,46.15,"overcount"
"11536",51131,"Virginia","Northampton County","NHPI_AIC",14,19,5,30.3,"overcount"
"11537",51133,"Virginia","Northumberland County","A_A",61,67,6,9.38,"overcount"
"11538",51133,"Virginia","Northumberland County","A_AIC",89,103,14,14.58,"overcount"
"11539",51133,"Virginia","Northumberland County","NHPI_A",5,2,-3,-85.71,"undercount"
"11540",51133,"Virginia","Northumberland County","NHPI_AIC",8,21,13,89.66,"overcount"
"11541",51135,"Virginia","Nottoway County","A_A",82,64,-18,-24.66,"undercount"
"11542",51135,"Virginia","Nottoway County","A_AIC",136,121,-15,-11.67,"undercount"
"11543",51135,"Virginia","Nottoway County","NHPI_A",3,3,0,0,"equal"
"11544",51135,"Virginia","Nottoway County","NHPI_AIC",14,18,4,25,"overcount"
"11545",51137,"Virginia","Orange County","A_A",430,315,-115,-30.87,"undercount"
"11546",51137,"Virginia","Orange County","A_AIC",656,585,-71,-11.44,"undercount"
"11547",51137,"Virginia","Orange County","NHPI_A",23,18,-5,-24.39,"undercount"
"11548",51137,"Virginia","Orange County","NHPI_AIC",63,76,13,18.71,"overcount"
"11549",51139,"Virginia","Page County","A_A",116,138,22,17.32,"overcount"
"11550",51139,"Virginia","Page County","A_AIC",183,241,58,27.36,"overcount"
"11551",51139,"Virginia","Page County","NHPI_A",10,8,-2,-22.22,"undercount"
"11552",51139,"Virginia","Page County","NHPI_AIC",21,31,10,38.46,"overcount"
"11553",51141,"Virginia","Patrick County","A_A",57,52,-5,-9.17,"undercount"
"11554",51141,"Virginia","Patrick County","A_AIC",87,81,-6,-7.14,"undercount"
"11555",51141,"Virginia","Patrick County","NHPI_A",4,3,-1,-28.57,"undercount"
"11556",51141,"Virginia","Patrick County","NHPI_AIC",5,13,8,88.89,"overcount"
"11557",51143,"Virginia","Pittsylvania County","A_A",273,298,25,8.76,"overcount"
"11558",51143,"Virginia","Pittsylvania County","A_AIC",400,407,7,1.73,"overcount"
"11559",51143,"Virginia","Pittsylvania County","NHPI_A",26,19,-7,-31.11,"undercount"
"11560",51143,"Virginia","Pittsylvania County","NHPI_AIC",59,36,-23,-48.42,"undercount"
"11561",51145,"Virginia","Powhatan County","A_A",189,167,-22,-12.36,"undercount"
"11562",51145,"Virginia","Powhatan County","A_AIC",276,353,77,24.48,"overcount"
"11563",51145,"Virginia","Powhatan County","NHPI_A",26,18,-8,-36.36,"undercount"
"11564",51145,"Virginia","Powhatan County","NHPI_AIC",56,49,-7,-13.33,"undercount"
"11565",51147,"Virginia","Prince Edward County","A_A",291,202,-89,-36.11,"undercount"
"11566",51147,"Virginia","Prince Edward County","A_AIC",354,266,-88,-28.39,"undercount"
"11567",51147,"Virginia","Prince Edward County","NHPI_A",21,0,-21,-200,"undercount"
"11568",51147,"Virginia","Prince Edward County","NHPI_AIC",42,27,-15,-43.48,"undercount"
"11569",51149,"Virginia","Prince George County","A_A",720,834,114,14.67,"overcount"
"11570",51149,"Virginia","Prince George County","A_AIC",1033,1283,250,21.59,"overcount"
"11571",51149,"Virginia","Prince George County","NHPI_A",126,150,24,17.39,"overcount"
"11572",51149,"Virginia","Prince George County","NHPI_AIC",234,253,19,7.8,"overcount"
"11573",51153,"Virginia","Prince William County","A_A",45285,50368,5083,10.63,"overcount"
"11574",51153,"Virginia","Prince William County","A_AIC",54004,61408,7404,12.83,"overcount"
"11575",51153,"Virginia","Prince William County","NHPI_A",522,536,14,2.65,"overcount"
"11576",51153,"Virginia","Prince William County","NHPI_AIC",1343,1408,65,4.73,"overcount"
"11577",51155,"Virginia","Pulaski County","A_A",216,180,-36,-18.18,"undercount"
"11578",51155,"Virginia","Pulaski County","A_AIC",291,293,2,0.68,"overcount"
"11579",51155,"Virginia","Pulaski County","NHPI_A",5,3,-2,-50,"undercount"
"11580",51155,"Virginia","Pulaski County","NHPI_AIC",29,31,2,6.67,"overcount"
"11581",51157,"Virginia","Rappahannock County","A_A",94,63,-31,-39.49,"undercount"
"11582",51157,"Virginia","Rappahannock County","A_AIC",122,107,-15,-13.1,"undercount"
"11583",51157,"Virginia","Rappahannock County","NHPI_A",7,0,-7,-200,"undercount"
"11584",51157,"Virginia","Rappahannock County","NHPI_AIC",16,14,-2,-13.33,"undercount"
"11585",51159,"Virginia","Richmond County","A_A",61,42,-19,-36.89,"undercount"
"11586",51159,"Virginia","Richmond County","A_AIC",96,100,4,4.08,"overcount"
"11587",51159,"Virginia","Richmond County","NHPI_A",2,0,-2,-200,"undercount"
"11588",51159,"Virginia","Richmond County","NHPI_AIC",11,22,11,66.67,"overcount"
"11589",51161,"Virginia","Roanoke County","A_A",3380,3494,114,3.32,"overcount"
"11590",51161,"Virginia","Roanoke County","A_AIC",3875,4177,302,7.5,"overcount"
"11591",51161,"Virginia","Roanoke County","NHPI_A",29,24,-5,-18.87,"undercount"
"11592",51161,"Virginia","Roanoke County","NHPI_AIC",110,104,-6,-5.61,"undercount"
"11593",51163,"Virginia","Rockbridge County","A_A",173,183,10,5.62,"overcount"
"11594",51163,"Virginia","Rockbridge County","A_AIC",235,260,25,10.1,"overcount"
"11595",51163,"Virginia","Rockbridge County","NHPI_A",4,6,2,40,"overcount"
"11596",51163,"Virginia","Rockbridge County","NHPI_AIC",22,22,0,0,"equal"
"11597",51165,"Virginia","Rockingham County","A_A",813,926,113,13,"overcount"
"11598",51165,"Virginia","Rockingham County","A_AIC",1052,1323,271,22.82,"overcount"
"11599",51165,"Virginia","Rockingham County","NHPI_A",27,13,-14,-70,"undercount"
"11600",51165,"Virginia","Rockingham County","NHPI_AIC",62,65,3,4.72,"overcount"
"11601",51167,"Virginia","Russell County","A_A",69,42,-27,-48.65,"undercount"
"11602",51167,"Virginia","Russell County","A_AIC",115,77,-38,-39.58,"undercount"
"11603",51167,"Virginia","Russell County","NHPI_A",4,1,-3,-120,"undercount"
"11604",51167,"Virginia","Russell County","NHPI_AIC",12,15,3,22.22,"overcount"
"11605",51169,"Virginia","Scott County","A_A",38,20,-18,-62.07,"undercount"
"11606",51169,"Virginia","Scott County","A_AIC",77,50,-27,-42.52,"undercount"
"11607",51169,"Virginia","Scott County","NHPI_A",1,2,1,66.67,"overcount"
"11608",51169,"Virginia","Scott County","NHPI_AIC",11,18,7,48.28,"overcount"
"11609",51171,"Virginia","Shenandoah County","A_A",482,352,-130,-31.18,"undercount"
"11610",51171,"Virginia","Shenandoah County","A_AIC",598,549,-49,-8.54,"undercount"
"11611",51171,"Virginia","Shenandoah County","NHPI_A",11,8,-3,-31.58,"undercount"
"11612",51171,"Virginia","Shenandoah County","NHPI_AIC",32,29,-3,-9.84,"undercount"
"11613",51173,"Virginia","Smyth County","A_A",146,114,-32,-24.62,"undercount"
"11614",51173,"Virginia","Smyth County","A_AIC",193,189,-4,-2.09,"undercount"
"11615",51173,"Virginia","Smyth County","NHPI_A",4,1,-3,-120,"undercount"
"11616",51173,"Virginia","Smyth County","NHPI_AIC",20,34,14,51.85,"overcount"
"11617",51175,"Virginia","Southampton County","A_A",108,67,-41,-46.86,"undercount"
"11618",51175,"Virginia","Southampton County","A_AIC",170,99,-71,-52.79,"undercount"
"11619",51175,"Virginia","Southampton County","NHPI_A",12,21,9,54.55,"overcount"
"11620",51175,"Virginia","Southampton County","NHPI_AIC",28,50,22,56.41,"overcount"
"11621",51177,"Virginia","Spotsylvania County","A_A",3858,3983,125,3.19,"overcount"
"11622",51177,"Virginia","Spotsylvania County","A_AIC",5364,5861,497,8.86,"overcount"
"11623",51177,"Virginia","Spotsylvania County","NHPI_A",173,124,-49,-33,"undercount"
"11624",51177,"Virginia","Spotsylvania County","NHPI_AIC",351,354,3,0.85,"overcount"
"11625",51179,"Virginia","Stafford County","A_A",5671,6211,540,9.09,"overcount"
"11626",51179,"Virginia","Stafford County","A_AIC",8187,9468,1281,14.51,"overcount"
"11627",51179,"Virginia","Stafford County","NHPI_A",221,243,22,9.48,"overcount"
"11628",51179,"Virginia","Stafford County","NHPI_AIC",452,642,190,34.73,"overcount"
"11629",51181,"Virginia","Surry County","A_A",30,14,-16,-72.73,"undercount"
"11630",51181,"Virginia","Surry County","A_AIC",57,31,-26,-59.09,"undercount"
"11631",51181,"Virginia","Surry County","NHPI_A",3,10,7,107.69,"overcount"
"11632",51181,"Virginia","Surry County","NHPI_AIC",7,19,12,92.31,"overcount"
"11633",51183,"Virginia","Sussex County","A_A",46,11,-35,-122.81,"undercount"
"11634",51183,"Virginia","Sussex County","A_AIC",78,39,-39,-66.67,"undercount"
"11635",51183,"Virginia","Sussex County","NHPI_A",1,8,7,155.56,"overcount"
"11636",51183,"Virginia","Sussex County","NHPI_AIC",9,18,9,66.67,"overcount"
"11637",51185,"Virginia","Tazewell County","A_A",322,213,-109,-40.75,"undercount"
"11638",51185,"Virginia","Tazewell County","A_AIC",393,301,-92,-26.51,"undercount"
"11639",51185,"Virginia","Tazewell County","NHPI_A",7,15,8,72.73,"overcount"
"11640",51185,"Virginia","Tazewell County","NHPI_AIC",26,30,4,14.29,"overcount"
"11641",51187,"Virginia","Warren County","A_A",527,469,-58,-11.65,"undercount"
"11642",51187,"Virginia","Warren County","A_AIC",776,783,7,0.9,"overcount"
"11643",51187,"Virginia","Warren County","NHPI_A",7,13,6,60,"overcount"
"11644",51187,"Virginia","Warren County","NHPI_AIC",41,52,11,23.66,"overcount"
"11645",51191,"Virginia","Washington County","A_A",294,334,40,12.74,"overcount"
"11646",51191,"Virginia","Washington County","A_AIC",389,469,80,18.65,"overcount"
"11647",51191,"Virginia","Washington County","NHPI_A",10,0,-10,-200,"undercount"
"11648",51191,"Virginia","Washington County","NHPI_AIC",26,29,3,10.91,"overcount"
"11649",51193,"Virginia","Westmoreland County","A_A",143,146,3,2.08,"overcount"
"11650",51193,"Virginia","Westmoreland County","A_AIC",241,240,-1,-0.42,"undercount"
"11651",51193,"Virginia","Westmoreland County","NHPI_A",11,11,0,0,"equal"
"11652",51193,"Virginia","Westmoreland County","NHPI_AIC",33,30,-3,-9.52,"undercount"
"11653",51195,"Virginia","Wise County","A_A",165,150,-15,-9.52,"undercount"
"11654",51195,"Virginia","Wise County","A_AIC",233,215,-18,-8.04,"undercount"
"11655",51195,"Virginia","Wise County","NHPI_A",2,11,9,138.46,"overcount"
"11656",51195,"Virginia","Wise County","NHPI_AIC",12,29,17,82.93,"overcount"
"11657",51197,"Virginia","Wythe County","A_A",163,124,-39,-27.18,"undercount"
"11658",51197,"Virginia","Wythe County","A_AIC",221,189,-32,-15.61,"undercount"
"11659",51197,"Virginia","Wythe County","NHPI_A",4,2,-2,-66.67,"undercount"
"11660",51197,"Virginia","Wythe County","NHPI_AIC",19,26,7,31.11,"overcount"
"11661",51199,"Virginia","York County","A_A",4184,4272,88,2.08,"overcount"
"11662",51199,"Virginia","York County","A_AIC",5370,5873,503,8.95,"overcount"
"11663",51199,"Virginia","York County","NHPI_A",148,127,-21,-15.27,"undercount"
"11664",51199,"Virginia","York County","NHPI_AIC",274,305,31,10.71,"overcount"
"11665",51510,"Virginia","Alexandria city","A_A",10053,11349,1296,12.11,"overcount"
"11666",51510,"Virginia","Alexandria city","A_AIC",12408,14935,2527,18.48,"overcount"
"11667",51510,"Virginia","Alexandria city","NHPI_A",115,77,-38,-39.58,"undercount"
"11668",51510,"Virginia","Alexandria city","NHPI_AIC",334,366,32,9.14,"overcount"
"11669",51520,"Virginia","Bristol city","A_A",165,161,-4,-2.45,"undercount"
"11670",51520,"Virginia","Bristol city","A_AIC",228,192,-36,-17.14,"undercount"
"11671",51520,"Virginia","Bristol city","NHPI_A",8,4,-4,-66.67,"undercount"
"11672",51520,"Virginia","Bristol city","NHPI_AIC",24,16,-8,-40,"undercount"
"11673",51530,"Virginia","Buena Vista city","A_A",38,29,-9,-26.87,"undercount"
"11674",51530,"Virginia","Buena Vista city","A_AIC",67,56,-11,-17.89,"undercount"
"11675",51530,"Virginia","Buena Vista city","NHPI_A",29,24,-5,-18.87,"undercount"
"11676",51530,"Virginia","Buena Vista city","NHPI_AIC",34,29,-5,-15.87,"undercount"
"11677",51540,"Virginia","Charlottesville city","A_A",3282,4099,817,22.14,"overcount"
"11678",51540,"Virginia","Charlottesville city","A_AIC",3942,5039,1097,24.43,"overcount"
"11679",51540,"Virginia","Charlottesville city","NHPI_A",25,25,0,0,"equal"
"11680",51540,"Virginia","Charlottesville city","NHPI_AIC",84,73,-11,-14.01,"undercount"
"11681",51550,"Virginia","Chesapeake city","A_A",8657,8954,297,3.37,"overcount"
"11682",51550,"Virginia","Chesapeake city","A_AIC",12365,13321,956,7.44,"overcount"
"11683",51550,"Virginia","Chesapeake city","NHPI_A",249,317,68,24.03,"overcount"
"11684",51550,"Virginia","Chesapeake city","NHPI_AIC",595,894,299,40.16,"overcount"
"11685",51570,"Virginia","Colonial Heights city","A_A",609,569,-40,-6.79,"undercount"
"11686",51570,"Virginia","Colonial Heights city","A_AIC",772,759,-13,-1.7,"undercount"
"11687",51570,"Virginia","Colonial Heights city","NHPI_A",21,13,-8,-47.06,"undercount"
"11688",51570,"Virginia","Colonial Heights city","NHPI_AIC",53,44,-9,-18.56,"undercount"
"11689",51580,"Virginia","Covington city","A_A",49,38,-11,-25.29,"undercount"
"11690",51580,"Virginia","Covington city","A_AIC",75,49,-26,-41.94,"undercount"
"11691",51580,"Virginia","Covington city","NHPI_A",0,5,5,200,"overcount"
"11692",51580,"Virginia","Covington city","NHPI_AIC",2,23,21,168,"overcount"
"11693",51590,"Virginia","Danville city","A_A",511,516,5,0.97,"overcount"
"11694",51590,"Virginia","Danville city","A_AIC",639,588,-51,-8.31,"undercount"
"11695",51590,"Virginia","Danville city","NHPI_A",26,1,-25,-185.19,"undercount"
"11696",51590,"Virginia","Danville city","NHPI_AIC",59,16,-43,-114.67,"undercount"
"11697",51595,"Virginia","Emporia city","A_A",52,51,-1,-1.94,"undercount"
"11698",51595,"Virginia","Emporia city","A_AIC",60,73,13,19.55,"overcount"
"11699",51595,"Virginia","Emporia city","NHPI_A",6,4,-2,-40,"undercount"
"11700",51595,"Virginia","Emporia city","NHPI_AIC",8,30,22,115.79,"overcount"
"11701",51600,"Virginia","Fairfax city","A_A",4484,4536,52,1.15,"overcount"
"11702",51600,"Virginia","Fairfax city","A_AIC",4872,5075,203,4.08,"overcount"
"11703",51600,"Virginia","Fairfax city","NHPI_A",17,12,-5,-34.48,"undercount"
"11704",51600,"Virginia","Fairfax city","NHPI_AIC",53,37,-16,-35.56,"undercount"
"11705",51610,"Virginia","Falls Church city","A_A",1445,1512,67,4.53,"overcount"
"11706",51610,"Virginia","Falls Church city","A_AIC",1794,2070,276,14.29,"overcount"
"11707",51610,"Virginia","Falls Church city","NHPI_A",9,10,1,10.53,"overcount"
"11708",51610,"Virginia","Falls Church city","NHPI_AIC",23,42,19,58.46,"overcount"
"11709",51620,"Virginia","Franklin city","A_A",75,81,6,7.69,"overcount"
"11710",51620,"Virginia","Franklin city","A_AIC",109,124,15,12.88,"overcount"
"11711",51620,"Virginia","Franklin city","NHPI_A",3,2,-1,-40,"undercount"
"11712",51620,"Virginia","Franklin city","NHPI_AIC",15,15,0,0,"equal"
"11713",51630,"Virginia","Fredericksburg city","A_A",860,1330,470,42.92,"overcount"
"11714",51630,"Virginia","Fredericksburg city","A_AIC",1285,1840,555,35.52,"overcount"
"11715",51630,"Virginia","Fredericksburg city","NHPI_A",30,24,-6,-22.22,"undercount"
"11716",51630,"Virginia","Fredericksburg city","NHPI_AIC",95,70,-25,-30.3,"undercount"
"11717",51640,"Virginia","Galax city","A_A",61,52,-9,-15.93,"undercount"
"11718",51640,"Virginia","Galax city","A_AIC",77,83,6,7.5,"overcount"
"11719",51640,"Virginia","Galax city","NHPI_A",3,3,0,0,"equal"
"11720",51640,"Virginia","Galax city","NHPI_AIC",8,9,1,11.76,"overcount"
"11721",51650,"Virginia","Hampton city","A_A",3402,3532,130,3.75,"overcount"
"11722",51650,"Virginia","Hampton city","A_AIC",4998,5235,237,4.63,"overcount"
"11723",51650,"Virginia","Hampton city","NHPI_A",175,233,58,28.43,"overcount"
"11724",51650,"Virginia","Hampton city","NHPI_AIC",408,556,148,30.71,"overcount"
"11725",51660,"Virginia","Harrisonburg city","A_A",2288,2117,-171,-7.76,"undercount"
"11726",51660,"Virginia","Harrisonburg city","A_AIC",2859,2839,-20,-0.7,"undercount"
"11727",51660,"Virginia","Harrisonburg city","NHPI_A",76,20,-56,-116.67,"undercount"
"11728",51660,"Virginia","Harrisonburg city","NHPI_AIC",116,74,-42,-44.21,"undercount"
"11729",51670,"Virginia","Hopewell city","A_A",365,256,-109,-35.1,"undercount"
"11730",51670,"Virginia","Hopewell city","A_AIC",525,429,-96,-20.13,"undercount"
"11731",51670,"Virginia","Hopewell city","NHPI_A",34,15,-19,-77.55,"undercount"
"11732",51670,"Virginia","Hopewell city","NHPI_AIC",70,47,-23,-39.32,"undercount"
"11733",51678,"Virginia","Lexington city","A_A",212,284,72,29.03,"overcount"
"11734",51678,"Virginia","Lexington city","A_AIC",300,370,70,20.9,"overcount"
"11735",51678,"Virginia","Lexington city","NHPI_A",5,0,-5,-200,"undercount"
"11736",51678,"Virginia","Lexington city","NHPI_AIC",12,11,-1,-8.7,"undercount"
"11737",51680,"Virginia","Lynchburg city","A_A",2221,1782,-439,-21.93,"undercount"
"11738",51680,"Virginia","Lynchburg city","A_AIC",2642,2360,-282,-11.28,"undercount"
"11739",51680,"Virginia","Lynchburg city","NHPI_A",39,34,-5,-13.7,"undercount"
"11740",51680,"Virginia","Lynchburg city","NHPI_AIC",128,130,2,1.55,"overcount"
"11741",51683,"Virginia","Manassas city","A_A",2514,2721,207,7.91,"overcount"
"11742",51683,"Virginia","Manassas city","A_AIC",2852,3235,383,12.58,"overcount"
"11743",51683,"Virginia","Manassas city","NHPI_A",47,19,-28,-84.85,"undercount"
"11744",51683,"Virginia","Manassas city","NHPI_AIC",100,58,-42,-53.16,"undercount"
"11745",51685,"Virginia","Manassas Park city","A_A",2011,1858,-153,-7.91,"undercount"
"11746",51685,"Virginia","Manassas Park city","A_AIC",2173,2035,-138,-6.56,"undercount"
"11747",51685,"Virginia","Manassas Park city","NHPI_A",35,13,-22,-91.67,"undercount"
"11748",51685,"Virginia","Manassas Park city","NHPI_AIC",49,41,-8,-17.78,"undercount"
"11749",51690,"Virginia","Martinsville city","A_A",134,121,-13,-10.2,"undercount"
"11750",51690,"Virginia","Martinsville city","A_AIC",170,179,9,5.16,"overcount"
"11751",51690,"Virginia","Martinsville city","NHPI_A",2,4,2,66.67,"overcount"
"11752",51690,"Virginia","Martinsville city","NHPI_AIC",8,35,27,125.58,"overcount"
"11753",51700,"Virginia","Newport News city","A_A",5745,6315,570,9.45,"overcount"
"11754",51700,"Virginia","Newport News city","A_AIC",8214,9128,914,10.54,"overcount"
"11755",51700,"Virginia","Newport News city","NHPI_A",297,424,127,35.23,"overcount"
"11756",51700,"Virginia","Newport News city","NHPI_AIC",581,849,268,37.48,"overcount"
"11757",51710,"Virginia","Norfolk city","A_A",9085,8967,-118,-1.31,"undercount"
"11758",51710,"Virginia","Norfolk city","A_AIC",12218,12409,191,1.55,"overcount"
"11759",51710,"Virginia","Norfolk city","NHPI_A",433,478,45,9.88,"overcount"
"11760",51710,"Virginia","Norfolk city","NHPI_AIC",951,1085,134,13.16,"overcount"
"11761",51720,"Virginia","Norton city","A_A",77,30,-47,-87.85,"undercount"
"11762",51720,"Virginia","Norton city","A_AIC",81,43,-38,-61.29,"undercount"
"11763",51720,"Virginia","Norton city","NHPI_A",1,0,-1,-200,"undercount"
"11764",51720,"Virginia","Norton city","NHPI_AIC",3,5,2,50,"overcount"
"11765",51730,"Virginia","Petersburg city","A_A",310,337,27,8.35,"overcount"
"11766",51730,"Virginia","Petersburg city","A_AIC",469,495,26,5.39,"overcount"
"11767",51730,"Virginia","Petersburg city","NHPI_A",30,30,0,0,"equal"
"11768",51730,"Virginia","Petersburg city","NHPI_AIC",79,56,-23,-34.07,"undercount"
"11769",51735,"Virginia","Poquoson city","A_A",289,288,-1,-0.35,"undercount"
"11770",51735,"Virginia","Poquoson city","A_AIC",441,483,42,9.09,"overcount"
"11771",51735,"Virginia","Poquoson city","NHPI_A",8,2,-6,-120,"undercount"
"11772",51735,"Virginia","Poquoson city","NHPI_AIC",19,38,19,66.67,"overcount"
"11773",51740,"Virginia","Portsmouth city","A_A",1294,1275,-19,-1.48,"undercount"
"11774",51740,"Virginia","Portsmouth city","A_AIC",2104,2166,62,2.9,"overcount"
"11775",51740,"Virginia","Portsmouth city","NHPI_A",110,135,25,20.41,"overcount"
"11776",51740,"Virginia","Portsmouth city","NHPI_AIC",225,329,104,37.55,"overcount"
"11777",51750,"Virginia","Radford city","A_A",369,257,-112,-35.78,"undercount"
"11778",51750,"Virginia","Radford city","A_AIC",462,352,-110,-27.03,"undercount"
"11779",51750,"Virginia","Radford city","NHPI_A",5,0,-5,-200,"undercount"
"11780",51750,"Virginia","Radford city","NHPI_AIC",24,4,-20,-142.86,"undercount"
"11781",51760,"Virginia","Richmond city","A_A",5237,6304,1067,18.49,"overcount"
"11782",51760,"Virginia","Richmond city","A_AIC",7011,8889,1878,23.62,"overcount"
"11783",51760,"Virginia","Richmond city","NHPI_A",91,79,-12,-14.12,"undercount"
"11784",51760,"Virginia","Richmond city","NHPI_AIC",297,278,-19,-6.61,"undercount"
"11785",51770,"Virginia","Roanoke city","A_A",3282,2493,-789,-27.32,"undercount"
"11786",51770,"Virginia","Roanoke city","A_AIC",3806,3159,-647,-18.58,"undercount"
"11787",51770,"Virginia","Roanoke city","NHPI_A",57,45,-12,-23.53,"undercount"
"11788",51770,"Virginia","Roanoke city","NHPI_AIC",136,94,-42,-36.52,"undercount"
"11789",51775,"Virginia","Salem city","A_A",476,541,65,12.78,"overcount"
"11790",51775,"Virginia","Salem city","A_AIC",557,680,123,19.89,"overcount"
"11791",51775,"Virginia","Salem city","NHPI_A",10,8,-2,-22.22,"undercount"
"11792",51775,"Virginia","Salem city","NHPI_AIC",22,46,24,70.59,"overcount"
"11793",51790,"Virginia","Staunton city","A_A",350,325,-25,-7.41,"undercount"
"11794",51790,"Virginia","Staunton city","A_AIC",497,461,-36,-7.52,"undercount"
"11795",51790,"Virginia","Staunton city","NHPI_A",3,11,8,114.29,"overcount"
"11796",51790,"Virginia","Staunton city","NHPI_AIC",32,23,-9,-32.73,"undercount"
"11797",51800,"Virginia","Suffolk city","A_A",1875,1693,-182,-10.2,"undercount"
"11798",51800,"Virginia","Suffolk city","A_AIC",2750,2692,-58,-2.13,"undercount"
"11799",51800,"Virginia","Suffolk city","NHPI_A",77,72,-5,-6.71,"undercount"
"11800",51800,"Virginia","Suffolk city","NHPI_AIC",179,228,49,24.08,"overcount"
"11801",51810,"Virginia","Virginia Beach city","A_A",33054,34136,1082,3.22,"overcount"
"11802",51810,"Virginia","Virginia Beach city","A_AIC",41466,44312,2846,6.64,"overcount"
"11803",51810,"Virginia","Virginia Beach city","NHPI_A",653,684,31,4.64,"overcount"
"11804",51810,"Virginia","Virginia Beach city","NHPI_AIC",1524,2121,597,32.76,"overcount"
"11805",51820,"Virginia","Waynesboro city","A_A",387,260,-127,-39.26,"undercount"
"11806",51820,"Virginia","Waynesboro city","A_AIC",493,398,-95,-21.32,"undercount"
"11807",51820,"Virginia","Waynesboro city","NHPI_A",9,21,12,80,"overcount"
"11808",51820,"Virginia","Waynesboro city","NHPI_AIC",34,48,14,34.15,"overcount"
"11809",51830,"Virginia","Williamsburg city","A_A",851,500,-351,-51.96,"undercount"
"11810",51830,"Virginia","Williamsburg city","A_AIC",1090,653,-437,-50.14,"undercount"
"11811",51830,"Virginia","Williamsburg city","NHPI_A",17,25,8,38.1,"overcount"
"11812",51830,"Virginia","Williamsburg city","NHPI_AIC",31,44,13,34.67,"overcount"
"11813",51840,"Virginia","Winchester city","A_A",647,720,73,10.68,"overcount"
"11814",51840,"Virginia","Winchester city","A_AIC",805,888,83,9.81,"overcount"
"11815",51840,"Virginia","Winchester city","NHPI_A",6,14,8,80,"overcount"
"11816",51840,"Virginia","Winchester city","NHPI_AIC",27,33,6,20,"overcount"
"11817",53001,"Washington","Adams County","A_A",143,129,-14,-10.29,"undercount"
"11818",53001,"Washington","Adams County","A_AIC",199,223,24,11.37,"overcount"
"11819",53001,"Washington","Adams County","NHPI_A",11,8,-3,-31.58,"undercount"
"11820",53001,"Washington","Adams County","NHPI_AIC",31,50,19,46.91,"overcount"
"11821",53003,"Washington","Asotin County","A_A",220,206,-14,-6.57,"undercount"
"11822",53003,"Washington","Asotin County","A_AIC",369,387,18,4.76,"overcount"
"11823",53003,"Washington","Asotin County","NHPI_A",92,34,-58,-92.06,"undercount"
"11824",53003,"Washington","Asotin County","NHPI_AIC",141,101,-40,-33.06,"undercount"
"11825",53005,"Washington","Benton County","A_A",6522,6346,-176,-2.74,"undercount"
"11826",53005,"Washington","Benton County","A_AIC",8541,8927,386,4.42,"overcount"
"11827",53005,"Washington","Benton County","NHPI_A",363,543,180,39.74,"overcount"
"11828",53005,"Washington","Benton County","NHPI_AIC",738,1096,358,39.04,"overcount"
"11829",53007,"Washington","Chelan County","A_A",805,815,10,1.23,"overcount"
"11830",53007,"Washington","Chelan County","A_AIC",1184,1415,231,17.78,"overcount"
"11831",53007,"Washington","Chelan County","NHPI_A",145,109,-36,-28.35,"undercount"
"11832",53007,"Washington","Chelan County","NHPI_AIC",247,294,47,17.38,"overcount"
"11833",53009,"Washington","Clallam County","A_A",1462,1250,-212,-15.63,"undercount"
"11834",53009,"Washington","Clallam County","A_AIC",2349,2211,-138,-6.05,"undercount"
"11835",53009,"Washington","Clallam County","NHPI_A",126,114,-12,-10,"undercount"
"11836",53009,"Washington","Clallam County","NHPI_AIC",406,434,28,6.67,"overcount"
"11837",53011,"Washington","Clark County","A_A",24718,24105,-613,-2.51,"undercount"
"11838",53011,"Washington","Clark County","A_AIC",33105,34338,1233,3.66,"overcount"
"11839",53011,"Washington","Clark County","NHPI_A",4389,5223,834,17.35,"overcount"
"11840",53011,"Washington","Clark County","NHPI_AIC",6734,8101,1367,18.43,"overcount"
"11841",53013,"Washington","Columbia County","A_A",52,21,-31,-84.93,"undercount"
"11842",53013,"Washington","Columbia County","A_AIC",72,48,-24,-40,"undercount"
"11843",53013,"Washington","Columbia County","NHPI_A",87,0,-87,-200,"undercount"
"11844",53013,"Washington","Columbia County","NHPI_AIC",98,24,-74,-121.31,"undercount"
"11845",53015,"Washington","Cowlitz County","A_A",1700,1781,81,4.65,"overcount"
"11846",53015,"Washington","Cowlitz County","A_AIC",2724,2857,133,4.77,"overcount"
"11847",53015,"Washington","Cowlitz County","NHPI_A",413,643,230,43.56,"overcount"
"11848",53015,"Washington","Cowlitz County","NHPI_AIC",706,1033,327,37.61,"overcount"
"11849",53017,"Washington","Douglas County","A_A",401,407,6,1.49,"overcount"
"11850",53017,"Washington","Douglas County","A_AIC",713,779,66,8.85,"overcount"
"11851",53017,"Washington","Douglas County","NHPI_A",87,57,-30,-41.67,"undercount"
"11852",53017,"Washington","Douglas County","NHPI_AIC",168,140,-28,-18.18,"undercount"
"11853",53019,"Washington","Ferry County","A_A",90,43,-47,-70.68,"undercount"
"11854",53019,"Washington","Ferry County","A_AIC",135,102,-33,-27.85,"undercount"
"11855",53019,"Washington","Ferry County","NHPI_A",23,11,-12,-70.59,"undercount"
"11856",53019,"Washington","Ferry County","NHPI_AIC",45,34,-11,-27.85,"undercount"
"11857",53021,"Washington","Franklin County","A_A",2095,1806,-289,-14.82,"undercount"
"11858",53021,"Washington","Franklin County","A_AIC",2687,2535,-152,-5.82,"undercount"
"11859",53021,"Washington","Franklin County","NHPI_A",198,199,1,0.5,"overcount"
"11860",53021,"Washington","Franklin County","NHPI_AIC",360,504,144,33.33,"overcount"
"11861",53023,"Washington","Garfield County","A_A",88,9,-79,-162.89,"undercount"
"11862",53023,"Washington","Garfield County","A_AIC",98,28,-70,-111.11,"undercount"
"11863",53023,"Washington","Garfield County","NHPI_A",0,0,0,0,"equal"
"11864",53023,"Washington","Garfield County","NHPI_AIC",8,10,2,22.22,"overcount"
"11865",53025,"Washington","Grant County","A_A",955,1161,206,19.47,"overcount"
"11866",53025,"Washington","Grant County","A_AIC",1435,1823,388,23.82,"overcount"
"11867",53025,"Washington","Grant County","NHPI_A",137,99,-38,-32.2,"undercount"
"11868",53025,"Washington","Grant County","NHPI_AIC",246,273,27,10.4,"overcount"
"11869",53027,"Washington","Grays Harbor County","A_A",1047,1024,-23,-2.22,"undercount"
"11870",53027,"Washington","Grays Harbor County","A_AIC",1837,2004,167,8.7,"overcount"
"11871",53027,"Washington","Grays Harbor County","NHPI_A",235,128,-107,-58.95,"undercount"
"11872",53027,"Washington","Grays Harbor County","NHPI_AIC",461,461,0,0,"equal"
"11873",53029,"Washington","Island County","A_A",4132,4013,-119,-2.92,"undercount"
"11874",53029,"Washington","Island County","A_AIC",5968,6084,116,1.92,"overcount"
"11875",53029,"Washington","Island County","NHPI_A",384,416,32,8,"overcount"
"11876",53029,"Washington","Island County","NHPI_AIC",773,923,150,17.69,"overcount"
"11877",53031,"Washington","Jefferson County","A_A",640,487,-153,-27.15,"undercount"
"11878",53031,"Washington","Jefferson County","A_AIC",929,912,-17,-1.85,"undercount"
"11879",53031,"Washington","Jefferson County","NHPI_A",77,52,-25,-38.76,"undercount"
"11880",53031,"Washington","Jefferson County","NHPI_AIC",148,194,46,26.9,"overcount"
"11881",53033,"Washington","King County","A_A",457740,453230,-4510,-0.99,"undercount"
"11882",53033,"Washington","King County","A_AIC",519071,527853,8782,1.68,"overcount"
"11883",53033,"Washington","King County","NHPI_A",17767,19685,1918,10.24,"overcount"
"11884",53033,"Washington","King County","NHPI_AIC",28469,31509,3040,10.14,"overcount"
"11885",53035,"Washington","Kitsap County","A_A",14179,14203,24,0.17,"overcount"
"11886",53035,"Washington","Kitsap County","A_AIC",22176,23249,1073,4.72,"overcount"
"11887",53035,"Washington","Kitsap County","NHPI_A",2437,2870,433,16.32,"overcount"
"11888",53035,"Washington","Kitsap County","NHPI_AIC",4598,5485,887,17.59,"overcount"
"11889",53037,"Washington","Kittitas County","A_A",981,909,-72,-7.62,"undercount"
"11890",53037,"Washington","Kittitas County","A_AIC",1594,1544,-50,-3.19,"undercount"
"11891",53037,"Washington","Kittitas County","NHPI_A",94,87,-7,-7.73,"undercount"
"11892",53037,"Washington","Kittitas County","NHPI_AIC",206,246,40,17.7,"overcount"
"11893",53039,"Washington","Klickitat County","A_A",178,148,-30,-18.4,"undercount"
"11894",53039,"Washington","Klickitat County","A_AIC",327,346,19,5.65,"overcount"
"11895",53039,"Washington","Klickitat County","NHPI_A",40,36,-4,-10.53,"undercount"
"11896",53039,"Washington","Klickitat County","NHPI_AIC",72,102,30,34.48,"overcount"
"11897",53041,"Washington","Lewis County","A_A",861,805,-56,-6.72,"undercount"
"11898",53041,"Washington","Lewis County","A_AIC",1535,1604,69,4.4,"overcount"
"11899",53041,"Washington","Lewis County","NHPI_A",172,162,-10,-5.99,"undercount"
"11900",53041,"Washington","Lewis County","NHPI_AIC",380,475,95,22.22,"overcount"
"11901",53043,"Washington","Lincoln County","A_A",68,70,2,2.9,"overcount"
"11902",53043,"Washington","Lincoln County","A_AIC",143,163,20,13.07,"overcount"
"11903",53043,"Washington","Lincoln County","NHPI_A",14,14,0,0,"equal"
"11904",53043,"Washington","Lincoln County","NHPI_AIC",42,46,4,9.09,"overcount"
"11905",53045,"Washington","Mason County","A_A",870,784,-86,-10.4,"undercount"
"11906",53045,"Washington","Mason County","A_AIC",1688,1760,72,4.18,"overcount"
"11907",53045,"Washington","Mason County","NHPI_A",313,221,-92,-34.46,"undercount"
"11908",53045,"Washington","Mason County","NHPI_AIC",594,630,36,5.88,"overcount"
"11909",53047,"Washington","Okanogan County","A_A",354,268,-86,-27.65,"undercount"
"11910",53047,"Washington","Okanogan County","A_AIC",526,515,-11,-2.11,"undercount"
"11911",53047,"Washington","Okanogan County","NHPI_A",52,41,-11,-23.66,"undercount"
"11912",53047,"Washington","Okanogan County","NHPI_AIC",113,93,-20,-19.42,"undercount"
"11913",53049,"Washington","Pacific County","A_A",448,495,47,9.97,"overcount"
"11914",53049,"Washington","Pacific County","A_AIC",632,698,66,9.92,"overcount"
"11915",53049,"Washington","Pacific County","NHPI_A",31,42,11,30.14,"overcount"
"11916",53049,"Washington","Pacific County","NHPI_AIC",74,103,29,32.77,"overcount"
"11917",53051,"Washington","Pend Oreille County","A_A",151,70,-81,-73.3,"undercount"
"11918",53051,"Washington","Pend Oreille County","A_AIC",231,154,-77,-40,"undercount"
"11919",53051,"Washington","Pend Oreille County","NHPI_A",19,9,-10,-71.43,"undercount"
"11920",53051,"Washington","Pend Oreille County","NHPI_AIC",45,32,-13,-33.77,"undercount"
"11921",53053,"Washington","Pierce County","A_A",63023,62945,-78,-0.12,"undercount"
"11922",53053,"Washington","Pierce County","A_AIC",90846,93268,2422,2.63,"overcount"
"11923",53053,"Washington","Pierce County","NHPI_A",15006,18262,3256,19.57,"overcount"
"11924",53053,"Washington","Pierce County","NHPI_AIC",22158,27426,5268,21.25,"overcount"
"11925",53055,"Washington","San Juan County","A_A",282,239,-43,-16.51,"undercount"
"11926",53055,"Washington","San Juan County","A_AIC",391,450,59,14.03,"overcount"
"11927",53055,"Washington","San Juan County","NHPI_A",23,23,0,0,"equal"
"11928",53055,"Washington","San Juan County","NHPI_AIC",44,67,23,41.44,"overcount"
"11929",53057,"Washington","Skagit County","A_A",2888,2826,-62,-2.17,"undercount"
"11930",53057,"Washington","Skagit County","A_AIC",4036,4474,438,10.29,"overcount"
"11931",53057,"Washington","Skagit County","NHPI_A",314,396,82,23.1,"overcount"
"11932",53057,"Washington","Skagit County","NHPI_AIC",598,778,180,26.16,"overcount"
"11933",53059,"Washington","Skamania County","A_A",129,122,-7,-5.58,"undercount"
"11934",53059,"Washington","Skamania County","A_AIC",229,260,31,12.68,"overcount"
"11935",53059,"Washington","Skamania County","NHPI_A",27,30,3,10.53,"overcount"
"11936",53059,"Washington","Skamania County","NHPI_AIC",64,80,16,22.22,"overcount"
"11937",53061,"Washington","Snohomish County","A_A",102591,101516,-1075,-1.05,"undercount"
"11938",53061,"Washington","Snohomish County","A_AIC",122203,123824,1621,1.32,"overcount"
"11939",53061,"Washington","Snohomish County","NHPI_A",5052,5002,-50,-0.99,"undercount"
"11940",53061,"Washington","Snohomish County","NHPI_AIC",9196,9800,604,6.36,"overcount"
"11941",53063,"Washington","Spokane County","A_A",12313,12582,269,2.16,"overcount"
"11942",53063,"Washington","Spokane County","A_AIC",19897,21194,1297,6.31,"overcount"
"11943",53063,"Washington","Spokane County","NHPI_A",3156,4264,1108,29.87,"overcount"
"11944",53063,"Washington","Spokane County","NHPI_AIC",4905,6483,1578,27.71,"overcount"
"11945",53065,"Washington","Stevens County","A_A",355,281,-74,-23.27,"undercount"
"11946",53065,"Washington","Stevens County","A_AIC",677,639,-38,-5.78,"undercount"
"11947",53065,"Washington","Stevens County","NHPI_A",76,84,8,10,"overcount"
"11948",53065,"Washington","Stevens County","NHPI_AIC",191,214,23,11.36,"overcount"
"11949",53067,"Washington","Thurston County","A_A",17686,17076,-610,-3.51,"undercount"
"11950",53067,"Washington","Thurston County","A_AIC",24904,25151,247,0.99,"overcount"
"11951",53067,"Washington","Thurston County","NHPI_A",2750,3254,504,16.79,"overcount"
"11952",53067,"Washington","Thurston County","NHPI_AIC",4607,5583,976,19.16,"overcount"
"11953",53069,"Washington","Wahkiakum County","A_A",68,43,-25,-45.05,"undercount"
"11954",53069,"Washington","Wahkiakum County","A_AIC",93,95,2,2.13,"overcount"
"11955",53069,"Washington","Wahkiakum County","NHPI_A",10,3,-7,-107.69,"undercount"
"11956",53069,"Washington","Wahkiakum County","NHPI_AIC",20,30,10,40,"overcount"
"11957",53071,"Washington","Walla Walla County","A_A",1093,944,-149,-14.63,"undercount"
"11958",53071,"Washington","Walla Walla County","A_AIC",1686,1758,72,4.18,"overcount"
"11959",53071,"Washington","Walla Walla County","NHPI_A",204,134,-70,-41.42,"undercount"
"11960",53071,"Washington","Walla Walla County","NHPI_AIC",374,438,64,15.76,"overcount"
"11961",53073,"Washington","Whatcom County","A_A",10739,10115,-624,-5.98,"undercount"
"11962",53073,"Washington","Whatcom County","A_AIC",14834,14570,-264,-1.8,"undercount"
"11963",53073,"Washington","Whatcom County","NHPI_A",591,684,93,14.59,"overcount"
"11964",53073,"Washington","Whatcom County","NHPI_AIC",1367,1612,245,16.45,"overcount"
"11965",53075,"Washington","Whitman County","A_A",4006,3634,-372,-9.74,"undercount"
"11966",53075,"Washington","Whitman County","A_AIC",5012,4876,-136,-2.75,"undercount"
"11967",53075,"Washington","Whitman County","NHPI_A",108,145,37,29.25,"overcount"
"11968",53075,"Washington","Whitman County","NHPI_AIC",273,353,80,25.56,"overcount"
"11969",53077,"Washington","Yakima County","A_A",2908,2794,-114,-4,"undercount"
"11970",53077,"Washington","Yakima County","A_AIC",4382,4343,-39,-0.89,"undercount"
"11971",53077,"Washington","Yakima County","NHPI_A",218,224,6,2.71,"overcount"
"11972",53077,"Washington","Yakima County","NHPI_AIC",558,625,67,11.33,"overcount"
"11973",54001,"West Virginia","Barbour County","A_A",46,32,-14,-35.9,"undercount"
"11974",54001,"West Virginia","Barbour County","A_AIC",76,57,-19,-28.57,"undercount"
"11975",54001,"West Virginia","Barbour County","NHPI_A",4,0,-4,-200,"undercount"
"11976",54001,"West Virginia","Barbour County","NHPI_AIC",12,3,-9,-120,"undercount"
"11977",54003,"West Virginia","Berkeley County","A_A",1347,1475,128,9.07,"overcount"
"11978",54003,"West Virginia","Berkeley County","A_AIC",2036,2351,315,14.36,"overcount"
"11979",54003,"West Virginia","Berkeley County","NHPI_A",28,43,15,42.25,"overcount"
"11980",54003,"West Virginia","Berkeley County","NHPI_AIC",138,146,8,5.63,"overcount"
"11981",54005,"West Virginia","Boone County","A_A",30,36,6,18.18,"overcount"
"11982",54005,"West Virginia","Boone County","A_AIC",45,94,49,70.5,"overcount"
"11983",54005,"West Virginia","Boone County","NHPI_A",1,2,1,66.67,"overcount"
"11984",54005,"West Virginia","Boone County","NHPI_AIC",3,12,9,120,"overcount"
"11985",54007,"West Virginia","Braxton County","A_A",32,23,-9,-32.73,"undercount"
"11986",54007,"West Virginia","Braxton County","A_AIC",52,49,-3,-5.94,"undercount"
"11987",54007,"West Virginia","Braxton County","NHPI_A",3,11,8,114.29,"overcount"
"11988",54007,"West Virginia","Braxton County","NHPI_AIC",6,17,11,95.65,"overcount"
"11989",54009,"West Virginia","Brooke County","A_A",90,55,-35,-48.28,"undercount"
"11990",54009,"West Virginia","Brooke County","A_AIC",135,123,-12,-9.3,"undercount"
"11991",54009,"West Virginia","Brooke County","NHPI_A",5,0,-5,-200,"undercount"
"11992",54009,"West Virginia","Brooke County","NHPI_AIC",16,12,-4,-28.57,"undercount"
"11993",54011,"West Virginia","Cabell County","A_A",1158,1353,195,15.53,"overcount"
"11994",54011,"West Virginia","Cabell County","A_AIC",1525,1755,230,14.02,"overcount"
"11995",54011,"West Virginia","Cabell County","NHPI_A",15,20,5,28.57,"overcount"
"11996",54011,"West Virginia","Cabell County","NHPI_AIC",84,79,-5,-6.13,"undercount"
"11997",54013,"West Virginia","Calhoun County","A_A",12,14,2,15.38,"overcount"
"11998",54013,"West Virginia","Calhoun County","A_AIC",18,22,4,20,"overcount"
"11999",54013,"West Virginia","Calhoun County","NHPI_A",2,2,0,0,"equal"
"12000",54013,"West Virginia","Calhoun County","NHPI_AIC",3,4,1,28.57,"overcount"
"12001",54015,"West Virginia","Clay County","A_A",7,17,10,83.33,"overcount"
"12002",54015,"West Virginia","Clay County","A_AIC",28,32,4,13.33,"overcount"
"12003",54015,"West Virginia","Clay County","NHPI_A",3,0,-3,-200,"undercount"
"12004",54015,"West Virginia","Clay County","NHPI_AIC",5,14,9,94.74,"overcount"
"12005",54017,"West Virginia","Doddridge County","A_A",40,16,-24,-85.71,"undercount"
"12006",54017,"West Virginia","Doddridge County","A_AIC",52,25,-27,-70.13,"undercount"
"12007",54017,"West Virginia","Doddridge County","NHPI_A",2,0,-2,-200,"undercount"
"12008",54017,"West Virginia","Doddridge County","NHPI_AIC",6,2,-4,-100,"undercount"
"12009",54019,"West Virginia","Fayette County","A_A",121,107,-14,-12.28,"undercount"
"12010",54019,"West Virginia","Fayette County","A_AIC",174,180,6,3.39,"overcount"
"12011",54019,"West Virginia","Fayette County","NHPI_A",6,3,-3,-66.67,"undercount"
"12012",54019,"West Virginia","Fayette County","NHPI_AIC",19,28,9,38.3,"overcount"
"12013",54021,"West Virginia","Gilmer County","A_A",56,32,-24,-54.55,"undercount"
"12014",54021,"West Virginia","Gilmer County","A_AIC",72,47,-25,-42.02,"undercount"
"12015",54021,"West Virginia","Gilmer County","NHPI_A",9,0,-9,-200,"undercount"
"12016",54021,"West Virginia","Gilmer County","NHPI_AIC",13,8,-5,-47.62,"undercount"
"12017",54023,"West Virginia","Grant County","A_A",26,24,-2,-8,"undercount"
"12018",54023,"West Virginia","Grant County","A_AIC",43,49,6,13.04,"overcount"
"12019",54023,"West Virginia","Grant County","NHPI_A",2,0,-2,-200,"undercount"
"12020",54023,"West Virginia","Grant County","NHPI_AIC",3,2,-1,-40,"undercount"
"12021",54025,"West Virginia","Greenbrier County","A_A",247,204,-43,-19.07,"undercount"
"12022",54025,"West Virginia","Greenbrier County","A_AIC",314,293,-21,-6.92,"undercount"
"12023",54025,"West Virginia","Greenbrier County","NHPI_A",6,14,8,80,"overcount"
"12024",54025,"West Virginia","Greenbrier County","NHPI_AIC",21,30,9,35.29,"overcount"
"12025",54027,"West Virginia","Hampshire County","A_A",76,61,-15,-21.9,"undercount"
"12026",54027,"West Virginia","Hampshire County","A_AIC",122,128,6,4.8,"overcount"
"12027",54027,"West Virginia","Hampshire County","NHPI_A",13,4,-9,-105.88,"undercount"
"12028",54027,"West Virginia","Hampshire County","NHPI_AIC",23,18,-5,-24.39,"undercount"
"12029",54029,"West Virginia","Hancock County","A_A",129,111,-18,-15,"undercount"
"12030",54029,"West Virginia","Hancock County","A_AIC",182,198,16,8.42,"overcount"
"12031",54029,"West Virginia","Hancock County","NHPI_A",4,8,4,66.67,"overcount"
"12032",54029,"West Virginia","Hancock County","NHPI_AIC",13,26,13,66.67,"overcount"
"12033",54031,"West Virginia","Hardy County","A_A",111,53,-58,-70.73,"undercount"
"12034",54031,"West Virginia","Hardy County","A_AIC",133,87,-46,-41.82,"undercount"
"12035",54031,"West Virginia","Hardy County","NHPI_A",5,0,-5,-200,"undercount"
"12036",54031,"West Virginia","Hardy County","NHPI_AIC",7,13,6,60,"overcount"
"12037",54033,"West Virginia","Harrison County","A_A",417,491,74,16.3,"overcount"
"12038",54033,"West Virginia","Harrison County","A_AIC",570,688,118,18.76,"overcount"
"12039",54033,"West Virginia","Harrison County","NHPI_A",15,28,13,60.47,"overcount"
"12040",54033,"West Virginia","Harrison County","NHPI_AIC",41,74,33,57.39,"overcount"
"12041",54035,"West Virginia","Jackson County","A_A",91,91,0,0,"equal"
"12042",54035,"West Virginia","Jackson County","A_AIC",132,145,13,9.39,"overcount"
"12043",54035,"West Virginia","Jackson County","NHPI_A",9,2,-7,-127.27,"undercount"
"12044",54035,"West Virginia","Jackson County","NHPI_AIC",17,3,-14,-140,"undercount"
"12045",54037,"West Virginia","Jefferson County","A_A",917,842,-75,-8.53,"undercount"
"12046",54037,"West Virginia","Jefferson County","A_AIC",1266,1359,93,7.09,"overcount"
"12047",54037,"West Virginia","Jefferson County","NHPI_A",36,17,-19,-71.7,"undercount"
"12048",54037,"West Virginia","Jefferson County","NHPI_AIC",99,93,-6,-6.25,"undercount"
"12049",54039,"West Virginia","Kanawha County","A_A",1876,2173,297,14.67,"overcount"
"12050",54039,"West Virginia","Kanawha County","A_AIC",2591,2956,365,13.16,"overcount"
"12051",54039,"West Virginia","Kanawha County","NHPI_A",39,47,8,18.6,"overcount"
"12052",54039,"West Virginia","Kanawha County","NHPI_AIC",145,173,28,17.61,"overcount"
"12053",54041,"West Virginia","Lewis County","A_A",77,58,-19,-28.15,"undercount"
"12054",54041,"West Virginia","Lewis County","A_AIC",98,107,9,8.78,"overcount"
"12055",54041,"West Virginia","Lewis County","NHPI_A",1,7,6,150,"overcount"
"12056",54041,"West Virginia","Lewis County","NHPI_AIC",2,20,18,163.64,"overcount"
"12057",54043,"West Virginia","Lincoln County","A_A",56,26,-30,-73.17,"undercount"
"12058",54043,"West Virginia","Lincoln County","A_AIC",86,45,-41,-62.6,"undercount"
"12059",54043,"West Virginia","Lincoln County","NHPI_A",1,0,-1,-200,"undercount"
"12060",54043,"West Virginia","Lincoln County","NHPI_AIC",4,8,4,66.67,"overcount"
"12061",54045,"West Virginia","Logan County","A_A",83,63,-20,-27.4,"undercount"
"12062",54045,"West Virginia","Logan County","A_AIC",120,85,-35,-34.15,"undercount"
"12063",54045,"West Virginia","Logan County","NHPI_A",1,1,0,0,"equal"
"12064",54045,"West Virginia","Logan County","NHPI_AIC",6,11,5,58.82,"overcount"
"12065",54047,"West Virginia","McDowell County","A_A",32,20,-12,-46.15,"undercount"
"12066",54047,"West Virginia","McDowell County","A_AIC",51,35,-16,-37.21,"undercount"
"12067",54047,"West Virginia","McDowell County","NHPI_A",1,4,3,120,"overcount"
"12068",54047,"West Virginia","McDowell County","NHPI_AIC",7,13,6,60,"overcount"
"12069",54049,"West Virginia","Marion County","A_A",361,266,-95,-30.3,"undercount"
"12070",54049,"West Virginia","Marion County","A_AIC",495,475,-20,-4.12,"undercount"
"12071",54049,"West Virginia","Marion County","NHPI_A",12,43,31,112.73,"overcount"
"12072",54049,"West Virginia","Marion County","NHPI_AIC",43,79,36,59.02,"overcount"
"12073",54051,"West Virginia","Marshall County","A_A",137,108,-29,-23.67,"undercount"
"12074",54051,"West Virginia","Marshall County","A_AIC",180,179,-1,-0.56,"undercount"
"12075",54051,"West Virginia","Marshall County","NHPI_A",3,7,4,80,"overcount"
"12076",54051,"West Virginia","Marshall County","NHPI_AIC",15,27,12,57.14,"overcount"
"12077",54053,"West Virginia","Mason County","A_A",77,74,-3,-3.97,"undercount"
"12078",54053,"West Virginia","Mason County","A_AIC",116,116,0,0,"equal"
"12079",54053,"West Virginia","Mason County","NHPI_A",16,5,-11,-104.76,"undercount"
"12080",54053,"West Virginia","Mason County","NHPI_AIC",22,14,-8,-44.44,"undercount"
"12081",54055,"West Virginia","Mercer County","A_A",345,292,-53,-16.64,"undercount"
"12082",54055,"West Virginia","Mercer County","A_AIC",448,416,-32,-7.41,"undercount"
"12083",54055,"West Virginia","Mercer County","NHPI_A",2,6,4,100,"overcount"
"12084",54055,"West Virginia","Mercer County","NHPI_AIC",24,32,8,28.57,"overcount"
"12085",54057,"West Virginia","Mineral County","A_A",157,114,-43,-31.73,"undercount"
"12086",54057,"West Virginia","Mineral County","A_AIC",203,174,-29,-15.38,"undercount"
"12087",54057,"West Virginia","Mineral County","NHPI_A",2,5,3,85.71,"overcount"
"12088",54057,"West Virginia","Mineral County","NHPI_AIC",18,8,-10,-76.92,"undercount"
"12089",54059,"West Virginia","Mingo County","A_A",70,33,-37,-71.84,"undercount"
"12090",54059,"West Virginia","Mingo County","A_AIC",95,61,-34,-43.59,"undercount"
"12091",54059,"West Virginia","Mingo County","NHPI_A",0,0,0,0,"equal"
"12092",54059,"West Virginia","Mingo County","NHPI_AIC",6,13,7,73.68,"overcount"
"12093",54061,"West Virginia","Monongalia County","A_A",3738,3769,31,0.83,"overcount"
"12094",54061,"West Virginia","Monongalia County","A_AIC",4469,4809,340,7.33,"overcount"
"12095",54061,"West Virginia","Monongalia County","NHPI_A",43,64,21,39.25,"overcount"
"12096",54061,"West Virginia","Monongalia County","NHPI_AIC",117,157,40,29.2,"overcount"
"12097",54063,"West Virginia","Monroe County","A_A",25,11,-14,-77.78,"undercount"
"12098",54063,"West Virginia","Monroe County","A_AIC",55,27,-28,-68.29,"undercount"
"12099",54063,"West Virginia","Monroe County","NHPI_A",3,0,-3,-200,"undercount"
"12100",54063,"West Virginia","Monroe County","NHPI_AIC",9,0,-9,-200,"undercount"
"12101",54065,"West Virginia","Morgan County","A_A",73,89,16,19.75,"overcount"
"12102",54065,"West Virginia","Morgan County","A_AIC",129,160,31,21.45,"overcount"
"12103",54065,"West Virginia","Morgan County","NHPI_A",5,0,-5,-200,"undercount"
"12104",54065,"West Virginia","Morgan County","NHPI_AIC",19,10,-9,-62.07,"undercount"
"12105",54067,"West Virginia","Nicholas County","A_A",99,72,-27,-31.58,"undercount"
"12106",54067,"West Virginia","Nicholas County","A_AIC",137,126,-11,-8.37,"undercount"
"12107",54067,"West Virginia","Nicholas County","NHPI_A",4,7,3,54.55,"overcount"
"12108",54067,"West Virginia","Nicholas County","NHPI_AIC",13,13,0,0,"equal"
"12109",54069,"West Virginia","Ohio County","A_A",336,387,51,14.11,"overcount"
"12110",54069,"West Virginia","Ohio County","A_AIC",468,543,75,14.84,"overcount"
"12111",54069,"West Virginia","Ohio County","NHPI_A",9,20,11,75.86,"overcount"
"12112",54069,"West Virginia","Ohio County","NHPI_AIC",41,46,5,11.49,"overcount"
"12113",54071,"West Virginia","Pendleton County","A_A",14,0,-14,-200,"undercount"
"12114",54071,"West Virginia","Pendleton County","A_AIC",29,1,-28,-186.67,"undercount"
"12115",54071,"West Virginia","Pendleton County","NHPI_A",5,2,-3,-85.71,"undercount"
"12116",54071,"West Virginia","Pendleton County","NHPI_AIC",11,6,-5,-58.82,"undercount"
"12117",54073,"West Virginia","Pleasants County","A_A",16,17,1,6.06,"overcount"
"12118",54073,"West Virginia","Pleasants County","A_AIC",37,27,-10,-31.25,"undercount"
"12119",54073,"West Virginia","Pleasants County","NHPI_A",0,0,0,0,"equal"
"12120",54073,"West Virginia","Pleasants County","NHPI_AIC",3,2,-1,-40,"undercount"
"12121",54075,"West Virginia","Pocahontas County","A_A",17,9,-8,-61.54,"undercount"
"12122",54075,"West Virginia","Pocahontas County","A_AIC",43,22,-21,-64.62,"undercount"
"12123",54075,"West Virginia","Pocahontas County","NHPI_A",0,0,0,0,"equal"
"12124",54075,"West Virginia","Pocahontas County","NHPI_AIC",3,0,-3,-200,"undercount"
"12125",54077,"West Virginia","Preston County","A_A",108,53,-55,-68.32,"undercount"
"12126",54077,"West Virginia","Preston County","A_AIC",153,98,-55,-43.82,"undercount"
"12127",54077,"West Virginia","Preston County","NHPI_A",9,5,-4,-57.14,"undercount"
"12128",54077,"West Virginia","Preston County","NHPI_AIC",23,19,-4,-19.05,"undercount"
"12129",54079,"West Virginia","Putnam County","A_A",516,599,83,14.89,"overcount"
"12130",54079,"West Virginia","Putnam County","A_AIC",657,837,180,24.1,"overcount"
"12131",54079,"West Virginia","Putnam County","NHPI_A",24,8,-16,-100,"undercount"
"12132",54079,"West Virginia","Putnam County","NHPI_AIC",48,40,-8,-18.18,"undercount"
"12133",54081,"West Virginia","Raleigh County","A_A",664,831,167,22.34,"overcount"
"12134",54081,"West Virginia","Raleigh County","A_AIC",910,1054,144,14.66,"overcount"
"12135",54081,"West Virginia","Raleigh County","NHPI_A",30,16,-14,-60.87,"undercount"
"12136",54081,"West Virginia","Raleigh County","NHPI_AIC",91,58,-33,-44.3,"undercount"
"12137",54083,"West Virginia","Randolph County","A_A",132,96,-36,-31.58,"undercount"
"12138",54083,"West Virginia","Randolph County","A_AIC",191,165,-26,-14.61,"undercount"
"12139",54083,"West Virginia","Randolph County","NHPI_A",0,1,1,200,"overcount"
"12140",54083,"West Virginia","Randolph County","NHPI_AIC",14,7,-7,-66.67,"undercount"
"12141",54085,"West Virginia","Ritchie County","A_A",24,19,-5,-23.26,"undercount"
"12142",54085,"West Virginia","Ritchie County","A_AIC",41,29,-12,-34.29,"undercount"
"12143",54085,"West Virginia","Ritchie County","NHPI_A",0,7,7,200,"overcount"
"12144",54085,"West Virginia","Ritchie County","NHPI_AIC",2,7,5,111.11,"overcount"
"12145",54087,"West Virginia","Roane County","A_A",51,38,-13,-29.21,"undercount"
"12146",54087,"West Virginia","Roane County","A_AIC",87,103,16,16.84,"overcount"
"12147",54087,"West Virginia","Roane County","NHPI_A",3,0,-3,-200,"undercount"
"12148",54087,"West Virginia","Roane County","NHPI_AIC",11,9,-2,-20,"undercount"
"12149",54089,"West Virginia","Summers County","A_A",35,33,-2,-5.88,"undercount"
"12150",54089,"West Virginia","Summers County","A_AIC",69,50,-19,-31.93,"undercount"
"12151",54089,"West Virginia","Summers County","NHPI_A",2,0,-2,-200,"undercount"
"12152",54089,"West Virginia","Summers County","NHPI_AIC",7,16,9,78.26,"overcount"
"12153",54091,"West Virginia","Taylor County","A_A",81,41,-40,-65.57,"undercount"
"12154",54091,"West Virginia","Taylor County","A_AIC",111,83,-28,-28.87,"undercount"
"12155",54091,"West Virginia","Taylor County","NHPI_A",1,0,-1,-200,"undercount"
"12156",54091,"West Virginia","Taylor County","NHPI_AIC",6,4,-2,-40,"undercount"
"12157",54093,"West Virginia","Tucker County","A_A",23,6,-17,-117.24,"undercount"
"12158",54093,"West Virginia","Tucker County","A_AIC",30,22,-8,-30.77,"undercount"
"12159",54093,"West Virginia","Tucker County","NHPI_A",1,1,0,0,"equal"
"12160",54093,"West Virginia","Tucker County","NHPI_AIC",1,3,2,100,"overcount"
"12161",54095,"West Virginia","Tyler County","A_A",63,3,-60,-181.82,"undercount"
"12162",54095,"West Virginia","Tyler County","A_AIC",79,18,-61,-125.77,"undercount"
"12163",54095,"West Virginia","Tyler County","NHPI_A",2,0,-2,-200,"undercount"
"12164",54095,"West Virginia","Tyler County","NHPI_AIC",5,2,-3,-85.71,"undercount"
"12165",54097,"West Virginia","Upshur County","A_A",126,87,-39,-36.62,"undercount"
"12166",54097,"West Virginia","Upshur County","A_AIC",163,129,-34,-23.29,"undercount"
"12167",54097,"West Virginia","Upshur County","NHPI_A",1,5,4,133.33,"overcount"
"12168",54097,"West Virginia","Upshur County","NHPI_AIC",12,15,3,22.22,"overcount"
"12169",54099,"West Virginia","Wayne County","A_A",113,85,-28,-28.28,"undercount"
"12170",54099,"West Virginia","Wayne County","A_AIC",188,160,-28,-16.09,"undercount"
"12171",54099,"West Virginia","Wayne County","NHPI_A",4,10,6,85.71,"overcount"
"12172",54099,"West Virginia","Wayne County","NHPI_AIC",14,29,15,69.77,"overcount"
"12173",54101,"West Virginia","Webster County","A_A",14,4,-10,-111.11,"undercount"
"12174",54101,"West Virginia","Webster County","A_AIC",23,16,-7,-35.9,"undercount"
"12175",54101,"West Virginia","Webster County","NHPI_A",1,2,1,66.67,"overcount"
"12176",54101,"West Virginia","Webster County","NHPI_AIC",5,11,6,75,"overcount"
"12177",54103,"West Virginia","Wetzel County","A_A",52,50,-2,-3.92,"undercount"
"12178",54103,"West Virginia","Wetzel County","A_AIC",70,81,11,14.57,"overcount"
"12179",54103,"West Virginia","Wetzel County","NHPI_A",0,0,0,0,"equal"
"12180",54103,"West Virginia","Wetzel County","NHPI_AIC",3,8,5,90.91,"overcount"
"12181",54105,"West Virginia","Wirt County","A_A",15,0,-15,-200,"undercount"
"12182",54105,"West Virginia","Wirt County","A_AIC",25,6,-19,-122.58,"undercount"
"12183",54105,"West Virginia","Wirt County","NHPI_A",1,4,3,120,"overcount"
"12184",54105,"West Virginia","Wirt County","NHPI_AIC",3,10,7,107.69,"overcount"
"12185",54107,"West Virginia","Wood County","A_A",459,570,111,21.57,"overcount"
"12186",54107,"West Virginia","Wood County","A_AIC",683,871,188,24.2,"overcount"
"12187",54107,"West Virginia","Wood County","NHPI_A",22,17,-5,-25.64,"undercount"
"12188",54107,"West Virginia","Wood County","NHPI_AIC",63,74,11,16.06,"overcount"
"12189",54109,"West Virginia","Wyoming County","A_A",40,13,-27,-101.89,"undercount"
"12190",54109,"West Virginia","Wyoming County","A_AIC",59,39,-20,-40.82,"undercount"
"12191",54109,"West Virginia","Wyoming County","NHPI_A",1,1,0,0,"equal"
"12192",54109,"West Virginia","Wyoming County","NHPI_AIC",5,5,0,0,"equal"
"12193",55001,"Wisconsin","Adams County","A_A",138,84,-54,-48.65,"undercount"
"12194",55001,"Wisconsin","Adams County","A_AIC",193,138,-55,-33.23,"undercount"
"12195",55001,"Wisconsin","Adams County","NHPI_A",6,8,2,28.57,"overcount"
"12196",55001,"Wisconsin","Adams County","NHPI_AIC",15,24,9,46.15,"overcount"
"12197",55003,"Wisconsin","Ashland County","A_A",95,85,-10,-11.11,"undercount"
"12198",55003,"Wisconsin","Ashland County","A_AIC",151,175,24,14.72,"overcount"
"12199",55003,"Wisconsin","Ashland County","NHPI_A",5,9,4,57.14,"overcount"
"12200",55003,"Wisconsin","Ashland County","NHPI_AIC",11,34,23,102.22,"overcount"
"12201",55005,"Wisconsin","Barron County","A_A",305,358,53,15.99,"overcount"
"12202",55005,"Wisconsin","Barron County","A_AIC",448,517,69,14.3,"overcount"
"12203",55005,"Wisconsin","Barron County","NHPI_A",8,5,-3,-46.15,"undercount"
"12204",55005,"Wisconsin","Barron County","NHPI_AIC",24,39,15,47.62,"overcount"
"12205",55007,"Wisconsin","Bayfield County","A_A",88,36,-52,-83.87,"undercount"
"12206",55007,"Wisconsin","Bayfield County","A_AIC",148,97,-51,-41.63,"undercount"
"12207",55007,"Wisconsin","Bayfield County","NHPI_A",2,2,0,0,"equal"
"12208",55007,"Wisconsin","Bayfield County","NHPI_AIC",11,17,6,42.86,"overcount"
"12209",55009,"Wisconsin","Brown County","A_A",9113,8536,-577,-6.54,"undercount"
"12210",55009,"Wisconsin","Brown County","A_AIC",10354,9980,-374,-3.68,"undercount"
"12211",55009,"Wisconsin","Brown County","NHPI_A",116,114,-2,-1.74,"undercount"
"12212",55009,"Wisconsin","Brown County","NHPI_AIC",325,280,-45,-14.88,"undercount"
"12213",55011,"Wisconsin","Buffalo County","A_A",52,22,-30,-81.08,"undercount"
"12214",55011,"Wisconsin","Buffalo County","A_AIC",85,55,-30,-42.86,"undercount"
"12215",55011,"Wisconsin","Buffalo County","NHPI_A",0,12,12,200,"overcount"
"12216",55011,"Wisconsin","Buffalo County","NHPI_AIC",8,24,16,100,"overcount"
"12217",55013,"Wisconsin","Burnett County","A_A",78,53,-25,-38.17,"undercount"
"12218",55013,"Wisconsin","Burnett County","A_AIC",126,133,7,5.41,"overcount"
"12219",55013,"Wisconsin","Burnett County","NHPI_A",7,10,3,35.29,"overcount"
"12220",55013,"Wisconsin","Burnett County","NHPI_AIC",16,17,1,6.06,"overcount"
"12221",55015,"Wisconsin","Calumet County","A_A",1216,1269,53,4.27,"overcount"
"12222",55015,"Wisconsin","Calumet County","A_AIC",1399,1556,157,10.63,"overcount"
"12223",55015,"Wisconsin","Calumet County","NHPI_A",27,42,15,43.48,"overcount"
"12224",55015,"Wisconsin","Calumet County","NHPI_AIC",44,56,12,24,"overcount"
"12225",55017,"Wisconsin","Chippewa County","A_A",947,984,37,3.83,"overcount"
"12226",55017,"Wisconsin","Chippewa County","A_AIC",1147,1292,145,11.89,"overcount"
"12227",55017,"Wisconsin","Chippewa County","NHPI_A",22,24,2,8.7,"overcount"
"12228",55017,"Wisconsin","Chippewa County","NHPI_AIC",50,57,7,13.08,"overcount"
"12229",55019,"Wisconsin","Clark County","A_A",170,106,-64,-46.38,"undercount"
"12230",55019,"Wisconsin","Clark County","A_AIC",231,177,-54,-26.47,"undercount"
"12231",55019,"Wisconsin","Clark County","NHPI_A",9,4,-5,-76.92,"undercount"
"12232",55019,"Wisconsin","Clark County","NHPI_AIC",18,10,-8,-57.14,"undercount"
"12233",55021,"Wisconsin","Columbia County","A_A",465,384,-81,-19.08,"undercount"
"12234",55021,"Wisconsin","Columbia County","A_AIC",673,589,-84,-13.31,"undercount"
"12235",55021,"Wisconsin","Columbia County","NHPI_A",40,11,-29,-113.73,"undercount"
"12236",55021,"Wisconsin","Columbia County","NHPI_AIC",69,53,-16,-26.23,"undercount"
"12237",55023,"Wisconsin","Crawford County","A_A",106,68,-38,-43.68,"undercount"
"12238",55023,"Wisconsin","Crawford County","A_AIC",149,126,-23,-16.73,"undercount"
"12239",55023,"Wisconsin","Crawford County","NHPI_A",7,1,-6,-150,"undercount"
"12240",55023,"Wisconsin","Crawford County","NHPI_AIC",19,26,7,31.11,"overcount"
"12241",55025,"Wisconsin","Dane County","A_A",35258,35820,562,1.58,"overcount"
"12242",55025,"Wisconsin","Dane County","A_AIC",40096,42686,2590,6.26,"overcount"
"12243",55025,"Wisconsin","Dane County","NHPI_A",176,214,38,19.49,"overcount"
"12244",55025,"Wisconsin","Dane County","NHPI_AIC",609,740,131,19.42,"overcount"
"12245",55027,"Wisconsin","Dodge County","A_A",539,531,-8,-1.5,"undercount"
"12246",55027,"Wisconsin","Dodge County","A_AIC",770,794,24,3.07,"overcount"
"12247",55027,"Wisconsin","Dodge County","NHPI_A",45,11,-34,-121.43,"undercount"
"12248",55027,"Wisconsin","Dodge County","NHPI_AIC",82,28,-54,-98.18,"undercount"
"12249",55029,"Wisconsin","Door County","A_A",160,136,-24,-16.22,"undercount"
"12250",55029,"Wisconsin","Door County","A_AIC",214,236,22,9.78,"overcount"
"12251",55029,"Wisconsin","Door County","NHPI_A",11,2,-9,-138.46,"undercount"
"12252",55029,"Wisconsin","Door County","NHPI_AIC",24,22,-2,-8.7,"undercount"
"12253",55031,"Wisconsin","Douglas County","A_A",463,317,-146,-37.44,"undercount"
"12254",55031,"Wisconsin","Douglas County","A_AIC",679,546,-133,-21.71,"undercount"
"12255",55031,"Wisconsin","Douglas County","NHPI_A",17,18,1,5.71,"overcount"
"12256",55031,"Wisconsin","Douglas County","NHPI_AIC",63,52,-11,-19.13,"undercount"
"12257",55033,"Wisconsin","Dunn County","A_A",1418,1455,37,2.58,"overcount"
"12258",55033,"Wisconsin","Dunn County","A_AIC",1588,1653,65,4.01,"overcount"
"12259",55033,"Wisconsin","Dunn County","NHPI_A",18,13,-5,-32.26,"undercount"
"12260",55033,"Wisconsin","Dunn County","NHPI_AIC",51,57,6,11.11,"overcount"
"12261",55035,"Wisconsin","Eau Claire County","A_A",4562,4388,-174,-3.89,"undercount"
"12262",55035,"Wisconsin","Eau Claire County","A_AIC",5179,5228,49,0.94,"overcount"
"12263",55035,"Wisconsin","Eau Claire County","NHPI_A",202,83,-119,-83.51,"undercount"
"12264",55035,"Wisconsin","Eau Claire County","NHPI_AIC",287,190,-97,-40.67,"undercount"
"12265",55037,"Wisconsin","Florence County","A_A",21,6,-15,-111.11,"undercount"
"12266",55037,"Wisconsin","Florence County","A_AIC",35,26,-9,-29.51,"undercount"
"12267",55037,"Wisconsin","Florence County","NHPI_A",1,4,3,120,"overcount"
"12268",55037,"Wisconsin","Florence County","NHPI_AIC",4,10,6,85.71,"overcount"
"12269",55039,"Wisconsin","Fond du Lac County","A_A",1788,1246,-542,-35.73,"undercount"
"12270",55039,"Wisconsin","Fond du Lac County","A_AIC",2134,1638,-496,-26.3,"undercount"
"12271",55039,"Wisconsin","Fond du Lac County","NHPI_A",37,31,-6,-17.65,"undercount"
"12272",55039,"Wisconsin","Fond du Lac County","NHPI_AIC",96,128,32,28.57,"overcount"
"12273",55041,"Wisconsin","Forest County","A_A",30,26,-4,-14.29,"undercount"
"12274",55041,"Wisconsin","Forest County","A_AIC",61,45,-16,-30.19,"undercount"
"12275",55041,"Wisconsin","Forest County","NHPI_A",12,7,-5,-52.63,"undercount"
"12276",55041,"Wisconsin","Forest County","NHPI_AIC",25,44,19,55.07,"overcount"
"12277",55043,"Wisconsin","Grant County","A_A",458,417,-41,-9.37,"undercount"
"12278",55043,"Wisconsin","Grant County","A_AIC",572,563,-9,-1.59,"undercount"
"12279",55043,"Wisconsin","Grant County","NHPI_A",11,8,-3,-31.58,"undercount"
"12280",55043,"Wisconsin","Grant County","NHPI_AIC",37,35,-2,-5.56,"undercount"
"12281",55045,"Wisconsin","Green County","A_A",224,180,-44,-21.78,"undercount"
"12282",55045,"Wisconsin","Green County","A_AIC",323,334,11,3.35,"overcount"
"12283",55045,"Wisconsin","Green County","NHPI_A",21,3,-18,-150,"undercount"
"12284",55045,"Wisconsin","Green County","NHPI_AIC",41,34,-7,-18.67,"undercount"
"12285",55047,"Wisconsin","Green Lake County","A_A",131,102,-29,-24.89,"undercount"
"12286",55047,"Wisconsin","Green Lake County","A_AIC",172,157,-15,-9.12,"undercount"
"12287",55047,"Wisconsin","Green Lake County","NHPI_A",7,0,-7,-200,"undercount"
"12288",55047,"Wisconsin","Green Lake County","NHPI_AIC",15,8,-7,-60.87,"undercount"
"12289",55049,"Wisconsin","Iowa County","A_A",179,184,5,2.75,"overcount"
"12290",55049,"Wisconsin","Iowa County","A_AIC",249,254,5,1.99,"overcount"
"12291",55049,"Wisconsin","Iowa County","NHPI_A",14,12,-2,-15.38,"undercount"
"12292",55049,"Wisconsin","Iowa County","NHPI_AIC",27,43,16,45.71,"overcount"
"12293",55051,"Wisconsin","Iron County","A_A",17,14,-3,-19.35,"undercount"
"12294",55051,"Wisconsin","Iron County","A_AIC",25,24,-1,-4.08,"undercount"
"12295",55051,"Wisconsin","Iron County","NHPI_A",0,0,0,0,"equal"
"12296",55051,"Wisconsin","Iron County","NHPI_AIC",4,9,5,76.92,"overcount"
"12297",55053,"Wisconsin","Jackson County","A_A",93,76,-17,-20.12,"undercount"
"12298",55053,"Wisconsin","Jackson County","A_AIC",163,143,-20,-13.07,"undercount"
"12299",55053,"Wisconsin","Jackson County","NHPI_A",21,0,-21,-200,"undercount"
"12300",55053,"Wisconsin","Jackson County","NHPI_AIC",39,8,-31,-131.91,"undercount"
"12301",55055,"Wisconsin","Jefferson County","A_A",784,668,-116,-15.98,"undercount"
"12302",55055,"Wisconsin","Jefferson County","A_AIC",1063,1070,7,0.66,"overcount"
"12303",55055,"Wisconsin","Jefferson County","NHPI_A",17,19,2,11.11,"overcount"
"12304",55055,"Wisconsin","Jefferson County","NHPI_AIC",49,92,43,60.99,"overcount"
"12305",55057,"Wisconsin","Juneau County","A_A",154,150,-4,-2.63,"undercount"
"12306",55057,"Wisconsin","Juneau County","A_AIC",221,233,12,5.29,"overcount"
"12307",55057,"Wisconsin","Juneau County","NHPI_A",9,1,-8,-160,"undercount"
"12308",55057,"Wisconsin","Juneau County","NHPI_AIC",24,16,-8,-40,"undercount"
"12309",55059,"Wisconsin","Kenosha County","A_A",2939,2808,-131,-4.56,"undercount"
"12310",55059,"Wisconsin","Kenosha County","A_AIC",3945,4049,104,2.6,"overcount"
"12311",55059,"Wisconsin","Kenosha County","NHPI_A",79,67,-12,-16.44,"undercount"
"12312",55059,"Wisconsin","Kenosha County","NHPI_AIC",256,189,-67,-30.11,"undercount"
"12313",55061,"Wisconsin","Kewaunee County","A_A",98,70,-28,-33.33,"undercount"
"12314",55061,"Wisconsin","Kewaunee County","A_AIC",143,119,-24,-18.32,"undercount"
"12315",55061,"Wisconsin","Kewaunee County","NHPI_A",10,7,-3,-35.29,"undercount"
"12316",55061,"Wisconsin","Kewaunee County","NHPI_AIC",21,21,0,0,"equal"
"12317",55063,"Wisconsin","La Crosse County","A_A",5657,5631,-26,-0.46,"undercount"
"12318",55063,"Wisconsin","La Crosse County","A_AIC",6338,6405,67,1.05,"overcount"
"12319",55063,"Wisconsin","La Crosse County","NHPI_A",42,16,-26,-89.66,"undercount"
"12320",55063,"Wisconsin","La Crosse County","NHPI_AIC",121,108,-13,-11.35,"undercount"
"12321",55065,"Wisconsin","Lafayette County","A_A",79,37,-42,-72.41,"undercount"
"12322",55065,"Wisconsin","Lafayette County","A_AIC",115,81,-34,-34.69,"undercount"
"12323",55065,"Wisconsin","Lafayette County","NHPI_A",0,4,4,200,"overcount"
"12324",55065,"Wisconsin","Lafayette County","NHPI_AIC",5,16,11,104.76,"overcount"
"12325",55067,"Wisconsin","Langlade County","A_A",96,74,-22,-25.88,"undercount"
"12326",55067,"Wisconsin","Langlade County","A_AIC",142,147,5,3.46,"overcount"
"12327",55067,"Wisconsin","Langlade County","NHPI_A",0,4,4,200,"overcount"
"12328",55067,"Wisconsin","Langlade County","NHPI_AIC",10,9,-1,-10.53,"undercount"
"12329",55069,"Wisconsin","Lincoln County","A_A",158,117,-41,-29.82,"undercount"
"12330",55069,"Wisconsin","Lincoln County","A_AIC",248,221,-27,-11.51,"undercount"
"12331",55069,"Wisconsin","Lincoln County","NHPI_A",11,2,-9,-138.46,"undercount"
"12332",55069,"Wisconsin","Lincoln County","NHPI_AIC",25,22,-3,-12.77,"undercount"
"12333",55071,"Wisconsin","Manitowoc County","A_A",2271,2260,-11,-0.49,"undercount"
"12334",55071,"Wisconsin","Manitowoc County","A_AIC",2617,2687,70,2.64,"overcount"
"12335",55071,"Wisconsin","Manitowoc County","NHPI_A",34,15,-19,-77.55,"undercount"
"12336",55071,"Wisconsin","Manitowoc County","NHPI_AIC",74,71,-3,-4.14,"undercount"
"12337",55073,"Wisconsin","Marathon County","A_A",8462,8462,0,0,"equal"
"12338",55073,"Wisconsin","Marathon County","A_AIC",9219,9334,115,1.24,"overcount"
"12339",55073,"Wisconsin","Marathon County","NHPI_A",42,29,-13,-36.62,"undercount"
"12340",55073,"Wisconsin","Marathon County","NHPI_AIC",145,136,-9,-6.41,"undercount"
"12341",55075,"Wisconsin","Marinette County","A_A",221,185,-36,-17.73,"undercount"
"12342",55075,"Wisconsin","Marinette County","A_AIC",356,356,0,0,"equal"
"12343",55075,"Wisconsin","Marinette County","NHPI_A",10,8,-2,-22.22,"undercount"
"12344",55075,"Wisconsin","Marinette County","NHPI_AIC",37,29,-8,-24.24,"undercount"
"12345",55077,"Wisconsin","Marquette County","A_A",112,52,-60,-73.17,"undercount"
"12346",55077,"Wisconsin","Marquette County","A_AIC",144,110,-34,-26.77,"undercount"
"12347",55077,"Wisconsin","Marquette County","NHPI_A",4,6,2,40,"overcount"
"12348",55077,"Wisconsin","Marquette County","NHPI_AIC",6,25,19,122.58,"overcount"
"12349",55078,"Wisconsin","Menominee County","A_A",79,2,-77,-190.12,"undercount"
"12350",55078,"Wisconsin","Menominee County","A_AIC",95,8,-87,-168.93,"undercount"
"12351",55078,"Wisconsin","Menominee County","NHPI_A",0,2,2,200,"overcount"
"12352",55078,"Wisconsin","Menominee County","NHPI_AIC",1,4,3,120,"overcount"
"12353",55079,"Wisconsin","Milwaukee County","A_A",46124,46321,197,0.43,"overcount"
"12354",55079,"Wisconsin","Milwaukee County","A_AIC",51460,53503,2043,3.89,"overcount"
"12355",55079,"Wisconsin","Milwaukee County","NHPI_A",223,278,55,21.96,"overcount"
"12356",55079,"Wisconsin","Milwaukee County","NHPI_AIC",935,1017,82,8.4,"overcount"
"12357",55081,"Wisconsin","Monroe County","A_A",445,359,-86,-21.39,"undercount"
"12358",55081,"Wisconsin","Monroe County","A_AIC",640,645,5,0.78,"overcount"
"12359",55081,"Wisconsin","Monroe County","NHPI_A",48,63,15,27.03,"overcount"
"12360",55081,"Wisconsin","Monroe County","NHPI_AIC",85,95,10,11.11,"overcount"
"12361",55083,"Wisconsin","Oconto County","A_A",182,110,-72,-49.32,"undercount"
"12362",55083,"Wisconsin","Oconto County","A_AIC",265,209,-56,-23.63,"undercount"
"12363",55083,"Wisconsin","Oconto County","NHPI_A",6,0,-6,-200,"undercount"
"12364",55083,"Wisconsin","Oconto County","NHPI_AIC",15,11,-4,-30.77,"undercount"
"12365",55085,"Wisconsin","Oneida County","A_A",196,195,-1,-0.51,"undercount"
"12366",55085,"Wisconsin","Oneida County","A_AIC",294,331,37,11.84,"overcount"
"12367",55085,"Wisconsin","Oneida County","NHPI_A",9,18,9,66.67,"overcount"
"12368",55085,"Wisconsin","Oneida County","NHPI_AIC",25,35,10,33.33,"overcount"
"12369",55087,"Wisconsin","Outagamie County","A_A",7184,6628,-556,-8.05,"undercount"
"12370",55087,"Wisconsin","Outagamie County","A_AIC",8113,7802,-311,-3.91,"undercount"
"12371",55087,"Wisconsin","Outagamie County","NHPI_A",112,112,0,0,"equal"
"12372",55087,"Wisconsin","Outagamie County","NHPI_AIC",232,251,19,7.87,"overcount"
"12373",55089,"Wisconsin","Ozaukee County","A_A",2321,2328,7,0.3,"overcount"
"12374",55089,"Wisconsin","Ozaukee County","A_AIC",2874,3049,175,5.91,"overcount"
"12375",55089,"Wisconsin","Ozaukee County","NHPI_A",25,14,-11,-56.41,"undercount"
"12376",55089,"Wisconsin","Ozaukee County","NHPI_AIC",79,91,12,14.12,"overcount"
"12377",55091,"Wisconsin","Pepin County","A_A",33,24,-9,-31.58,"undercount"
"12378",55091,"Wisconsin","Pepin County","A_AIC",48,55,7,13.59,"overcount"
"12379",55091,"Wisconsin","Pepin County","NHPI_A",1,0,-1,-200,"undercount"
"12380",55091,"Wisconsin","Pepin County","NHPI_AIC",2,3,1,40,"overcount"
"12381",55093,"Wisconsin","Pierce County","A_A",542,289,-253,-60.89,"undercount"
"12382",55093,"Wisconsin","Pierce County","A_AIC",746,525,-221,-34.78,"undercount"
"12383",55093,"Wisconsin","Pierce County","NHPI_A",17,10,-7,-51.85,"undercount"
"12384",55093,"Wisconsin","Pierce County","NHPI_AIC",48,59,11,20.56,"overcount"
"12385",55095,"Wisconsin","Polk County","A_A",267,206,-61,-25.79,"undercount"
"12386",55095,"Wisconsin","Polk County","A_AIC",395,349,-46,-12.37,"undercount"
"12387",55095,"Wisconsin","Polk County","NHPI_A",10,7,-3,-35.29,"undercount"
"12388",55095,"Wisconsin","Polk County","NHPI_AIC",32,33,1,3.08,"overcount"
"12389",55097,"Wisconsin","Portage County","A_A",2336,2260,-76,-3.31,"undercount"
"12390",55097,"Wisconsin","Portage County","A_AIC",2641,2685,44,1.65,"overcount"
"12391",55097,"Wisconsin","Portage County","NHPI_A",24,16,-8,-40,"undercount"
"12392",55097,"Wisconsin","Portage County","NHPI_AIC",67,90,23,29.3,"overcount"
"12393",55099,"Wisconsin","Price County","A_A",94,67,-27,-33.54,"undercount"
"12394",55099,"Wisconsin","Price County","A_AIC",133,104,-29,-24.47,"undercount"
"12395",55099,"Wisconsin","Price County","NHPI_A",129,124,-5,-3.95,"undercount"
"12396",55099,"Wisconsin","Price County","NHPI_AIC",132,139,7,5.17,"overcount"
"12397",55101,"Wisconsin","Racine County","A_A",2512,2289,-223,-9.29,"undercount"
"12398",55101,"Wisconsin","Racine County","A_AIC",3259,3377,118,3.56,"overcount"
"12399",55101,"Wisconsin","Racine County","NHPI_A",71,47,-24,-40.68,"undercount"
"12400",55101,"Wisconsin","Racine County","NHPI_AIC",224,198,-26,-12.32,"undercount"
"12401",55103,"Wisconsin","Richland County","A_A",135,109,-26,-21.31,"undercount"
"12402",55103,"Wisconsin","Richland County","A_AIC",180,168,-12,-6.9,"undercount"
"12403",55103,"Wisconsin","Richland County","NHPI_A",6,0,-6,-200,"undercount"
"12404",55103,"Wisconsin","Richland County","NHPI_AIC",14,15,1,6.9,"overcount"
"12405",55105,"Wisconsin","Rock County","A_A",2065,2061,-4,-0.19,"undercount"
"12406",55105,"Wisconsin","Rock County","A_AIC",2844,2964,120,4.13,"overcount"
"12407",55105,"Wisconsin","Rock County","NHPI_A",65,51,-14,-24.14,"undercount"
"12408",55105,"Wisconsin","Rock County","NHPI_AIC",174,172,-2,-1.16,"undercount"
"12409",55107,"Wisconsin","Rusk County","A_A",45,60,15,28.57,"overcount"
"12410",55107,"Wisconsin","Rusk County","A_AIC",92,113,21,20.49,"overcount"
"12411",55107,"Wisconsin","Rusk County","NHPI_A",4,5,1,22.22,"overcount"
"12412",55107,"Wisconsin","Rusk County","NHPI_AIC",13,10,-3,-26.09,"undercount"
"12413",55109,"Wisconsin","St. Croix County","A_A",1023,1007,-16,-1.58,"undercount"
"12414",55109,"Wisconsin","St. Croix County","A_AIC",1602,1565,-37,-2.34,"undercount"
"12415",55109,"Wisconsin","St. Croix County","NHPI_A",30,33,3,9.52,"overcount"
"12416",55109,"Wisconsin","St. Croix County","NHPI_AIC",71,105,34,38.64,"overcount"
"12417",55111,"Wisconsin","Sauk County","A_A",431,397,-34,-8.21,"undercount"
"12418",55111,"Wisconsin","Sauk County","A_AIC",620,598,-22,-3.61,"undercount"
"12419",55111,"Wisconsin","Sauk County","NHPI_A",21,15,-6,-33.33,"undercount"
"12420",55111,"Wisconsin","Sauk County","NHPI_AIC",53,66,13,21.85,"overcount"
"12421",55113,"Wisconsin","Sawyer County","A_A",66,64,-2,-3.08,"undercount"
"12422",55113,"Wisconsin","Sawyer County","A_AIC",116,127,11,9.05,"overcount"
"12423",55113,"Wisconsin","Sawyer County","NHPI_A",0,2,2,200,"overcount"
"12424",55113,"Wisconsin","Sawyer County","NHPI_AIC",8,15,7,60.87,"overcount"
"12425",55115,"Wisconsin","Shawano County","A_A",194,165,-29,-16.16,"undercount"
"12426",55115,"Wisconsin","Shawano County","A_AIC",301,253,-48,-17.33,"undercount"
"12427",55115,"Wisconsin","Shawano County","NHPI_A",23,6,-17,-117.24,"undercount"
"12428",55115,"Wisconsin","Shawano County","NHPI_AIC",48,18,-30,-90.91,"undercount"
"12429",55117,"Wisconsin","Sheboygan County","A_A",6853,6900,47,0.68,"overcount"
"12430",55117,"Wisconsin","Sheboygan County","A_AIC",7398,7603,205,2.73,"overcount"
"12431",55117,"Wisconsin","Sheboygan County","NHPI_A",48,21,-27,-78.26,"undercount"
"12432",55117,"Wisconsin","Sheboygan County","NHPI_AIC",116,112,-4,-3.51,"undercount"
"12433",55119,"Wisconsin","Taylor County","A_A",100,62,-38,-46.91,"undercount"
"12434",55119,"Wisconsin","Taylor County","A_AIC",143,105,-38,-30.65,"undercount"
"12435",55119,"Wisconsin","Taylor County","NHPI_A",8,5,-3,-46.15,"undercount"
"12436",55119,"Wisconsin","Taylor County","NHPI_AIC",17,31,14,58.33,"overcount"
"12437",55121,"Wisconsin","Trempealeau County","A_A",187,119,-68,-44.44,"undercount"
"12438",55121,"Wisconsin","Trempealeau County","A_AIC",247,228,-19,-8,"undercount"
"12439",55121,"Wisconsin","Trempealeau County","NHPI_A",7,0,-7,-200,"undercount"
"12440",55121,"Wisconsin","Trempealeau County","NHPI_AIC",18,12,-6,-40,"undercount"
"12441",55123,"Wisconsin","Vernon County","A_A",145,91,-54,-45.76,"undercount"
"12442",55123,"Wisconsin","Vernon County","A_AIC",221,191,-30,-14.56,"undercount"
"12443",55123,"Wisconsin","Vernon County","NHPI_A",11,9,-2,-20,"undercount"
"12444",55123,"Wisconsin","Vernon County","NHPI_AIC",27,27,0,0,"equal"
"12445",55125,"Wisconsin","Vilas County","A_A",123,57,-66,-73.33,"undercount"
"12446",55125,"Wisconsin","Vilas County","A_AIC",185,130,-55,-34.92,"undercount"
"12447",55125,"Wisconsin","Vilas County","NHPI_A",1,0,-1,-200,"undercount"
"12448",55125,"Wisconsin","Vilas County","NHPI_AIC",12,24,12,66.67,"overcount"
"12449",55127,"Wisconsin","Walworth County","A_A",1052,1005,-47,-4.57,"undercount"
"12450",55127,"Wisconsin","Walworth County","A_AIC",1385,1485,100,6.97,"overcount"
"12451",55127,"Wisconsin","Walworth County","NHPI_A",34,10,-24,-109.09,"undercount"
"12452",55127,"Wisconsin","Walworth County","NHPI_AIC",78,63,-15,-21.28,"undercount"
"12453",55129,"Wisconsin","Washburn County","A_A",104,59,-45,-55.21,"undercount"
"12454",55129,"Wisconsin","Washburn County","A_AIC",130,111,-19,-15.77,"undercount"
"12455",55129,"Wisconsin","Washburn County","NHPI_A",4,4,0,0,"equal"
"12456",55129,"Wisconsin","Washburn County","NHPI_AIC",7,18,11,88,"overcount"
"12457",55131,"Wisconsin","Washington County","A_A",2061,1963,-98,-4.87,"undercount"
"12458",55131,"Wisconsin","Washington County","A_AIC",2589,2718,129,4.86,"overcount"
"12459",55131,"Wisconsin","Washington County","NHPI_A",44,28,-16,-44.44,"undercount"
"12460",55131,"Wisconsin","Washington County","NHPI_AIC",93,131,38,33.93,"overcount"
"12461",55133,"Wisconsin","Waukesha County","A_A",16311,15751,-560,-3.49,"undercount"
"12462",55133,"Wisconsin","Waukesha County","A_AIC",18870,19029,159,0.84,"overcount"
"12463",55133,"Wisconsin","Waukesha County","NHPI_A",155,121,-34,-24.64,"undercount"
"12464",55133,"Wisconsin","Waukesha County","NHPI_AIC",347,412,65,17.13,"overcount"
"12465",55135,"Wisconsin","Waupaca County","A_A",265,254,-11,-4.24,"undercount"
"12466",55135,"Wisconsin","Waupaca County","A_AIC",392,378,-14,-3.64,"undercount"
"12467",55135,"Wisconsin","Waupaca County","NHPI_A",8,4,-4,-66.67,"undercount"
"12468",55135,"Wisconsin","Waupaca County","NHPI_AIC",24,32,8,28.57,"overcount"
"12469",55137,"Wisconsin","Waushara County","A_A",125,98,-27,-24.22,"undercount"
"12470",55137,"Wisconsin","Waushara County","A_AIC",168,175,7,4.08,"overcount"
"12471",55137,"Wisconsin","Waushara County","NHPI_A",12,14,2,15.38,"overcount"
"12472",55137,"Wisconsin","Waushara County","NHPI_AIC",21,17,-4,-21.05,"undercount"
"12473",55139,"Wisconsin","Winnebago County","A_A",5461,5592,131,2.37,"overcount"
"12474",55139,"Wisconsin","Winnebago County","A_AIC",6386,6568,182,2.81,"overcount"
"12475",55139,"Wisconsin","Winnebago County","NHPI_A",80,53,-27,-40.6,"undercount"
"12476",55139,"Wisconsin","Winnebago County","NHPI_AIC",185,199,14,7.29,"overcount"
"12477",55141,"Wisconsin","Wood County","A_A",1450,1387,-63,-4.44,"undercount"
"12478",55141,"Wisconsin","Wood County","A_AIC",1634,1659,25,1.52,"overcount"
"12479",55141,"Wisconsin","Wood County","NHPI_A",12,29,17,82.93,"overcount"
"12480",55141,"Wisconsin","Wood County","NHPI_AIC",31,86,55,94.02,"overcount"
"12481",56001,"Wyoming","Albany County","A_A",1361,1040,-321,-26.74,"undercount"
"12482",56001,"Wyoming","Albany County","A_AIC",1723,1450,-273,-17.21,"undercount"
"12483",56001,"Wyoming","Albany County","NHPI_A",31,30,-1,-3.28,"undercount"
"12484",56001,"Wyoming","Albany County","NHPI_AIC",92,81,-11,-12.72,"undercount"
"12485",56003,"Wyoming","Big Horn County","A_A",57,45,-12,-23.53,"undercount"
"12486",56003,"Wyoming","Big Horn County","A_AIC",94,96,2,2.11,"overcount"
"12487",56003,"Wyoming","Big Horn County","NHPI_A",3,6,3,66.67,"overcount"
"12488",56003,"Wyoming","Big Horn County","NHPI_AIC",16,23,7,35.9,"overcount"
"12489",56005,"Wyoming","Campbell County","A_A",314,320,6,1.89,"overcount"
"12490",56005,"Wyoming","Campbell County","A_AIC",540,548,8,1.47,"overcount"
"12491",56005,"Wyoming","Campbell County","NHPI_A",23,25,2,8.33,"overcount"
"12492",56005,"Wyoming","Campbell County","NHPI_AIC",66,56,-10,-16.39,"undercount"
"12493",56007,"Wyoming","Carbon County","A_A",120,99,-21,-19.18,"undercount"
"12494",56007,"Wyoming","Carbon County","A_AIC",156,161,5,3.15,"overcount"
"12495",56007,"Wyoming","Carbon County","NHPI_A",14,15,1,6.9,"overcount"
"12496",56007,"Wyoming","Carbon County","NHPI_AIC",29,24,-5,-18.87,"undercount"
"12497",56009,"Wyoming","Converse County","A_A",96,56,-40,-52.63,"undercount"
"12498",56009,"Wyoming","Converse County","A_AIC",137,112,-25,-20.08,"undercount"
"12499",56009,"Wyoming","Converse County","NHPI_A",7,0,-7,-200,"undercount"
"12500",56009,"Wyoming","Converse County","NHPI_AIC",20,15,-5,-28.57,"undercount"
"12501",56011,"Wyoming","Crook County","A_A",17,9,-8,-61.54,"undercount"
"12502",56011,"Wyoming","Crook County","A_AIC",30,23,-7,-26.42,"undercount"
"12503",56011,"Wyoming","Crook County","NHPI_A",1,7,6,150,"overcount"
"12504",56011,"Wyoming","Crook County","NHPI_AIC",5,20,15,120,"overcount"
"12505",56013,"Wyoming","Fremont County","A_A",190,216,26,12.81,"overcount"
"12506",56013,"Wyoming","Fremont County","A_AIC",353,399,46,12.23,"overcount"
"12507",56013,"Wyoming","Fremont County","NHPI_A",15,11,-4,-30.77,"undercount"
"12508",56013,"Wyoming","Fremont County","NHPI_AIC",62,99,37,45.96,"overcount"
"12509",56015,"Wyoming","Goshen County","A_A",95,46,-49,-69.5,"undercount"
"12510",56015,"Wyoming","Goshen County","A_AIC",130,83,-47,-44.13,"undercount"
"12511",56015,"Wyoming","Goshen County","NHPI_A",8,0,-8,-200,"undercount"
"12512",56015,"Wyoming","Goshen County","NHPI_AIC",27,2,-25,-172.41,"undercount"
"12513",56017,"Wyoming","Hot Springs County","A_A",26,20,-6,-26.09,"undercount"
"12514",56017,"Wyoming","Hot Springs County","A_AIC",32,45,13,33.77,"overcount"
"12515",56017,"Wyoming","Hot Springs County","NHPI_A",4,5,1,22.22,"overcount"
"12516",56017,"Wyoming","Hot Springs County","NHPI_AIC",7,17,10,83.33,"overcount"
"12517",56019,"Wyoming","Johnson County","A_A",60,17,-43,-111.69,"undercount"
"12518",56019,"Wyoming","Johnson County","A_AIC",76,51,-25,-39.37,"undercount"
"12519",56019,"Wyoming","Johnson County","NHPI_A",2,7,5,111.11,"overcount"
"12520",56019,"Wyoming","Johnson County","NHPI_AIC",12,11,-1,-8.7,"undercount"
"12521",56021,"Wyoming","Laramie County","A_A",1222,1266,44,3.54,"overcount"
"12522",56021,"Wyoming","Laramie County","A_AIC",2037,2258,221,10.29,"overcount"
"12523",56021,"Wyoming","Laramie County","NHPI_A",94,136,42,36.52,"overcount"
"12524",56021,"Wyoming","Laramie County","NHPI_AIC",226,362,136,46.26,"overcount"
"12525",56023,"Wyoming","Lincoln County","A_A",109,97,-12,-11.65,"undercount"
"12526",56023,"Wyoming","Lincoln County","A_AIC",174,176,2,1.14,"overcount"
"12527",56023,"Wyoming","Lincoln County","NHPI_A",14,21,7,40,"overcount"
"12528",56023,"Wyoming","Lincoln County","NHPI_AIC",36,58,22,46.81,"overcount"
"12529",56025,"Wyoming","Natrona County","A_A",622,635,13,2.07,"overcount"
"12530",56025,"Wyoming","Natrona County","A_AIC",997,1120,123,11.62,"overcount"
"12531",56025,"Wyoming","Natrona County","NHPI_A",44,78,34,55.74,"overcount"
"12532",56025,"Wyoming","Natrona County","NHPI_AIC",151,214,63,34.52,"overcount"
"12533",56027,"Wyoming","Niobrara County","A_A",13,12,-1,-8,"undercount"
"12534",56027,"Wyoming","Niobrara County","A_AIC",23,33,10,35.71,"overcount"
"12535",56027,"Wyoming","Niobrara County","NHPI_A",0,5,5,200,"overcount"
"12536",56027,"Wyoming","Niobrara County","NHPI_AIC",3,12,9,120,"overcount"
"12537",56029,"Wyoming","Park County","A_A",211,218,7,3.26,"overcount"
"12538",56029,"Wyoming","Park County","A_AIC",323,357,34,10,"overcount"
"12539",56029,"Wyoming","Park County","NHPI_A",18,17,-1,-5.71,"undercount"
"12540",56029,"Wyoming","Park County","NHPI_AIC",47,67,20,35.09,"overcount"
"12541",56031,"Wyoming","Platte County","A_A",57,44,-13,-25.74,"undercount"
"12542",56031,"Wyoming","Platte County","A_AIC",95,66,-29,-36.02,"undercount"
"12543",56031,"Wyoming","Platte County","NHPI_A",8,4,-4,-66.67,"undercount"
"12544",56031,"Wyoming","Platte County","NHPI_AIC",15,9,-6,-50,"undercount"
"12545",56033,"Wyoming","Sheridan County","A_A",249,182,-67,-31.09,"undercount"
"12546",56033,"Wyoming","Sheridan County","A_AIC",388,343,-45,-12.31,"undercount"
"12547",56033,"Wyoming","Sheridan County","NHPI_A",16,17,1,6.06,"overcount"
"12548",56033,"Wyoming","Sheridan County","NHPI_AIC",48,58,10,18.87,"overcount"
"12549",56035,"Wyoming","Sublette County","A_A",69,49,-20,-33.9,"undercount"
"12550",56035,"Wyoming","Sublette County","A_AIC",110,77,-33,-35.29,"undercount"
"12551",56035,"Wyoming","Sublette County","NHPI_A",7,10,3,35.29,"overcount"
"12552",56035,"Wyoming","Sublette County","NHPI_AIC",19,22,3,14.63,"overcount"
"12553",56037,"Wyoming","Sweetwater County","A_A",386,285,-101,-30.1,"undercount"
"12554",56037,"Wyoming","Sweetwater County","A_AIC",596,543,-53,-9.31,"undercount"
"12555",56037,"Wyoming","Sweetwater County","NHPI_A",56,61,5,8.55,"overcount"
"12556",56037,"Wyoming","Sweetwater County","NHPI_AIC",105,146,41,32.67,"overcount"
"12557",56039,"Wyoming","Teton County","A_A",342,321,-21,-6.33,"undercount"
"12558",56039,"Wyoming","Teton County","A_AIC",500,570,70,13.08,"overcount"
"12559",56039,"Wyoming","Teton County","NHPI_A",17,3,-14,-140,"undercount"
"12560",56039,"Wyoming","Teton County","NHPI_AIC",55,34,-21,-47.19,"undercount"
"12561",56041,"Wyoming","Uinta County","A_A",98,108,10,9.71,"overcount"
"12562",56041,"Wyoming","Uinta County","A_AIC",180,184,4,2.2,"overcount"
"12563",56041,"Wyoming","Uinta County","NHPI_A",25,27,2,7.69,"overcount"
"12564",56041,"Wyoming","Uinta County","NHPI_AIC",56,77,21,31.58,"overcount"
"12565",56043,"Wyoming","Washakie County","A_A",58,35,-23,-49.46,"undercount"
"12566",56043,"Wyoming","Washakie County","A_AIC",77,66,-11,-15.38,"undercount"
"12567",56043,"Wyoming","Washakie County","NHPI_A",0,1,1,200,"overcount"
"12568",56043,"Wyoming","Washakie County","NHPI_AIC",4,7,3,54.55,"overcount"
"12569",56045,"Wyoming","Weston County","A_A",97,28,-69,-110.4,"undercount"
"12570",56045,"Wyoming","Weston County","A_AIC",119,61,-58,-64.44,"undercount"
"12571",56045,"Wyoming","Weston County","NHPI_A",1,9,8,160,"overcount"
"12572",56045,"Wyoming","Weston County","NHPI_AIC",7,17,10,83.33,"overcount"
