"","STATE","STNAME","AGEGRP","RACE","ESTIM","MR","NUM_DIFF","EOC","COVERAGE"
"1",1,"Alabama",1,"A_A",3994,3745,-249,-6.43,"undercount"
"2",1,"Alabama",1,"A_AIC",5993,5825,-168,-2.84,"undercount"
"3",1,"Alabama",1,"NHPI_A",223,633,410,95.79,"overcount"
"4",1,"Alabama",1,"NHPI_AIC",625,954,329,41.67,"overcount"
"5",1,"Alabama",2,"A_A",3761,4055,294,7.52,"overcount"
"6",1,"Alabama",2,"A_AIC",5618,5638,20,0.36,"overcount"
"7",1,"Alabama",2,"NHPI_A",196,466,270,81.57,"overcount"
"8",1,"Alabama",2,"NHPI_AIC",513,723,210,33.98,"overcount"
"9",1,"Alabama",3,"A_A",3460,3621,161,4.55,"overcount"
"10",1,"Alabama",3,"A_AIC",5116,5065,-51,-1,"undercount"
"11",1,"Alabama",3,"NHPI_A",163,383,220,80.59,"overcount"
"12",1,"Alabama",3,"NHPI_AIC",471,622,151,27.63,"overcount"
"13",1,"Alabama",4,"A_A",3114,3564,450,13.48,"overcount"
"14",1,"Alabama",4,"A_AIC",4464,4823,359,7.73,"overcount"
"15",1,"Alabama",4,"NHPI_A",205,382,177,60.31,"overcount"
"16",1,"Alabama",4,"NHPI_AIC",424,601,177,34.54,"overcount"
"17",1,"Alabama",5,"A_A",3920,4732,812,18.77,"overcount"
"18",1,"Alabama",5,"A_AIC",5215,5910,695,12.49,"overcount"
"19",1,"Alabama",5,"NHPI_A",240,727,487,100.72,"overcount"
"20",1,"Alabama",5,"NHPI_AIC",439,879,440,66.77,"overcount"
"21",1,"Alabama",6,"A_A",4180,5209,1029,21.92,"overcount"
"22",1,"Alabama",6,"A_AIC",5171,6278,1107,19.34,"overcount"
"23",1,"Alabama",6,"NHPI_A",201,700,499,110.77,"overcount"
"24",1,"Alabama",6,"NHPI_AIC",400,825,425,69.39,"overcount"
"25",1,"Alabama",7,"A_A",4122,5040,918,20.04,"overcount"
"26",1,"Alabama",7,"A_AIC",4920,5961,1041,19.13,"overcount"
"27",1,"Alabama",7,"NHPI_A",235,531,296,77.28,"overcount"
"28",1,"Alabama",7,"NHPI_AIC",428,625,197,37.42,"overcount"
"29",1,"Alabama",8,"A_A",4816,5252,436,8.66,"overcount"
"30",1,"Alabama",8,"A_AIC",5441,5947,506,8.89,"overcount"
"31",1,"Alabama",8,"NHPI_A",204,410,206,67.1,"overcount"
"32",1,"Alabama",8,"NHPI_AIC",364,565,201,43.27,"overcount"
"33",1,"Alabama",9,"A_A",4178,4585,407,9.29,"overcount"
"34",1,"Alabama",9,"A_AIC",4695,5014,319,6.57,"overcount"
"35",1,"Alabama",9,"NHPI_A",144,270,126,60.87,"overcount"
"36",1,"Alabama",9,"NHPI_AIC",259,401,142,43.03,"overcount"
"37",1,"Alabama",10,"A_A",3712,3911,199,5.22,"overcount"
"38",1,"Alabama",10,"A_AIC",4182,4382,200,4.67,"overcount"
"39",1,"Alabama",10,"NHPI_A",168,235,67,33.25,"overcount"
"40",1,"Alabama",10,"NHPI_AIC",293,386,93,27.39,"overcount"
"41",1,"Alabama",11,"A_A",3066,3285,219,6.9,"overcount"
"42",1,"Alabama",11,"A_AIC",3493,3720,227,6.29,"overcount"
"43",1,"Alabama",11,"NHPI_A",108,157,49,36.98,"overcount"
"44",1,"Alabama",11,"NHPI_AIC",226,269,43,17.37,"overcount"
"45",1,"Alabama",12,"A_A",2642,2751,109,4.04,"overcount"
"46",1,"Alabama",12,"A_AIC",3007,3057,50,1.65,"overcount"
"47",1,"Alabama",12,"NHPI_A",87,107,20,20.62,"overcount"
"48",1,"Alabama",12,"NHPI_AIC",176,198,22,11.76,"overcount"
"49",1,"Alabama",13,"A_A",2137,2158,21,0.98,"overcount"
"50",1,"Alabama",13,"A_AIC",2389,2304,-85,-3.62,"undercount"
"51",1,"Alabama",13,"NHPI_A",73,82,9,11.61,"overcount"
"52",1,"Alabama",13,"NHPI_AIC",154,131,-23,-16.14,"undercount"
"53",1,"Alabama",14,"A_A",1332,1407,75,5.48,"overcount"
"54",1,"Alabama",14,"A_AIC",1560,1503,-57,-3.72,"undercount"
"55",1,"Alabama",14,"NHPI_A",46,54,8,16,"overcount"
"56",1,"Alabama",14,"NHPI_AIC",126,106,-20,-17.24,"undercount"
"57",1,"Alabama",15,"A_A",947,885,-62,-6.77,"undercount"
"58",1,"Alabama",15,"A_AIC",1096,951,-145,-14.17,"undercount"
"59",1,"Alabama",15,"NHPI_A",35,35,0,0,"equal"
"60",1,"Alabama",15,"NHPI_AIC",84,75,-9,-11.32,"undercount"
"61",1,"Alabama",16,"A_A",700,591,-109,-16.89,"undercount"
"62",1,"Alabama",16,"A_AIC",821,599,-222,-31.27,"undercount"
"63",1,"Alabama",16,"NHPI_A",25,16,-9,-43.9,"undercount"
"64",1,"Alabama",16,"NHPI_AIC",71,39,-32,-58.18,"undercount"
"65",1,"Alabama",17,"A_A",440,306,-134,-35.92,"undercount"
"66",1,"Alabama",17,"A_AIC",528,309,-219,-52.33,"undercount"
"67",1,"Alabama",17,"NHPI_A",25,12,-13,-70.27,"undercount"
"68",1,"Alabama",17,"NHPI_AIC",64,38,-26,-50.98,"undercount"
"69",1,"Alabama",18,"A_A",248,143,-105,-53.71,"undercount"
"70",1,"Alabama",18,"A_AIC",344,155,-189,-75.75,"undercount"
"71",1,"Alabama",18,"NHPI_A",35,8,-27,-125.58,"undercount"
"72",1,"Alabama",18,"NHPI_AIC",90,21,-69,-124.32,"undercount"
"73",2,"Alaska",1,"A_A",2626,2450,-176,-6.93,"undercount"
"74",2,"Alaska",1,"A_AIC",4186,4707,521,11.72,"overcount"
"75",2,"Alaska",1,"NHPI_A",514,868,354,51.23,"overcount"
"76",2,"Alaska",1,"NHPI_AIC",942,1580,638,50.59,"overcount"
"77",2,"Alaska",2,"A_A",2779,2785,6,0.22,"overcount"
"78",2,"Alaska",2,"A_AIC",4118,4645,527,12.03,"overcount"
"79",2,"Alaska",2,"NHPI_A",519,829,310,45.99,"overcount"
"80",2,"Alaska",2,"NHPI_AIC",842,1422,580,51.24,"overcount"
"81",2,"Alaska",3,"A_A",2484,2932,448,16.54,"overcount"
"82",2,"Alaska",3,"A_AIC",3820,4540,720,17.22,"overcount"
"83",2,"Alaska",3,"NHPI_A",399,768,369,63.24,"overcount"
"84",2,"Alaska",3,"NHPI_AIC",727,1238,511,52.01,"overcount"
"85",2,"Alaska",4,"A_A",2387,3030,643,23.74,"overcount"
"86",2,"Alaska",4,"A_AIC",3395,4345,950,24.55,"overcount"
"87",2,"Alaska",4,"NHPI_A",415,769,354,59.8,"overcount"
"88",2,"Alaska",4,"NHPI_AIC",684,1143,459,50.25,"overcount"
"89",2,"Alaska",5,"A_A",2604,2898,294,10.69,"overcount"
"90",2,"Alaska",5,"A_AIC",3504,3968,464,12.42,"overcount"
"91",2,"Alaska",5,"NHPI_A",450,850,400,61.54,"overcount"
"92",2,"Alaska",5,"NHPI_AIC",693,1132,439,48.11,"overcount"
"93",2,"Alaska",6,"A_A",2849,2886,37,1.29,"overcount"
"94",2,"Alaska",6,"A_AIC",3614,3763,149,4.04,"overcount"
"95",2,"Alaska",6,"NHPI_A",472,729,257,42.8,"overcount"
"96",2,"Alaska",6,"NHPI_AIC",674,995,321,38.47,"overcount"
"97",2,"Alaska",7,"A_A",2610,2546,-64,-2.48,"undercount"
"98",2,"Alaska",7,"A_AIC",3162,3286,124,3.85,"overcount"
"99",2,"Alaska",7,"NHPI_A",417,621,204,39.31,"overcount"
"100",2,"Alaska",7,"NHPI_AIC",602,810,208,29.46,"overcount"
"101",2,"Alaska",8,"A_A",2682,2886,204,7.33,"overcount"
"102",2,"Alaska",8,"A_AIC",3138,3446,308,9.36,"overcount"
"103",2,"Alaska",8,"NHPI_A",339,464,125,31.13,"overcount"
"104",2,"Alaska",8,"NHPI_AIC",496,623,127,22.7,"overcount"
"105",2,"Alaska",9,"A_A",2539,2946,407,14.84,"overcount"
"106",2,"Alaska",9,"A_AIC",2895,3377,482,15.37,"overcount"
"107",2,"Alaska",9,"NHPI_A",346,441,95,24.14,"overcount"
"108",2,"Alaska",9,"NHPI_AIC",484,570,86,16.32,"overcount"
"109",2,"Alaska",10,"A_A",2706,3117,411,14.12,"overcount"
"110",2,"Alaska",10,"A_AIC",3074,3473,399,12.19,"overcount"
"111",2,"Alaska",10,"NHPI_A",308,421,113,31,"overcount"
"112",2,"Alaska",10,"NHPI_AIC",469,552,83,16.26,"overcount"
"113",2,"Alaska",11,"A_A",2538,2933,395,14.44,"overcount"
"114",2,"Alaska",11,"A_AIC",2861,3265,404,13.19,"overcount"
"115",2,"Alaska",11,"NHPI_A",237,317,80,28.88,"overcount"
"116",2,"Alaska",11,"NHPI_AIC",372,432,60,14.93,"overcount"
"117",2,"Alaska",12,"A_A",2066,2543,477,20.7,"overcount"
"118",2,"Alaska",12,"A_AIC",2281,2572,291,11.99,"overcount"
"119",2,"Alaska",12,"NHPI_A",181,222,41,20.35,"overcount"
"120",2,"Alaska",12,"NHPI_AIC",251,302,51,18.44,"overcount"
"121",2,"Alaska",13,"A_A",1768,1915,147,7.98,"overcount"
"122",2,"Alaska",13,"A_AIC",1872,2033,161,8.25,"overcount"
"123",2,"Alaska",13,"NHPI_A",141,162,21,13.86,"overcount"
"124",2,"Alaska",13,"NHPI_AIC",185,194,9,4.75,"overcount"
"125",2,"Alaska",14,"A_A",1224,1154,-70,-5.89,"undercount"
"126",2,"Alaska",14,"A_AIC",1301,1127,-174,-14.33,"undercount"
"127",2,"Alaska",14,"NHPI_A",78,103,25,27.62,"overcount"
"128",2,"Alaska",14,"NHPI_AIC",107,121,14,12.28,"overcount"
"129",2,"Alaska",15,"A_A",710,773,63,8.5,"overcount"
"130",2,"Alaska",15,"A_AIC",757,785,28,3.63,"overcount"
"131",2,"Alaska",15,"NHPI_A",33,42,9,24,"overcount"
"132",2,"Alaska",15,"NHPI_AIC",50,46,-4,-8.33,"undercount"
"133",2,"Alaska",16,"A_A",562,512,-50,-9.31,"undercount"
"134",2,"Alaska",16,"A_AIC",603,506,-97,-17.49,"undercount"
"135",2,"Alaska",16,"NHPI_A",44,32,-12,-31.58,"undercount"
"136",2,"Alaska",16,"NHPI_AIC",61,40,-21,-41.58,"undercount"
"137",2,"Alaska",17,"A_A",420,363,-57,-14.56,"undercount"
"138",2,"Alaska",17,"A_AIC",466,319,-147,-37.45,"undercount"
"139",2,"Alaska",17,"NHPI_A",29,18,-11,-46.81,"undercount"
"140",2,"Alaska",17,"NHPI_AIC",39,18,-21,-73.68,"undercount"
"141",2,"Alaska",18,"A_A",350,213,-137,-48.67,"undercount"
"142",2,"Alaska",18,"A_AIC",368,194,-174,-61.92,"undercount"
"143",2,"Alaska",18,"NHPI_A",14,6,-8,-80,"undercount"
"144",2,"Alaska",18,"NHPI_AIC",14,12,-2,-15.38,"undercount"
"145",4,"Arizona",1,"A_A",13242,12977,-265,-2.02,"undercount"
"146",4,"Arizona",1,"A_AIC",20355,21537,1182,5.64,"overcount"
"147",4,"Arizona",1,"NHPI_A",1210,1299,89,7.09,"overcount"
"148",4,"Arizona",1,"NHPI_AIC",2681,3013,332,11.66,"overcount"
"149",4,"Arizona",2,"A_A",13991,12986,-1005,-7.45,"undercount"
"150",4,"Arizona",2,"A_AIC",20842,20525,-317,-1.53,"undercount"
"151",4,"Arizona",2,"NHPI_A",1281,1342,61,4.65,"overcount"
"152",4,"Arizona",2,"NHPI_AIC",2780,2866,86,3.05,"overcount"
"153",4,"Arizona",3,"A_A",11028,11998,970,8.43,"overcount"
"154",4,"Arizona",3,"A_AIC",16190,18442,2252,13.01,"overcount"
"155",4,"Arizona",3,"NHPI_A",1088,1311,223,18.59,"overcount"
"156",4,"Arizona",3,"NHPI_AIC",2137,2718,581,23.93,"overcount"
"157",4,"Arizona",4,"A_A",9784,12277,2493,22.6,"overcount"
"158",4,"Arizona",4,"A_AIC",13750,17935,4185,26.42,"overcount"
"159",4,"Arizona",4,"NHPI_A",1105,1460,355,27.68,"overcount"
"160",4,"Arizona",4,"NHPI_AIC",2032,2751,719,30.06,"overcount"
"161",4,"Arizona",5,"A_A",9690,13937,4247,35.95,"overcount"
"162",4,"Arizona",5,"A_AIC",13132,18785,5653,35.42,"overcount"
"163",4,"Arizona",5,"NHPI_A",1028,1615,587,44.42,"overcount"
"164",4,"Arizona",5,"NHPI_AIC",1841,2715,874,38.37,"overcount"
"165",4,"Arizona",6,"A_A",13892,16822,2930,19.08,"overcount"
"166",4,"Arizona",6,"A_AIC",17409,21068,3659,19.02,"overcount"
"167",4,"Arizona",6,"NHPI_A",1155,1578,423,30.95,"overcount"
"168",4,"Arizona",6,"NHPI_AIC",2039,2606,567,24.41,"overcount"
"169",4,"Arizona",7,"A_A",16682,17371,689,4.05,"overcount"
"170",4,"Arizona",7,"A_AIC",19707,21117,1410,6.91,"overcount"
"171",4,"Arizona",7,"NHPI_A",1205,1510,305,22.47,"overcount"
"172",4,"Arizona",7,"NHPI_AIC",2124,2404,280,12.37,"overcount"
"173",4,"Arizona",8,"A_A",17870,18437,567,3.12,"overcount"
"174",4,"Arizona",8,"A_AIC",20340,21632,1292,6.16,"overcount"
"175",4,"Arizona",8,"NHPI_A",1126,1297,171,14.11,"overcount"
"176",4,"Arizona",8,"NHPI_AIC",1800,2024,224,11.72,"overcount"
"177",4,"Arizona",9,"A_A",14915,15327,412,2.72,"overcount"
"178",4,"Arizona",9,"A_AIC",16808,17595,787,4.58,"overcount"
"179",4,"Arizona",9,"NHPI_A",922,1124,202,19.75,"overcount"
"180",4,"Arizona",9,"NHPI_AIC",1492,1703,211,13.21,"overcount"
"181",4,"Arizona",10,"A_A",12649,13380,731,5.62,"overcount"
"182",4,"Arizona",10,"A_AIC",14174,15376,1202,8.14,"overcount"
"183",4,"Arizona",10,"NHPI_A",800,1007,207,22.91,"overcount"
"184",4,"Arizona",10,"NHPI_AIC",1307,1555,248,17.33,"overcount"
"185",4,"Arizona",11,"A_A",10734,11466,732,6.59,"overcount"
"186",4,"Arizona",11,"A_AIC",12002,13065,1063,8.48,"overcount"
"187",4,"Arizona",11,"NHPI_A",690,807,117,15.63,"overcount"
"188",4,"Arizona",11,"NHPI_AIC",1096,1241,145,12.41,"overcount"
"189",4,"Arizona",12,"A_A",8944,9423,479,5.22,"overcount"
"190",4,"Arizona",12,"A_AIC",9838,10602,764,7.48,"overcount"
"191",4,"Arizona",12,"NHPI_A",532,582,50,8.98,"overcount"
"192",4,"Arizona",12,"NHPI_AIC",863,906,43,4.86,"overcount"
"193",4,"Arizona",13,"A_A",7427,7667,240,3.18,"overcount"
"194",4,"Arizona",13,"A_AIC",8039,8461,422,5.12,"overcount"
"195",4,"Arizona",13,"NHPI_A",433,475,42,9.25,"overcount"
"196",4,"Arizona",13,"NHPI_AIC",672,730,58,8.27,"overcount"
"197",4,"Arizona",14,"A_A",5331,5319,-12,-0.23,"undercount"
"198",4,"Arizona",14,"A_AIC",5778,5826,48,0.83,"overcount"
"199",4,"Arizona",14,"NHPI_A",304,309,5,1.63,"overcount"
"200",4,"Arizona",14,"NHPI_AIC",471,471,0,0,"equal"
"201",4,"Arizona",15,"A_A",3938,3944,6,0.15,"overcount"
"202",4,"Arizona",15,"A_AIC",4252,4302,50,1.17,"overcount"
"203",4,"Arizona",15,"NHPI_A",202,197,-5,-2.51,"undercount"
"204",4,"Arizona",15,"NHPI_AIC",297,322,25,8.08,"overcount"
"205",4,"Arizona",16,"A_A",2783,2633,-150,-5.54,"undercount"
"206",4,"Arizona",16,"A_AIC",2984,2876,-108,-3.69,"undercount"
"207",4,"Arizona",16,"NHPI_A",140,107,-33,-26.72,"undercount"
"208",4,"Arizona",16,"NHPI_AIC",234,192,-42,-19.72,"undercount"
"209",4,"Arizona",17,"A_A",1694,1464,-230,-14.57,"undercount"
"210",4,"Arizona",17,"A_AIC",1822,1601,-221,-12.91,"undercount"
"211",4,"Arizona",17,"NHPI_A",73,57,-16,-24.62,"undercount"
"212",4,"Arizona",17,"NHPI_AIC",123,103,-20,-17.7,"undercount"
"213",4,"Arizona",18,"A_A",1397,1028,-369,-30.43,"undercount"
"214",4,"Arizona",18,"A_AIC",1562,1116,-446,-33.31,"undercount"
"215",4,"Arizona",18,"NHPI_A",57,35,-22,-47.83,"undercount"
"216",4,"Arizona",18,"NHPI_AIC",96,64,-32,-40,"undercount"
"217",5,"Arkansas",1,"A_A",3133,2785,-348,-11.76,"undercount"
"218",5,"Arkansas",1,"A_AIC",4531,4263,-268,-6.1,"undercount"
"219",5,"Arkansas",1,"NHPI_A",375,1028,653,93.09,"overcount"
"220",5,"Arkansas",1,"NHPI_AIC",635,1261,626,66.03,"overcount"
"221",5,"Arkansas",2,"A_A",2896,2833,-63,-2.2,"undercount"
"222",5,"Arkansas",2,"A_AIC",4538,4031,-507,-11.83,"undercount"
"223",5,"Arkansas",2,"NHPI_A",359,815,456,77.68,"overcount"
"224",5,"Arkansas",2,"NHPI_AIC",654,1011,357,42.88,"overcount"
"225",5,"Arkansas",3,"A_A",2099,2428,329,14.54,"overcount"
"226",5,"Arkansas",3,"A_AIC",3141,3341,200,6.17,"overcount"
"227",5,"Arkansas",3,"NHPI_A",330,612,282,59.87,"overcount"
"228",5,"Arkansas",3,"NHPI_AIC",509,761,252,39.69,"overcount"
"229",5,"Arkansas",4,"A_A",2161,2708,547,22.47,"overcount"
"230",5,"Arkansas",4,"A_AIC",3005,3529,524,16.04,"overcount"
"231",5,"Arkansas",4,"NHPI_A",256,503,247,65.09,"overcount"
"232",5,"Arkansas",4,"NHPI_AIC",505,639,134,23.43,"overcount"
"233",5,"Arkansas",5,"A_A",2291,3453,1162,40.46,"overcount"
"234",5,"Arkansas",5,"A_AIC",3025,4314,1289,35.13,"overcount"
"235",5,"Arkansas",5,"NHPI_A",380,685,305,57.28,"overcount"
"236",5,"Arkansas",5,"NHPI_AIC",584,921,337,44.78,"overcount"
"237",5,"Arkansas",6,"A_A",3046,3871,825,23.85,"overcount"
"238",5,"Arkansas",6,"A_AIC",3647,4409,762,18.92,"overcount"
"239",5,"Arkansas",6,"NHPI_A",449,737,288,48.57,"overcount"
"240",5,"Arkansas",6,"NHPI_AIC",615,844,229,31.39,"overcount"
"241",5,"Arkansas",7,"A_A",3226,3622,396,11.57,"overcount"
"242",5,"Arkansas",7,"A_AIC",3765,4124,359,9.1,"overcount"
"243",5,"Arkansas",7,"NHPI_A",455,766,311,50.94,"overcount"
"244",5,"Arkansas",7,"NHPI_AIC",627,851,224,30.31,"overcount"
"245",5,"Arkansas",8,"A_A",3294,3322,28,0.85,"overcount"
"246",5,"Arkansas",8,"A_AIC",3627,3672,45,1.23,"overcount"
"247",5,"Arkansas",8,"NHPI_A",343,457,114,28.5,"overcount"
"248",5,"Arkansas",8,"NHPI_AIC",430,527,97,20.27,"overcount"
"249",5,"Arkansas",9,"A_A",2793,2789,-4,-0.14,"undercount"
"250",5,"Arkansas",9,"A_AIC",3076,2937,-139,-4.62,"undercount"
"251",5,"Arkansas",9,"NHPI_A",188,303,115,46.84,"overcount"
"252",5,"Arkansas",9,"NHPI_AIC",280,387,107,32.08,"overcount"
"253",5,"Arkansas",10,"A_A",2323,2361,38,1.62,"overcount"
"254",5,"Arkansas",10,"A_AIC",2610,2487,-123,-4.83,"undercount"
"255",5,"Arkansas",10,"NHPI_A",165,228,63,32.06,"overcount"
"256",5,"Arkansas",10,"NHPI_AIC",261,265,4,1.52,"overcount"
"257",5,"Arkansas",11,"A_A",2106,2172,66,3.09,"overcount"
"258",5,"Arkansas",11,"A_AIC",2343,2308,-35,-1.51,"undercount"
"259",5,"Arkansas",11,"NHPI_A",133,199,66,39.76,"overcount"
"260",5,"Arkansas",11,"NHPI_AIC",204,267,63,26.75,"overcount"
"261",5,"Arkansas",12,"A_A",1768,1829,61,3.39,"overcount"
"262",5,"Arkansas",12,"A_AIC",1976,1879,-97,-5.03,"undercount"
"263",5,"Arkansas",12,"NHPI_A",113,144,31,24.12,"overcount"
"264",5,"Arkansas",12,"NHPI_AIC",189,175,-14,-7.69,"undercount"
"265",5,"Arkansas",13,"A_A",1299,1324,25,1.91,"overcount"
"266",5,"Arkansas",13,"A_AIC",1462,1394,-68,-4.76,"undercount"
"267",5,"Arkansas",13,"NHPI_A",74,90,16,19.51,"overcount"
"268",5,"Arkansas",13,"NHPI_AIC",109,125,16,13.68,"overcount"
"269",5,"Arkansas",14,"A_A",906,827,-79,-9.12,"undercount"
"270",5,"Arkansas",14,"A_AIC",1011,808,-203,-22.32,"undercount"
"271",5,"Arkansas",14,"NHPI_A",52,59,7,12.61,"overcount"
"272",5,"Arkansas",14,"NHPI_AIC",108,78,-30,-32.26,"undercount"
"273",5,"Arkansas",15,"A_A",624,517,-107,-18.76,"undercount"
"274",5,"Arkansas",15,"A_AIC",725,527,-198,-31.63,"undercount"
"275",5,"Arkansas",15,"NHPI_A",38,26,-12,-37.5,"undercount"
"276",5,"Arkansas",15,"NHPI_AIC",80,49,-31,-48.06,"undercount"
"277",5,"Arkansas",16,"A_A",381,357,-24,-6.5,"undercount"
"278",5,"Arkansas",16,"A_AIC",455,246,-209,-59.63,"undercount"
"279",5,"Arkansas",16,"NHPI_A",28,16,-12,-54.55,"undercount"
"280",5,"Arkansas",16,"NHPI_AIC",57,18,-39,-104,"undercount"
"281",5,"Arkansas",17,"A_A",254,209,-45,-19.44,"undercount"
"282",5,"Arkansas",17,"A_AIC",304,189,-115,-46.65,"undercount"
"283",5,"Arkansas",17,"NHPI_A",20,11,-9,-58.06,"undercount"
"284",5,"Arkansas",17,"NHPI_AIC",40,23,-17,-53.97,"undercount"
"285",5,"Arkansas",18,"A_A",156,130,-26,-18.18,"undercount"
"286",5,"Arkansas",18,"A_AIC",218,125,-93,-54.23,"undercount"
"287",5,"Arkansas",18,"NHPI_A",35,6,-29,-141.46,"undercount"
"288",5,"Arkansas",18,"NHPI_AIC",53,19,-34,-94.44,"undercount"
"289",6,"California",1,"A_A",295013,283840,-11173,-3.86,"undercount"
"290",6,"California",1,"A_AIC",376824,387189,10365,2.71,"overcount"
"291",6,"California",1,"NHPI_A",12126,13753,1627,12.57,"overcount"
"292",6,"California",1,"NHPI_AIC",26927,30381,3454,12.05,"overcount"
"293",6,"California",2,"A_A",289379,290530,1151,0.4,"overcount"
"294",6,"California",2,"A_AIC",361038,379498,18460,4.99,"overcount"
"295",6,"California",2,"NHPI_A",11415,13456,2041,16.41,"overcount"
"296",6,"California",2,"NHPI_AIC",25799,27656,1857,6.95,"overcount"
"297",6,"California",3,"A_A",266829,294384,27555,9.82,"overcount"
"298",6,"California",3,"A_AIC",323570,372607,49037,14.09,"overcount"
"299",6,"California",3,"NHPI_A",12474,14441,1967,14.62,"overcount"
"300",6,"California",3,"NHPI_AIC",23994,28352,4358,16.65,"overcount"
"301",6,"California",4,"A_A",285602,333420,47818,15.45,"overcount"
"302",6,"California",4,"A_AIC",334912,405356,70444,19.03,"overcount"
"303",6,"California",4,"NHPI_A",13536,16747,3211,21.21,"overcount"
"304",6,"California",4,"NHPI_AIC",23917,30903,6986,25.49,"overcount"
"305",6,"California",5,"A_A",289742,363189,73447,22.5,"overcount"
"306",6,"California",5,"A_AIC",332586,422169,89583,23.74,"overcount"
"307",6,"California",5,"NHPI_A",13146,17025,3879,25.71,"overcount"
"308",6,"California",5,"NHPI_AIC",23084,29558,6474,24.6,"overcount"
"309",6,"California",6,"A_A",359263,387605,28342,7.59,"overcount"
"310",6,"California",6,"A_AIC",398075,439040,40965,9.79,"overcount"
"311",6,"California",6,"NHPI_A",13360,16120,2760,18.72,"overcount"
"312",6,"California",6,"NHPI_AIC",23473,27682,4209,16.46,"overcount"
"313",6,"California",7,"A_A",397415,388420,-8995,-2.29,"undercount"
"314",6,"California",7,"A_AIC",429144,431064,1920,0.45,"overcount"
"315",6,"California",7,"NHPI_A",13262,14274,1012,7.35,"overcount"
"316",6,"California",7,"NHPI_AIC",22383,23993,1610,6.94,"overcount"
"317",6,"California",8,"A_A",402690,417740,15050,3.67,"overcount"
"318",6,"California",8,"A_AIC",429695,452982,23287,5.28,"overcount"
"319",6,"California",8,"NHPI_A",12031,13172,1141,9.05,"overcount"
"320",6,"California",8,"NHPI_AIC",19642,21190,1548,7.58,"overcount"
"321",6,"California",9,"A_A",375181,388766,13585,3.56,"overcount"
"322",6,"California",9,"A_AIC",399188,419433,20245,4.95,"overcount"
"323",6,"California",9,"NHPI_A",12199,13081,882,6.98,"overcount"
"324",6,"California",9,"NHPI_AIC",19583,20647,1064,5.29,"overcount"
"325",6,"California",10,"A_A",361000,381698,20698,5.57,"overcount"
"326",6,"California",10,"A_AIC",382963,410667,27704,6.98,"overcount"
"327",6,"California",10,"NHPI_A",12117,12848,731,5.86,"overcount"
"328",6,"California",10,"NHPI_AIC",19535,20541,1006,5.02,"overcount"
"329",6,"California",11,"A_A",339928,361716,21788,6.21,"overcount"
"330",6,"California",11,"A_AIC",358878,386525,27647,7.42,"overcount"
"331",6,"California",11,"NHPI_A",10188,11008,820,7.74,"overcount"
"332",6,"California",11,"NHPI_AIC",16543,17729,1186,6.92,"overcount"
"333",6,"California",12,"A_A",301126,318234,17108,5.52,"overcount"
"334",6,"California",12,"A_AIC",314316,335446,21130,6.5,"overcount"
"335",6,"California",12,"NHPI_A",7997,8320,323,3.96,"overcount"
"336",6,"California",12,"NHPI_AIC",12772,13184,412,3.17,"overcount"
"337",6,"California",13,"A_A",246668,259014,12346,4.88,"overcount"
"338",6,"California",13,"A_AIC",255847,271004,15157,5.75,"overcount"
"339",6,"California",13,"NHPI_A",6116,6342,226,3.63,"overcount"
"340",6,"California",13,"NHPI_AIC",9645,10019,374,3.8,"overcount"
"341",6,"California",14,"A_A",169021,177830,8809,5.08,"overcount"
"342",6,"California",14,"A_AIC",175169,185691,10522,5.83,"overcount"
"343",6,"California",14,"NHPI_A",4052,4037,-15,-0.37,"undercount"
"344",6,"California",14,"NHPI_AIC",6579,6514,-65,-0.99,"undercount"
"345",6,"California",15,"A_A",135941,141735,5794,4.17,"overcount"
"346",6,"California",15,"A_AIC",140638,147694,7056,4.89,"overcount"
"347",6,"California",15,"NHPI_A",3089,2912,-177,-5.9,"undercount"
"348",6,"California",15,"NHPI_AIC",4799,4657,-142,-3,"undercount"
"349",6,"California",16,"A_A",106458,108036,1578,1.47,"overcount"
"350",6,"California",16,"A_AIC",110185,112748,2563,2.3,"overcount"
"351",6,"California",16,"NHPI_A",2078,1899,-179,-9,"undercount"
"352",6,"California",16,"NHPI_AIC",3289,3213,-76,-2.34,"undercount"
"353",6,"California",17,"A_A",79875,76705,-3170,-4.05,"undercount"
"354",6,"California",17,"A_AIC",82408,79890,-2518,-3.1,"undercount"
"355",6,"California",17,"NHPI_A",1254,1133,-121,-10.14,"undercount"
"356",6,"California",17,"NHPI_AIC",2153,2044,-109,-5.19,"undercount"
"357",6,"California",18,"A_A",76899,65261,-11638,-16.37,"undercount"
"358",6,"California",18,"A_AIC",78943,67863,-11080,-15.09,"undercount"
"359",6,"California",18,"NHPI_A",917,863,-54,-6.07,"undercount"
"360",6,"California",18,"NHPI_AIC",1663,1683,20,1.2,"overcount"
"361",8,"Colorado",1,"A_A",10765,9477,-1288,-12.73,"undercount"
"362",8,"Colorado",1,"A_AIC",16680,17506,826,4.83,"overcount"
"363",8,"Colorado",1,"NHPI_A",664,734,70,10.01,"overcount"
"364",8,"Colorado",1,"NHPI_AIC",1683,1888,205,11.48,"overcount"
"365",8,"Colorado",2,"A_A",11096,10911,-185,-1.68,"undercount"
"366",8,"Colorado",2,"A_AIC",16398,17758,1360,7.96,"overcount"
"367",8,"Colorado",2,"NHPI_A",816,750,-66,-8.43,"undercount"
"368",8,"Colorado",2,"NHPI_AIC",1698,1756,58,3.36,"overcount"
"369",8,"Colorado",3,"A_A",9156,9849,693,7.29,"overcount"
"370",8,"Colorado",3,"A_AIC",13556,15456,1900,13.1,"overcount"
"371",8,"Colorado",3,"NHPI_A",614,715,101,15.2,"overcount"
"372",8,"Colorado",3,"NHPI_AIC",1421,1585,164,10.91,"overcount"
"373",8,"Colorado",4,"A_A",8488,9214,726,8.2,"overcount"
"374",8,"Colorado",4,"A_AIC",12189,14028,1839,14.03,"overcount"
"375",8,"Colorado",4,"NHPI_A",634,719,85,12.56,"overcount"
"376",8,"Colorado",4,"NHPI_AIC",1423,1533,110,7.44,"overcount"
"377",8,"Colorado",5,"A_A",9542,10737,1195,11.79,"overcount"
"378",8,"Colorado",5,"A_AIC",13018,14867,1849,13.26,"overcount"
"379",8,"Colorado",5,"NHPI_A",632,939,307,39.08,"overcount"
"380",8,"Colorado",5,"NHPI_AIC",1350,1722,372,24.22,"overcount"
"381",8,"Colorado",6,"A_A",11237,12629,1392,11.67,"overcount"
"382",8,"Colorado",6,"A_AIC",14179,16199,2020,13.3,"overcount"
"383",8,"Colorado",6,"NHPI_A",685,843,158,20.68,"overcount"
"384",8,"Colorado",6,"NHPI_AIC",1360,1556,196,13.44,"overcount"
"385",8,"Colorado",7,"A_A",12636,12708,72,0.57,"overcount"
"386",8,"Colorado",7,"A_AIC",14994,15824,830,5.39,"overcount"
"387",8,"Colorado",7,"NHPI_A",650,711,61,8.96,"overcount"
"388",8,"Colorado",7,"NHPI_AIC",1254,1330,76,5.88,"overcount"
"389",8,"Colorado",8,"A_A",14136,13895,-241,-1.72,"undercount"
"390",8,"Colorado",8,"A_AIC",16244,16535,291,1.78,"overcount"
"391",8,"Colorado",8,"NHPI_A",611,639,28,4.48,"overcount"
"392",8,"Colorado",8,"NHPI_AIC",1186,1150,-36,-3.08,"undercount"
"393",8,"Colorado",9,"A_A",11762,11893,131,1.11,"overcount"
"394",8,"Colorado",9,"A_AIC",13385,13669,284,2.1,"overcount"
"395",8,"Colorado",9,"NHPI_A",583,535,-48,-8.59,"undercount"
"396",8,"Colorado",9,"NHPI_AIC",982,978,-4,-0.41,"undercount"
"397",8,"Colorado",10,"A_A",9864,10531,667,6.54,"overcount"
"398",8,"Colorado",10,"A_AIC",11209,12157,948,8.11,"overcount"
"399",8,"Colorado",10,"NHPI_A",552,558,6,1.08,"overcount"
"400",8,"Colorado",10,"NHPI_AIC",994,987,-7,-0.71,"undercount"
"401",8,"Colorado",11,"A_A",8435,8888,453,5.23,"overcount"
"402",8,"Colorado",11,"A_AIC",9503,10151,648,6.59,"overcount"
"403",8,"Colorado",11,"NHPI_A",417,413,-4,-0.96,"undercount"
"404",8,"Colorado",11,"NHPI_AIC",799,706,-93,-12.36,"undercount"
"405",8,"Colorado",12,"A_A",6718,7234,516,7.4,"overcount"
"406",8,"Colorado",12,"A_AIC",7434,8045,611,7.89,"overcount"
"407",8,"Colorado",12,"NHPI_A",330,302,-28,-8.86,"undercount"
"408",8,"Colorado",12,"NHPI_AIC",519,497,-22,-4.33,"undercount"
"409",8,"Colorado",13,"A_A",5394,5708,314,5.66,"overcount"
"410",8,"Colorado",13,"A_AIC",5861,6140,279,4.65,"overcount"
"411",8,"Colorado",13,"NHPI_A",234,272,38,15.02,"overcount"
"412",8,"Colorado",13,"NHPI_AIC",358,406,48,12.57,"overcount"
"413",8,"Colorado",14,"A_A",3658,3914,256,6.76,"overcount"
"414",8,"Colorado",14,"A_AIC",3969,4150,181,4.46,"overcount"
"415",8,"Colorado",14,"NHPI_A",152,127,-25,-17.92,"undercount"
"416",8,"Colorado",14,"NHPI_AIC",239,201,-38,-17.27,"undercount"
"417",8,"Colorado",15,"A_A",2623,2766,143,5.31,"overcount"
"418",8,"Colorado",15,"A_AIC",2801,2891,90,3.16,"overcount"
"419",8,"Colorado",15,"NHPI_A",98,82,-16,-17.78,"undercount"
"420",8,"Colorado",15,"NHPI_AIC",146,113,-33,-25.48,"undercount"
"421",8,"Colorado",16,"A_A",2059,2044,-15,-0.73,"undercount"
"422",8,"Colorado",16,"A_AIC",2221,2157,-64,-2.92,"undercount"
"423",8,"Colorado",16,"NHPI_A",69,55,-14,-22.58,"undercount"
"424",8,"Colorado",16,"NHPI_AIC",113,81,-32,-32.99,"undercount"
"425",8,"Colorado",17,"A_A",1445,1357,-88,-6.28,"undercount"
"426",8,"Colorado",17,"A_AIC",1536,1357,-179,-12.37,"undercount"
"427",8,"Colorado",17,"NHPI_A",40,13,-27,-101.89,"undercount"
"428",8,"Colorado",17,"NHPI_AIC",68,34,-34,-66.67,"undercount"
"429",8,"Colorado",18,"A_A",1261,1064,-197,-16.95,"undercount"
"430",8,"Colorado",18,"A_AIC",1350,1116,-234,-18.98,"undercount"
"431",8,"Colorado",18,"NHPI_A",42,13,-29,-105.45,"undercount"
"432",8,"Colorado",18,"NHPI_AIC",81,42,-39,-63.41,"undercount"
"433",9,"Connecticut",1,"A_A",10571,10875,304,2.84,"overcount"
"434",9,"Connecticut",1,"A_AIC",12980,14525,1545,11.23,"overcount"
"435",9,"Connecticut",1,"NHPI_A",252,235,-17,-6.98,"undercount"
"436",9,"Connecticut",1,"NHPI_AIC",505,527,22,4.26,"overcount"
"437",9,"Connecticut",2,"A_A",10331,10612,281,2.68,"overcount"
"438",9,"Connecticut",2,"A_AIC",12454,13775,1321,10.07,"overcount"
"439",9,"Connecticut",2,"NHPI_A",241,230,-11,-4.67,"undercount"
"440",9,"Connecticut",2,"NHPI_AIC",504,503,-1,-0.2,"undercount"
"441",9,"Connecticut",3,"A_A",8951,9157,206,2.28,"overcount"
"442",9,"Connecticut",3,"A_AIC",10603,11609,1006,9.06,"overcount"
"443",9,"Connecticut",3,"NHPI_A",238,285,47,17.97,"overcount"
"444",9,"Connecticut",3,"NHPI_AIC",440,541,101,20.59,"overcount"
"445",9,"Connecticut",4,"A_A",7847,8579,732,8.91,"overcount"
"446",9,"Connecticut",4,"A_AIC",9343,10610,1267,12.7,"overcount"
"447",9,"Connecticut",4,"NHPI_A",237,299,62,23.13,"overcount"
"448",9,"Connecticut",4,"NHPI_AIC",554,565,11,1.97,"overcount"
"449",9,"Connecticut",5,"A_A",8368,9879,1511,16.56,"overcount"
"450",9,"Connecticut",5,"A_AIC",9706,11591,1885,17.7,"overcount"
"451",9,"Connecticut",5,"NHPI_A",302,334,32,10.06,"overcount"
"452",9,"Connecticut",5,"NHPI_AIC",726,634,-92,-13.53,"undercount"
"453",9,"Connecticut",6,"A_A",10370,13896,3526,29.06,"overcount"
"454",9,"Connecticut",6,"A_AIC",11340,15141,3801,28.71,"overcount"
"455",9,"Connecticut",6,"NHPI_A",254,276,22,8.3,"overcount"
"456",9,"Connecticut",6,"NHPI_AIC",524,574,50,9.11,"overcount"
"457",9,"Connecticut",7,"A_A",12645,14416,1771,13.09,"overcount"
"458",9,"Connecticut",7,"A_AIC",13457,15465,2008,13.89,"overcount"
"459",9,"Connecticut",7,"NHPI_A",233,298,65,24.48,"overcount"
"460",9,"Connecticut",7,"NHPI_AIC",477,574,97,18.46,"overcount"
"461",9,"Connecticut",8,"A_A",13471,14015,544,3.96,"overcount"
"462",9,"Connecticut",8,"A_AIC",14291,15047,756,5.15,"overcount"
"463",9,"Connecticut",8,"NHPI_A",245,367,122,39.87,"overcount"
"464",9,"Connecticut",8,"NHPI_AIC",443,639,196,36.23,"overcount"
"465",9,"Connecticut",9,"A_A",11790,11701,-89,-0.76,"undercount"
"466",9,"Connecticut",9,"A_AIC",12473,12506,33,0.26,"overcount"
"467",9,"Connecticut",9,"NHPI_A",198,348,150,54.95,"overcount"
"468",9,"Connecticut",9,"NHPI_AIC",427,604,177,34.34,"overcount"
"469",9,"Connecticut",10,"A_A",9847,9952,105,1.06,"overcount"
"470",9,"Connecticut",10,"A_AIC",10476,10678,202,1.91,"overcount"
"471",9,"Connecticut",10,"NHPI_A",176,298,122,51.48,"overcount"
"472",9,"Connecticut",10,"NHPI_AIC",364,557,193,41.91,"overcount"
"473",9,"Connecticut",11,"A_A",7652,8058,406,5.17,"overcount"
"474",9,"Connecticut",11,"A_AIC",8204,8681,477,5.65,"overcount"
"475",9,"Connecticut",11,"NHPI_A",176,216,40,20.41,"overcount"
"476",9,"Connecticut",11,"NHPI_AIC",368,401,33,8.58,"overcount"
"477",9,"Connecticut",12,"A_A",5971,6317,346,5.63,"overcount"
"478",9,"Connecticut",12,"A_AIC",6339,6731,392,6,"overcount"
"479",9,"Connecticut",12,"NHPI_A",128,104,-24,-20.69,"undercount"
"480",9,"Connecticut",12,"NHPI_AIC",260,240,-20,-8,"undercount"
"481",9,"Connecticut",13,"A_A",4694,4888,194,4.05,"overcount"
"482",9,"Connecticut",13,"A_AIC",4972,5191,219,4.31,"overcount"
"483",9,"Connecticut",13,"NHPI_A",99,85,-14,-15.22,"undercount"
"484",9,"Connecticut",13,"NHPI_AIC",204,188,-16,-8.16,"undercount"
"485",9,"Connecticut",14,"A_A",3080,3252,172,5.43,"overcount"
"486",9,"Connecticut",14,"A_AIC",3266,3450,184,5.48,"overcount"
"487",9,"Connecticut",14,"NHPI_A",64,41,-23,-43.81,"undercount"
"488",9,"Connecticut",14,"NHPI_AIC",130,109,-21,-17.57,"undercount"
"489",9,"Connecticut",15,"A_A",2166,2246,80,3.63,"overcount"
"490",9,"Connecticut",15,"A_AIC",2304,2400,96,4.08,"overcount"
"491",9,"Connecticut",15,"NHPI_A",48,31,-17,-43.04,"undercount"
"492",9,"Connecticut",15,"NHPI_AIC",87,84,-3,-3.51,"undercount"
"493",9,"Connecticut",16,"A_A",1494,1413,-81,-5.57,"undercount"
"494",9,"Connecticut",16,"A_AIC",1587,1511,-76,-4.91,"undercount"
"495",9,"Connecticut",16,"NHPI_A",26,16,-10,-47.62,"undercount"
"496",9,"Connecticut",16,"NHPI_AIC",59,46,-13,-24.76,"undercount"
"497",9,"Connecticut",17,"A_A",876,764,-112,-13.66,"undercount"
"498",9,"Connecticut",17,"A_AIC",953,837,-116,-12.96,"undercount"
"499",9,"Connecticut",17,"NHPI_A",35,16,-19,-74.51,"undercount"
"500",9,"Connecticut",17,"NHPI_AIC",53,36,-17,-38.2,"undercount"
"501",9,"Connecticut",18,"A_A",786,496,-290,-45.24,"undercount"
"502",9,"Connecticut",18,"A_AIC",852,526,-326,-47.31,"undercount"
"503",9,"Connecticut",18,"NHPI_A",32,12,-20,-90.91,"undercount"
"504",9,"Connecticut",18,"NHPI_AIC",60,34,-26,-55.32,"undercount"
"505",10,"Delaware",1,"A_A",2186,2155,-31,-1.43,"undercount"
"506",10,"Delaware",1,"A_AIC",2708,2938,230,8.15,"overcount"
"507",10,"Delaware",1,"NHPI_A",77,64,-13,-18.44,"undercount"
"508",10,"Delaware",1,"NHPI_AIC",137,154,17,11.68,"overcount"
"509",10,"Delaware",2,"A_A",2157,2112,-45,-2.11,"undercount"
"510",10,"Delaware",2,"A_AIC",2677,2808,131,4.78,"overcount"
"511",10,"Delaware",2,"NHPI_A",84,74,-10,-12.66,"undercount"
"512",10,"Delaware",2,"NHPI_AIC",129,127,-2,-1.56,"undercount"
"513",10,"Delaware",3,"A_A",1665,1710,45,2.67,"overcount"
"514",10,"Delaware",3,"A_AIC",2141,2246,105,4.79,"overcount"
"515",10,"Delaware",3,"NHPI_A",41,58,17,34.34,"overcount"
"516",10,"Delaware",3,"NHPI_AIC",94,131,37,32.89,"overcount"
"517",10,"Delaware",4,"A_A",1471,1858,387,23.25,"overcount"
"518",10,"Delaware",4,"A_AIC",1829,2403,574,27.13,"overcount"
"519",10,"Delaware",4,"NHPI_A",54,49,-5,-9.71,"undercount"
"520",10,"Delaware",4,"NHPI_AIC",88,120,32,30.77,"overcount"
"521",10,"Delaware",5,"A_A",1490,2074,584,32.77,"overcount"
"522",10,"Delaware",5,"A_AIC",1767,2505,738,34.55,"overcount"
"523",10,"Delaware",5,"NHPI_A",49,70,21,35.29,"overcount"
"524",10,"Delaware",5,"NHPI_AIC",67,139,72,69.9,"overcount"
"525",10,"Delaware",6,"A_A",2426,2897,471,17.7,"overcount"
"526",10,"Delaware",6,"A_AIC",2752,3253,501,16.69,"overcount"
"527",10,"Delaware",6,"NHPI_A",53,82,29,42.96,"overcount"
"528",10,"Delaware",6,"NHPI_AIC",101,135,34,28.81,"overcount"
"529",10,"Delaware",7,"A_A",2718,2957,239,8.42,"overcount"
"530",10,"Delaware",7,"A_AIC",2943,3239,296,9.58,"overcount"
"531",10,"Delaware",7,"NHPI_A",71,55,-16,-25.4,"undercount"
"532",10,"Delaware",7,"NHPI_AIC",129,106,-23,-19.57,"undercount"
"533",10,"Delaware",8,"A_A",2720,2802,82,2.97,"overcount"
"534",10,"Delaware",8,"A_AIC",2895,3064,169,5.67,"overcount"
"535",10,"Delaware",8,"NHPI_A",57,67,10,16.13,"overcount"
"536",10,"Delaware",8,"NHPI_AIC",86,114,28,28,"overcount"
"537",10,"Delaware",9,"A_A",2315,2290,-25,-1.09,"undercount"
"538",10,"Delaware",9,"A_AIC",2472,2506,34,1.37,"overcount"
"539",10,"Delaware",9,"NHPI_A",52,34,-18,-41.86,"undercount"
"540",10,"Delaware",9,"NHPI_AIC",73,82,9,11.61,"overcount"
"541",10,"Delaware",10,"A_A",1972,2077,105,5.19,"overcount"
"542",10,"Delaware",10,"A_AIC",2110,2252,142,6.51,"overcount"
"543",10,"Delaware",10,"NHPI_A",33,37,4,11.43,"overcount"
"544",10,"Delaware",10,"NHPI_AIC",63,89,26,34.21,"overcount"
"545",10,"Delaware",11,"A_A",1567,1663,96,5.94,"overcount"
"546",10,"Delaware",11,"A_AIC",1693,1804,111,6.35,"overcount"
"547",10,"Delaware",11,"NHPI_A",27,38,11,33.85,"overcount"
"548",10,"Delaware",11,"NHPI_AIC",61,69,8,12.31,"overcount"
"549",10,"Delaware",12,"A_A",1257,1359,102,7.8,"overcount"
"550",10,"Delaware",12,"A_AIC",1351,1442,91,6.52,"overcount"
"551",10,"Delaware",12,"NHPI_A",26,17,-9,-41.86,"undercount"
"552",10,"Delaware",12,"NHPI_AIC",39,36,-3,-8,"undercount"
"553",10,"Delaware",13,"A_A",1103,1156,53,4.69,"overcount"
"554",10,"Delaware",13,"A_AIC",1189,1232,43,3.55,"overcount"
"555",10,"Delaware",13,"NHPI_A",23,16,-7,-35.9,"undercount"
"556",10,"Delaware",13,"NHPI_AIC",52,34,-18,-41.86,"undercount"
"557",10,"Delaware",14,"A_A",834,899,65,7.5,"overcount"
"558",10,"Delaware",14,"A_AIC",883,949,66,7.21,"overcount"
"559",10,"Delaware",14,"NHPI_A",18,9,-9,-66.67,"undercount"
"560",10,"Delaware",14,"NHPI_AIC",39,30,-9,-26.09,"undercount"
"561",10,"Delaware",15,"A_A",692,653,-39,-5.8,"undercount"
"562",10,"Delaware",15,"A_AIC",734,694,-40,-5.6,"undercount"
"563",10,"Delaware",15,"NHPI_A",4,3,-1,-28.57,"undercount"
"564",10,"Delaware",15,"NHPI_AIC",15,18,3,18.18,"overcount"
"565",10,"Delaware",16,"A_A",362,362,0,0,"equal"
"566",10,"Delaware",16,"A_AIC",391,380,-11,-2.85,"undercount"
"567",10,"Delaware",16,"NHPI_A",8,7,-1,-13.33,"undercount"
"568",10,"Delaware",16,"NHPI_AIC",23,16,-7,-35.9,"undercount"
"569",10,"Delaware",17,"A_A",204,184,-20,-10.31,"undercount"
"570",10,"Delaware",17,"A_AIC",228,207,-21,-9.66,"undercount"
"571",10,"Delaware",17,"NHPI_A",3,7,4,80,"overcount"
"572",10,"Delaware",17,"NHPI_AIC",7,7,0,0,"equal"
"573",10,"Delaware",18,"A_A",196,134,-62,-37.58,"undercount"
"574",10,"Delaware",18,"A_AIC",211,152,-59,-32.51,"undercount"
"575",10,"Delaware",18,"NHPI_A",6,3,-3,-66.67,"undercount"
"576",10,"Delaware",18,"NHPI_AIC",15,12,-3,-22.22,"undercount"
"577",11,"District of Columbia",1,"A_A",1333,678,-655,-65.14,"undercount"
"578",11,"District of Columbia",1,"A_AIC",1934,1541,-393,-22.62,"undercount"
"579",11,"District of Columbia",1,"NHPI_A",62,53,-9,-15.65,"undercount"
"580",11,"District of Columbia",1,"NHPI_AIC",112,100,-12,-11.32,"undercount"
"581",11,"District of Columbia",2,"A_A",923,494,-429,-60.55,"undercount"
"582",11,"District of Columbia",2,"A_AIC",1307,872,-435,-39.93,"undercount"
"583",11,"District of Columbia",2,"NHPI_A",77,64,-13,-18.44,"undercount"
"584",11,"District of Columbia",2,"NHPI_AIC",119,92,-27,-25.59,"undercount"
"585",11,"District of Columbia",3,"A_A",880,385,-495,-78.26,"undercount"
"586",11,"District of Columbia",3,"A_AIC",1147,629,-518,-58.33,"undercount"
"587",11,"District of Columbia",3,"NHPI_A",42,36,-6,-15.38,"undercount"
"588",11,"District of Columbia",3,"NHPI_AIC",78,56,-22,-32.84,"undercount"
"589",11,"District of Columbia",4,"A_A",1212,1189,-23,-1.92,"undercount"
"590",11,"District of Columbia",4,"A_AIC",1396,1645,249,16.38,"overcount"
"591",11,"District of Columbia",4,"NHPI_A",81,46,-35,-55.12,"undercount"
"592",11,"District of Columbia",4,"NHPI_AIC",120,113,-7,-6.01,"undercount"
"593",11,"District of Columbia",5,"A_A",1790,3294,1504,59.17,"overcount"
"594",11,"District of Columbia",5,"A_AIC",2096,4124,2028,65.21,"overcount"
"595",11,"District of Columbia",5,"NHPI_A",82,90,8,9.3,"overcount"
"596",11,"District of Columbia",5,"NHPI_AIC",156,186,30,17.54,"overcount"
"597",11,"District of Columbia",6,"A_A",2828,3873,1045,31.19,"overcount"
"598",11,"District of Columbia",6,"A_AIC",3302,4755,1453,36.07,"overcount"
"599",11,"District of Columbia",6,"NHPI_A",107,115,8,7.21,"overcount"
"600",11,"District of Columbia",6,"NHPI_AIC",176,213,37,19.02,"overcount"
"601",11,"District of Columbia",7,"A_A",2939,3353,414,13.16,"overcount"
"602",11,"District of Columbia",7,"A_AIC",3312,4032,720,19.61,"overcount"
"603",11,"District of Columbia",7,"NHPI_A",91,92,1,1.09,"overcount"
"604",11,"District of Columbia",7,"NHPI_AIC",146,175,29,18.07,"overcount"
"605",11,"District of Columbia",8,"A_A",2307,2326,19,0.82,"overcount"
"606",11,"District of Columbia",8,"A_AIC",2504,2722,218,8.34,"overcount"
"607",11,"District of Columbia",8,"NHPI_A",65,58,-7,-11.38,"undercount"
"608",11,"District of Columbia",8,"NHPI_AIC",89,123,34,32.08,"overcount"
"609",11,"District of Columbia",9,"A_A",1451,1349,-102,-7.29,"undercount"
"610",11,"District of Columbia",9,"A_AIC",1609,1576,-33,-2.07,"undercount"
"611",11,"District of Columbia",9,"NHPI_A",65,60,-5,-8,"undercount"
"612",11,"District of Columbia",9,"NHPI_AIC",93,117,24,22.86,"overcount"
"613",11,"District of Columbia",10,"A_A",950,988,38,3.92,"overcount"
"614",11,"District of Columbia",10,"A_AIC",1074,1180,106,9.41,"overcount"
"615",11,"District of Columbia",10,"NHPI_A",42,51,9,19.35,"overcount"
"616",11,"District of Columbia",10,"NHPI_AIC",60,92,32,42.11,"overcount"
"617",11,"District of Columbia",11,"A_A",850,874,24,2.78,"overcount"
"618",11,"District of Columbia",11,"A_AIC",968,1040,72,7.17,"overcount"
"619",11,"District of Columbia",11,"NHPI_A",31,30,-1,-3.28,"undercount"
"620",11,"District of Columbia",11,"NHPI_AIC",57,69,12,19.05,"overcount"
"621",11,"District of Columbia",12,"A_A",811,803,-8,-0.99,"undercount"
"622",11,"District of Columbia",12,"A_AIC",908,914,6,0.66,"overcount"
"623",11,"District of Columbia",12,"NHPI_A",22,25,3,12.77,"overcount"
"624",11,"District of Columbia",12,"NHPI_AIC",38,57,19,40,"overcount"
"625",11,"District of Columbia",13,"A_A",788,716,-72,-9.57,"undercount"
"626",11,"District of Columbia",13,"A_AIC",859,807,-52,-6.24,"undercount"
"627",11,"District of Columbia",13,"NHPI_A",29,19,-10,-41.67,"undercount"
"628",11,"District of Columbia",13,"NHPI_AIC",57,43,-14,-28,"undercount"
"629",11,"District of Columbia",14,"A_A",474,459,-15,-3.22,"undercount"
"630",11,"District of Columbia",14,"A_AIC",530,507,-23,-4.44,"undercount"
"631",11,"District of Columbia",14,"NHPI_A",9,26,17,97.14,"overcount"
"632",11,"District of Columbia",14,"NHPI_AIC",39,38,-1,-2.6,"undercount"
"633",11,"District of Columbia",15,"A_A",303,352,49,14.96,"overcount"
"634",11,"District of Columbia",15,"A_AIC",327,392,65,18.08,"overcount"
"635",11,"District of Columbia",15,"NHPI_A",9,3,-6,-100,"undercount"
"636",11,"District of Columbia",15,"NHPI_AIC",14,16,2,13.33,"overcount"
"637",11,"District of Columbia",16,"A_A",261,235,-26,-10.48,"undercount"
"638",11,"District of Columbia",16,"A_AIC",272,260,-12,-4.51,"undercount"
"639",11,"District of Columbia",16,"NHPI_A",1,1,0,0,"equal"
"640",11,"District of Columbia",16,"NHPI_AIC",4,6,2,40,"overcount"
"641",11,"District of Columbia",17,"A_A",160,164,4,2.47,"overcount"
"642",11,"District of Columbia",17,"A_AIC",166,179,13,7.54,"overcount"
"643",11,"District of Columbia",17,"NHPI_A",8,1,-7,-155.56,"undercount"
"644",11,"District of Columbia",17,"NHPI_AIC",10,7,-3,-35.29,"undercount"
"645",11,"District of Columbia",18,"A_A",212,173,-39,-20.26,"undercount"
"646",11,"District of Columbia",18,"A_AIC",221,194,-27,-13.01,"undercount"
"647",11,"District of Columbia",18,"NHPI_A",6,0,-6,-200,"undercount"
"648",11,"District of Columbia",18,"NHPI_AIC",13,11,-2,-16.67,"undercount"
"649",12,"Florida",1,"A_A",32217,28094,-4123,-13.67,"undercount"
"650",12,"Florida",1,"A_AIC",47263,43646,-3617,-7.96,"undercount"
"651",12,"Florida",1,"NHPI_A",2007,1450,-557,-32.22,"undercount"
"652",12,"Florida",1,"NHPI_AIC",4412,3611,-801,-19.97,"undercount"
"653",12,"Florida",2,"A_A",30229,30135,-94,-0.31,"undercount"
"654",12,"Florida",2,"A_AIC",44125,43759,-366,-0.83,"undercount"
"655",12,"Florida",2,"NHPI_A",1786,1308,-478,-30.9,"undercount"
"656",12,"Florida",2,"NHPI_AIC",4114,3200,-914,-24.99,"undercount"
"657",12,"Florida",3,"A_A",28228,28992,764,2.67,"overcount"
"658",12,"Florida",3,"A_AIC",38694,40991,2297,5.77,"overcount"
"659",12,"Florida",3,"NHPI_A",1213,1299,86,6.85,"overcount"
"660",12,"Florida",3,"NHPI_AIC",2984,3183,199,6.45,"overcount"
"661",12,"Florida",4,"A_A",26293,30460,4167,14.68,"overcount"
"662",12,"Florida",4,"A_AIC",35151,41250,6099,15.97,"overcount"
"663",12,"Florida",4,"NHPI_A",1361,1599,238,16.08,"overcount"
"664",12,"Florida",4,"NHPI_AIC",2996,3694,698,20.87,"overcount"
"665",12,"Florida",5,"A_A",28108,34690,6582,20.96,"overcount"
"666",12,"Florida",5,"A_AIC",36169,44066,7897,19.68,"overcount"
"667",12,"Florida",5,"NHPI_A",1355,1870,515,31.94,"overcount"
"668",12,"Florida",5,"NHPI_AIC",3093,3939,846,24.06,"overcount"
"669",12,"Florida",6,"A_A",33401,37613,4212,11.86,"overcount"
"670",12,"Florida",6,"A_AIC",40898,45729,4831,11.15,"overcount"
"671",12,"Florida",6,"NHPI_A",1541,1948,407,23.33,"overcount"
"672",12,"Florida",6,"NHPI_AIC",3438,3839,401,11.02,"overcount"
"673",12,"Florida",7,"A_A",38194,39598,1404,3.61,"overcount"
"674",12,"Florida",7,"A_AIC",44799,46775,1976,4.32,"overcount"
"675",12,"Florida",7,"NHPI_A",1671,1666,-5,-0.3,"undercount"
"676",12,"Florida",7,"NHPI_AIC",3546,3567,21,0.59,"overcount"
"677",12,"Florida",8,"A_A",41893,42903,1010,2.38,"overcount"
"678",12,"Florida",8,"A_AIC",47519,49529,2010,4.14,"overcount"
"679",12,"Florida",8,"NHPI_A",1398,1494,96,6.64,"overcount"
"680",12,"Florida",8,"NHPI_AIC",2986,3233,247,7.94,"overcount"
"681",12,"Florida",9,"A_A",38536,39788,1252,3.2,"overcount"
"682",12,"Florida",9,"A_AIC",43292,45337,2045,4.61,"overcount"
"683",12,"Florida",9,"NHPI_A",1157,1406,249,19.43,"overcount"
"684",12,"Florida",9,"NHPI_AIC",2550,3164,614,21.49,"overcount"
"685",12,"Florida",10,"A_A",34298,35894,1596,4.55,"overcount"
"686",12,"Florida",10,"A_AIC",38828,41021,2193,5.49,"overcount"
"687",12,"Florida",10,"NHPI_A",1237,1289,52,4.12,"overcount"
"688",12,"Florida",10,"NHPI_AIC",2721,3021,300,10.45,"overcount"
"689",12,"Florida",11,"A_A",30746,32737,1991,6.27,"overcount"
"690",12,"Florida",11,"A_AIC",34907,36913,2006,5.59,"overcount"
"691",12,"Florida",11,"NHPI_A",1077,1063,-14,-1.31,"undercount"
"692",12,"Florida",11,"NHPI_AIC",2341,2556,215,8.78,"overcount"
"693",12,"Florida",12,"A_A",26382,28378,1996,7.29,"overcount"
"694",12,"Florida",12,"A_AIC",29610,31591,1981,6.47,"overcount"
"695",12,"Florida",12,"NHPI_A",815,816,1,0.12,"overcount"
"696",12,"Florida",12,"NHPI_AIC",1794,1960,166,8.84,"overcount"
"697",12,"Florida",13,"A_A",22313,22937,624,2.76,"overcount"
"698",12,"Florida",13,"A_AIC",24816,25431,615,2.45,"overcount"
"699",12,"Florida",13,"NHPI_A",690,619,-71,-10.85,"undercount"
"700",12,"Florida",13,"NHPI_AIC",1498,1485,-13,-0.87,"undercount"
"701",12,"Florida",14,"A_A",16136,16434,298,1.83,"overcount"
"702",12,"Florida",14,"A_AIC",17863,18107,244,1.36,"overcount"
"703",12,"Florida",14,"NHPI_A",435,370,-65,-16.15,"undercount"
"704",12,"Florida",14,"NHPI_AIC",1016,981,-35,-3.51,"undercount"
"705",12,"Florida",15,"A_A",12275,11870,-405,-3.35,"undercount"
"706",12,"Florida",15,"A_AIC",13548,13159,-389,-2.91,"undercount"
"707",12,"Florida",15,"NHPI_A",319,246,-73,-25.84,"undercount"
"708",12,"Florida",15,"NHPI_AIC",688,700,12,1.73,"overcount"
"709",12,"Florida",16,"A_A",8195,7212,-983,-12.76,"undercount"
"710",12,"Florida",16,"A_AIC",9068,8141,-927,-10.77,"undercount"
"711",12,"Florida",16,"NHPI_A",194,166,-28,-15.56,"undercount"
"712",12,"Florida",16,"NHPI_AIC",420,494,74,16.19,"overcount"
"713",12,"Florida",17,"A_A",4899,4003,-896,-20.13,"undercount"
"714",12,"Florida",17,"A_AIC",5442,4505,-937,-18.84,"undercount"
"715",12,"Florida",17,"NHPI_A",140,103,-37,-30.45,"undercount"
"716",12,"Florida",17,"NHPI_AIC",316,306,-10,-3.22,"undercount"
"717",12,"Florida",18,"A_A",3944,2461,-1483,-46.31,"undercount"
"718",12,"Florida",18,"A_AIC",4392,2914,-1478,-40.46,"undercount"
"719",12,"Florida",18,"NHPI_A",146,78,-68,-60.71,"undercount"
"720",12,"Florida",18,"NHPI_AIC",352,239,-113,-38.24,"undercount"
"721",13,"Georgia",1,"A_A",23766,22773,-993,-4.27,"undercount"
"722",13,"Georgia",1,"A_AIC",31159,30712,-447,-1.44,"undercount"
"723",13,"Georgia",1,"NHPI_A",996,1101,105,10.01,"overcount"
"724",13,"Georgia",1,"NHPI_AIC",2041,2040,-1,-0.05,"undercount"
"725",13,"Georgia",2,"A_A",24022,24320,298,1.23,"overcount"
"726",13,"Georgia",2,"A_AIC",31113,30783,-330,-1.07,"undercount"
"727",13,"Georgia",2,"NHPI_A",955,993,38,3.9,"overcount"
"728",13,"Georgia",2,"NHPI_AIC",2079,1805,-274,-14.11,"undercount"
"729",13,"Georgia",3,"A_A",20071,21795,1724,8.24,"overcount"
"730",13,"Georgia",3,"A_AIC",25364,27183,1819,6.92,"overcount"
"731",13,"Georgia",3,"NHPI_A",793,814,21,2.61,"overcount"
"732",13,"Georgia",3,"NHPI_AIC",1726,1499,-227,-14.08,"undercount"
"733",13,"Georgia",4,"A_A",18382,22037,3655,18.09,"overcount"
"734",13,"Georgia",4,"A_AIC",22793,26661,3868,15.64,"overcount"
"735",13,"Georgia",4,"NHPI_A",754,865,111,13.71,"overcount"
"736",13,"Georgia",4,"NHPI_AIC",1545,1627,82,5.17,"overcount"
"737",13,"Georgia",5,"A_A",17807,23672,5865,28.28,"overcount"
"738",13,"Georgia",5,"A_AIC",21266,27884,6618,26.93,"overcount"
"739",13,"Georgia",5,"NHPI_A",732,1186,454,47.34,"overcount"
"740",13,"Georgia",5,"NHPI_AIC",1396,1772,376,23.74,"overcount"
"741",13,"Georgia",6,"A_A",23018,27595,4577,18.09,"overcount"
"742",13,"Georgia",6,"A_AIC",26301,31200,4899,17.04,"overcount"
"743",13,"Georgia",6,"NHPI_A",827,1176,349,34.85,"overcount"
"744",13,"Georgia",6,"NHPI_AIC",1524,1726,202,12.43,"overcount"
"745",13,"Georgia",7,"A_A",26728,29024,2296,8.24,"overcount"
"746",13,"Georgia",7,"A_AIC",29588,32187,2599,8.41,"overcount"
"747",13,"Georgia",7,"NHPI_A",915,1084,169,16.91,"overcount"
"748",13,"Georgia",7,"NHPI_AIC",1580,1561,-19,-1.21,"undercount"
"749",13,"Georgia",8,"A_A",31154,32768,1614,5.05,"overcount"
"750",13,"Georgia",8,"A_AIC",33665,35648,1983,5.72,"overcount"
"751",13,"Georgia",8,"NHPI_A",795,835,40,4.91,"overcount"
"752",13,"Georgia",8,"NHPI_AIC",1419,1268,-151,-11.24,"undercount"
"753",13,"Georgia",9,"A_A",26665,27794,1129,4.15,"overcount"
"754",13,"Georgia",9,"A_AIC",28699,29733,1034,3.54,"overcount"
"755",13,"Georgia",9,"NHPI_A",728,673,-55,-7.85,"undercount"
"756",13,"Georgia",9,"NHPI_AIC",1239,1118,-121,-10.27,"undercount"
"757",13,"Georgia",10,"A_A",22094,23791,1697,7.4,"overcount"
"758",13,"Georgia",10,"A_AIC",23856,25398,1542,6.26,"overcount"
"759",13,"Georgia",10,"NHPI_A",503,500,-3,-0.6,"undercount"
"760",13,"Georgia",10,"NHPI_AIC",940,907,-33,-3.57,"undercount"
"761",13,"Georgia",11,"A_A",18568,20055,1487,7.7,"overcount"
"762",13,"Georgia",11,"A_AIC",19924,21266,1342,6.52,"overcount"
"763",13,"Georgia",11,"NHPI_A",453,442,-11,-2.46,"undercount"
"764",13,"Georgia",11,"NHPI_AIC",812,742,-70,-9.01,"undercount"
"765",13,"Georgia",12,"A_A",15107,15860,753,4.86,"overcount"
"766",13,"Georgia",12,"A_AIC",16196,16722,526,3.2,"overcount"
"767",13,"Georgia",12,"NHPI_A",280,311,31,10.49,"overcount"
"768",13,"Georgia",12,"NHPI_AIC",597,514,-83,-14.94,"undercount"
"769",13,"Georgia",13,"A_A",11874,12053,179,1.5,"overcount"
"770",13,"Georgia",13,"A_AIC",12669,12480,-189,-1.5,"undercount"
"771",13,"Georgia",13,"NHPI_A",224,213,-11,-5.03,"undercount"
"772",13,"Georgia",13,"NHPI_AIC",516,379,-137,-30.61,"undercount"
"773",13,"Georgia",14,"A_A",8076,8340,264,3.22,"overcount"
"774",13,"Georgia",14,"A_AIC",8638,8612,-26,-0.3,"undercount"
"775",13,"Georgia",14,"NHPI_A",156,119,-37,-26.91,"undercount"
"776",13,"Georgia",14,"NHPI_AIC",344,238,-106,-36.43,"undercount"
"777",13,"Georgia",15,"A_A",5562,5507,-55,-0.99,"undercount"
"778",13,"Georgia",15,"A_AIC",5896,5565,-331,-5.78,"undercount"
"779",13,"Georgia",15,"NHPI_A",90,64,-26,-33.77,"undercount"
"780",13,"Georgia",15,"NHPI_AIC",210,145,-65,-36.62,"undercount"
"781",13,"Georgia",16,"A_A",3208,3305,97,2.98,"overcount"
"782",13,"Georgia",16,"A_AIC",3449,3369,-80,-2.35,"undercount"
"783",13,"Georgia",16,"NHPI_A",50,38,-12,-27.27,"undercount"
"784",13,"Georgia",16,"NHPI_AIC",129,89,-40,-36.7,"undercount"
"785",13,"Georgia",17,"A_A",1790,1686,-104,-5.98,"undercount"
"786",13,"Georgia",17,"A_AIC",1962,1733,-229,-12.4,"undercount"
"787",13,"Georgia",17,"NHPI_A",53,28,-25,-61.73,"undercount"
"788",13,"Georgia",17,"NHPI_AIC",107,64,-43,-50.29,"undercount"
"789",13,"Georgia",18,"A_A",1398,1084,-314,-25.3,"undercount"
"790",13,"Georgia",18,"A_AIC",1575,1029,-546,-41.94,"undercount"
"791",13,"Georgia",18,"NHPI_A",46,12,-34,-117.24,"undercount"
"792",13,"Georgia",18,"NHPI_AIC",107,56,-51,-62.58,"undercount"
"793",15,"Hawaii",1,"A_A",23216,19976,-3240,-15,"undercount"
"794",15,"Hawaii",1,"A_AIC",48718,51330,2612,5.22,"overcount"
"795",15,"Hawaii",1,"NHPI_A",9303,12258,2955,27.41,"overcount"
"796",15,"Hawaii",1,"NHPI_AIC",29806,38307,8501,24.96,"overcount"
"797",15,"Hawaii",2,"A_A",24258,22258,-2000,-8.6,"undercount"
"798",15,"Hawaii",2,"A_AIC",44098,51387,7289,15.27,"overcount"
"799",15,"Hawaii",2,"NHPI_A",9923,11466,1543,14.43,"overcount"
"800",15,"Hawaii",2,"NHPI_AIC",26010,35646,9636,31.26,"overcount"
"801",15,"Hawaii",3,"A_A",20710,24422,3712,16.45,"overcount"
"802",15,"Hawaii",3,"A_AIC",39972,51564,11592,25.33,"overcount"
"803",15,"Hawaii",3,"NHPI_A",8517,10891,2374,24.46,"overcount"
"804",15,"Hawaii",3,"NHPI_AIC",23903,33223,9320,32.63,"overcount"
"805",15,"Hawaii",4,"A_A",23302,27199,3897,15.43,"overcount"
"806",15,"Hawaii",4,"A_AIC",43161,53492,10331,21.38,"overcount"
"807",15,"Hawaii",4,"NHPI_A",9355,11480,2125,20.4,"overcount"
"808",15,"Hawaii",4,"NHPI_AIC",24996,33513,8517,29.11,"overcount"
"809",15,"Hawaii",5,"A_A",23599,26765,3166,12.57,"overcount"
"810",15,"Hawaii",5,"A_AIC",41032,47358,6326,14.31,"overcount"
"811",15,"Hawaii",5,"NHPI_A",9211,11536,2325,22.41,"overcount"
"812",15,"Hawaii",5,"NHPI_AIC",23539,29154,5615,21.31,"overcount"
"813",15,"Hawaii",6,"A_A",27368,28654,1286,4.59,"overcount"
"814",15,"Hawaii",6,"A_AIC",43472,48555,5083,11.05,"overcount"
"815",15,"Hawaii",6,"NHPI_A",9769,11314,1545,14.66,"overcount"
"816",15,"Hawaii",6,"NHPI_AIC",23766,28236,4470,17.19,"overcount"
"817",15,"Hawaii",7,"A_A",29676,29563,-113,-0.38,"undercount"
"818",15,"Hawaii",7,"A_AIC",42611,46392,3781,8.5,"overcount"
"819",15,"Hawaii",7,"NHPI_A",8588,9896,1308,14.15,"overcount"
"820",15,"Hawaii",7,"NHPI_AIC",19761,24481,4720,21.34,"overcount"
"821",15,"Hawaii",8,"A_A",31173,33890,2717,8.35,"overcount"
"822",15,"Hawaii",8,"A_AIC",42114,48797,6683,14.7,"overcount"
"823",15,"Hawaii",8,"NHPI_A",7774,9195,1421,16.75,"overcount"
"824",15,"Hawaii",8,"NHPI_AIC",17292,22026,4734,24.08,"overcount"
"825",15,"Hawaii",9,"A_A",33862,37721,3859,10.78,"overcount"
"826",15,"Hawaii",9,"A_AIC",44531,51741,7210,14.98,"overcount"
"827",15,"Hawaii",9,"NHPI_A",7717,8840,1123,13.57,"overcount"
"828",15,"Hawaii",9,"NHPI_AIC",17337,21386,4049,20.91,"overcount"
"829",15,"Hawaii",10,"A_A",37272,41645,4373,11.08,"overcount"
"830",15,"Hawaii",10,"A_AIC",47774,55002,7228,14.07,"overcount"
"831",15,"Hawaii",10,"NHPI_A",8299,9278,979,11.14,"overcount"
"832",15,"Hawaii",10,"NHPI_AIC",17795,21750,3955,20,"overcount"
"833",15,"Hawaii",11,"A_A",39119,44168,5049,12.12,"overcount"
"834",15,"Hawaii",11,"A_AIC",48637,55762,7125,13.65,"overcount"
"835",15,"Hawaii",11,"NHPI_A",7842,8554,712,8.69,"overcount"
"836",15,"Hawaii",11,"NHPI_AIC",16205,19131,2926,16.56,"overcount"
"837",15,"Hawaii",12,"A_A",37301,42425,5124,12.85,"overcount"
"838",15,"Hawaii",12,"A_AIC",45253,51790,6537,13.47,"overcount"
"839",15,"Hawaii",12,"NHPI_A",6669,6958,289,4.24,"overcount"
"840",15,"Hawaii",12,"NHPI_AIC",14211,15751,1540,10.28,"overcount"
"841",15,"Hawaii",13,"A_A",34084,38258,4174,11.54,"overcount"
"842",15,"Hawaii",13,"A_AIC",39986,45130,5144,12.09,"overcount"
"843",15,"Hawaii",13,"NHPI_A",5319,5642,323,5.89,"overcount"
"844",15,"Hawaii",13,"NHPI_AIC",11453,12202,749,6.33,"overcount"
"845",15,"Hawaii",14,"A_A",26726,29262,2536,9.06,"overcount"
"846",15,"Hawaii",14,"A_AIC",30701,34105,3404,10.51,"overcount"
"847",15,"Hawaii",14,"NHPI_A",4104,4105,1,0.02,"overcount"
"848",15,"Hawaii",14,"NHPI_AIC",8419,9128,709,8.08,"overcount"
"849",15,"Hawaii",15,"A_A",22289,22906,617,2.73,"overcount"
"850",15,"Hawaii",15,"A_AIC",24867,25928,1061,4.18,"overcount"
"851",15,"Hawaii",15,"NHPI_A",3118,2779,-339,-11.5,"undercount"
"852",15,"Hawaii",15,"NHPI_AIC",5864,5966,102,1.72,"overcount"
"853",15,"Hawaii",16,"A_A",21676,21410,-266,-1.23,"undercount"
"854",15,"Hawaii",16,"A_AIC",23610,23509,-101,-0.43,"undercount"
"855",15,"Hawaii",16,"NHPI_A",2220,1965,-255,-12.19,"undercount"
"856",15,"Hawaii",16,"NHPI_AIC",4258,4220,-38,-0.9,"undercount"
"857",15,"Hawaii",17,"A_A",21171,19950,-1221,-5.94,"undercount"
"858",15,"Hawaii",17,"A_AIC",22460,21392,-1068,-4.87,"undercount"
"859",15,"Hawaii",17,"NHPI_A",1492,1230,-262,-19.25,"undercount"
"860",15,"Hawaii",17,"NHPI_AIC",2842,2781,-61,-2.17,"undercount"
"861",15,"Hawaii",18,"A_A",24987,21161,-3826,-16.58,"undercount"
"862",15,"Hawaii",18,"A_AIC",26110,22253,-3857,-15.95,"undercount"
"863",15,"Hawaii",18,"NHPI_A",1249,905,-344,-31.94,"undercount"
"864",15,"Hawaii",18,"NHPI_AIC",2431,2032,-399,-17.88,"undercount"
"865",16,"Idaho",1,"A_A",1568,1253,-315,-22.33,"undercount"
"866",16,"Idaho",1,"A_AIC",3396,2990,-406,-12.72,"undercount"
"867",16,"Idaho",1,"NHPI_A",238,227,-11,-4.73,"undercount"
"868",16,"Idaho",1,"NHPI_AIC",643,639,-4,-0.62,"undercount"
"869",16,"Idaho",2,"A_A",1741,1521,-220,-13.49,"undercount"
"870",16,"Idaho",2,"A_AIC",3409,3061,-348,-10.76,"undercount"
"871",16,"Idaho",2,"NHPI_A",208,247,39,17.14,"overcount"
"872",16,"Idaho",2,"NHPI_AIC",595,633,38,6.19,"overcount"
"873",16,"Idaho",3,"A_A",1273,1349,76,5.8,"overcount"
"874",16,"Idaho",3,"A_AIC",2624,2761,137,5.09,"overcount"
"875",16,"Idaho",3,"NHPI_A",191,240,49,22.74,"overcount"
"876",16,"Idaho",3,"NHPI_AIC",520,553,33,6.15,"overcount"
"877",16,"Idaho",4,"A_A",1110,1382,272,21.83,"overcount"
"878",16,"Idaho",4,"A_AIC",2233,2675,442,18.01,"overcount"
"879",16,"Idaho",4,"NHPI_A",183,304,121,49.69,"overcount"
"880",16,"Idaho",4,"NHPI_AIC",452,590,138,26.49,"overcount"
"881",16,"Idaho",5,"A_A",1353,1674,321,21.21,"overcount"
"882",16,"Idaho",5,"A_AIC",2186,2586,400,16.76,"overcount"
"883",16,"Idaho",5,"NHPI_A",210,368,158,54.67,"overcount"
"884",16,"Idaho",5,"NHPI_AIC",426,638,212,39.85,"overcount"
"885",16,"Idaho",6,"A_A",1444,1834,390,23.79,"overcount"
"886",16,"Idaho",6,"A_AIC",2074,2598,524,22.43,"overcount"
"887",16,"Idaho",6,"NHPI_A",163,258,95,45.13,"overcount"
"888",16,"Idaho",6,"NHPI_AIC",356,468,112,27.18,"overcount"
"889",16,"Idaho",7,"A_A",1648,1711,63,3.75,"overcount"
"890",16,"Idaho",7,"A_AIC",2262,2354,92,3.99,"overcount"
"891",16,"Idaho",7,"NHPI_A",199,240,41,18.68,"overcount"
"892",16,"Idaho",7,"NHPI_AIC",379,388,9,2.35,"overcount"
"893",16,"Idaho",8,"A_A",1709,1779,70,4.01,"overcount"
"894",16,"Idaho",8,"A_AIC",2160,2322,162,7.23,"overcount"
"895",16,"Idaho",8,"NHPI_A",178,188,10,5.46,"overcount"
"896",16,"Idaho",8,"NHPI_AIC",287,299,12,4.1,"overcount"
"897",16,"Idaho",9,"A_A",1415,1481,66,4.56,"overcount"
"898",16,"Idaho",9,"A_AIC",1790,1902,112,6.07,"overcount"
"899",16,"Idaho",9,"NHPI_A",151,182,31,18.62,"overcount"
"900",16,"Idaho",9,"NHPI_AIC",258,279,21,7.82,"overcount"
"901",16,"Idaho",10,"A_A",1226,1374,148,11.38,"overcount"
"902",16,"Idaho",10,"A_AIC",1509,1752,243,14.9,"overcount"
"903",16,"Idaho",10,"NHPI_A",136,160,24,16.22,"overcount"
"904",16,"Idaho",10,"NHPI_AIC",220,237,17,7.44,"overcount"
"905",16,"Idaho",11,"A_A",1050,1245,195,16.99,"overcount"
"906",16,"Idaho",11,"A_AIC",1265,1509,244,17.59,"overcount"
"907",16,"Idaho",11,"NHPI_A",104,133,29,24.47,"overcount"
"908",16,"Idaho",11,"NHPI_AIC",205,198,-7,-3.47,"undercount"
"909",16,"Idaho",12,"A_A",940,1058,118,11.81,"overcount"
"910",16,"Idaho",12,"A_AIC",1068,1196,128,11.31,"overcount"
"911",16,"Idaho",12,"NHPI_A",75,89,14,17.07,"overcount"
"912",16,"Idaho",12,"NHPI_AIC",142,152,10,6.8,"overcount"
"913",16,"Idaho",13,"A_A",724,804,80,10.47,"overcount"
"914",16,"Idaho",13,"A_AIC",786,882,96,11.51,"overcount"
"915",16,"Idaho",13,"NHPI_A",67,62,-5,-7.75,"undercount"
"916",16,"Idaho",13,"NHPI_AIC",89,107,18,18.37,"overcount"
"917",16,"Idaho",14,"A_A",475,534,59,11.69,"overcount"
"918",16,"Idaho",14,"A_AIC",529,587,58,10.39,"overcount"
"919",16,"Idaho",14,"NHPI_A",52,38,-14,-31.11,"undercount"
"920",16,"Idaho",14,"NHPI_AIC",90,63,-27,-35.29,"undercount"
"921",16,"Idaho",15,"A_A",308,325,17,5.37,"overcount"
"922",16,"Idaho",15,"A_AIC",360,255,-105,-34.15,"undercount"
"923",16,"Idaho",15,"NHPI_A",27,26,-1,-3.77,"undercount"
"924",16,"Idaho",15,"NHPI_AIC",55,35,-20,-44.44,"undercount"
"925",16,"Idaho",16,"A_A",277,285,8,2.85,"overcount"
"926",16,"Idaho",16,"A_AIC",303,272,-31,-10.78,"undercount"
"927",16,"Idaho",16,"NHPI_A",14,7,-7,-66.67,"undercount"
"928",16,"Idaho",16,"NHPI_AIC",24,19,-5,-23.26,"undercount"
"929",16,"Idaho",17,"A_A",231,218,-13,-5.79,"undercount"
"930",16,"Idaho",17,"A_AIC",255,171,-84,-39.44,"undercount"
"931",16,"Idaho",17,"NHPI_A",19,13,-6,-37.5,"undercount"
"932",16,"Idaho",17,"NHPI_AIC",46,15,-31,-101.64,"undercount"
"933",16,"Idaho",18,"A_A",287,207,-80,-32.39,"undercount"
"934",16,"Idaho",18,"A_AIC",312,159,-153,-64.97,"undercount"
"935",16,"Idaho",18,"NHPI_A",12,4,-8,-100,"undercount"
"936",16,"Idaho",18,"NHPI_AIC",26,9,-17,-97.14,"undercount"
"937",17,"Illinois",1,"A_A",43549,40361,-3188,-7.6,"undercount"
"938",17,"Illinois",1,"A_AIC",53821,53738,-83,-0.15,"undercount"
"939",17,"Illinois",1,"NHPI_A",679,574,-105,-16.76,"undercount"
"940",17,"Illinois",1,"NHPI_AIC",1453,1368,-85,-6.03,"undercount"
"941",17,"Illinois",2,"A_A",41042,40230,-812,-2,"undercount"
"942",17,"Illinois",2,"A_AIC",49693,51382,1689,3.34,"overcount"
"943",17,"Illinois",2,"NHPI_A",531,547,16,2.97,"overcount"
"944",17,"Illinois",2,"NHPI_AIC",1353,1256,-97,-7.44,"undercount"
"945",17,"Illinois",3,"A_A",34836,35705,869,2.46,"overcount"
"946",17,"Illinois",3,"A_AIC",41801,44468,2667,6.18,"overcount"
"947",17,"Illinois",3,"NHPI_A",781,562,-219,-32.61,"undercount"
"948",17,"Illinois",3,"NHPI_AIC",1409,1236,-173,-13.08,"undercount"
"949",17,"Illinois",4,"A_A",34792,36186,1394,3.93,"overcount"
"950",17,"Illinois",4,"A_AIC",40478,43485,3007,7.16,"overcount"
"951",17,"Illinois",4,"NHPI_A",790,682,-108,-14.67,"undercount"
"952",17,"Illinois",4,"NHPI_AIC",1514,1406,-108,-7.4,"undercount"
"953",17,"Illinois",5,"A_A",39777,45527,5750,13.48,"overcount"
"954",17,"Illinois",5,"A_AIC",44830,51627,6797,14.09,"overcount"
"955",17,"Illinois",5,"NHPI_A",846,830,-16,-1.91,"undercount"
"956",17,"Illinois",5,"NHPI_AIC",1629,1567,-62,-3.88,"undercount"
"957",17,"Illinois",6,"A_A",45506,56750,11244,21.99,"overcount"
"958",17,"Illinois",6,"A_AIC",50181,62368,12187,21.66,"overcount"
"959",17,"Illinois",6,"NHPI_A",781,679,-102,-13.97,"undercount"
"960",17,"Illinois",6,"NHPI_AIC",1573,1439,-134,-8.9,"undercount"
"961",17,"Illinois",7,"A_A",50675,56928,6253,11.62,"overcount"
"962",17,"Illinois",7,"A_AIC",54776,61477,6701,11.53,"overcount"
"963",17,"Illinois",7,"NHPI_A",884,669,-215,-27.69,"undercount"
"964",17,"Illinois",7,"NHPI_AIC",1640,1325,-315,-21.25,"undercount"
"965",17,"Illinois",8,"A_A",53385,55798,2413,4.42,"overcount"
"966",17,"Illinois",8,"A_AIC",56902,59478,2576,4.43,"overcount"
"967",17,"Illinois",8,"NHPI_A",868,598,-270,-36.83,"undercount"
"968",17,"Illinois",8,"NHPI_AIC",1476,1143,-333,-25.43,"undercount"
"969",17,"Illinois",9,"A_A",46433,46294,-139,-0.3,"undercount"
"970",17,"Illinois",9,"A_AIC",49090,49295,205,0.42,"overcount"
"971",17,"Illinois",9,"NHPI_A",642,512,-130,-22.53,"undercount"
"972",17,"Illinois",9,"NHPI_AIC",1133,1071,-62,-5.63,"undercount"
"973",17,"Illinois",10,"A_A",38162,39570,1408,3.62,"overcount"
"974",17,"Illinois",10,"A_AIC",40607,42021,1414,3.42,"overcount"
"975",17,"Illinois",10,"NHPI_A",583,488,-95,-17.74,"undercount"
"976",17,"Illinois",10,"NHPI_AIC",1017,972,-45,-4.52,"undercount"
"977",17,"Illinois",11,"A_A",34836,36263,1427,4.01,"overcount"
"978",17,"Illinois",11,"A_AIC",37064,38219,1155,3.07,"overcount"
"979",17,"Illinois",11,"NHPI_A",473,405,-68,-15.49,"undercount"
"980",17,"Illinois",11,"NHPI_AIC",920,798,-122,-14.2,"undercount"
"981",17,"Illinois",12,"A_A",31711,33904,2193,6.68,"overcount"
"982",17,"Illinois",12,"A_AIC",33470,35318,1848,5.37,"overcount"
"983",17,"Illinois",12,"NHPI_A",381,346,-35,-9.63,"undercount"
"984",17,"Illinois",12,"NHPI_AIC",706,681,-25,-3.6,"undercount"
"985",17,"Illinois",13,"A_A",27592,29034,1442,5.09,"overcount"
"986",17,"Illinois",13,"A_AIC",28864,30075,1211,4.11,"overcount"
"987",17,"Illinois",13,"NHPI_A",286,207,-79,-32.05,"undercount"
"988",17,"Illinois",13,"NHPI_AIC",533,478,-55,-10.88,"undercount"
"989",17,"Illinois",14,"A_A",19379,20557,1178,5.9,"overcount"
"990",17,"Illinois",14,"A_AIC",20085,21089,1004,4.88,"overcount"
"991",17,"Illinois",14,"NHPI_A",185,147,-38,-22.89,"undercount"
"992",17,"Illinois",14,"NHPI_AIC",308,311,3,0.97,"overcount"
"993",17,"Illinois",15,"A_A",13434,13835,401,2.94,"overcount"
"994",17,"Illinois",15,"A_AIC",13984,14226,242,1.72,"overcount"
"995",17,"Illinois",15,"NHPI_A",155,71,-84,-74.34,"undercount"
"996",17,"Illinois",15,"NHPI_AIC",278,175,-103,-45.47,"undercount"
"997",17,"Illinois",16,"A_A",8494,8240,-254,-3.04,"undercount"
"998",17,"Illinois",16,"A_AIC",8885,8570,-315,-3.61,"undercount"
"999",17,"Illinois",16,"NHPI_A",109,54,-55,-67.48,"undercount"
"1000",17,"Illinois",16,"NHPI_AIC",182,150,-32,-19.28,"undercount"
"1001",17,"Illinois",17,"A_A",5800,5250,-550,-9.95,"undercount"
"1002",17,"Illinois",17,"A_AIC",6074,5428,-646,-11.23,"undercount"
"1003",17,"Illinois",17,"NHPI_A",68,38,-30,-56.6,"undercount"
"1004",17,"Illinois",17,"NHPI_AIC",127,107,-20,-17.09,"undercount"
"1005",17,"Illinois",18,"A_A",5416,3967,-1449,-30.89,"undercount"
"1006",17,"Illinois",18,"A_AIC",5723,4077,-1646,-33.59,"undercount"
"1007",17,"Illinois",18,"NHPI_A",79,27,-52,-98.11,"undercount"
"1008",17,"Illinois",18,"NHPI_AIC",152,81,-71,-60.94,"undercount"
"1009",18,"Indiana",1,"A_A",7571,7992,421,5.41,"overcount"
"1010",18,"Indiana",1,"A_AIC",10530,12005,1475,13.09,"overcount"
"1011",18,"Indiana",1,"NHPI_A",300,300,0,0,"equal"
"1012",18,"Indiana",1,"NHPI_AIC",644,783,139,19.48,"overcount"
"1013",18,"Indiana",2,"A_A",7317,7936,619,8.12,"overcount"
"1014",18,"Indiana",2,"A_AIC",9889,11489,1600,14.97,"overcount"
"1015",18,"Indiana",2,"NHPI_A",299,324,25,8.03,"overcount"
"1016",18,"Indiana",2,"NHPI_AIC",626,729,103,15.2,"overcount"
"1017",18,"Indiana",3,"A_A",6178,6794,616,9.5,"overcount"
"1018",18,"Indiana",3,"A_AIC",8798,9667,869,9.41,"overcount"
"1019",18,"Indiana",3,"NHPI_A",308,303,-5,-1.64,"undercount"
"1020",18,"Indiana",3,"NHPI_AIC",615,640,25,3.98,"overcount"
"1021",18,"Indiana",4,"A_A",6537,7806,1269,17.7,"overcount"
"1022",18,"Indiana",4,"A_AIC",8713,10587,1874,19.42,"overcount"
"1023",18,"Indiana",4,"NHPI_A",305,329,24,7.57,"overcount"
"1024",18,"Indiana",4,"NHPI_AIC",637,747,110,15.9,"overcount"
"1025",18,"Indiana",5,"A_A",9063,11881,2818,26.91,"overcount"
"1026",18,"Indiana",5,"A_AIC",10790,14170,3380,27.08,"overcount"
"1027",18,"Indiana",5,"NHPI_A",223,349,126,44.06,"overcount"
"1028",18,"Indiana",5,"NHPI_AIC",559,753,194,29.57,"overcount"
"1029",18,"Indiana",6,"A_A",7872,10554,2682,29.11,"overcount"
"1030",18,"Indiana",6,"A_AIC",9272,12169,2897,27.02,"overcount"
"1031",18,"Indiana",6,"NHPI_A",272,343,71,23.09,"overcount"
"1032",18,"Indiana",6,"NHPI_AIC",551,605,54,9.34,"overcount"
"1033",18,"Indiana",7,"A_A",8103,9910,1807,20.06,"overcount"
"1034",18,"Indiana",7,"A_AIC",9365,11281,1916,18.56,"overcount"
"1035",18,"Indiana",7,"NHPI_A",317,336,19,5.82,"overcount"
"1036",18,"Indiana",7,"NHPI_AIC",591,573,-18,-3.09,"undercount"
"1037",18,"Indiana",8,"A_A",9415,9677,262,2.74,"overcount"
"1038",18,"Indiana",8,"A_AIC",10512,10723,211,1.99,"overcount"
"1039",18,"Indiana",8,"NHPI_A",320,268,-52,-17.69,"undercount"
"1040",18,"Indiana",8,"NHPI_AIC",567,455,-112,-21.92,"undercount"
"1041",18,"Indiana",9,"A_A",8437,8057,-380,-4.61,"undercount"
"1042",18,"Indiana",9,"A_AIC",9240,8792,-448,-4.97,"undercount"
"1043",18,"Indiana",9,"NHPI_A",217,239,22,9.65,"overcount"
"1044",18,"Indiana",9,"NHPI_AIC",411,400,-11,-2.71,"undercount"
"1045",18,"Indiana",10,"A_A",6690,6444,-246,-3.75,"undercount"
"1046",18,"Indiana",10,"A_AIC",7391,7127,-264,-3.64,"undercount"
"1047",18,"Indiana",10,"NHPI_A",190,220,30,14.63,"overcount"
"1048",18,"Indiana",10,"NHPI_AIC",376,377,1,0.27,"overcount"
"1049",18,"Indiana",11,"A_A",5249,5279,30,0.57,"overcount"
"1050",18,"Indiana",11,"A_AIC",5842,5781,-61,-1.05,"undercount"
"1051",18,"Indiana",11,"NHPI_A",173,175,2,1.15,"overcount"
"1052",18,"Indiana",11,"NHPI_AIC",315,319,4,1.26,"overcount"
"1053",18,"Indiana",12,"A_A",4256,4200,-56,-1.32,"undercount"
"1054",18,"Indiana",12,"A_AIC",4661,4421,-240,-5.29,"undercount"
"1055",18,"Indiana",12,"NHPI_A",134,135,1,0.74,"overcount"
"1056",18,"Indiana",12,"NHPI_AIC",260,234,-26,-10.53,"undercount"
"1057",18,"Indiana",13,"A_A",3562,3433,-129,-3.69,"undercount"
"1058",18,"Indiana",13,"A_AIC",3831,3499,-332,-9.06,"undercount"
"1059",18,"Indiana",13,"NHPI_A",115,95,-20,-19.05,"undercount"
"1060",18,"Indiana",13,"NHPI_AIC",207,174,-33,-17.32,"undercount"
"1061",18,"Indiana",14,"A_A",2199,2243,44,1.98,"overcount"
"1062",18,"Indiana",14,"A_AIC",2432,2227,-205,-8.8,"undercount"
"1063",18,"Indiana",14,"NHPI_A",63,47,-16,-29.09,"undercount"
"1064",18,"Indiana",14,"NHPI_AIC",125,94,-31,-28.31,"undercount"
"1065",18,"Indiana",15,"A_A",1577,1514,-63,-4.08,"undercount"
"1066",18,"Indiana",15,"A_AIC",1760,1511,-249,-15.22,"undercount"
"1067",18,"Indiana",15,"NHPI_A",49,24,-25,-68.49,"undercount"
"1068",18,"Indiana",15,"NHPI_AIC",94,65,-29,-36.48,"undercount"
"1069",18,"Indiana",16,"A_A",1023,961,-62,-6.25,"undercount"
"1070",18,"Indiana",16,"A_AIC",1152,969,-183,-17.26,"undercount"
"1071",18,"Indiana",16,"NHPI_A",43,24,-19,-56.72,"undercount"
"1072",18,"Indiana",16,"NHPI_AIC",81,43,-38,-61.29,"undercount"
"1073",18,"Indiana",17,"A_A",663,534,-129,-21.55,"undercount"
"1074",18,"Indiana",17,"A_AIC",780,520,-260,-40,"undercount"
"1075",18,"Indiana",17,"NHPI_A",31,12,-19,-88.37,"undercount"
"1076",18,"Indiana",17,"NHPI_AIC",43,36,-7,-17.72,"undercount"
"1077",18,"Indiana",18,"A_A",543,320,-223,-51.68,"undercount"
"1078",18,"Indiana",18,"A_AIC",629,279,-350,-77.09,"undercount"
"1079",18,"Indiana",18,"NHPI_A",44,9,-35,-132.08,"undercount"
"1080",18,"Indiana",18,"NHPI_AIC",67,15,-52,-126.83,"undercount"
"1081",19,"Iowa",1,"A_A",4658,3889,-769,-17.99,"undercount"
"1082",19,"Iowa",1,"A_AIC",6305,5913,-392,-6.42,"undercount"
"1083",19,"Iowa",1,"NHPI_A",148,297,149,66.97,"overcount"
"1084",19,"Iowa",1,"NHPI_AIC",347,516,169,39.17,"overcount"
"1085",19,"Iowa",2,"A_A",4139,4080,-59,-1.44,"undercount"
"1086",19,"Iowa",2,"A_AIC",5522,5856,334,5.87,"overcount"
"1087",19,"Iowa",2,"NHPI_A",135,243,108,57.14,"overcount"
"1088",19,"Iowa",2,"NHPI_AIC",307,474,167,42.77,"overcount"
"1089",19,"Iowa",3,"A_A",3572,3629,57,1.58,"overcount"
"1090",19,"Iowa",3,"A_AIC",4847,5144,297,5.95,"overcount"
"1091",19,"Iowa",3,"NHPI_A",155,199,44,24.86,"overcount"
"1092",19,"Iowa",3,"NHPI_AIC",314,346,32,9.7,"overcount"
"1093",19,"Iowa",4,"A_A",3678,4318,640,16.01,"overcount"
"1094",19,"Iowa",4,"A_AIC",4792,5602,810,15.59,"overcount"
"1095",19,"Iowa",4,"NHPI_A",146,210,64,35.96,"overcount"
"1096",19,"Iowa",4,"NHPI_AIC",320,347,27,8.1,"overcount"
"1097",19,"Iowa",5,"A_A",5067,6879,1812,30.34,"overcount"
"1098",19,"Iowa",5,"A_AIC",6040,7846,1806,26.01,"overcount"
"1099",19,"Iowa",5,"NHPI_A",133,266,133,66.67,"overcount"
"1100",19,"Iowa",5,"NHPI_AIC",361,389,28,7.47,"overcount"
"1101",19,"Iowa",6,"A_A",5344,5865,521,9.3,"overcount"
"1102",19,"Iowa",6,"A_AIC",5913,6526,613,9.86,"overcount"
"1103",19,"Iowa",6,"NHPI_A",181,253,72,33.18,"overcount"
"1104",19,"Iowa",6,"NHPI_AIC",343,316,-27,-8.19,"undercount"
"1105",19,"Iowa",7,"A_A",4959,5040,81,1.62,"overcount"
"1106",19,"Iowa",7,"A_AIC",5452,5490,38,0.69,"overcount"
"1107",19,"Iowa",7,"NHPI_A",182,263,81,36.4,"overcount"
"1108",19,"Iowa",7,"NHPI_AIC",305,311,6,1.95,"overcount"
"1109",19,"Iowa",8,"A_A",4860,4831,-29,-0.6,"undercount"
"1110",19,"Iowa",8,"A_AIC",5307,5222,-85,-1.61,"undercount"
"1111",19,"Iowa",8,"NHPI_A",160,193,33,18.7,"overcount"
"1112",19,"Iowa",8,"NHPI_AIC",277,261,-16,-5.95,"undercount"
"1113",19,"Iowa",9,"A_A",4036,3948,-88,-2.2,"undercount"
"1114",19,"Iowa",9,"A_AIC",4331,4130,-201,-4.75,"undercount"
"1115",19,"Iowa",9,"NHPI_A",123,129,6,4.76,"overcount"
"1116",19,"Iowa",9,"NHPI_AIC",203,182,-21,-10.91,"undercount"
"1117",19,"Iowa",10,"A_A",3128,3086,-42,-1.35,"undercount"
"1118",19,"Iowa",10,"A_AIC",3416,3284,-132,-3.94,"undercount"
"1119",19,"Iowa",10,"NHPI_A",132,112,-20,-16.39,"undercount"
"1120",19,"Iowa",10,"NHPI_AIC",197,195,-2,-1.02,"undercount"
"1121",19,"Iowa",11,"A_A",2267,2380,113,4.86,"overcount"
"1122",19,"Iowa",11,"A_AIC",2520,2372,-148,-6.05,"undercount"
"1123",19,"Iowa",11,"NHPI_A",66,93,27,33.96,"overcount"
"1124",19,"Iowa",11,"NHPI_AIC",141,117,-24,-18.6,"undercount"
"1125",19,"Iowa",12,"A_A",1973,2051,78,3.88,"overcount"
"1126",19,"Iowa",12,"A_AIC",2149,2073,-76,-3.6,"undercount"
"1127",19,"Iowa",12,"NHPI_A",52,46,-6,-12.24,"undercount"
"1128",19,"Iowa",12,"NHPI_AIC",121,89,-32,-30.48,"undercount"
"1129",19,"Iowa",13,"A_A",1514,1551,37,2.41,"overcount"
"1130",19,"Iowa",13,"A_AIC",1625,1462,-163,-10.56,"undercount"
"1131",19,"Iowa",13,"NHPI_A",41,49,8,17.78,"overcount"
"1132",19,"Iowa",13,"NHPI_AIC",65,57,-8,-13.11,"undercount"
"1133",19,"Iowa",14,"A_A",1097,1087,-10,-0.92,"undercount"
"1134",19,"Iowa",14,"A_AIC",1171,999,-172,-15.85,"undercount"
"1135",19,"Iowa",14,"NHPI_A",29,31,2,6.67,"overcount"
"1136",19,"Iowa",14,"NHPI_AIC",43,55,12,24.49,"overcount"
"1137",19,"Iowa",15,"A_A",757,721,-36,-4.87,"undercount"
"1138",19,"Iowa",15,"A_AIC",809,682,-127,-17.04,"undercount"
"1139",19,"Iowa",15,"NHPI_A",25,17,-8,-38.1,"undercount"
"1140",19,"Iowa",15,"NHPI_AIC",43,20,-23,-73.02,"undercount"
"1141",19,"Iowa",16,"A_A",494,469,-25,-5.19,"undercount"
"1142",19,"Iowa",16,"A_AIC",541,358,-183,-40.71,"undercount"
"1143",19,"Iowa",16,"NHPI_A",17,9,-8,-61.54,"undercount"
"1144",19,"Iowa",16,"NHPI_AIC",32,19,-13,-50.98,"undercount"
"1145",19,"Iowa",17,"A_A",306,267,-39,-13.61,"undercount"
"1146",19,"Iowa",17,"A_AIC",349,234,-115,-39.45,"undercount"
"1147",19,"Iowa",17,"NHPI_A",8,5,-3,-46.15,"undercount"
"1148",19,"Iowa",17,"NHPI_AIC",13,10,-3,-26.09,"undercount"
"1149",19,"Iowa",18,"A_A",209,141,-68,-38.86,"undercount"
"1150",19,"Iowa",18,"A_AIC",247,109,-138,-77.53,"undercount"
"1151",19,"Iowa",18,"NHPI_A",16,4,-12,-120,"undercount"
"1152",19,"Iowa",18,"NHPI_AIC",37,11,-26,-108.33,"undercount"
"1153",20,"Kansas",1,"A_A",5803,5229,-574,-10.41,"undercount"
"1154",20,"Kansas",1,"A_AIC",7806,8337,531,6.58,"overcount"
"1155",20,"Kansas",1,"NHPI_A",271,297,26,9.15,"overcount"
"1156",20,"Kansas",1,"NHPI_AIC",548,732,184,28.75,"overcount"
"1157",20,"Kansas",2,"A_A",4995,5438,443,8.49,"overcount"
"1158",20,"Kansas",2,"A_AIC",6739,7955,1216,16.55,"overcount"
"1159",20,"Kansas",2,"NHPI_A",166,260,94,44.13,"overcount"
"1160",20,"Kansas",2,"NHPI_AIC",420,601,181,35.46,"overcount"
"1161",20,"Kansas",3,"A_A",4149,4662,513,11.64,"overcount"
"1162",20,"Kansas",3,"A_AIC",5592,6654,1062,17.34,"overcount"
"1163",20,"Kansas",3,"NHPI_A",209,238,29,12.98,"overcount"
"1164",20,"Kansas",3,"NHPI_AIC",476,506,30,6.11,"overcount"
"1165",20,"Kansas",4,"A_A",3721,4778,1057,24.87,"overcount"
"1166",20,"Kansas",4,"A_AIC",5008,6347,1339,23.58,"overcount"
"1167",20,"Kansas",4,"NHPI_A",195,235,40,18.6,"overcount"
"1168",20,"Kansas",4,"NHPI_AIC",427,476,49,10.85,"overcount"
"1169",20,"Kansas",5,"A_A",5640,6691,1051,17.05,"overcount"
"1170",20,"Kansas",5,"A_AIC",6740,8081,1341,18.1,"overcount"
"1171",20,"Kansas",5,"NHPI_A",205,324,119,44.99,"overcount"
"1172",20,"Kansas",5,"NHPI_AIC",436,538,102,20.94,"overcount"
"1173",20,"Kansas",6,"A_A",6055,6765,710,11.08,"overcount"
"1174",20,"Kansas",6,"A_AIC",6921,7791,870,11.83,"overcount"
"1175",20,"Kansas",6,"NHPI_A",232,290,58,22.22,"overcount"
"1176",20,"Kansas",6,"NHPI_AIC",435,470,35,7.73,"overcount"
"1177",20,"Kansas",7,"A_A",5861,6222,361,5.98,"overcount"
"1178",20,"Kansas",7,"A_AIC",6559,7124,565,8.26,"overcount"
"1179",20,"Kansas",7,"NHPI_A",242,270,28,10.94,"overcount"
"1180",20,"Kansas",7,"NHPI_AIC",413,402,-11,-2.7,"undercount"
"1181",20,"Kansas",8,"A_A",6680,6625,-55,-0.83,"undercount"
"1182",20,"Kansas",8,"A_AIC",7335,7376,41,0.56,"overcount"
"1183",20,"Kansas",8,"NHPI_A",179,206,27,14.03,"overcount"
"1184",20,"Kansas",8,"NHPI_AIC",345,327,-18,-5.36,"undercount"
"1185",20,"Kansas",9,"A_A",5214,5380,166,3.13,"overcount"
"1186",20,"Kansas",9,"A_AIC",5661,5789,128,2.24,"overcount"
"1187",20,"Kansas",9,"NHPI_A",163,200,37,20.39,"overcount"
"1188",20,"Kansas",9,"NHPI_AIC",273,281,8,2.89,"overcount"
"1189",20,"Kansas",10,"A_A",4297,4300,3,0.07,"overcount"
"1190",20,"Kansas",10,"A_AIC",4694,4636,-58,-1.24,"undercount"
"1191",20,"Kansas",10,"NHPI_A",128,158,30,20.98,"overcount"
"1192",20,"Kansas",10,"NHPI_AIC",211,241,30,13.27,"overcount"
"1193",20,"Kansas",11,"A_A",3530,3637,107,2.99,"overcount"
"1194",20,"Kansas",11,"A_AIC",3853,4021,168,4.27,"overcount"
"1195",20,"Kansas",11,"NHPI_A",127,114,-13,-10.79,"undercount"
"1196",20,"Kansas",11,"NHPI_AIC",209,177,-32,-16.58,"undercount"
"1197",20,"Kansas",12,"A_A",3137,3228,91,2.86,"overcount"
"1198",20,"Kansas",12,"A_AIC",3336,3411,75,2.22,"overcount"
"1199",20,"Kansas",12,"NHPI_A",102,96,-6,-6.06,"undercount"
"1200",20,"Kansas",12,"NHPI_AIC",178,138,-40,-25.32,"undercount"
"1201",20,"Kansas",13,"A_A",2553,2537,-16,-0.63,"undercount"
"1202",20,"Kansas",13,"A_AIC",2722,2492,-230,-8.82,"undercount"
"1203",20,"Kansas",13,"NHPI_A",67,69,2,2.94,"overcount"
"1204",20,"Kansas",13,"NHPI_AIC",132,86,-46,-42.2,"undercount"
"1205",20,"Kansas",14,"A_A",1632,1693,61,3.67,"overcount"
"1206",20,"Kansas",14,"A_AIC",1720,1636,-84,-5.01,"undercount"
"1207",20,"Kansas",14,"NHPI_A",35,39,4,10.81,"overcount"
"1208",20,"Kansas",14,"NHPI_AIC",66,60,-6,-9.52,"undercount"
"1209",20,"Kansas",15,"A_A",1125,1113,-12,-1.07,"undercount"
"1210",20,"Kansas",15,"A_AIC",1208,1070,-138,-12.12,"undercount"
"1211",20,"Kansas",15,"NHPI_A",36,30,-6,-18.18,"undercount"
"1212",20,"Kansas",15,"NHPI_AIC",62,33,-29,-61.05,"undercount"
"1213",20,"Kansas",16,"A_A",679,682,3,0.44,"overcount"
"1214",20,"Kansas",16,"A_AIC",730,651,-79,-11.44,"undercount"
"1215",20,"Kansas",16,"NHPI_A",22,20,-2,-9.52,"undercount"
"1216",20,"Kansas",16,"NHPI_AIC",41,31,-10,-27.78,"undercount"
"1217",20,"Kansas",17,"A_A",434,370,-64,-15.92,"undercount"
"1218",20,"Kansas",17,"A_AIC",493,343,-150,-35.89,"undercount"
"1219",20,"Kansas",17,"NHPI_A",17,8,-9,-72,"undercount"
"1220",20,"Kansas",17,"NHPI_AIC",41,18,-23,-77.97,"undercount"
"1221",20,"Kansas",18,"A_A",395,278,-117,-34.77,"undercount"
"1222",20,"Kansas",18,"A_AIC",445,265,-180,-50.7,"undercount"
"1223",20,"Kansas",18,"NHPI_A",23,10,-13,-78.79,"undercount"
"1224",20,"Kansas",18,"NHPI_AIC",44,19,-25,-79.37,"undercount"
"1225",21,"Kentucky",1,"A_A",4197,4007,-190,-4.63,"undercount"
"1226",21,"Kentucky",1,"A_AIC",5749,6246,497,8.29,"overcount"
"1227",21,"Kentucky",1,"NHPI_A",292,398,106,30.72,"overcount"
"1228",21,"Kentucky",1,"NHPI_AIC",566,798,232,34.02,"overcount"
"1229",21,"Kentucky",2,"A_A",3902,4359,457,11.06,"overcount"
"1230",21,"Kentucky",2,"A_AIC",5401,6155,754,13.05,"overcount"
"1231",21,"Kentucky",2,"NHPI_A",291,318,27,8.87,"overcount"
"1232",21,"Kentucky",2,"NHPI_AIC",544,590,46,8.11,"overcount"
"1233",21,"Kentucky",3,"A_A",2834,3404,570,18.28,"overcount"
"1234",21,"Kentucky",3,"A_AIC",4143,4767,624,14.01,"overcount"
"1235",21,"Kentucky",3,"NHPI_A",163,224,61,31.52,"overcount"
"1236",21,"Kentucky",3,"NHPI_AIC",417,415,-2,-0.48,"undercount"
"1237",21,"Kentucky",4,"A_A",2617,3068,451,15.87,"overcount"
"1238",21,"Kentucky",4,"A_AIC",3650,4276,626,15.8,"overcount"
"1239",21,"Kentucky",4,"NHPI_A",188,267,79,34.73,"overcount"
"1240",21,"Kentucky",4,"NHPI_AIC",414,425,11,2.62,"overcount"
"1241",21,"Kentucky",5,"A_A",3573,3940,367,9.77,"overcount"
"1242",21,"Kentucky",5,"A_AIC",4548,5049,501,10.44,"overcount"
"1243",21,"Kentucky",5,"NHPI_A",212,404,192,62.34,"overcount"
"1244",21,"Kentucky",5,"NHPI_AIC",448,590,142,27.36,"overcount"
"1245",21,"Kentucky",6,"A_A",3754,4834,1080,25.15,"overcount"
"1246",21,"Kentucky",6,"A_AIC",4571,5775,1204,23.27,"overcount"
"1247",21,"Kentucky",6,"NHPI_A",207,363,156,54.74,"overcount"
"1248",21,"Kentucky",6,"NHPI_AIC",394,506,112,24.89,"overcount"
"1249",21,"Kentucky",7,"A_A",4424,4971,547,11.64,"overcount"
"1250",21,"Kentucky",7,"A_AIC",5104,5755,651,11.99,"overcount"
"1251",21,"Kentucky",7,"NHPI_A",244,312,68,24.46,"overcount"
"1252",21,"Kentucky",7,"NHPI_AIC",386,407,21,5.3,"overcount"
"1253",21,"Kentucky",8,"A_A",4997,5059,62,1.23,"overcount"
"1254",21,"Kentucky",8,"A_AIC",5612,5678,66,1.17,"overcount"
"1255",21,"Kentucky",8,"NHPI_A",233,234,1,0.43,"overcount"
"1256",21,"Kentucky",8,"NHPI_AIC",376,350,-26,-7.16,"undercount"
"1257",21,"Kentucky",9,"A_A",4273,4150,-123,-2.92,"undercount"
"1258",21,"Kentucky",9,"A_AIC",4747,4450,-297,-6.46,"undercount"
"1259",21,"Kentucky",9,"NHPI_A",182,174,-8,-4.49,"undercount"
"1260",21,"Kentucky",9,"NHPI_AIC",325,269,-56,-18.86,"undercount"
"1261",21,"Kentucky",10,"A_A",3185,3231,46,1.43,"overcount"
"1262",21,"Kentucky",10,"A_AIC",3607,3571,-36,-1,"undercount"
"1263",21,"Kentucky",10,"NHPI_A",187,151,-36,-21.3,"undercount"
"1264",21,"Kentucky",10,"NHPI_AIC",303,269,-34,-11.89,"undercount"
"1265",21,"Kentucky",11,"A_A",2546,2521,-25,-0.99,"undercount"
"1266",21,"Kentucky",11,"A_AIC",2909,2761,-148,-5.22,"undercount"
"1267",21,"Kentucky",11,"NHPI_A",130,111,-19,-15.77,"undercount"
"1268",21,"Kentucky",11,"NHPI_AIC",228,186,-42,-20.29,"undercount"
"1269",21,"Kentucky",12,"A_A",2158,2087,-71,-3.35,"undercount"
"1270",21,"Kentucky",12,"A_AIC",2432,2171,-261,-11.34,"undercount"
"1271",21,"Kentucky",12,"NHPI_A",86,96,10,10.99,"overcount"
"1272",21,"Kentucky",12,"NHPI_AIC",151,143,-8,-5.44,"undercount"
"1273",21,"Kentucky",13,"A_A",1883,1747,-136,-7.49,"undercount"
"1274",21,"Kentucky",13,"A_AIC",2087,1759,-328,-17.06,"undercount"
"1275",21,"Kentucky",13,"NHPI_A",69,67,-2,-2.94,"undercount"
"1276",21,"Kentucky",13,"NHPI_AIC",139,110,-29,-23.29,"undercount"
"1277",21,"Kentucky",14,"A_A",1129,1160,31,2.71,"overcount"
"1278",21,"Kentucky",14,"A_AIC",1248,1141,-107,-8.96,"undercount"
"1279",21,"Kentucky",14,"NHPI_A",63,26,-37,-83.15,"undercount"
"1280",21,"Kentucky",14,"NHPI_AIC",116,50,-66,-79.52,"undercount"
"1281",21,"Kentucky",15,"A_A",857,804,-53,-6.38,"undercount"
"1282",21,"Kentucky",15,"A_AIC",944,806,-138,-15.77,"undercount"
"1283",21,"Kentucky",15,"NHPI_A",34,30,-4,-12.5,"undercount"
"1284",21,"Kentucky",15,"NHPI_AIC",75,53,-22,-34.38,"undercount"
"1285",21,"Kentucky",16,"A_A",533,442,-91,-18.67,"undercount"
"1286",21,"Kentucky",16,"A_AIC",616,463,-153,-28.36,"undercount"
"1287",21,"Kentucky",16,"NHPI_A",24,11,-13,-74.29,"undercount"
"1288",21,"Kentucky",16,"NHPI_AIC",53,34,-19,-43.68,"undercount"
"1289",21,"Kentucky",17,"A_A",290,250,-40,-14.81,"undercount"
"1290",21,"Kentucky",17,"A_AIC",366,277,-89,-27.68,"undercount"
"1291",21,"Kentucky",17,"NHPI_A",17,8,-9,-72,"undercount"
"1292",21,"Kentucky",17,"NHPI_AIC",32,25,-7,-24.56,"undercount"
"1293",21,"Kentucky",18,"A_A",185,143,-42,-25.61,"undercount"
"1294",21,"Kentucky",18,"A_AIC",271,127,-144,-72.36,"undercount"
"1295",21,"Kentucky",18,"NHPI_A",23,5,-18,-128.57,"undercount"
"1296",21,"Kentucky",18,"NHPI_AIC",57,8,-49,-150.77,"undercount"
"1297",22,"Louisiana",1,"A_A",5277,4668,-609,-12.25,"undercount"
"1298",22,"Louisiana",1,"A_AIC",7687,6866,-821,-11.28,"undercount"
"1299",22,"Louisiana",1,"NHPI_A",199,202,3,1.5,"overcount"
"1300",22,"Louisiana",1,"NHPI_AIC",556,494,-62,-11.81,"undercount"
"1301",22,"Louisiana",2,"A_A",5240,4661,-579,-11.7,"undercount"
"1302",22,"Louisiana",2,"A_AIC",7716,6400,-1316,-18.65,"undercount"
"1303",22,"Louisiana",2,"NHPI_A",218,199,-19,-9.11,"undercount"
"1304",22,"Louisiana",2,"NHPI_AIC",675,452,-223,-39.57,"undercount"
"1305",22,"Louisiana",3,"A_A",4503,4347,-156,-3.53,"undercount"
"1306",22,"Louisiana",3,"A_AIC",6145,5661,-484,-8.2,"undercount"
"1307",22,"Louisiana",3,"NHPI_A",166,171,5,2.97,"overcount"
"1308",22,"Louisiana",3,"NHPI_AIC",423,378,-45,-11.24,"undercount"
"1309",22,"Louisiana",4,"A_A",4433,4696,263,5.76,"overcount"
"1310",22,"Louisiana",4,"A_AIC",5722,5944,222,3.81,"overcount"
"1311",22,"Louisiana",4,"NHPI_A",153,197,44,25.14,"overcount"
"1312",22,"Louisiana",4,"NHPI_AIC",375,436,61,15.04,"overcount"
"1313",22,"Louisiana",5,"A_A",5750,6714,964,15.47,"overcount"
"1314",22,"Louisiana",5,"A_AIC",6973,7961,988,13.23,"overcount"
"1315",22,"Louisiana",5,"NHPI_A",190,330,140,53.85,"overcount"
"1316",22,"Louisiana",5,"NHPI_AIC",395,561,166,34.73,"overcount"
"1317",22,"Louisiana",6,"A_A",5391,7239,1848,29.26,"overcount"
"1318",22,"Louisiana",6,"A_AIC",6520,8380,1860,24.97,"overcount"
"1319",22,"Louisiana",6,"NHPI_A",172,289,117,50.76,"overcount"
"1320",22,"Louisiana",6,"NHPI_AIC",403,509,106,23.25,"overcount"
"1321",22,"Louisiana",7,"A_A",5482,6345,863,14.59,"overcount"
"1322",22,"Louisiana",7,"A_AIC",6399,7237,838,12.29,"overcount"
"1323",22,"Louisiana",7,"NHPI_A",185,280,95,40.86,"overcount"
"1324",22,"Louisiana",7,"NHPI_AIC",389,459,70,16.51,"overcount"
"1325",22,"Louisiana",8,"A_A",6031,6250,219,3.57,"overcount"
"1326",22,"Louisiana",8,"A_AIC",6760,7004,244,3.55,"overcount"
"1327",22,"Louisiana",8,"NHPI_A",189,205,16,8.12,"overcount"
"1328",22,"Louisiana",8,"NHPI_AIC",336,346,10,2.93,"overcount"
"1329",22,"Louisiana",9,"A_A",5198,5352,154,2.92,"overcount"
"1330",22,"Louisiana",9,"A_AIC",5792,5908,116,1.98,"overcount"
"1331",22,"Louisiana",9,"NHPI_A",152,173,21,12.92,"overcount"
"1332",22,"Louisiana",9,"NHPI_AIC",300,311,11,3.6,"overcount"
"1333",22,"Louisiana",10,"A_A",4555,4832,277,5.9,"overcount"
"1334",22,"Louisiana",10,"A_AIC",5130,5344,214,4.09,"overcount"
"1335",22,"Louisiana",10,"NHPI_A",125,150,25,18.18,"overcount"
"1336",22,"Louisiana",10,"NHPI_AIC",261,291,30,10.87,"overcount"
"1337",22,"Louisiana",11,"A_A",4405,4659,254,5.6,"overcount"
"1338",22,"Louisiana",11,"A_AIC",4973,5144,171,3.38,"overcount"
"1339",22,"Louisiana",11,"NHPI_A",111,127,16,13.45,"overcount"
"1340",22,"Louisiana",11,"NHPI_AIC",214,253,39,16.7,"overcount"
"1341",22,"Louisiana",12,"A_A",3878,4134,256,6.39,"overcount"
"1342",22,"Louisiana",12,"A_AIC",4367,4556,189,4.24,"overcount"
"1343",22,"Louisiana",12,"NHPI_A",90,91,1,1.1,"overcount"
"1344",22,"Louisiana",12,"NHPI_AIC",188,193,5,2.62,"overcount"
"1345",22,"Louisiana",13,"A_A",2960,3107,147,4.85,"overcount"
"1346",22,"Louisiana",13,"A_AIC",3298,3291,-7,-0.21,"undercount"
"1347",22,"Louisiana",13,"NHPI_A",81,75,-6,-7.69,"undercount"
"1348",22,"Louisiana",13,"NHPI_AIC",202,180,-22,-11.52,"undercount"
"1349",22,"Louisiana",14,"A_A",1850,1914,64,3.4,"overcount"
"1350",22,"Louisiana",14,"A_AIC",2083,2109,26,1.24,"overcount"
"1351",22,"Louisiana",14,"NHPI_A",52,40,-12,-26.09,"undercount"
"1352",22,"Louisiana",14,"NHPI_AIC",142,94,-48,-40.68,"undercount"
"1353",22,"Louisiana",15,"A_A",1363,1252,-111,-8.49,"undercount"
"1354",22,"Louisiana",15,"A_AIC",1548,1355,-193,-13.3,"undercount"
"1355",22,"Louisiana",15,"NHPI_A",30,23,-7,-26.42,"undercount"
"1356",22,"Louisiana",15,"NHPI_AIC",96,75,-21,-24.56,"undercount"
"1357",22,"Louisiana",16,"A_A",817,820,3,0.37,"overcount"
"1358",22,"Louisiana",16,"A_AIC",939,868,-71,-7.86,"undercount"
"1359",22,"Louisiana",16,"NHPI_A",40,14,-26,-96.3,"undercount"
"1360",22,"Louisiana",16,"NHPI_AIC",91,45,-46,-67.65,"undercount"
"1361",22,"Louisiana",17,"A_A",610,491,-119,-21.62,"undercount"
"1362",22,"Louisiana",17,"A_AIC",726,548,-178,-27.94,"undercount"
"1363",22,"Louisiana",17,"NHPI_A",18,15,-3,-18.18,"undercount"
"1364",22,"Louisiana",17,"NHPI_AIC",47,37,-10,-23.81,"undercount"
"1365",22,"Louisiana",18,"A_A",444,348,-96,-24.24,"undercount"
"1366",22,"Louisiana",18,"A_AIC",528,379,-149,-32.86,"undercount"
"1367",22,"Louisiana",18,"NHPI_A",31,7,-24,-126.32,"undercount"
"1368",22,"Louisiana",18,"NHPI_AIC",68,28,-40,-83.33,"undercount"
"1369",23,"Maine",1,"A_A",1098,869,-229,-23.28,"undercount"
"1370",23,"Maine",1,"A_AIC",1824,1681,-143,-8.16,"undercount"
"1371",23,"Maine",1,"NHPI_A",57,22,-35,-88.61,"undercount"
"1372",23,"Maine",1,"NHPI_AIC",121,76,-45,-45.69,"undercount"
"1373",23,"Maine",2,"A_A",1167,1017,-150,-13.74,"undercount"
"1374",23,"Maine",2,"A_AIC",1867,1728,-139,-7.73,"undercount"
"1375",23,"Maine",2,"NHPI_A",53,36,-17,-38.2,"undercount"
"1376",23,"Maine",2,"NHPI_AIC",126,104,-22,-19.13,"undercount"
"1377",23,"Maine",3,"A_A",1082,1065,-17,-1.58,"undercount"
"1378",23,"Maine",3,"A_AIC",1645,1639,-6,-0.37,"undercount"
"1379",23,"Maine",3,"NHPI_A",34,30,-4,-12.5,"undercount"
"1380",23,"Maine",3,"NHPI_AIC",98,96,-2,-2.06,"undercount"
"1381",23,"Maine",4,"A_A",1060,1526,466,36.04,"overcount"
"1382",23,"Maine",4,"A_AIC",1471,2074,603,34.02,"overcount"
"1383",23,"Maine",4,"NHPI_A",41,24,-17,-52.31,"undercount"
"1384",23,"Maine",4,"NHPI_AIC",122,83,-39,-38.05,"undercount"
"1385",23,"Maine",5,"A_A",936,1078,142,14.1,"overcount"
"1386",23,"Maine",5,"A_AIC",1278,1532,254,18.08,"overcount"
"1387",23,"Maine",5,"NHPI_A",41,50,9,19.78,"overcount"
"1388",23,"Maine",5,"NHPI_AIC",80,114,34,35.05,"overcount"
"1389",23,"Maine",6,"A_A",898,1091,193,19.41,"overcount"
"1390",23,"Maine",6,"A_AIC",1122,1358,236,19.03,"overcount"
"1391",23,"Maine",6,"NHPI_A",40,38,-2,-5.13,"undercount"
"1392",23,"Maine",6,"NHPI_AIC",81,73,-8,-10.39,"undercount"
"1393",23,"Maine",7,"A_A",915,1083,168,16.82,"overcount"
"1394",23,"Maine",7,"A_AIC",1115,1331,216,17.66,"overcount"
"1395",23,"Maine",7,"NHPI_A",61,32,-29,-62.37,"undercount"
"1396",23,"Maine",7,"NHPI_AIC",104,79,-25,-27.32,"undercount"
"1397",23,"Maine",8,"A_A",1221,1200,-21,-1.73,"undercount"
"1398",23,"Maine",8,"A_AIC",1408,1421,13,0.92,"overcount"
"1399",23,"Maine",8,"NHPI_A",52,20,-32,-88.89,"undercount"
"1400",23,"Maine",8,"NHPI_AIC",79,42,-37,-61.16,"undercount"
"1401",23,"Maine",9,"A_A",1029,1088,59,5.57,"overcount"
"1402",23,"Maine",9,"A_AIC",1187,1291,104,8.39,"overcount"
"1403",23,"Maine",9,"NHPI_A",23,28,5,19.61,"overcount"
"1404",23,"Maine",9,"NHPI_AIC",55,56,1,1.8,"overcount"
"1405",23,"Maine",10,"A_A",932,880,-52,-5.74,"undercount"
"1406",23,"Maine",10,"A_AIC",1079,1065,-14,-1.31,"undercount"
"1407",23,"Maine",10,"NHPI_A",30,31,1,3.28,"overcount"
"1408",23,"Maine",10,"NHPI_AIC",59,60,1,1.68,"overcount"
"1409",23,"Maine",11,"A_A",830,832,2,0.24,"overcount"
"1410",23,"Maine",11,"A_AIC",952,981,29,3,"overcount"
"1411",23,"Maine",11,"NHPI_A",35,17,-18,-69.23,"undercount"
"1412",23,"Maine",11,"NHPI_AIC",72,47,-25,-42.02,"undercount"
"1413",23,"Maine",12,"A_A",629,707,78,11.68,"overcount"
"1414",23,"Maine",12,"A_AIC",712,791,79,10.51,"overcount"
"1415",23,"Maine",12,"NHPI_A",39,17,-22,-78.57,"undercount"
"1416",23,"Maine",12,"NHPI_AIC",65,52,-13,-22.22,"undercount"
"1417",23,"Maine",13,"A_A",513,528,15,2.88,"overcount"
"1418",23,"Maine",13,"A_AIC",552,541,-11,-2.01,"undercount"
"1419",23,"Maine",13,"NHPI_A",29,16,-13,-57.78,"undercount"
"1420",23,"Maine",13,"NHPI_AIC",42,37,-5,-12.66,"undercount"
"1421",23,"Maine",14,"A_A",313,312,-1,-0.32,"undercount"
"1422",23,"Maine",14,"A_AIC",347,346,-1,-0.29,"undercount"
"1423",23,"Maine",14,"NHPI_A",24,8,-16,-100,"undercount"
"1424",23,"Maine",14,"NHPI_AIC",37,21,-16,-55.17,"undercount"
"1425",23,"Maine",15,"A_A",205,238,33,14.9,"overcount"
"1426",23,"Maine",15,"A_AIC",230,259,29,11.86,"overcount"
"1427",23,"Maine",15,"NHPI_A",8,0,-8,-200,"undercount"
"1428",23,"Maine",15,"NHPI_AIC",12,11,-1,-8.7,"undercount"
"1429",23,"Maine",16,"A_A",162,148,-14,-9.03,"undercount"
"1430",23,"Maine",16,"A_AIC",185,136,-49,-30.53,"undercount"
"1431",23,"Maine",16,"NHPI_A",11,4,-7,-93.33,"undercount"
"1432",23,"Maine",16,"NHPI_AIC",23,10,-13,-78.79,"undercount"
"1433",23,"Maine",17,"A_A",109,76,-33,-35.68,"undercount"
"1434",23,"Maine",17,"A_AIC",123,71,-52,-53.61,"undercount"
"1435",23,"Maine",17,"NHPI_A",6,1,-5,-142.86,"undercount"
"1436",23,"Maine",17,"NHPI_AIC",11,5,-6,-75,"undercount"
"1437",23,"Maine",18,"A_A",68,45,-23,-40.71,"undercount"
"1438",23,"Maine",18,"A_AIC",96,62,-34,-43.04,"undercount"
"1439",23,"Maine",18,"NHPI_A",7,3,-4,-80,"undercount"
"1440",23,"Maine",18,"NHPI_AIC",19,2,-17,-161.9,"undercount"
"1441",24,"Maryland",1,"A_A",22509,21160,-1349,-6.18,"undercount"
"1442",24,"Maryland",1,"A_AIC",28410,29510,1100,3.8,"overcount"
"1443",24,"Maryland",1,"NHPI_A",633,441,-192,-35.75,"undercount"
"1444",24,"Maryland",1,"NHPI_AIC",1123,1100,-23,-2.07,"undercount"
"1445",24,"Maryland",2,"A_A",20861,21478,617,2.91,"overcount"
"1446",24,"Maryland",2,"A_AIC",26119,28425,2306,8.46,"overcount"
"1447",24,"Maryland",2,"NHPI_A",547,344,-203,-45.57,"undercount"
"1448",24,"Maryland",2,"NHPI_AIC",1064,936,-128,-12.8,"undercount"
"1449",24,"Maryland",3,"A_A",18483,19738,1255,6.57,"overcount"
"1450",24,"Maryland",3,"A_AIC",22511,25402,2891,12.07,"overcount"
"1451",24,"Maryland",3,"NHPI_A",293,319,26,8.5,"overcount"
"1452",24,"Maryland",3,"NHPI_AIC",720,847,127,16.21,"overcount"
"1453",24,"Maryland",4,"A_A",17495,20183,2688,14.27,"overcount"
"1454",24,"Maryland",4,"A_AIC",20788,25102,4314,18.8,"overcount"
"1455",24,"Maryland",4,"NHPI_A",343,387,44,12.05,"overcount"
"1456",24,"Maryland",4,"NHPI_AIC",748,927,179,21.37,"overcount"
"1457",24,"Maryland",5,"A_A",17802,21776,3974,20.08,"overcount"
"1458",24,"Maryland",5,"A_AIC",20660,25512,4852,21.02,"overcount"
"1459",24,"Maryland",5,"NHPI_A",323,574,251,55.96,"overcount"
"1460",24,"Maryland",5,"NHPI_AIC",750,1068,318,34.98,"overcount"
"1461",24,"Maryland",6,"A_A",22025,25991,3966,16.52,"overcount"
"1462",24,"Maryland",6,"A_AIC",24541,29385,4844,17.97,"overcount"
"1463",24,"Maryland",6,"NHPI_A",398,659,261,49.39,"overcount"
"1464",24,"Maryland",6,"NHPI_AIC",793,1142,349,36.07,"overcount"
"1465",24,"Maryland",7,"A_A",27116,28624,1508,5.41,"overcount"
"1466",24,"Maryland",7,"A_AIC",29217,31543,2326,7.66,"overcount"
"1467",24,"Maryland",7,"NHPI_A",545,565,20,3.6,"overcount"
"1468",24,"Maryland",7,"NHPI_AIC",915,1020,105,10.85,"overcount"
"1469",24,"Maryland",8,"A_A",28197,30066,1869,6.42,"overcount"
"1470",24,"Maryland",8,"A_AIC",30050,32639,2589,8.26,"overcount"
"1471",24,"Maryland",8,"NHPI_A",377,447,70,16.99,"overcount"
"1472",24,"Maryland",8,"NHPI_AIC",723,829,106,13.66,"overcount"
"1473",24,"Maryland",9,"A_A",25417,26823,1406,5.38,"overcount"
"1474",24,"Maryland",9,"A_AIC",27122,29090,1968,7,"overcount"
"1475",24,"Maryland",9,"NHPI_A",357,426,69,17.62,"overcount"
"1476",24,"Maryland",9,"NHPI_AIC",700,816,116,15.3,"overcount"
"1477",24,"Maryland",10,"A_A",23565,25266,1701,6.97,"overcount"
"1478",24,"Maryland",10,"A_AIC",25210,27218,2008,7.66,"overcount"
"1479",24,"Maryland",10,"NHPI_A",331,338,7,2.09,"overcount"
"1480",24,"Maryland",10,"NHPI_AIC",677,718,41,5.88,"overcount"
"1481",24,"Maryland",11,"A_A",20825,22652,1827,8.4,"overcount"
"1482",24,"Maryland",11,"A_AIC",22148,24315,2167,9.33,"overcount"
"1483",24,"Maryland",11,"NHPI_A",229,313,84,31,"overcount"
"1484",24,"Maryland",11,"NHPI_AIC",507,615,108,19.25,"overcount"
"1485",24,"Maryland",12,"A_A",17303,18388,1085,6.08,"overcount"
"1486",24,"Maryland",12,"A_AIC",18295,19627,1332,7.02,"overcount"
"1487",24,"Maryland",12,"NHPI_A",188,225,37,17.92,"overcount"
"1488",24,"Maryland",12,"NHPI_AIC",377,484,107,24.85,"overcount"
"1489",24,"Maryland",13,"A_A",14466,15484,1018,6.8,"overcount"
"1490",24,"Maryland",13,"A_AIC",15301,16274,973,6.16,"overcount"
"1491",24,"Maryland",13,"NHPI_A",132,128,-4,-3.08,"undercount"
"1492",24,"Maryland",13,"NHPI_AIC",321,316,-5,-1.57,"undercount"
"1493",24,"Maryland",14,"A_A",10836,10869,33,0.3,"overcount"
"1494",24,"Maryland",14,"A_AIC",11342,11378,36,0.32,"overcount"
"1495",24,"Maryland",14,"NHPI_A",96,92,-4,-4.26,"undercount"
"1496",24,"Maryland",14,"NHPI_AIC",241,198,-43,-19.59,"undercount"
"1497",24,"Maryland",15,"A_A",8127,8032,-95,-1.18,"undercount"
"1498",24,"Maryland",15,"A_AIC",8458,8363,-95,-1.13,"undercount"
"1499",24,"Maryland",15,"NHPI_A",73,53,-20,-31.75,"undercount"
"1500",24,"Maryland",15,"NHPI_AIC",177,116,-61,-41.64,"undercount"
"1501",24,"Maryland",16,"A_A",5306,5070,-236,-4.55,"undercount"
"1502",24,"Maryland",16,"A_AIC",5541,5361,-180,-3.3,"undercount"
"1503",24,"Maryland",16,"NHPI_A",48,31,-17,-43.04,"undercount"
"1504",24,"Maryland",16,"NHPI_AIC",118,104,-14,-12.61,"undercount"
"1505",24,"Maryland",17,"A_A",3329,2961,-368,-11.7,"undercount"
"1506",24,"Maryland",17,"A_AIC",3491,3131,-360,-10.87,"undercount"
"1507",24,"Maryland",17,"NHPI_A",39,19,-20,-68.97,"undercount"
"1508",24,"Maryland",17,"NHPI_AIC",90,70,-20,-25,"undercount"
"1509",24,"Maryland",18,"A_A",2925,2094,-831,-33.11,"undercount"
"1510",24,"Maryland",18,"A_AIC",3078,2266,-812,-30.39,"undercount"
"1511",24,"Maryland",18,"NHPI_A",60,30,-30,-66.67,"undercount"
"1512",24,"Maryland",18,"NHPI_AIC",111,126,15,12.66,"overcount"
"1513",25,"Massachusetts",1,"A_A",26612,24510,-2102,-8.22,"undercount"
"1514",25,"Massachusetts",1,"A_AIC",32322,32044,-278,-0.86,"undercount"
"1515",25,"Massachusetts",1,"NHPI_A",435,494,59,12.7,"overcount"
"1516",25,"Massachusetts",1,"NHPI_AIC",1060,1067,7,0.66,"overcount"
"1517",25,"Massachusetts",2,"A_A",24769,24141,-628,-2.57,"undercount"
"1518",25,"Massachusetts",2,"A_AIC",29355,30458,1103,3.69,"overcount"
"1519",25,"Massachusetts",2,"NHPI_A",414,454,40,9.22,"overcount"
"1520",25,"Massachusetts",2,"NHPI_AIC",981,934,-47,-4.91,"undercount"
"1521",25,"Massachusetts",3,"A_A",20957,21041,84,0.4,"overcount"
"1522",25,"Massachusetts",3,"A_AIC",23850,25575,1725,6.98,"overcount"
"1523",25,"Massachusetts",3,"NHPI_A",466,490,24,5.02,"overcount"
"1524",25,"Massachusetts",3,"NHPI_AIC",904,965,61,6.53,"overcount"
"1525",25,"Massachusetts",4,"A_A",23791,26084,2293,9.19,"overcount"
"1526",25,"Massachusetts",4,"A_AIC",26931,30600,3669,12.75,"overcount"
"1527",25,"Massachusetts",4,"NHPI_A",461,566,105,20.45,"overcount"
"1528",25,"Massachusetts",4,"NHPI_AIC",1018,1112,94,8.83,"overcount"
"1529",25,"Massachusetts",5,"A_A",26727,33756,7029,23.24,"overcount"
"1530",25,"Massachusetts",5,"A_AIC",29903,38128,8225,24.18,"overcount"
"1531",25,"Massachusetts",5,"NHPI_A",509,671,162,27.46,"overcount"
"1532",25,"Massachusetts",5,"NHPI_AIC",1111,1284,173,14.45,"overcount"
"1533",25,"Massachusetts",6,"A_A",30468,36696,6228,18.55,"overcount"
"1534",25,"Massachusetts",6,"A_AIC",32950,39775,6825,18.77,"overcount"
"1535",25,"Massachusetts",6,"NHPI_A",457,589,132,25.24,"overcount"
"1536",25,"Massachusetts",6,"NHPI_AIC",1034,1118,84,7.81,"overcount"
"1537",25,"Massachusetts",7,"A_A",32839,34499,1660,4.93,"overcount"
"1538",25,"Massachusetts",7,"A_AIC",34879,36853,1974,5.5,"overcount"
"1539",25,"Massachusetts",7,"NHPI_A",556,480,-76,-14.67,"undercount"
"1540",25,"Massachusetts",7,"NHPI_AIC",1138,958,-180,-17.18,"undercount"
"1541",25,"Massachusetts",8,"A_A",34531,33874,-657,-1.92,"undercount"
"1542",25,"Massachusetts",8,"A_AIC",36323,35848,-475,-1.32,"undercount"
"1543",25,"Massachusetts",8,"NHPI_A",510,441,-69,-14.51,"undercount"
"1544",25,"Massachusetts",8,"NHPI_AIC",972,910,-62,-6.59,"undercount"
"1545",25,"Massachusetts",9,"A_A",28639,27511,-1128,-4.02,"undercount"
"1546",25,"Massachusetts",9,"A_AIC",30084,29199,-885,-2.99,"undercount"
"1547",25,"Massachusetts",9,"NHPI_A",478,408,-70,-15.8,"undercount"
"1548",25,"Massachusetts",9,"NHPI_AIC",942,887,-55,-6.01,"undercount"
"1549",25,"Massachusetts",10,"A_A",24142,24218,76,0.31,"overcount"
"1550",25,"Massachusetts",10,"A_AIC",25356,25650,294,1.15,"overcount"
"1551",25,"Massachusetts",10,"NHPI_A",389,362,-27,-7.19,"undercount"
"1552",25,"Massachusetts",10,"NHPI_AIC",828,801,-27,-3.31,"undercount"
"1553",25,"Massachusetts",11,"A_A",19876,19957,81,0.41,"overcount"
"1554",25,"Massachusetts",11,"A_AIC",20943,21113,170,0.81,"overcount"
"1555",25,"Massachusetts",11,"NHPI_A",353,296,-57,-17.57,"undercount"
"1556",25,"Massachusetts",11,"NHPI_AIC",746,660,-86,-12.23,"undercount"
"1557",25,"Massachusetts",12,"A_A",15788,16270,482,3.01,"overcount"
"1558",25,"Massachusetts",12,"A_AIC",16611,17121,510,3.02,"overcount"
"1559",25,"Massachusetts",12,"NHPI_A",231,224,-7,-3.08,"undercount"
"1560",25,"Massachusetts",12,"NHPI_AIC",547,498,-49,-9.38,"undercount"
"1561",25,"Massachusetts",13,"A_A",11629,12326,697,5.82,"overcount"
"1562",25,"Massachusetts",13,"A_AIC",12147,12882,735,5.87,"overcount"
"1563",25,"Massachusetts",13,"NHPI_A",175,165,-10,-5.88,"undercount"
"1564",25,"Massachusetts",13,"NHPI_AIC",405,386,-19,-4.8,"undercount"
"1565",25,"Massachusetts",14,"A_A",7971,8557,586,7.09,"overcount"
"1566",25,"Massachusetts",14,"A_AIC",8327,8905,578,6.71,"overcount"
"1567",25,"Massachusetts",14,"NHPI_A",113,99,-14,-13.21,"undercount"
"1568",25,"Massachusetts",14,"NHPI_AIC",281,239,-42,-16.15,"undercount"
"1569",25,"Massachusetts",15,"A_A",5955,6677,722,11.43,"overcount"
"1570",25,"Massachusetts",15,"A_AIC",6195,6933,738,11.24,"overcount"
"1571",25,"Massachusetts",15,"NHPI_A",74,105,31,34.64,"overcount"
"1572",25,"Massachusetts",15,"NHPI_AIC",176,217,41,20.87,"overcount"
"1573",25,"Massachusetts",16,"A_A",4142,4631,489,11.15,"overcount"
"1574",25,"Massachusetts",16,"A_AIC",4336,4794,458,10.03,"overcount"
"1575",25,"Massachusetts",16,"NHPI_A",99,54,-45,-58.82,"undercount"
"1576",25,"Massachusetts",16,"NHPI_AIC",198,127,-71,-43.69,"undercount"
"1577",25,"Massachusetts",17,"A_A",2868,2822,-46,-1.62,"undercount"
"1578",25,"Massachusetts",17,"A_AIC",3015,2947,-68,-2.28,"undercount"
"1579",25,"Massachusetts",17,"NHPI_A",43,39,-4,-9.76,"undercount"
"1580",25,"Massachusetts",17,"NHPI_AIC",122,102,-20,-17.86,"undercount"
"1581",25,"Massachusetts",18,"A_A",2603,2103,-500,-21.25,"undercount"
"1582",25,"Massachusetts",18,"A_AIC",2729,2204,-525,-21.29,"undercount"
"1583",25,"Massachusetts",18,"NHPI_A",58,34,-24,-52.17,"undercount"
"1584",25,"Massachusetts",18,"NHPI_AIC",116,95,-21,-19.91,"undercount"
"1585",26,"Michigan",1,"A_A",18611,17545,-1066,-5.9,"undercount"
"1586",26,"Michigan",1,"A_AIC",23866,25539,1673,6.77,"overcount"
"1587",26,"Michigan",1,"NHPI_A",448,228,-220,-65.09,"undercount"
"1588",26,"Michigan",1,"NHPI_AIC",958,944,-14,-1.47,"undercount"
"1589",26,"Michigan",2,"A_A",19500,19328,-172,-0.89,"undercount"
"1590",26,"Michigan",2,"A_AIC",23995,26591,2596,10.26,"overcount"
"1591",26,"Michigan",2,"NHPI_A",582,315,-267,-59.53,"undercount"
"1592",26,"Michigan",2,"NHPI_AIC",1078,944,-134,-13.25,"undercount"
"1593",26,"Michigan",3,"A_A",17459,17035,-424,-2.46,"undercount"
"1594",26,"Michigan",3,"A_AIC",22212,23252,1040,4.58,"overcount"
"1595",26,"Michigan",3,"NHPI_A",393,289,-104,-30.5,"undercount"
"1596",26,"Michigan",3,"NHPI_AIC",925,877,-48,-5.33,"undercount"
"1597",26,"Michigan",4,"A_A",16646,17472,826,4.84,"overcount"
"1598",26,"Michigan",4,"A_AIC",20655,22814,2159,9.93,"overcount"
"1599",26,"Michigan",4,"NHPI_A",333,270,-63,-20.9,"undercount"
"1600",26,"Michigan",4,"NHPI_AIC",836,901,65,7.48,"overcount"
"1601",26,"Michigan",5,"A_A",20252,21279,1027,4.95,"overcount"
"1602",26,"Michigan",5,"A_AIC",23617,25431,1814,7.4,"overcount"
"1603",26,"Michigan",5,"NHPI_A",392,322,-70,-19.61,"undercount"
"1604",26,"Michigan",5,"NHPI_AIC",863,916,53,5.96,"overcount"
"1605",26,"Michigan",6,"A_A",17926,20634,2708,14.05,"overcount"
"1606",26,"Michigan",6,"A_AIC",20620,23697,3077,13.89,"overcount"
"1607",26,"Michigan",6,"NHPI_A",363,301,-62,-18.67,"undercount"
"1608",26,"Michigan",6,"NHPI_AIC",829,795,-34,-4.19,"undercount"
"1609",26,"Michigan",7,"A_A",19148,21942,2794,13.6,"overcount"
"1610",26,"Michigan",7,"A_AIC",21404,24637,3233,14.04,"overcount"
"1611",26,"Michigan",7,"NHPI_A",415,282,-133,-38.16,"undercount"
"1612",26,"Michigan",7,"NHPI_AIC",832,699,-133,-17.37,"undercount"
"1613",26,"Michigan",8,"A_A",23760,22905,-855,-3.66,"undercount"
"1614",26,"Michigan",8,"A_AIC",26008,25453,-555,-2.16,"undercount"
"1615",26,"Michigan",8,"NHPI_A",328,260,-68,-23.13,"undercount"
"1616",26,"Michigan",8,"NHPI_AIC",765,651,-114,-16.1,"undercount"
"1617",26,"Michigan",9,"A_A",21174,19445,-1729,-8.51,"undercount"
"1618",26,"Michigan",9,"A_AIC",23023,21564,-1459,-6.54,"undercount"
"1619",26,"Michigan",9,"NHPI_A",264,235,-29,-11.62,"undercount"
"1620",26,"Michigan",9,"NHPI_AIC",644,615,-29,-4.61,"undercount"
"1621",26,"Michigan",10,"A_A",17670,16201,-1469,-8.67,"undercount"
"1622",26,"Michigan",10,"A_AIC",19342,18022,-1320,-7.07,"undercount"
"1623",26,"Michigan",10,"NHPI_A",253,234,-19,-7.8,"undercount"
"1624",26,"Michigan",10,"NHPI_AIC",636,629,-7,-1.11,"undercount"
"1625",26,"Michigan",11,"A_A",13672,12829,-843,-6.36,"undercount"
"1626",26,"Michigan",11,"A_AIC",15115,14450,-665,-4.5,"undercount"
"1627",26,"Michigan",11,"NHPI_A",216,211,-5,-2.34,"undercount"
"1628",26,"Michigan",11,"NHPI_AIC",520,530,10,1.9,"overcount"
"1629",26,"Michigan",12,"A_A",10789,10730,-59,-0.55,"undercount"
"1630",26,"Michigan",12,"A_AIC",11866,11806,-60,-0.51,"undercount"
"1631",26,"Michigan",12,"NHPI_A",173,166,-7,-4.13,"undercount"
"1632",26,"Michigan",12,"NHPI_AIC",362,419,57,14.6,"overcount"
"1633",26,"Michigan",13,"A_A",9398,9450,52,0.55,"overcount"
"1634",26,"Michigan",13,"A_AIC",10235,10120,-115,-1.13,"undercount"
"1635",26,"Michigan",13,"NHPI_A",131,148,17,12.19,"overcount"
"1636",26,"Michigan",13,"NHPI_AIC",316,317,1,0.32,"overcount"
"1637",26,"Michigan",14,"A_A",6533,6606,73,1.11,"overcount"
"1638",26,"Michigan",14,"A_AIC",7031,7061,30,0.43,"overcount"
"1639",26,"Michigan",14,"NHPI_A",84,71,-13,-16.77,"undercount"
"1640",26,"Michigan",14,"NHPI_AIC",197,186,-11,-5.74,"undercount"
"1641",26,"Michigan",15,"A_A",4738,4436,-302,-6.58,"undercount"
"1642",26,"Michigan",15,"A_AIC",5137,4811,-326,-6.55,"undercount"
"1643",26,"Michigan",15,"NHPI_A",49,52,3,5.94,"overcount"
"1644",26,"Michigan",15,"NHPI_AIC",150,167,17,10.73,"overcount"
"1645",26,"Michigan",16,"A_A",2910,2638,-272,-9.81,"undercount"
"1646",26,"Michigan",16,"A_AIC",3179,2796,-383,-12.82,"undercount"
"1647",26,"Michigan",16,"NHPI_A",61,26,-35,-80.46,"undercount"
"1648",26,"Michigan",16,"NHPI_AIC",141,80,-61,-55.2,"undercount"
"1649",26,"Michigan",17,"A_A",1856,1569,-287,-16.76,"undercount"
"1650",26,"Michigan",17,"A_AIC",2045,1667,-378,-20.37,"undercount"
"1651",26,"Michigan",17,"NHPI_A",43,11,-32,-118.52,"undercount"
"1652",26,"Michigan",17,"NHPI_AIC",85,58,-27,-37.76,"undercount"
"1653",26,"Michigan",18,"A_A",1532,1018,-514,-40.31,"undercount"
"1654",26,"Michigan",18,"A_AIC",1710,1103,-607,-43.16,"undercount"
"1655",26,"Michigan",18,"NHPI_A",52,21,-31,-84.93,"undercount"
"1656",26,"Michigan",18,"NHPI_AIC",108,55,-53,-65.03,"undercount"
"1657",27,"Minnesota",1,"A_A",21175,19993,-1182,-5.74,"undercount"
"1658",27,"Minnesota",1,"A_AIC",25729,27003,1274,4.83,"overcount"
"1659",27,"Minnesota",1,"NHPI_A",469,269,-200,-54.2,"undercount"
"1660",27,"Minnesota",1,"NHPI_AIC",1092,750,-342,-37.13,"undercount"
"1661",27,"Minnesota",2,"A_A",19039,19439,400,2.08,"overcount"
"1662",27,"Minnesota",2,"A_AIC",22914,25110,2196,9.15,"overcount"
"1663",27,"Minnesota",2,"NHPI_A",435,266,-169,-48.22,"undercount"
"1664",27,"Minnesota",2,"NHPI_AIC",1098,693,-405,-45.23,"undercount"
"1665",27,"Minnesota",3,"A_A",16159,17903,1744,10.24,"overcount"
"1666",27,"Minnesota",3,"A_AIC",19432,21929,2497,12.07,"overcount"
"1667",27,"Minnesota",3,"NHPI_A",284,235,-49,-18.88,"undercount"
"1668",27,"Minnesota",3,"NHPI_AIC",820,580,-240,-34.29,"undercount"
"1669",27,"Minnesota",4,"A_A",15914,19915,4001,22.33,"overcount"
"1670",27,"Minnesota",4,"A_AIC",18610,23236,4626,22.11,"overcount"
"1671",27,"Minnesota",4,"NHPI_A",271,309,38,13.1,"overcount"
"1672",27,"Minnesota",4,"NHPI_AIC",733,695,-38,-5.32,"undercount"
"1673",27,"Minnesota",5,"A_A",17517,21698,4181,21.32,"overcount"
"1674",27,"Minnesota",5,"A_AIC",19521,24078,4557,20.9,"overcount"
"1675",27,"Minnesota",5,"NHPI_A",280,283,3,1.07,"overcount"
"1676",27,"Minnesota",5,"NHPI_AIC",645,596,-49,-7.9,"undercount"
"1677",27,"Minnesota",6,"A_A",19997,22410,2413,11.38,"overcount"
"1678",27,"Minnesota",6,"A_AIC",21881,24367,2486,10.75,"overcount"
"1679",27,"Minnesota",6,"NHPI_A",301,304,3,0.99,"overcount"
"1680",27,"Minnesota",6,"NHPI_AIC",796,622,-174,-24.54,"undercount"
"1681",27,"Minnesota",7,"A_A",18678,19382,704,3.7,"overcount"
"1682",27,"Minnesota",7,"A_AIC",20237,20979,742,3.6,"overcount"
"1683",27,"Minnesota",7,"NHPI_A",289,222,-67,-26.22,"undercount"
"1684",27,"Minnesota",7,"NHPI_AIC",764,449,-315,-51.94,"undercount"
"1685",27,"Minnesota",8,"A_A",18557,18649,92,0.49,"overcount"
"1686",27,"Minnesota",8,"A_AIC",19954,19930,-24,-0.12,"undercount"
"1687",27,"Minnesota",8,"NHPI_A",292,228,-64,-24.62,"undercount"
"1688",27,"Minnesota",8,"NHPI_AIC",718,429,-289,-50.39,"undercount"
"1689",27,"Minnesota",9,"A_A",14553,14451,-102,-0.7,"undercount"
"1690",27,"Minnesota",9,"A_AIC",15560,15395,-165,-1.07,"undercount"
"1691",27,"Minnesota",9,"NHPI_A",245,223,-22,-9.4,"undercount"
"1692",27,"Minnesota",9,"NHPI_AIC",561,440,-121,-24.18,"undercount"
"1693",27,"Minnesota",10,"A_A",11091,11546,455,4.02,"overcount"
"1694",27,"Minnesota",10,"A_AIC",12002,12270,268,2.21,"overcount"
"1695",27,"Minnesota",10,"NHPI_A",211,196,-15,-7.37,"undercount"
"1696",27,"Minnesota",10,"NHPI_AIC",503,350,-153,-35.87,"undercount"
"1697",27,"Minnesota",11,"A_A",8554,9063,509,5.78,"overcount"
"1698",27,"Minnesota",11,"A_AIC",9299,9697,398,4.19,"overcount"
"1699",27,"Minnesota",11,"NHPI_A",217,156,-61,-32.71,"undercount"
"1700",27,"Minnesota",11,"NHPI_AIC",445,304,-141,-37.65,"undercount"
"1701",27,"Minnesota",12,"A_A",6995,7439,444,6.15,"overcount"
"1702",27,"Minnesota",12,"A_AIC",7523,7725,202,2.65,"overcount"
"1703",27,"Minnesota",12,"NHPI_A",139,98,-41,-34.6,"undercount"
"1704",27,"Minnesota",12,"NHPI_AIC",358,191,-167,-60.84,"undercount"
"1705",27,"Minnesota",13,"A_A",5127,5660,533,9.88,"overcount"
"1706",27,"Minnesota",13,"A_AIC",5406,5802,396,7.07,"overcount"
"1707",27,"Minnesota",13,"NHPI_A",89,73,-16,-19.75,"undercount"
"1708",27,"Minnesota",13,"NHPI_AIC",230,150,-80,-42.11,"undercount"
"1709",27,"Minnesota",14,"A_A",3431,3796,365,10.1,"overcount"
"1710",27,"Minnesota",14,"A_AIC",3612,3738,126,3.43,"overcount"
"1711",27,"Minnesota",14,"NHPI_A",45,41,-4,-9.3,"undercount"
"1712",27,"Minnesota",14,"NHPI_AIC",126,71,-55,-55.84,"undercount"
"1713",27,"Minnesota",15,"A_A",2578,2591,13,0.5,"overcount"
"1714",27,"Minnesota",15,"A_AIC",2729,2544,-185,-7.02,"undercount"
"1715",27,"Minnesota",15,"NHPI_A",42,28,-14,-40,"undercount"
"1716",27,"Minnesota",15,"NHPI_AIC",93,59,-34,-44.74,"undercount"
"1717",27,"Minnesota",16,"A_A",1713,1794,81,4.62,"overcount"
"1718",27,"Minnesota",16,"A_AIC",1837,1703,-134,-7.57,"undercount"
"1719",27,"Minnesota",16,"NHPI_A",23,15,-8,-42.11,"undercount"
"1720",27,"Minnesota",16,"NHPI_AIC",50,30,-20,-50,"undercount"
"1721",27,"Minnesota",17,"A_A",1038,1099,61,5.71,"overcount"
"1722",27,"Minnesota",17,"A_AIC",1101,1072,-29,-2.67,"undercount"
"1723",27,"Minnesota",17,"NHPI_A",23,7,-16,-106.67,"undercount"
"1724",27,"Minnesota",17,"NHPI_AIC",58,19,-39,-101.3,"undercount"
"1725",27,"Minnesota",18,"A_A",979,964,-15,-1.54,"undercount"
"1726",27,"Minnesota",18,"A_AIC",1113,978,-135,-12.91,"undercount"
"1727",27,"Minnesota",18,"NHPI_A",32,5,-27,-145.95,"undercount"
"1728",27,"Minnesota",18,"NHPI_AIC",60,31,-29,-63.74,"undercount"
"1729",28,"Mississippi",1,"A_A",2039,1627,-412,-22.48,"undercount"
"1730",28,"Mississippi",1,"A_AIC",3348,2685,-663,-21.98,"undercount"
"1731",28,"Mississippi",1,"NHPI_A",107,161,54,40.3,"overcount"
"1732",28,"Mississippi",1,"NHPI_AIC",336,311,-25,-7.73,"undercount"
"1733",28,"Mississippi",2,"A_A",2061,1878,-183,-9.29,"undercount"
"1734",28,"Mississippi",2,"A_AIC",3399,2723,-676,-22.08,"undercount"
"1735",28,"Mississippi",2,"NHPI_A",91,112,21,20.69,"overcount"
"1736",28,"Mississippi",2,"NHPI_AIC",407,237,-170,-52.8,"undercount"
"1737",28,"Mississippi",3,"A_A",1904,1740,-164,-9,"undercount"
"1738",28,"Mississippi",3,"A_AIC",3107,2403,-704,-25.55,"undercount"
"1739",28,"Mississippi",3,"NHPI_A",84,88,4,4.65,"overcount"
"1740",28,"Mississippi",3,"NHPI_AIC",288,206,-82,-33.2,"undercount"
"1741",28,"Mississippi",4,"A_A",1834,1883,49,2.64,"overcount"
"1742",28,"Mississippi",4,"A_AIC",2811,2540,-271,-10.13,"undercount"
"1743",28,"Mississippi",4,"NHPI_A",102,157,55,42.47,"overcount"
"1744",28,"Mississippi",4,"NHPI_AIC",308,293,-15,-4.99,"undercount"
"1745",28,"Mississippi",5,"A_A",2284,2220,-64,-2.84,"undercount"
"1746",28,"Mississippi",5,"A_AIC",2997,2827,-170,-5.84,"undercount"
"1747",28,"Mississippi",5,"NHPI_A",135,257,122,62.24,"overcount"
"1748",28,"Mississippi",5,"NHPI_AIC",288,369,81,24.66,"overcount"
"1749",28,"Mississippi",6,"A_A",2111,2475,364,15.87,"overcount"
"1750",28,"Mississippi",6,"A_AIC",2752,2979,227,7.92,"overcount"
"1751",28,"Mississippi",6,"NHPI_A",163,210,47,25.2,"overcount"
"1752",28,"Mississippi",6,"NHPI_AIC",323,309,-14,-4.43,"undercount"
"1753",28,"Mississippi",7,"A_A",2091,2315,224,10.17,"overcount"
"1754",28,"Mississippi",7,"A_AIC",2587,2701,114,4.31,"overcount"
"1755",28,"Mississippi",7,"NHPI_A",108,180,72,50,"overcount"
"1756",28,"Mississippi",7,"NHPI_AIC",239,226,-13,-5.59,"undercount"
"1757",28,"Mississippi",8,"A_A",2151,2423,272,11.89,"overcount"
"1758",28,"Mississippi",8,"A_AIC",2539,2709,170,6.48,"overcount"
"1759",28,"Mississippi",8,"NHPI_A",106,125,19,16.45,"overcount"
"1760",28,"Mississippi",8,"NHPI_AIC",245,194,-51,-23.23,"undercount"
"1761",28,"Mississippi",9,"A_A",2195,2135,-60,-2.77,"undercount"
"1762",28,"Mississippi",9,"A_AIC",2521,2341,-180,-7.4,"undercount"
"1763",28,"Mississippi",9,"NHPI_A",73,110,37,40.44,"overcount"
"1764",28,"Mississippi",9,"NHPI_AIC",155,184,29,17.11,"overcount"
"1765",28,"Mississippi",10,"A_A",1804,1921,117,6.28,"overcount"
"1766",28,"Mississippi",10,"A_AIC",2093,2134,41,1.94,"overcount"
"1767",28,"Mississippi",10,"NHPI_A",83,88,5,5.85,"overcount"
"1768",28,"Mississippi",10,"NHPI_AIC",174,189,15,8.26,"overcount"
"1769",28,"Mississippi",11,"A_A",1567,1691,124,7.61,"overcount"
"1770",28,"Mississippi",11,"A_AIC",1861,1867,6,0.32,"overcount"
"1771",28,"Mississippi",11,"NHPI_A",60,73,13,19.55,"overcount"
"1772",28,"Mississippi",11,"NHPI_AIC",155,131,-24,-16.78,"undercount"
"1773",28,"Mississippi",12,"A_A",1299,1417,118,8.69,"overcount"
"1774",28,"Mississippi",12,"A_AIC",1560,1534,-26,-1.68,"undercount"
"1775",28,"Mississippi",12,"NHPI_A",70,41,-29,-52.25,"undercount"
"1776",28,"Mississippi",12,"NHPI_AIC",127,87,-40,-37.38,"undercount"
"1777",28,"Mississippi",13,"A_A",1054,1012,-42,-4.07,"undercount"
"1778",28,"Mississippi",13,"A_AIC",1196,1026,-170,-15.3,"undercount"
"1779",28,"Mississippi",13,"NHPI_A",36,41,5,12.99,"overcount"
"1780",28,"Mississippi",13,"NHPI_AIC",84,79,-5,-6.13,"undercount"
"1781",28,"Mississippi",14,"A_A",702,700,-2,-0.29,"undercount"
"1782",28,"Mississippi",14,"A_AIC",807,668,-139,-18.85,"undercount"
"1783",28,"Mississippi",14,"NHPI_A",28,14,-14,-66.67,"undercount"
"1784",28,"Mississippi",14,"NHPI_AIC",63,44,-19,-35.51,"undercount"
"1785",28,"Mississippi",15,"A_A",531,468,-63,-12.61,"undercount"
"1786",28,"Mississippi",15,"A_AIC",613,350,-263,-54.62,"undercount"
"1787",28,"Mississippi",15,"NHPI_A",25,12,-13,-70.27,"undercount"
"1788",28,"Mississippi",15,"NHPI_AIC",70,33,-37,-71.84,"undercount"
"1789",28,"Mississippi",16,"A_A",358,281,-77,-24.1,"undercount"
"1790",28,"Mississippi",16,"A_AIC",433,277,-156,-43.94,"undercount"
"1791",28,"Mississippi",16,"NHPI_A",14,17,3,19.35,"overcount"
"1792",28,"Mississippi",16,"NHPI_AIC",47,26,-21,-57.53,"undercount"
"1793",28,"Mississippi",17,"A_A",221,185,-36,-17.73,"undercount"
"1794",28,"Mississippi",17,"A_AIC",293,144,-149,-68.19,"undercount"
"1795",28,"Mississippi",17,"NHPI_A",13,9,-4,-36.36,"undercount"
"1796",28,"Mississippi",17,"NHPI_AIC",46,8,-38,-140.74,"undercount"
"1797",28,"Mississippi",18,"A_A",182,106,-76,-52.78,"undercount"
"1798",28,"Mississippi",18,"A_AIC",236,91,-145,-88.69,"undercount"
"1799",28,"Mississippi",18,"NHPI_A",6,5,-1,-18.18,"undercount"
"1800",28,"Mississippi",18,"NHPI_AIC",50,5,-45,-163.64,"undercount"
"1801",29,"Missouri",1,"A_A",8023,6960,-1063,-14.19,"undercount"
"1802",29,"Missouri",1,"A_AIC",11425,11277,-148,-1.3,"undercount"
"1803",29,"Missouri",1,"NHPI_A",538,756,218,33.69,"overcount"
"1804",29,"Missouri",1,"NHPI_AIC",1085,1475,390,30.47,"overcount"
"1805",29,"Missouri",2,"A_A",7374,7235,-139,-1.9,"undercount"
"1806",29,"Missouri",2,"A_AIC",10253,10729,476,4.54,"overcount"
"1807",29,"Missouri",2,"NHPI_A",524,686,162,26.78,"overcount"
"1808",29,"Missouri",2,"NHPI_AIC",1082,1238,156,13.45,"overcount"
"1809",29,"Missouri",3,"A_A",6107,6165,58,0.95,"overcount"
"1810",29,"Missouri",3,"A_AIC",8578,9104,526,5.95,"overcount"
"1811",29,"Missouri",3,"NHPI_A",386,625,239,47.28,"overcount"
"1812",29,"Missouri",3,"NHPI_AIC",878,1117,239,23.96,"overcount"
"1813",29,"Missouri",4,"A_A",5580,6808,1228,19.83,"overcount"
"1814",29,"Missouri",4,"A_AIC",7834,9394,1560,18.11,"overcount"
"1815",29,"Missouri",4,"NHPI_A",395,698,303,55.44,"overcount"
"1816",29,"Missouri",4,"NHPI_AIC",1111,1232,121,10.33,"overcount"
"1817",29,"Missouri",5,"A_A",6900,10019,3119,36.87,"overcount"
"1818",29,"Missouri",5,"A_AIC",8997,12220,3223,30.38,"overcount"
"1819",29,"Missouri",5,"NHPI_A",456,749,293,48.63,"overcount"
"1820",29,"Missouri",5,"NHPI_AIC",1064,1168,104,9.32,"overcount"
"1821",29,"Missouri",6,"A_A",7583,9973,2390,27.23,"overcount"
"1822",29,"Missouri",6,"A_AIC",9104,11810,2706,25.88,"overcount"
"1823",29,"Missouri",6,"NHPI_A",406,748,342,59.27,"overcount"
"1824",29,"Missouri",6,"NHPI_AIC",797,1138,341,35.25,"overcount"
"1825",29,"Missouri",7,"A_A",8453,9535,1082,12.03,"overcount"
"1826",29,"Missouri",7,"A_AIC",9787,11064,1277,12.25,"overcount"
"1827",29,"Missouri",7,"NHPI_A",572,680,108,17.25,"overcount"
"1828",29,"Missouri",7,"NHPI_AIC",851,961,110,12.14,"overcount"
"1829",29,"Missouri",8,"A_A",9479,9416,-63,-0.67,"undercount"
"1830",29,"Missouri",8,"A_AIC",10638,10668,30,0.28,"overcount"
"1831",29,"Missouri",8,"NHPI_A",474,539,65,12.83,"overcount"
"1832",29,"Missouri",8,"NHPI_AIC",760,746,-14,-1.86,"undercount"
"1833",29,"Missouri",9,"A_A",7606,7711,105,1.37,"overcount"
"1834",29,"Missouri",9,"A_AIC",8457,8581,124,1.46,"overcount"
"1835",29,"Missouri",9,"NHPI_A",310,436,126,33.78,"overcount"
"1836",29,"Missouri",9,"NHPI_AIC",528,598,70,12.43,"overcount"
"1837",29,"Missouri",10,"A_A",6209,6307,98,1.57,"overcount"
"1838",29,"Missouri",10,"A_AIC",6977,7104,127,1.8,"overcount"
"1839",29,"Missouri",10,"NHPI_A",301,376,75,22.16,"overcount"
"1840",29,"Missouri",10,"NHPI_AIC",491,589,98,18.15,"overcount"
"1841",29,"Missouri",11,"A_A",4963,5176,213,4.2,"overcount"
"1842",29,"Missouri",11,"A_AIC",5628,5840,212,3.7,"overcount"
"1843",29,"Missouri",11,"NHPI_A",281,324,43,14.21,"overcount"
"1844",29,"Missouri",11,"NHPI_AIC",469,499,30,6.2,"overcount"
"1845",29,"Missouri",12,"A_A",4162,4478,316,7.31,"overcount"
"1846",29,"Missouri",12,"A_AIC",4595,4914,319,6.71,"overcount"
"1847",29,"Missouri",12,"NHPI_A",214,216,2,0.93,"overcount"
"1848",29,"Missouri",12,"NHPI_AIC",335,330,-5,-1.5,"undercount"
"1849",29,"Missouri",13,"A_A",3606,3768,162,4.39,"overcount"
"1850",29,"Missouri",13,"A_AIC",3912,3914,2,0.05,"overcount"
"1851",29,"Missouri",13,"NHPI_A",147,150,3,2.02,"overcount"
"1852",29,"Missouri",13,"NHPI_AIC",221,221,0,0,"equal"
"1853",29,"Missouri",14,"A_A",2506,2614,108,4.22,"overcount"
"1854",29,"Missouri",14,"A_AIC",2740,2779,39,1.41,"overcount"
"1855",29,"Missouri",14,"NHPI_A",73,68,-5,-7.09,"undercount"
"1856",29,"Missouri",14,"NHPI_AIC",155,130,-25,-17.54,"undercount"
"1857",29,"Missouri",15,"A_A",1757,1843,86,4.78,"overcount"
"1858",29,"Missouri",15,"A_AIC",1952,1901,-51,-2.65,"undercount"
"1859",29,"Missouri",15,"NHPI_A",63,56,-7,-11.76,"undercount"
"1860",29,"Missouri",15,"NHPI_AIC",103,92,-11,-11.28,"undercount"
"1861",29,"Missouri",16,"A_A",1159,1135,-24,-2.09,"undercount"
"1862",29,"Missouri",16,"A_AIC",1306,1130,-176,-14.45,"undercount"
"1863",29,"Missouri",16,"NHPI_A",38,33,-5,-14.08,"undercount"
"1864",29,"Missouri",16,"NHPI_AIC",86,71,-15,-19.11,"undercount"
"1865",29,"Missouri",17,"A_A",727,662,-65,-9.36,"undercount"
"1866",29,"Missouri",17,"A_AIC",840,673,-167,-22.08,"undercount"
"1867",29,"Missouri",17,"NHPI_A",38,18,-20,-71.43,"undercount"
"1868",29,"Missouri",17,"NHPI_AIC",87,40,-47,-74.02,"undercount"
"1869",29,"Missouri",18,"A_A",528,408,-120,-25.64,"undercount"
"1870",29,"Missouri",18,"A_AIC",616,412,-204,-39.69,"undercount"
"1871",29,"Missouri",18,"NHPI_A",47,20,-27,-80.6,"undercount"
"1872",29,"Missouri",18,"NHPI_AIC",89,38,-51,-80.31,"undercount"
"1873",30,"Montana",1,"A_A",588,309,-279,-62.21,"undercount"
"1874",30,"Montana",1,"A_AIC",1277,974,-303,-26.92,"undercount"
"1875",30,"Montana",1,"NHPI_A",57,36,-21,-45.16,"undercount"
"1876",30,"Montana",1,"NHPI_AIC",189,183,-6,-3.23,"undercount"
"1877",30,"Montana",2,"A_A",539,365,-174,-38.5,"undercount"
"1878",30,"Montana",2,"A_AIC",1080,904,-176,-17.74,"undercount"
"1879",30,"Montana",2,"NHPI_A",78,51,-27,-41.86,"undercount"
"1880",30,"Montana",2,"NHPI_AIC",181,182,1,0.55,"overcount"
"1881",30,"Montana",3,"A_A",493,356,-137,-32.27,"undercount"
"1882",30,"Montana",3,"A_AIC",977,898,-79,-8.43,"undercount"
"1883",30,"Montana",3,"NHPI_A",60,52,-8,-14.29,"undercount"
"1884",30,"Montana",3,"NHPI_AIC",166,181,15,8.65,"overcount"
"1885",30,"Montana",4,"A_A",556,563,7,1.25,"overcount"
"1886",30,"Montana",4,"A_AIC",975,1053,78,7.69,"overcount"
"1887",30,"Montana",4,"NHPI_A",68,81,13,17.45,"overcount"
"1888",30,"Montana",4,"NHPI_AIC",151,194,43,24.93,"overcount"
"1889",30,"Montana",5,"A_A",861,749,-112,-13.91,"undercount"
"1890",30,"Montana",5,"A_AIC",1274,1161,-113,-9.28,"undercount"
"1891",30,"Montana",5,"NHPI_A",51,89,38,54.29,"overcount"
"1892",30,"Montana",5,"NHPI_AIC",155,177,22,13.25,"overcount"
"1893",30,"Montana",6,"A_A",539,557,18,3.28,"overcount"
"1894",30,"Montana",6,"A_AIC",851,863,12,1.4,"overcount"
"1895",30,"Montana",6,"NHPI_A",81,61,-20,-28.17,"undercount"
"1896",30,"Montana",6,"NHPI_AIC",161,143,-18,-11.84,"undercount"
"1897",30,"Montana",7,"A_A",453,518,65,13.39,"overcount"
"1898",30,"Montana",7,"A_AIC",636,743,107,15.52,"overcount"
"1899",30,"Montana",7,"NHPI_A",71,64,-7,-10.37,"undercount"
"1900",30,"Montana",7,"NHPI_AIC",128,109,-19,-16.03,"undercount"
"1901",30,"Montana",8,"A_A",552,486,-66,-12.72,"undercount"
"1902",30,"Montana",8,"A_AIC",706,669,-37,-5.38,"undercount"
"1903",30,"Montana",8,"NHPI_A",52,57,5,9.17,"overcount"
"1904",30,"Montana",8,"NHPI_AIC",93,94,1,1.07,"overcount"
"1905",30,"Montana",9,"A_A",480,471,-9,-1.89,"undercount"
"1906",30,"Montana",9,"A_AIC",599,591,-8,-1.34,"undercount"
"1907",30,"Montana",9,"NHPI_A",56,42,-14,-28.57,"undercount"
"1908",30,"Montana",9,"NHPI_AIC",83,85,2,2.38,"overcount"
"1909",30,"Montana",10,"A_A",378,444,66,16.06,"overcount"
"1910",30,"Montana",10,"A_AIC",525,583,58,10.47,"overcount"
"1911",30,"Montana",10,"NHPI_A",39,51,12,26.67,"overcount"
"1912",30,"Montana",10,"NHPI_AIC",95,89,-6,-6.52,"undercount"
"1913",30,"Montana",11,"A_A",384,425,41,10.14,"overcount"
"1914",30,"Montana",11,"A_AIC",498,520,22,4.32,"overcount"
"1915",30,"Montana",11,"NHPI_A",43,44,1,2.3,"overcount"
"1916",30,"Montana",11,"NHPI_AIC",91,71,-20,-24.69,"undercount"
"1917",30,"Montana",12,"A_A",334,358,24,6.94,"overcount"
"1918",30,"Montana",12,"A_AIC",416,442,26,6.06,"overcount"
"1919",30,"Montana",12,"NHPI_A",32,28,-4,-13.33,"undercount"
"1920",30,"Montana",12,"NHPI_AIC",56,65,9,14.88,"overcount"
"1921",30,"Montana",13,"A_A",258,310,52,18.31,"overcount"
"1922",30,"Montana",13,"A_AIC",316,335,19,5.84,"overcount"
"1923",30,"Montana",13,"NHPI_A",28,29,1,3.51,"overcount"
"1924",30,"Montana",13,"NHPI_AIC",45,50,5,10.53,"overcount"
"1925",30,"Montana",14,"A_A",129,150,21,15.05,"overcount"
"1926",30,"Montana",14,"A_AIC",155,159,4,2.55,"overcount"
"1927",30,"Montana",14,"NHPI_A",29,23,-6,-23.08,"undercount"
"1928",30,"Montana",14,"NHPI_AIC",44,27,-17,-47.89,"undercount"
"1929",30,"Montana",15,"A_A",121,111,-10,-8.62,"undercount"
"1930",30,"Montana",15,"A_AIC",158,120,-38,-27.34,"undercount"
"1931",30,"Montana",15,"NHPI_A",19,17,-2,-11.11,"undercount"
"1932",30,"Montana",15,"NHPI_AIC",29,10,-19,-97.44,"undercount"
"1933",30,"Montana",16,"A_A",121,96,-25,-23.04,"undercount"
"1934",30,"Montana",16,"A_AIC",136,53,-83,-87.83,"undercount"
"1935",30,"Montana",16,"NHPI_A",18,6,-12,-100,"undercount"
"1936",30,"Montana",16,"NHPI_AIC",23,6,-17,-117.24,"undercount"
"1937",30,"Montana",17,"A_A",58,61,3,5.04,"overcount"
"1938",30,"Montana",17,"A_AIC",79,31,-48,-87.27,"undercount"
"1939",30,"Montana",17,"NHPI_A",10,2,-8,-133.33,"undercount"
"1940",30,"Montana",17,"NHPI_AIC",22,4,-18,-138.46,"undercount"
"1941",30,"Montana",18,"A_A",71,50,-21,-34.71,"undercount"
"1942",30,"Montana",18,"A_AIC",86,37,-49,-79.67,"undercount"
"1943",30,"Montana",18,"NHPI_A",17,1,-16,-177.78,"undercount"
"1944",30,"Montana",18,"NHPI_AIC",27,8,-19,-108.57,"undercount"
"1945",31,"Nebraska",1,"A_A",3122,2669,-453,-15.64,"undercount"
"1946",31,"Nebraska",1,"A_AIC",4413,4215,-198,-4.59,"undercount"
"1947",31,"Nebraska",1,"NHPI_A",214,258,44,18.64,"overcount"
"1948",31,"Nebraska",1,"NHPI_AIC",394,481,87,19.89,"overcount"
"1949",31,"Nebraska",2,"A_A",2784,2747,-37,-1.34,"undercount"
"1950",31,"Nebraska",2,"A_AIC",3802,3928,126,3.26,"overcount"
"1951",31,"Nebraska",2,"NHPI_A",187,206,19,9.67,"overcount"
"1952",31,"Nebraska",2,"NHPI_AIC",324,321,-3,-0.93,"undercount"
"1953",31,"Nebraska",3,"A_A",2269,2272,3,0.13,"overcount"
"1954",31,"Nebraska",3,"A_AIC",3143,3272,129,4.02,"overcount"
"1955",31,"Nebraska",3,"NHPI_A",171,162,-9,-5.41,"undercount"
"1956",31,"Nebraska",3,"NHPI_AIC",284,303,19,6.47,"overcount"
"1957",31,"Nebraska",4,"A_A",2237,2448,211,9.01,"overcount"
"1958",31,"Nebraska",4,"A_AIC",3012,3292,280,8.88,"overcount"
"1959",31,"Nebraska",4,"NHPI_A",180,174,-6,-3.39,"undercount"
"1960",31,"Nebraska",4,"NHPI_AIC",326,308,-18,-5.68,"undercount"
"1961",31,"Nebraska",5,"A_A",2551,3407,856,28.73,"overcount"
"1962",31,"Nebraska",5,"A_AIC",3234,4143,909,24.64,"overcount"
"1963",31,"Nebraska",5,"NHPI_A",232,233,1,0.43,"overcount"
"1964",31,"Nebraska",5,"NHPI_AIC",374,350,-24,-6.63,"undercount"
"1965",31,"Nebraska",6,"A_A",2831,3620,789,24.46,"overcount"
"1966",31,"Nebraska",6,"A_AIC",3432,4230,798,20.83,"overcount"
"1967",31,"Nebraska",6,"NHPI_A",162,210,48,25.81,"overcount"
"1968",31,"Nebraska",6,"NHPI_AIC",276,297,21,7.33,"overcount"
"1969",31,"Nebraska",7,"A_A",2621,3062,441,15.52,"overcount"
"1970",31,"Nebraska",7,"A_AIC",3054,3521,467,14.21,"overcount"
"1971",31,"Nebraska",7,"NHPI_A",138,199,61,36.2,"overcount"
"1972",31,"Nebraska",7,"NHPI_AIC",226,273,47,18.84,"overcount"
"1973",31,"Nebraska",8,"A_A",3037,3021,-16,-0.53,"undercount"
"1974",31,"Nebraska",8,"A_AIC",3371,3419,48,1.41,"overcount"
"1975",31,"Nebraska",8,"NHPI_A",136,156,20,13.7,"overcount"
"1976",31,"Nebraska",8,"NHPI_AIC",189,209,20,10.05,"overcount"
"1977",31,"Nebraska",9,"A_A",2440,2481,41,1.67,"overcount"
"1978",31,"Nebraska",9,"A_AIC",2718,2738,20,0.73,"overcount"
"1979",31,"Nebraska",9,"NHPI_A",99,111,12,11.43,"overcount"
"1980",31,"Nebraska",9,"NHPI_AIC",164,146,-18,-11.61,"undercount"
"1981",31,"Nebraska",10,"A_A",1741,1860,119,6.61,"overcount"
"1982",31,"Nebraska",10,"A_AIC",1964,2077,113,5.59,"overcount"
"1983",31,"Nebraska",10,"NHPI_A",69,100,31,36.69,"overcount"
"1984",31,"Nebraska",10,"NHPI_AIC",128,143,15,11.07,"overcount"
"1985",31,"Nebraska",11,"A_A",1457,1534,77,5.15,"overcount"
"1986",31,"Nebraska",11,"A_AIC",1642,1671,29,1.75,"overcount"
"1987",31,"Nebraska",11,"NHPI_A",68,92,24,30,"overcount"
"1988",31,"Nebraska",11,"NHPI_AIC",129,126,-3,-2.35,"undercount"
"1989",31,"Nebraska",12,"A_A",1225,1318,93,7.31,"overcount"
"1990",31,"Nebraska",12,"A_AIC",1353,1315,-38,-2.85,"undercount"
"1991",31,"Nebraska",12,"NHPI_A",52,62,10,17.54,"overcount"
"1992",31,"Nebraska",12,"NHPI_AIC",84,81,-3,-3.64,"undercount"
"1993",31,"Nebraska",13,"A_A",1095,1115,20,1.81,"overcount"
"1994",31,"Nebraska",13,"A_AIC",1181,1071,-110,-9.77,"undercount"
"1995",31,"Nebraska",13,"NHPI_A",46,39,-7,-16.47,"undercount"
"1996",31,"Nebraska",13,"NHPI_AIC",75,54,-21,-32.56,"undercount"
"1997",31,"Nebraska",14,"A_A",720,716,-4,-0.56,"undercount"
"1998",31,"Nebraska",14,"A_AIC",756,656,-100,-14.16,"undercount"
"1999",31,"Nebraska",14,"NHPI_A",37,24,-13,-42.62,"undercount"
"2000",31,"Nebraska",14,"NHPI_AIC",43,40,-3,-7.23,"undercount"
"2001",31,"Nebraska",15,"A_A",472,478,6,1.26,"overcount"
"2002",31,"Nebraska",15,"A_AIC",521,438,-83,-17.31,"undercount"
"2003",31,"Nebraska",15,"NHPI_A",14,22,8,44.44,"overcount"
"2004",31,"Nebraska",15,"NHPI_AIC",32,29,-3,-9.84,"undercount"
"2005",31,"Nebraska",16,"A_A",273,275,2,0.73,"overcount"
"2006",31,"Nebraska",16,"A_AIC",313,243,-70,-25.18,"undercount"
"2007",31,"Nebraska",16,"NHPI_A",6,7,1,15.38,"overcount"
"2008",31,"Nebraska",16,"NHPI_AIC",15,10,-5,-40,"undercount"
"2009",31,"Nebraska",17,"A_A",177,174,-3,-1.71,"undercount"
"2010",31,"Nebraska",17,"A_AIC",203,165,-38,-20.65,"undercount"
"2011",31,"Nebraska",17,"NHPI_A",9,4,-5,-76.92,"undercount"
"2012",31,"Nebraska",17,"NHPI_AIC",22,9,-13,-83.87,"undercount"
"2013",31,"Nebraska",18,"A_A",183,125,-58,-37.66,"undercount"
"2014",31,"Nebraska",18,"A_AIC",215,99,-116,-73.89,"undercount"
"2015",31,"Nebraska",18,"NHPI_A",13,2,-11,-146.67,"undercount"
"2016",31,"Nebraska",18,"NHPI_AIC",20,4,-16,-133.33,"undercount"
"2017",32,"Nevada",1,"A_A",11070,10420,-650,-6.05,"undercount"
"2018",32,"Nevada",1,"A_AIC",17073,18068,995,5.66,"overcount"
"2019",32,"Nevada",1,"NHPI_A",1435,1608,173,11.37,"overcount"
"2020",32,"Nevada",1,"NHPI_AIC",3144,3901,757,21.49,"overcount"
"2021",32,"Nevada",2,"A_A",11236,11354,118,1.04,"overcount"
"2022",32,"Nevada",2,"A_AIC",16632,17801,1169,6.79,"overcount"
"2023",32,"Nevada",2,"NHPI_A",1421,1623,202,13.27,"overcount"
"2024",32,"Nevada",2,"NHPI_AIC",3156,3607,451,13.34,"overcount"
"2025",32,"Nevada",3,"A_A",9555,12088,2533,23.41,"overcount"
"2026",32,"Nevada",3,"A_AIC",13432,17681,4249,27.31,"overcount"
"2027",32,"Nevada",3,"NHPI_A",1126,1512,386,29.26,"overcount"
"2028",32,"Nevada",3,"NHPI_AIC",2380,3177,797,28.68,"overcount"
"2029",32,"Nevada",4,"A_A",9010,12441,3431,31.99,"overcount"
"2030",32,"Nevada",4,"A_AIC",12052,17086,5034,34.55,"overcount"
"2031",32,"Nevada",4,"NHPI_A",1023,1554,531,41.21,"overcount"
"2032",32,"Nevada",4,"NHPI_AIC",2007,3089,1082,42.46,"overcount"
"2033",32,"Nevada",5,"A_A",9600,13401,3801,33.05,"overcount"
"2034",32,"Nevada",5,"A_AIC",12258,17266,5008,33.92,"overcount"
"2035",32,"Nevada",5,"NHPI_A",1053,1756,703,50.05,"overcount"
"2036",32,"Nevada",5,"NHPI_AIC",1940,3106,1166,46.21,"overcount"
"2037",32,"Nevada",6,"A_A",13415,15450,2035,14.1,"overcount"
"2038",32,"Nevada",6,"A_AIC",16323,19328,3005,16.86,"overcount"
"2039",32,"Nevada",6,"NHPI_A",1235,1898,663,42.32,"overcount"
"2040",32,"Nevada",6,"NHPI_AIC",2281,3243,962,34.83,"overcount"
"2041",32,"Nevada",7,"A_A",15111,15925,814,5.25,"overcount"
"2042",32,"Nevada",7,"A_AIC",17495,19337,1842,10,"overcount"
"2043",32,"Nevada",7,"NHPI_A",1366,1747,381,24.48,"overcount"
"2044",32,"Nevada",7,"NHPI_AIC",2429,2918,489,18.29,"overcount"
"2045",32,"Nevada",8,"A_A",15792,17237,1445,8.75,"overcount"
"2046",32,"Nevada",8,"A_AIC",17741,20060,2319,12.27,"overcount"
"2047",32,"Nevada",8,"NHPI_A",1144,1510,366,27.58,"overcount"
"2048",32,"Nevada",8,"NHPI_AIC",1906,2479,573,26.13,"overcount"
"2049",32,"Nevada",9,"A_A",14676,16505,1829,11.73,"overcount"
"2050",32,"Nevada",9,"A_AIC",16146,18626,2480,14.26,"overcount"
"2051",32,"Nevada",9,"NHPI_A",1076,1302,226,19.01,"overcount"
"2052",32,"Nevada",9,"NHPI_AIC",1785,2163,378,19.15,"overcount"
"2053",32,"Nevada",10,"A_A",13881,15941,2060,13.82,"overcount"
"2054",32,"Nevada",10,"A_AIC",15248,17641,2393,14.55,"overcount"
"2055",32,"Nevada",10,"NHPI_A",909,1230,321,30.01,"overcount"
"2056",32,"Nevada",10,"NHPI_AIC",1606,1986,380,21.16,"overcount"
"2057",32,"Nevada",11,"A_A",12919,14927,2008,14.42,"overcount"
"2058",32,"Nevada",11,"A_AIC",14112,16281,2169,14.27,"overcount"
"2059",32,"Nevada",11,"NHPI_A",810,948,138,15.7,"overcount"
"2060",32,"Nevada",11,"NHPI_AIC",1415,1555,140,9.43,"overcount"
"2061",32,"Nevada",12,"A_A",12034,13670,1636,12.73,"overcount"
"2062",32,"Nevada",12,"A_AIC",12925,14686,1761,12.76,"overcount"
"2063",32,"Nevada",12,"NHPI_A",668,828,160,21.39,"overcount"
"2064",32,"Nevada",12,"NHPI_AIC",1133,1288,155,12.8,"overcount"
"2065",32,"Nevada",13,"A_A",10669,12042,1373,12.09,"overcount"
"2066",32,"Nevada",13,"A_AIC",11354,12831,1477,12.21,"overcount"
"2067",32,"Nevada",13,"NHPI_A",532,665,133,22.22,"overcount"
"2068",32,"Nevada",13,"NHPI_AIC",905,1062,157,15.96,"overcount"
"2069",32,"Nevada",14,"A_A",7581,8622,1041,12.85,"overcount"
"2070",32,"Nevada",14,"A_AIC",8046,9149,1103,12.83,"overcount"
"2071",32,"Nevada",14,"NHPI_A",417,492,75,16.5,"overcount"
"2072",32,"Nevada",14,"NHPI_AIC",666,797,131,17.91,"overcount"
"2073",32,"Nevada",15,"A_A",5654,6181,527,8.91,"overcount"
"2074",32,"Nevada",15,"A_AIC",5969,6536,567,9.07,"overcount"
"2075",32,"Nevada",15,"NHPI_A",262,319,57,19.62,"overcount"
"2076",32,"Nevada",15,"NHPI_AIC",453,491,38,8.05,"overcount"
"2077",32,"Nevada",16,"A_A",4001,3966,-35,-0.88,"undercount"
"2078",32,"Nevada",16,"A_AIC",4203,4198,-5,-0.12,"undercount"
"2079",32,"Nevada",16,"NHPI_A",183,156,-27,-15.93,"undercount"
"2080",32,"Nevada",16,"NHPI_AIC",276,256,-20,-7.52,"undercount"
"2081",32,"Nevada",17,"A_A",2407,2132,-275,-12.12,"undercount"
"2082",32,"Nevada",17,"A_AIC",2540,2231,-309,-12.95,"undercount"
"2083",32,"Nevada",17,"NHPI_A",81,100,19,20.99,"overcount"
"2084",32,"Nevada",17,"NHPI_AIC",144,156,12,8,"overcount"
"2085",32,"Nevada",18,"A_A",1689,1176,-513,-35.81,"undercount"
"2086",32,"Nevada",18,"A_AIC",1797,1250,-547,-35.9,"undercount"
"2087",32,"Nevada",18,"NHPI_A",56,59,3,5.22,"overcount"
"2088",32,"Nevada",18,"NHPI_AIC",91,94,3,3.24,"overcount"
"2089",33,"New Hampshire",1,"A_A",2380,2390,10,0.42,"overcount"
"2090",33,"New Hampshire",1,"A_AIC",3188,3479,291,8.73,"overcount"
"2091",33,"New Hampshire",1,"NHPI_A",52,36,-16,-36.36,"undercount"
"2092",33,"New Hampshire",1,"NHPI_AIC",110,111,1,0.9,"overcount"
"2093",33,"New Hampshire",2,"A_A",2296,2335,39,1.68,"overcount"
"2094",33,"New Hampshire",2,"A_AIC",3163,3287,124,3.84,"overcount"
"2095",33,"New Hampshire",2,"NHPI_A",55,36,-19,-41.76,"undercount"
"2096",33,"New Hampshire",2,"NHPI_AIC",123,106,-17,-14.85,"undercount"
"2097",33,"New Hampshire",3,"A_A",1771,1917,146,7.92,"overcount"
"2098",33,"New Hampshire",3,"A_AIC",2338,2741,403,15.87,"overcount"
"2099",33,"New Hampshire",3,"NHPI_A",43,40,-3,-7.23,"undercount"
"2100",33,"New Hampshire",3,"NHPI_AIC",77,120,43,43.65,"overcount"
"2101",33,"New Hampshire",4,"A_A",1466,1810,344,21,"overcount"
"2102",33,"New Hampshire",4,"A_AIC",2017,2518,501,22.09,"overcount"
"2103",33,"New Hampshire",4,"NHPI_A",44,50,6,12.77,"overcount"
"2104",33,"New Hampshire",4,"NHPI_AIC",124,119,-5,-4.12,"undercount"
"2105",33,"New Hampshire",5,"A_A",1683,2221,538,27.56,"overcount"
"2106",33,"New Hampshire",5,"A_AIC",2111,2694,583,24.27,"overcount"
"2107",33,"New Hampshire",5,"NHPI_A",65,60,-5,-8,"undercount"
"2108",33,"New Hampshire",5,"NHPI_AIC",123,111,-12,-10.26,"undercount"
"2109",33,"New Hampshire",6,"A_A",1944,2533,589,26.31,"overcount"
"2110",33,"New Hampshire",6,"A_AIC",2236,2860,624,24.49,"overcount"
"2111",33,"New Hampshire",6,"NHPI_A",51,35,-16,-37.21,"undercount"
"2112",33,"New Hampshire",6,"NHPI_AIC",94,87,-7,-7.73,"undercount"
"2113",33,"New Hampshire",7,"A_A",2536,2946,410,14.96,"overcount"
"2114",33,"New Hampshire",7,"A_AIC",2785,3246,461,15.29,"overcount"
"2115",33,"New Hampshire",7,"NHPI_A",71,32,-39,-75.73,"undercount"
"2116",33,"New Hampshire",7,"NHPI_AIC",104,70,-34,-39.08,"undercount"
"2117",33,"New Hampshire",8,"A_A",2919,3123,204,6.75,"overcount"
"2118",33,"New Hampshire",8,"A_AIC",3159,3394,235,7.17,"overcount"
"2119",33,"New Hampshire",8,"NHPI_A",49,48,-1,-2.06,"undercount"
"2120",33,"New Hampshire",8,"NHPI_AIC",76,108,32,34.78,"overcount"
"2121",33,"New Hampshire",9,"A_A",2274,2434,160,6.8,"overcount"
"2122",33,"New Hampshire",9,"A_AIC",2481,2680,199,7.71,"overcount"
"2123",33,"New Hampshire",9,"NHPI_A",34,41,7,18.67,"overcount"
"2124",33,"New Hampshire",9,"NHPI_AIC",80,85,5,6.06,"overcount"
"2125",33,"New Hampshire",10,"A_A",1817,1992,175,9.19,"overcount"
"2126",33,"New Hampshire",10,"A_AIC",1989,2207,218,10.39,"overcount"
"2127",33,"New Hampshire",10,"NHPI_A",51,54,3,5.71,"overcount"
"2128",33,"New Hampshire",10,"NHPI_AIC",98,96,-2,-2.06,"undercount"
"2129",33,"New Hampshire",11,"A_A",1442,1526,84,5.66,"overcount"
"2130",33,"New Hampshire",11,"A_AIC",1577,1688,111,6.8,"overcount"
"2131",33,"New Hampshire",11,"NHPI_A",26,46,20,55.56,"overcount"
"2132",33,"New Hampshire",11,"NHPI_AIC",55,75,20,30.77,"overcount"
"2133",33,"New Hampshire",12,"A_A",1204,1298,94,7.51,"overcount"
"2134",33,"New Hampshire",12,"A_AIC",1289,1409,120,8.9,"overcount"
"2135",33,"New Hampshire",12,"NHPI_A",34,24,-10,-34.48,"undercount"
"2136",33,"New Hampshire",12,"NHPI_AIC",55,49,-6,-11.54,"undercount"
"2137",33,"New Hampshire",13,"A_A",918,973,55,5.82,"overcount"
"2138",33,"New Hampshire",13,"A_AIC",1013,989,-24,-2.4,"undercount"
"2139",33,"New Hampshire",13,"NHPI_A",25,19,-6,-27.27,"undercount"
"2140",33,"New Hampshire",13,"NHPI_AIC",44,31,-13,-34.67,"undercount"
"2141",33,"New Hampshire",14,"A_A",653,627,-26,-4.06,"undercount"
"2142",33,"New Hampshire",14,"A_AIC",704,641,-63,-9.37,"undercount"
"2143",33,"New Hampshire",14,"NHPI_A",16,5,-11,-104.76,"undercount"
"2144",33,"New Hampshire",14,"NHPI_AIC",30,18,-12,-50,"undercount"
"2145",33,"New Hampshire",15,"A_A",412,323,-89,-24.22,"undercount"
"2146",33,"New Hampshire",15,"A_AIC",432,332,-100,-26.18,"undercount"
"2147",33,"New Hampshire",15,"NHPI_A",10,3,-7,-107.69,"undercount"
"2148",33,"New Hampshire",15,"NHPI_AIC",20,10,-10,-66.67,"undercount"
"2149",33,"New Hampshire",16,"A_A",277,257,-20,-7.49,"undercount"
"2150",33,"New Hampshire",16,"A_AIC",302,276,-26,-9,"undercount"
"2151",33,"New Hampshire",16,"NHPI_A",11,0,-11,-200,"undercount"
"2152",33,"New Hampshire",16,"NHPI_AIC",14,4,-10,-111.11,"undercount"
"2153",33,"New Hampshire",17,"A_A",151,130,-21,-14.95,"undercount"
"2154",33,"New Hampshire",17,"A_AIC",178,114,-64,-43.84,"undercount"
"2155",33,"New Hampshire",17,"NHPI_A",9,2,-7,-127.27,"undercount"
"2156",33,"New Hampshire",17,"NHPI_AIC",13,6,-7,-73.68,"undercount"
"2157",33,"New Hampshire",18,"A_A",164,98,-66,-50.38,"undercount"
"2158",33,"New Hampshire",18,"A_AIC",179,72,-107,-85.26,"undercount"
"2159",33,"New Hampshire",18,"NHPI_A",13,1,-12,-171.43,"undercount"
"2160",33,"New Hampshire",18,"NHPI_AIC",15,3,-12,-133.33,"undercount"
"2161",34,"New Jersey",1,"A_A",52323,52915,592,1.13,"overcount"
"2162",34,"New Jersey",1,"A_AIC",60630,63254,2624,4.24,"overcount"
"2163",34,"New Jersey",1,"NHPI_A",654,598,-56,-8.95,"undercount"
"2164",34,"New Jersey",1,"NHPI_AIC",1337,1224,-113,-8.82,"undercount"
"2165",34,"New Jersey",2,"A_A",51277,52472,1195,2.3,"overcount"
"2166",34,"New Jersey",2,"A_AIC",58560,61244,2684,4.48,"overcount"
"2167",34,"New Jersey",2,"NHPI_A",623,548,-75,-12.81,"undercount"
"2168",34,"New Jersey",2,"NHPI_AIC",1295,1132,-163,-13.43,"undercount"
"2169",34,"New Jersey",3,"A_A",45759,48073,2314,4.93,"overcount"
"2170",34,"New Jersey",3,"A_AIC",51061,55236,4175,7.86,"overcount"
"2171",34,"New Jersey",3,"NHPI_A",485,560,75,14.35,"overcount"
"2172",34,"New Jersey",3,"NHPI_AIC",1021,1111,90,8.44,"overcount"
"2173",34,"New Jersey",4,"A_A",40049,43972,3923,9.34,"overcount"
"2174",34,"New Jersey",4,"A_AIC",43709,49520,5811,12.47,"overcount"
"2175",34,"New Jersey",4,"NHPI_A",526,669,143,23.93,"overcount"
"2176",34,"New Jersey",4,"NHPI_AIC",1061,1315,254,21.38,"overcount"
"2177",34,"New Jersey",5,"A_A",37263,42810,5547,13.85,"overcount"
"2178",34,"New Jersey",5,"A_AIC",40429,46783,6354,14.57,"overcount"
"2179",34,"New Jersey",5,"NHPI_A",684,768,84,11.57,"overcount"
"2180",34,"New Jersey",5,"NHPI_AIC",1284,1517,233,16.64,"overcount"
"2181",34,"New Jersey",6,"A_A",52284,61749,9465,16.6,"overcount"
"2182",34,"New Jersey",6,"A_AIC",55525,65214,9689,16.05,"overcount"
"2183",34,"New Jersey",6,"NHPI_A",787,764,-23,-2.97,"undercount"
"2184",34,"New Jersey",6,"NHPI_AIC",1391,1396,5,0.36,"overcount"
"2185",34,"New Jersey",7,"A_A",62811,71101,8290,12.38,"overcount"
"2186",34,"New Jersey",7,"A_AIC",65879,74364,8485,12.1,"overcount"
"2187",34,"New Jersey",7,"NHPI_A",811,729,-82,-10.65,"undercount"
"2188",34,"New Jersey",7,"NHPI_AIC",1441,1328,-113,-8.16,"undercount"
"2189",34,"New Jersey",8,"A_A",66810,71800,4990,7.2,"overcount"
"2190",34,"New Jersey",8,"A_AIC",69797,74886,5089,7.03,"overcount"
"2191",34,"New Jersey",8,"NHPI_A",766,560,-206,-31.07,"undercount"
"2192",34,"New Jersey",8,"NHPI_AIC",1339,1179,-160,-12.71,"undercount"
"2193",34,"New Jersey",9,"A_A",60296,61961,1665,2.72,"overcount"
"2194",34,"New Jersey",9,"A_AIC",62859,64767,1908,2.99,"overcount"
"2195",34,"New Jersey",9,"NHPI_A",631,598,-33,-5.37,"undercount"
"2196",34,"New Jersey",9,"NHPI_AIC",1170,1183,13,1.1,"overcount"
"2197",34,"New Jersey",10,"A_A",55427,56869,1442,2.57,"overcount"
"2198",34,"New Jersey",10,"A_AIC",57985,59593,1608,2.74,"overcount"
"2199",34,"New Jersey",10,"NHPI_A",516,535,19,3.62,"overcount"
"2200",34,"New Jersey",10,"NHPI_AIC",1076,1108,32,2.93,"overcount"
"2201",34,"New Jersey",11,"A_A",48695,50832,2137,4.29,"overcount"
"2202",34,"New Jersey",11,"A_AIC",50971,53107,2136,4.1,"overcount"
"2203",34,"New Jersey",11,"NHPI_A",430,446,16,3.65,"overcount"
"2204",34,"New Jersey",11,"NHPI_AIC",920,948,28,3,"overcount"
"2205",34,"New Jersey",12,"A_A",37693,40454,2761,7.07,"overcount"
"2206",34,"New Jersey",12,"A_AIC",39373,42164,2791,6.85,"overcount"
"2207",34,"New Jersey",12,"NHPI_A",343,324,-19,-5.7,"undercount"
"2208",34,"New Jersey",12,"NHPI_AIC",689,717,28,3.98,"overcount"
"2209",34,"New Jersey",13,"A_A",31174,33395,2221,6.88,"overcount"
"2210",34,"New Jersey",13,"A_AIC",32385,34580,2195,6.56,"overcount"
"2211",34,"New Jersey",13,"NHPI_A",280,230,-50,-19.61,"undercount"
"2212",34,"New Jersey",13,"NHPI_AIC",517,543,26,4.91,"overcount"
"2213",34,"New Jersey",14,"A_A",21824,23114,1290,5.74,"overcount"
"2214",34,"New Jersey",14,"A_AIC",22584,23962,1378,5.92,"overcount"
"2215",34,"New Jersey",14,"NHPI_A",193,149,-44,-25.73,"undercount"
"2216",34,"New Jersey",14,"NHPI_AIC",366,342,-24,-6.78,"undercount"
"2217",34,"New Jersey",15,"A_A",15842,16088,246,1.54,"overcount"
"2218",34,"New Jersey",15,"A_AIC",16411,16723,312,1.88,"overcount"
"2219",34,"New Jersey",15,"NHPI_A",107,97,-10,-9.8,"undercount"
"2220",34,"New Jersey",15,"NHPI_AIC",237,256,19,7.71,"overcount"
"2221",34,"New Jersey",16,"A_A",10269,9596,-673,-6.78,"undercount"
"2222",34,"New Jersey",16,"A_AIC",10637,10035,-602,-5.82,"undercount"
"2223",34,"New Jersey",16,"NHPI_A",104,71,-33,-37.71,"undercount"
"2224",34,"New Jersey",16,"NHPI_AIC",199,162,-37,-20.5,"undercount"
"2225",34,"New Jersey",17,"A_A",6250,5317,-933,-16.13,"undercount"
"2226",34,"New Jersey",17,"A_AIC",6530,5654,-876,-14.38,"undercount"
"2227",34,"New Jersey",17,"NHPI_A",57,38,-19,-40,"undercount"
"2228",34,"New Jersey",17,"NHPI_AIC",121,138,17,13.13,"overcount"
"2229",34,"New Jersey",18,"A_A",5495,3694,-1801,-39.2,"undercount"
"2230",34,"New Jersey",18,"A_AIC",5728,3965,-1763,-36.38,"undercount"
"2231",34,"New Jersey",18,"NHPI_A",67,47,-20,-35.09,"undercount"
"2232",34,"New Jersey",18,"NHPI_AIC",136,159,23,15.59,"overcount"
"2233",35,"New Mexico",1,"A_A",2336,1747,-589,-28.85,"undercount"
"2234",35,"New Mexico",1,"A_AIC",3999,3480,-519,-13.88,"undercount"
"2235",35,"New Mexico",1,"NHPI_A",272,243,-29,-11.26,"undercount"
"2236",35,"New Mexico",1,"NHPI_AIC",564,587,23,4,"overcount"
"2237",35,"New Mexico",2,"A_A",2350,1941,-409,-19.06,"undercount"
"2238",35,"New Mexico",2,"A_AIC",3992,3343,-649,-17.7,"undercount"
"2239",35,"New Mexico",2,"NHPI_A",197,260,63,27.57,"overcount"
"2240",35,"New Mexico",2,"NHPI_AIC",432,521,89,18.68,"overcount"
"2241",35,"New Mexico",3,"A_A",2055,1867,-188,-9.59,"undercount"
"2242",35,"New Mexico",3,"A_AIC",3304,3102,-202,-6.31,"undercount"
"2243",35,"New Mexico",3,"NHPI_A",218,210,-8,-3.74,"undercount"
"2244",35,"New Mexico",3,"NHPI_AIC",437,431,-6,-1.38,"undercount"
"2245",35,"New Mexico",4,"A_A",1675,1791,116,6.69,"overcount"
"2246",35,"New Mexico",4,"A_AIC",2611,2875,264,9.62,"overcount"
"2247",35,"New Mexico",4,"NHPI_A",242,243,1,0.41,"overcount"
"2248",35,"New Mexico",4,"NHPI_AIC",432,451,19,4.3,"overcount"
"2249",35,"New Mexico",5,"A_A",1948,2012,64,3.23,"overcount"
"2250",35,"New Mexico",5,"A_AIC",2955,2981,26,0.88,"overcount"
"2251",35,"New Mexico",5,"NHPI_A",214,271,57,23.51,"overcount"
"2252",35,"New Mexico",5,"NHPI_AIC",415,461,46,10.5,"overcount"
"2253",35,"New Mexico",6,"A_A",2402,2344,-58,-2.44,"undercount"
"2254",35,"New Mexico",6,"A_AIC",3323,3213,-110,-3.37,"undercount"
"2255",35,"New Mexico",6,"NHPI_A",225,277,52,20.72,"overcount"
"2256",35,"New Mexico",6,"NHPI_AIC",406,458,52,12.04,"overcount"
"2257",35,"New Mexico",7,"A_A",2535,2490,-45,-1.79,"undercount"
"2258",35,"New Mexico",7,"A_AIC",3232,3210,-22,-0.68,"undercount"
"2259",35,"New Mexico",7,"NHPI_A",237,203,-34,-15.45,"undercount"
"2260",35,"New Mexico",7,"NHPI_AIC",410,360,-50,-12.99,"undercount"
"2261",35,"New Mexico",8,"A_A",2492,2482,-10,-0.4,"undercount"
"2262",35,"New Mexico",8,"A_AIC",3048,3025,-23,-0.76,"undercount"
"2263",35,"New Mexico",8,"NHPI_A",177,171,-6,-3.45,"undercount"
"2264",35,"New Mexico",8,"NHPI_AIC",334,259,-75,-25.3,"undercount"
"2265",35,"New Mexico",9,"A_A",2199,2340,141,6.21,"overcount"
"2266",35,"New Mexico",9,"A_AIC",2662,2842,180,6.54,"overcount"
"2267",35,"New Mexico",9,"NHPI_A",195,187,-8,-4.19,"undercount"
"2268",35,"New Mexico",9,"NHPI_AIC",302,319,17,5.48,"overcount"
"2269",35,"New Mexico",10,"A_A",2165,2185,20,0.92,"overcount"
"2270",35,"New Mexico",10,"A_AIC",2563,2651,88,3.38,"overcount"
"2271",35,"New Mexico",10,"NHPI_A",196,185,-11,-5.77,"undercount"
"2272",35,"New Mexico",10,"NHPI_AIC",321,308,-13,-4.13,"undercount"
"2273",35,"New Mexico",11,"A_A",1835,1933,98,5.2,"overcount"
"2274",35,"New Mexico",11,"A_AIC",2199,2367,168,7.36,"overcount"
"2275",35,"New Mexico",11,"NHPI_A",172,186,14,7.82,"overcount"
"2276",35,"New Mexico",11,"NHPI_AIC",261,305,44,15.55,"overcount"
"2277",35,"New Mexico",12,"A_A",1639,1699,60,3.59,"overcount"
"2278",35,"New Mexico",12,"A_AIC",1864,1956,92,4.82,"overcount"
"2279",35,"New Mexico",12,"NHPI_A",145,130,-15,-10.91,"undercount"
"2280",35,"New Mexico",12,"NHPI_AIC",217,200,-17,-8.15,"undercount"
"2281",35,"New Mexico",13,"A_A",1415,1430,15,1.05,"overcount"
"2282",35,"New Mexico",13,"A_AIC",1554,1612,58,3.66,"overcount"
"2283",35,"New Mexico",13,"NHPI_A",115,104,-11,-10.05,"undercount"
"2284",35,"New Mexico",13,"NHPI_AIC",155,145,-10,-6.67,"undercount"
"2285",35,"New Mexico",14,"A_A",945,897,-48,-5.21,"undercount"
"2286",35,"New Mexico",14,"A_AIC",1065,911,-154,-15.59,"undercount"
"2287",35,"New Mexico",14,"NHPI_A",79,45,-34,-54.84,"undercount"
"2288",35,"New Mexico",14,"NHPI_AIC",111,93,-18,-17.65,"undercount"
"2289",35,"New Mexico",15,"A_A",669,635,-34,-5.21,"undercount"
"2290",35,"New Mexico",15,"A_AIC",755,627,-128,-18.52,"undercount"
"2291",35,"New Mexico",15,"NHPI_A",48,47,-1,-2.11,"undercount"
"2292",35,"New Mexico",15,"NHPI_AIC",74,49,-25,-40.65,"undercount"
"2293",35,"New Mexico",16,"A_A",468,412,-56,-12.73,"undercount"
"2294",35,"New Mexico",16,"A_AIC",545,421,-124,-25.67,"undercount"
"2295",35,"New Mexico",16,"NHPI_A",36,35,-1,-2.82,"undercount"
"2296",35,"New Mexico",16,"NHPI_AIC",60,42,-18,-35.29,"undercount"
"2297",35,"New Mexico",17,"A_A",355,310,-45,-13.53,"undercount"
"2298",35,"New Mexico",17,"A_AIC",401,286,-115,-33.48,"undercount"
"2299",35,"New Mexico",17,"NHPI_A",29,18,-11,-46.81,"undercount"
"2300",35,"New Mexico",17,"NHPI_AIC",44,20,-24,-75,"undercount"
"2301",35,"New Mexico",18,"A_A",264,175,-89,-40.55,"undercount"
"2302",35,"New Mexico",18,"A_AIC",313,184,-129,-51.91,"undercount"
"2303",35,"New Mexico",18,"NHPI_A",25,9,-16,-94.12,"undercount"
"2304",35,"New Mexico",18,"NHPI_AIC",36,17,-19,-71.7,"undercount"
"2305",36,"New York",1,"A_A",100333,83953,-16380,-17.78,"undercount"
"2306",36,"New York",1,"A_AIC",117931,103795,-14136,-12.75,"undercount"
"2307",36,"New York",1,"NHPI_A",1623,1762,139,8.21,"overcount"
"2308",36,"New York",1,"NHPI_AIC",3443,3272,-171,-5.09,"undercount"
"2309",36,"New York",2,"A_A",95095,84672,-10423,-11.6,"undercount"
"2310",36,"New York",2,"A_AIC",110076,100472,-9604,-9.12,"undercount"
"2311",36,"New York",2,"NHPI_A",1464,1742,278,17.34,"overcount"
"2312",36,"New York",2,"NHPI_AIC",3217,3103,-114,-3.61,"undercount"
"2313",36,"New York",3,"A_A",80021,84255,4234,5.15,"overcount"
"2314",36,"New York",3,"A_AIC",90170,97232,7062,7.54,"overcount"
"2315",36,"New York",3,"NHPI_A",1487,1770,283,17.38,"overcount"
"2316",36,"New York",3,"NHPI_AIC",2850,3235,385,12.65,"overcount"
"2317",36,"New York",4,"A_A",81900,96979,15079,16.86,"overcount"
"2318",36,"New York",4,"A_AIC",90772,109434,18662,18.64,"overcount"
"2319",36,"New York",4,"NHPI_A",1695,2213,518,26.51,"overcount"
"2320",36,"New York",4,"NHPI_AIC",3170,3967,797,22.33,"overcount"
"2321",36,"New York",5,"A_A",92229,122603,30374,28.28,"overcount"
"2322",36,"New York",5,"A_AIC",101483,134628,33145,28.08,"overcount"
"2323",36,"New York",5,"NHPI_A",1867,2517,650,29.65,"overcount"
"2324",36,"New York",5,"NHPI_AIC",3405,4394,989,25.36,"overcount"
"2325",36,"New York",6,"A_A",111904,135182,23278,18.84,"overcount"
"2326",36,"New York",6,"A_AIC",120950,146475,25525,19.09,"overcount"
"2327",36,"New York",6,"NHPI_A",1783,2262,479,23.68,"overcount"
"2328",36,"New York",6,"NHPI_AIC",3469,4133,664,17.47,"overcount"
"2329",36,"New York",7,"A_A",123512,130059,6547,5.16,"overcount"
"2330",36,"New York",7,"A_AIC",131527,139866,8339,6.15,"overcount"
"2331",36,"New York",7,"NHPI_A",1837,2092,255,12.98,"overcount"
"2332",36,"New York",7,"NHPI_AIC",3456,3865,409,11.17,"overcount"
"2333",36,"New York",8,"A_A",120907,122983,2076,1.7,"overcount"
"2334",36,"New York",8,"A_AIC",128147,131378,3231,2.49,"overcount"
"2335",36,"New York",8,"NHPI_A",1745,1803,58,3.27,"overcount"
"2336",36,"New York",8,"NHPI_AIC",3101,3478,377,11.46,"overcount"
"2337",36,"New York",9,"A_A",113090,113173,83,0.07,"overcount"
"2338",36,"New York",9,"A_AIC",119814,120660,846,0.7,"overcount"
"2339",36,"New York",9,"NHPI_A",1554,1814,260,15.44,"overcount"
"2340",36,"New York",9,"NHPI_AIC",2941,3444,503,15.76,"overcount"
"2341",36,"New York",10,"A_A",107855,112188,4333,3.94,"overcount"
"2342",36,"New York",10,"A_AIC",114304,119108,4804,4.12,"overcount"
"2343",36,"New York",10,"NHPI_A",1475,1652,177,11.32,"overcount"
"2344",36,"New York",10,"NHPI_AIC",2931,3250,319,10.32,"overcount"
"2345",36,"New York",11,"A_A",101050,105678,4628,4.48,"overcount"
"2346",36,"New York",11,"A_AIC",106693,111732,5039,4.61,"overcount"
"2347",36,"New York",11,"NHPI_A",1215,1329,114,8.96,"overcount"
"2348",36,"New York",11,"NHPI_AIC",2516,2833,317,11.85,"overcount"
"2349",36,"New York",12,"A_A",83652,87220,3568,4.18,"overcount"
"2350",36,"New York",12,"A_AIC",88164,91582,3418,3.8,"overcount"
"2351",36,"New York",12,"NHPI_A",859,913,54,6.09,"overcount"
"2352",36,"New York",12,"NHPI_AIC",1933,2040,107,5.39,"overcount"
"2353",36,"New York",13,"A_A",69173,70642,1469,2.1,"overcount"
"2354",36,"New York",13,"A_AIC",72640,73990,1350,1.84,"overcount"
"2355",36,"New York",13,"NHPI_A",731,746,15,2.03,"overcount"
"2356",36,"New York",13,"NHPI_AIC",1567,1583,16,1.02,"overcount"
"2357",36,"New York",14,"A_A",44654,46150,1496,3.3,"overcount"
"2358",36,"New York",14,"A_AIC",46609,48364,1755,3.7,"overcount"
"2359",36,"New York",14,"NHPI_A",434,474,40,8.81,"overcount"
"2360",36,"New York",14,"NHPI_AIC",1004,1048,44,4.29,"overcount"
"2361",36,"New York",15,"A_A",34969,35350,381,1.08,"overcount"
"2362",36,"New York",15,"A_AIC",36531,36937,406,1.11,"overcount"
"2363",36,"New York",15,"NHPI_A",356,360,4,1.12,"overcount"
"2364",36,"New York",15,"NHPI_AIC",780,745,-35,-4.59,"undercount"
"2365",36,"New York",16,"A_A",24495,23940,-555,-2.29,"undercount"
"2366",36,"New York",16,"A_AIC",25493,25031,-462,-1.83,"undercount"
"2367",36,"New York",16,"NHPI_A",225,243,18,7.69,"overcount"
"2368",36,"New York",16,"NHPI_AIC",568,553,-15,-2.68,"undercount"
"2369",36,"New York",17,"A_A",15470,14820,-650,-4.29,"undercount"
"2370",36,"New York",17,"A_AIC",16224,15426,-798,-5.04,"undercount"
"2371",36,"New York",17,"NHPI_A",178,161,-17,-10.03,"undercount"
"2372",36,"New York",17,"NHPI_AIC",428,357,-71,-18.09,"undercount"
"2373",36,"New York",18,"A_A",14759,11708,-3051,-23.06,"undercount"
"2374",36,"New York",18,"A_AIC",15383,12165,-3218,-23.36,"undercount"
"2375",36,"New York",18,"NHPI_A",140,147,7,4.88,"overcount"
"2376",36,"New York",18,"NHPI_AIC",373,344,-29,-8.09,"undercount"
"2377",37,"North Carolina",1,"A_A",17090,16736,-354,-2.09,"undercount"
"2378",37,"North Carolina",1,"A_AIC",23230,24462,1232,5.17,"overcount"
"2379",37,"North Carolina",1,"NHPI_A",806,1158,352,35.85,"overcount"
"2380",37,"North Carolina",1,"NHPI_AIC",1774,2248,474,23.57,"overcount"
"2381",37,"North Carolina",2,"A_A",16147,16819,672,4.08,"overcount"
"2382",37,"North Carolina",2,"A_AIC",21867,23407,1540,6.8,"overcount"
"2383",37,"North Carolina",2,"NHPI_A",739,958,219,25.81,"overcount"
"2384",37,"North Carolina",2,"NHPI_AIC",1644,1814,170,9.83,"overcount"
"2385",37,"North Carolina",3,"A_A",13567,15137,1570,10.94,"overcount"
"2386",37,"North Carolina",3,"A_AIC",17824,20054,2230,11.77,"overcount"
"2387",37,"North Carolina",3,"NHPI_A",540,800,260,38.81,"overcount"
"2388",37,"North Carolina",3,"NHPI_AIC",1338,1458,120,8.58,"overcount"
"2389",37,"North Carolina",4,"A_A",12495,14874,2379,17.38,"overcount"
"2390",37,"North Carolina",4,"A_AIC",15952,18947,2995,17.16,"overcount"
"2391",37,"North Carolina",4,"NHPI_A",563,805,242,35.38,"overcount"
"2392",37,"North Carolina",4,"NHPI_AIC",1193,1438,245,18.62,"overcount"
"2393",37,"North Carolina",5,"A_A",13475,17329,3854,25.02,"overcount"
"2394",37,"North Carolina",5,"A_AIC",16616,21093,4477,23.74,"overcount"
"2395",37,"North Carolina",5,"NHPI_A",687,1124,437,48.26,"overcount"
"2396",37,"North Carolina",5,"NHPI_AIC",1347,1822,475,29.98,"overcount"
"2397",37,"North Carolina",6,"A_A",16094,20534,4440,24.24,"overcount"
"2398",37,"North Carolina",6,"A_AIC",18740,23673,4933,23.26,"overcount"
"2399",37,"North Carolina",6,"NHPI_A",673,1169,496,53.85,"overcount"
"2400",37,"North Carolina",6,"NHPI_AIC",1259,1765,506,33.47,"overcount"
"2401",37,"North Carolina",7,"A_A",18823,20669,1846,9.35,"overcount"
"2402",37,"North Carolina",7,"A_AIC",21001,23570,2569,11.53,"overcount"
"2403",37,"North Carolina",7,"NHPI_A",791,1138,347,35.98,"overcount"
"2404",37,"North Carolina",7,"NHPI_AIC",1313,1630,317,21.54,"overcount"
"2405",37,"North Carolina",8,"A_A",20504,21103,599,2.88,"overcount"
"2406",37,"North Carolina",8,"A_AIC",22588,23508,920,3.99,"overcount"
"2407",37,"North Carolina",8,"NHPI_A",622,835,213,29.24,"overcount"
"2408",37,"North Carolina",8,"NHPI_AIC",1067,1185,118,10.48,"overcount"
"2409",37,"North Carolina",9,"A_A",17205,17833,628,3.58,"overcount"
"2410",37,"North Carolina",9,"A_AIC",18678,19513,835,4.37,"overcount"
"2411",37,"North Carolina",9,"NHPI_A",461,639,178,32.36,"overcount"
"2412",37,"North Carolina",9,"NHPI_AIC",898,995,97,10.25,"overcount"
"2413",37,"North Carolina",10,"A_A",13627,14474,847,6.03,"overcount"
"2414",37,"North Carolina",10,"A_AIC",14798,15852,1054,6.88,"overcount"
"2415",37,"North Carolina",10,"NHPI_A",457,538,81,16.28,"overcount"
"2416",37,"North Carolina",10,"NHPI_AIC",799,902,103,12.11,"overcount"
"2417",37,"North Carolina",11,"A_A",11069,11833,764,6.67,"overcount"
"2418",37,"North Carolina",11,"A_AIC",12062,12928,866,6.93,"overcount"
"2419",37,"North Carolina",11,"NHPI_A",339,407,68,18.23,"overcount"
"2420",37,"North Carolina",11,"NHPI_AIC",643,685,42,6.33,"overcount"
"2421",37,"North Carolina",12,"A_A",8903,9467,564,6.14,"overcount"
"2422",37,"North Carolina",12,"A_AIC",9718,10082,364,3.68,"overcount"
"2423",37,"North Carolina",12,"NHPI_A",258,273,15,5.65,"overcount"
"2424",37,"North Carolina",12,"NHPI_AIC",465,421,-44,-9.93,"undercount"
"2425",37,"North Carolina",13,"A_A",6948,7259,311,4.38,"overcount"
"2426",37,"North Carolina",13,"A_AIC",7591,7557,-34,-0.45,"undercount"
"2427",37,"North Carolina",13,"NHPI_A",177,206,29,15.14,"overcount"
"2428",37,"North Carolina",13,"NHPI_AIC",397,340,-57,-15.47,"undercount"
"2429",37,"North Carolina",14,"A_A",4700,4887,187,3.9,"overcount"
"2430",37,"North Carolina",14,"A_AIC",5098,5042,-56,-1.1,"undercount"
"2431",37,"North Carolina",14,"NHPI_A",120,94,-26,-24.3,"undercount"
"2432",37,"North Carolina",14,"NHPI_AIC",229,187,-42,-20.19,"undercount"
"2433",37,"North Carolina",15,"A_A",3280,3215,-65,-2,"undercount"
"2434",37,"North Carolina",15,"A_AIC",3561,3308,-253,-7.37,"undercount"
"2435",37,"North Carolina",15,"NHPI_A",80,83,3,3.68,"overcount"
"2436",37,"North Carolina",15,"NHPI_AIC",180,164,-16,-9.3,"undercount"
"2437",37,"North Carolina",16,"A_A",2187,2004,-183,-8.73,"undercount"
"2438",37,"North Carolina",16,"A_AIC",2357,1926,-431,-20.13,"undercount"
"2439",37,"North Carolina",16,"NHPI_A",54,39,-15,-32.26,"undercount"
"2440",37,"North Carolina",16,"NHPI_AIC",136,84,-52,-47.27,"undercount"
"2441",37,"North Carolina",17,"A_A",1238,1098,-140,-11.99,"undercount"
"2442",37,"North Carolina",17,"A_AIC",1368,1111,-257,-20.73,"undercount"
"2443",37,"North Carolina",17,"NHPI_A",27,24,-3,-11.76,"undercount"
"2444",37,"North Carolina",17,"NHPI_AIC",69,56,-13,-20.8,"undercount"
"2445",37,"North Carolina",18,"A_A",1062,681,-381,-43.72,"undercount"
"2446",37,"North Carolina",18,"A_AIC",1212,620,-592,-64.63,"undercount"
"2447",37,"North Carolina",18,"NHPI_A",48,19,-29,-86.57,"undercount"
"2448",37,"North Carolina",18,"NHPI_AIC",104,47,-57,-75.5,"undercount"
"2449",38,"North Dakota",1,"A_A",522,383,-139,-30.72,"undercount"
"2450",38,"North Dakota",1,"A_AIC",865,827,-38,-4.49,"undercount"
"2451",38,"North Dakota",1,"NHPI_A",32,23,-9,-32.73,"undercount"
"2452",38,"North Dakota",1,"NHPI_AIC",74,105,31,34.64,"overcount"
"2453",38,"North Dakota",2,"A_A",431,377,-54,-13.37,"undercount"
"2454",38,"North Dakota",2,"A_AIC",743,659,-84,-11.98,"undercount"
"2455",38,"North Dakota",2,"NHPI_A",36,20,-16,-57.14,"undercount"
"2456",38,"North Dakota",2,"NHPI_AIC",88,86,-2,-2.3,"undercount"
"2457",38,"North Dakota",3,"A_A",343,349,6,1.73,"overcount"
"2458",38,"North Dakota",3,"A_AIC",626,568,-58,-9.72,"undercount"
"2459",38,"North Dakota",3,"NHPI_A",30,27,-3,-10.53,"undercount"
"2460",38,"North Dakota",3,"NHPI_AIC",79,67,-12,-16.44,"undercount"
"2461",38,"North Dakota",4,"A_A",390,513,123,27.24,"overcount"
"2462",38,"North Dakota",4,"A_AIC",605,741,136,20.21,"overcount"
"2463",38,"North Dakota",4,"NHPI_A",34,31,-3,-9.23,"undercount"
"2464",38,"North Dakota",4,"NHPI_AIC",61,62,1,1.63,"overcount"
"2465",38,"North Dakota",5,"A_A",721,1450,729,67.16,"overcount"
"2466",38,"North Dakota",5,"A_AIC",1050,1728,678,48.81,"overcount"
"2467",38,"North Dakota",5,"NHPI_A",64,75,11,15.83,"overcount"
"2468",38,"North Dakota",5,"NHPI_AIC",117,124,7,5.81,"overcount"
"2469",38,"North Dakota",6,"A_A",582,895,313,42.38,"overcount"
"2470",38,"North Dakota",6,"A_AIC",773,1068,295,32.05,"overcount"
"2471",38,"North Dakota",6,"NHPI_A",43,40,-3,-7.23,"undercount"
"2472",38,"North Dakota",6,"NHPI_AIC",68,73,5,7.09,"overcount"
"2473",38,"North Dakota",7,"A_A",550,623,73,12.45,"overcount"
"2474",38,"North Dakota",7,"A_AIC",676,743,67,9.44,"overcount"
"2475",38,"North Dakota",7,"NHPI_A",53,32,-21,-49.41,"undercount"
"2476",38,"North Dakota",7,"NHPI_AIC",78,54,-24,-36.36,"undercount"
"2477",38,"North Dakota",8,"A_A",465,604,139,26.01,"overcount"
"2478",38,"North Dakota",8,"A_AIC",546,679,133,21.71,"overcount"
"2479",38,"North Dakota",8,"NHPI_A",28,14,-14,-66.67,"undercount"
"2480",38,"North Dakota",8,"NHPI_AIC",51,31,-20,-48.78,"undercount"
"2481",38,"North Dakota",9,"A_A",433,488,55,11.94,"overcount"
"2482",38,"North Dakota",9,"A_AIC",484,517,33,6.59,"overcount"
"2483",38,"North Dakota",9,"NHPI_A",23,19,-4,-19.05,"undercount"
"2484",38,"North Dakota",9,"NHPI_AIC",45,29,-16,-43.24,"undercount"
"2485",38,"North Dakota",10,"A_A",302,375,73,21.57,"overcount"
"2486",38,"North Dakota",10,"A_AIC",364,393,29,7.66,"overcount"
"2487",38,"North Dakota",10,"NHPI_A",19,14,-5,-30.3,"undercount"
"2488",38,"North Dakota",10,"NHPI_AIC",39,22,-17,-55.74,"undercount"
"2489",38,"North Dakota",11,"A_A",240,253,13,5.27,"overcount"
"2490",38,"North Dakota",11,"A_AIC",281,283,2,0.71,"overcount"
"2491",38,"North Dakota",11,"NHPI_A",15,9,-6,-50,"undercount"
"2492",38,"North Dakota",11,"NHPI_AIC",29,28,-1,-3.51,"undercount"
"2493",38,"North Dakota",12,"A_A",193,219,26,12.62,"overcount"
"2494",38,"North Dakota",12,"A_AIC",234,214,-20,-8.93,"undercount"
"2495",38,"North Dakota",12,"NHPI_A",16,14,-2,-13.33,"undercount"
"2496",38,"North Dakota",12,"NHPI_AIC",19,13,-6,-37.5,"undercount"
"2497",38,"North Dakota",13,"A_A",200,215,15,7.23,"overcount"
"2498",38,"North Dakota",13,"A_AIC",226,189,-37,-17.83,"undercount"
"2499",38,"North Dakota",13,"NHPI_A",4,7,3,54.55,"overcount"
"2500",38,"North Dakota",13,"NHPI_AIC",20,8,-12,-85.71,"undercount"
"2501",38,"North Dakota",14,"A_A",114,134,20,16.13,"overcount"
"2502",38,"North Dakota",14,"A_AIC",127,103,-24,-20.87,"undercount"
"2503",38,"North Dakota",14,"NHPI_A",4,0,-4,-200,"undercount"
"2504",38,"North Dakota",14,"NHPI_AIC",10,4,-6,-85.71,"undercount"
"2505",38,"North Dakota",15,"A_A",75,56,-19,-29.01,"undercount"
"2506",38,"North Dakota",15,"A_AIC",95,56,-39,-51.66,"undercount"
"2507",38,"North Dakota",15,"NHPI_A",5,5,0,0,"equal"
"2508",38,"North Dakota",15,"NHPI_AIC",15,8,-7,-60.87,"undercount"
"2509",38,"North Dakota",16,"A_A",37,44,7,17.28,"overcount"
"2510",38,"North Dakota",16,"A_AIC",49,38,-11,-25.29,"undercount"
"2511",38,"North Dakota",16,"NHPI_A",3,4,1,28.57,"overcount"
"2512",38,"North Dakota",16,"NHPI_AIC",4,2,-2,-66.67,"undercount"
"2513",38,"North Dakota",17,"A_A",35,36,1,2.82,"overcount"
"2514",38,"North Dakota",17,"A_AIC",39,24,-15,-47.62,"undercount"
"2515",38,"North Dakota",17,"NHPI_A",4,0,-4,-200,"undercount"
"2516",38,"North Dakota",17,"NHPI_AIC",12,2,-10,-142.86,"undercount"
"2517",38,"North Dakota",18,"A_A",27,18,-9,-40,"undercount"
"2518",38,"North Dakota",18,"A_AIC",37,1,-36,-189.47,"undercount"
"2519",38,"North Dakota",18,"NHPI_A",5,0,-5,-200,"undercount"
"2520",38,"North Dakota",18,"NHPI_AIC",7,0,-7,-200,"undercount"
"2521",39,"Ohio",1,"A_A",15050,13923,-1127,-7.78,"undercount"
"2522",39,"Ohio",1,"A_AIC",20534,21602,1068,5.07,"overcount"
"2523",39,"Ohio",1,"NHPI_A",540,579,39,6.97,"overcount"
"2524",39,"Ohio",1,"NHPI_AIC",1123,1310,187,15.37,"overcount"
"2525",39,"Ohio",2,"A_A",14186,14453,267,1.86,"overcount"
"2526",39,"Ohio",2,"A_AIC",18732,21289,2557,12.78,"overcount"
"2527",39,"Ohio",2,"NHPI_A",452,513,61,12.64,"overcount"
"2528",39,"Ohio",2,"NHPI_AIC",956,1141,185,17.64,"overcount"
"2529",39,"Ohio",3,"A_A",12545,12086,-459,-3.73,"undercount"
"2530",39,"Ohio",3,"A_AIC",16841,17575,734,4.27,"overcount"
"2531",39,"Ohio",3,"NHPI_A",370,406,36,9.28,"overcount"
"2532",39,"Ohio",3,"NHPI_AIC",876,968,92,9.98,"overcount"
"2533",39,"Ohio",4,"A_A",11013,12368,1355,11.59,"overcount"
"2534",39,"Ohio",4,"A_AIC",14538,17137,2599,16.41,"overcount"
"2535",39,"Ohio",4,"NHPI_A",369,396,27,7.06,"overcount"
"2536",39,"Ohio",4,"NHPI_AIC",912,1001,89,9.3,"overcount"
"2537",39,"Ohio",5,"A_A",11772,16906,5134,35.8,"overcount"
"2538",39,"Ohio",5,"A_AIC",14574,20797,6223,35.19,"overcount"
"2539",39,"Ohio",5,"NHPI_A",361,557,196,42.7,"overcount"
"2540",39,"Ohio",5,"NHPI_AIC",841,1070,229,23.97,"overcount"
"2541",39,"Ohio",6,"A_A",14713,19317,4604,27.06,"overcount"
"2542",39,"Ohio",6,"A_AIC",17125,22350,5225,26.47,"overcount"
"2543",39,"Ohio",6,"NHPI_A",403,548,145,30.49,"overcount"
"2544",39,"Ohio",6,"NHPI_AIC",834,962,128,14.25,"overcount"
"2545",39,"Ohio",7,"A_A",17392,19146,1754,9.6,"overcount"
"2546",39,"Ohio",7,"A_AIC",19647,21771,2124,10.26,"overcount"
"2547",39,"Ohio",7,"NHPI_A",418,472,54,12.13,"overcount"
"2548",39,"Ohio",7,"NHPI_AIC",798,870,72,8.63,"overcount"
"2549",39,"Ohio",8,"A_A",19188,18618,-570,-3.02,"undercount"
"2550",39,"Ohio",8,"A_AIC",21078,20935,-143,-0.68,"undercount"
"2551",39,"Ohio",8,"NHPI_A",431,374,-57,-14.16,"undercount"
"2552",39,"Ohio",8,"NHPI_AIC",821,746,-75,-9.57,"undercount"
"2553",39,"Ohio",9,"A_A",16667,15343,-1324,-8.27,"undercount"
"2554",39,"Ohio",9,"A_AIC",18193,17010,-1183,-6.72,"undercount"
"2555",39,"Ohio",9,"NHPI_A",326,343,17,5.08,"overcount"
"2556",39,"Ohio",9,"NHPI_AIC",671,641,-30,-4.57,"undercount"
"2557",39,"Ohio",10,"A_A",13811,13049,-762,-5.67,"undercount"
"2558",39,"Ohio",10,"A_AIC",15131,14549,-582,-3.92,"undercount"
"2559",39,"Ohio",10,"NHPI_A",248,305,57,20.61,"overcount"
"2560",39,"Ohio",10,"NHPI_AIC",524,615,91,15.98,"overcount"
"2561",39,"Ohio",11,"A_A",10889,10766,-123,-1.14,"undercount"
"2562",39,"Ohio",11,"A_AIC",12139,11888,-251,-2.09,"undercount"
"2563",39,"Ohio",11,"NHPI_A",209,262,53,22.51,"overcount"
"2564",39,"Ohio",11,"NHPI_AIC",445,557,112,22.36,"overcount"
"2565",39,"Ohio",12,"A_A",8700,9209,509,5.68,"overcount"
"2566",39,"Ohio",12,"A_AIC",9648,9950,302,3.08,"overcount"
"2567",39,"Ohio",12,"NHPI_A",178,215,37,18.83,"overcount"
"2568",39,"Ohio",12,"NHPI_AIC",381,387,6,1.56,"overcount"
"2569",39,"Ohio",13,"A_A",7694,7789,95,1.23,"overcount"
"2570",39,"Ohio",13,"A_AIC",8375,8216,-159,-1.92,"undercount"
"2571",39,"Ohio",13,"NHPI_A",133,141,8,5.84,"overcount"
"2572",39,"Ohio",13,"NHPI_AIC",292,299,7,2.37,"overcount"
"2573",39,"Ohio",14,"A_A",5402,5519,117,2.14,"overcount"
"2574",39,"Ohio",14,"A_AIC",5795,5753,-42,-0.73,"undercount"
"2575",39,"Ohio",14,"NHPI_A",106,91,-15,-15.23,"undercount"
"2576",39,"Ohio",14,"NHPI_AIC",198,178,-20,-10.64,"undercount"
"2577",39,"Ohio",15,"A_A",3827,3723,-104,-2.75,"undercount"
"2578",39,"Ohio",15,"A_AIC",4138,3851,-287,-7.18,"undercount"
"2579",39,"Ohio",15,"NHPI_A",71,67,-4,-5.8,"undercount"
"2580",39,"Ohio",15,"NHPI_AIC",175,150,-25,-15.38,"undercount"
"2581",39,"Ohio",16,"A_A",2502,2273,-229,-9.59,"undercount"
"2582",39,"Ohio",16,"A_AIC",2760,2436,-324,-12.47,"undercount"
"2583",39,"Ohio",16,"NHPI_A",54,38,-16,-34.78,"undercount"
"2584",39,"Ohio",16,"NHPI_AIC",122,91,-31,-29.11,"undercount"
"2585",39,"Ohio",17,"A_A",1558,1330,-228,-15.79,"undercount"
"2586",39,"Ohio",17,"A_AIC",1764,1403,-361,-22.8,"undercount"
"2587",39,"Ohio",17,"NHPI_A",43,16,-27,-91.53,"undercount"
"2588",39,"Ohio",17,"NHPI_AIC",121,59,-62,-68.89,"undercount"
"2589",39,"Ohio",18,"A_A",1348,875,-473,-42.56,"undercount"
"2590",39,"Ohio",18,"A_AIC",1530,873,-657,-54.68,"undercount"
"2591",39,"Ohio",18,"NHPI_A",63,13,-50,-131.58,"undercount"
"2592",39,"Ohio",18,"NHPI_AIC",123,46,-77,-91.12,"undercount"
"2593",40,"Oklahoma",1,"A_A",4753,4570,-183,-3.93,"undercount"
"2594",40,"Oklahoma",1,"A_AIC",7596,7810,214,2.78,"overcount"
"2595",40,"Oklahoma",1,"NHPI_A",394,589,195,39.67,"overcount"
"2596",40,"Oklahoma",1,"NHPI_AIC",944,1137,193,18.55,"overcount"
"2597",40,"Oklahoma",2,"A_A",4239,4651,412,9.27,"overcount"
"2598",40,"Oklahoma",2,"A_AIC",6311,7221,910,13.45,"overcount"
"2599",40,"Oklahoma",2,"NHPI_A",378,471,93,21.91,"overcount"
"2600",40,"Oklahoma",2,"NHPI_AIC",819,903,84,9.76,"overcount"
"2601",40,"Oklahoma",3,"A_A",3856,4330,474,11.58,"overcount"
"2602",40,"Oklahoma",3,"A_AIC",5818,6500,682,11.07,"overcount"
"2603",40,"Oklahoma",3,"NHPI_A",334,433,99,25.81,"overcount"
"2604",40,"Oklahoma",3,"NHPI_AIC",766,797,31,3.97,"overcount"
"2605",40,"Oklahoma",4,"A_A",4204,4958,754,16.46,"overcount"
"2606",40,"Oklahoma",4,"A_AIC",5840,6913,1073,16.83,"overcount"
"2607",40,"Oklahoma",4,"NHPI_A",297,456,159,42.23,"overcount"
"2608",40,"Oklahoma",4,"NHPI_AIC",613,793,180,25.6,"overcount"
"2609",40,"Oklahoma",5,"A_A",6590,6601,11,0.17,"overcount"
"2610",40,"Oklahoma",5,"A_AIC",8309,8375,66,0.79,"overcount"
"2611",40,"Oklahoma",5,"NHPI_A",350,642,292,58.87,"overcount"
"2612",40,"Oklahoma",5,"NHPI_AIC",735,999,264,30.45,"overcount"
"2613",40,"Oklahoma",6,"A_A",5840,6452,612,9.96,"overcount"
"2614",40,"Oklahoma",6,"A_AIC",7319,8066,747,9.71,"overcount"
"2615",40,"Oklahoma",6,"NHPI_A",399,619,220,43.22,"overcount"
"2616",40,"Oklahoma",6,"NHPI_AIC",782,935,153,17.82,"overcount"
"2617",40,"Oklahoma",7,"A_A",4986,5609,623,11.76,"overcount"
"2618",40,"Oklahoma",7,"A_AIC",6009,6848,839,13.05,"overcount"
"2619",40,"Oklahoma",7,"NHPI_A",394,508,114,25.28,"overcount"
"2620",40,"Oklahoma",7,"NHPI_AIC",748,736,-12,-1.62,"undercount"
"2621",40,"Oklahoma",8,"A_A",6066,5784,-282,-4.76,"undercount"
"2622",40,"Oklahoma",8,"A_AIC",6913,6755,-158,-2.31,"undercount"
"2623",40,"Oklahoma",8,"NHPI_A",361,398,37,9.75,"overcount"
"2624",40,"Oklahoma",8,"NHPI_AIC",623,581,-42,-6.98,"undercount"
"2625",40,"Oklahoma",9,"A_A",4894,5076,182,3.65,"overcount"
"2626",40,"Oklahoma",9,"A_AIC",5589,5772,183,3.22,"overcount"
"2627",40,"Oklahoma",9,"NHPI_A",246,319,73,25.84,"overcount"
"2628",40,"Oklahoma",9,"NHPI_AIC",430,432,2,0.46,"overcount"
"2629",40,"Oklahoma",10,"A_A",4380,4551,171,3.83,"overcount"
"2630",40,"Oklahoma",10,"A_AIC",4945,5121,176,3.5,"overcount"
"2631",40,"Oklahoma",10,"NHPI_A",218,249,31,13.28,"overcount"
"2632",40,"Oklahoma",10,"NHPI_AIC",380,385,5,1.31,"overcount"
"2633",40,"Oklahoma",11,"A_A",3633,3906,273,7.24,"overcount"
"2634",40,"Oklahoma",11,"A_AIC",4133,4467,334,7.77,"overcount"
"2635",40,"Oklahoma",11,"NHPI_A",151,217,66,35.87,"overcount"
"2636",40,"Oklahoma",11,"NHPI_AIC",308,350,42,12.77,"overcount"
"2637",40,"Oklahoma",12,"A_A",3268,3499,231,6.83,"overcount"
"2638",40,"Oklahoma",12,"A_AIC",3527,3835,308,8.37,"overcount"
"2639",40,"Oklahoma",12,"NHPI_A",164,186,22,12.57,"overcount"
"2640",40,"Oklahoma",12,"NHPI_AIC",238,232,-6,-2.55,"undercount"
"2641",40,"Oklahoma",13,"A_A",2632,2729,97,3.62,"overcount"
"2642",40,"Oklahoma",13,"A_AIC",2823,2922,99,3.45,"overcount"
"2643",40,"Oklahoma",13,"NHPI_A",163,105,-58,-43.28,"undercount"
"2644",40,"Oklahoma",13,"NHPI_AIC",226,182,-44,-21.57,"undercount"
"2645",40,"Oklahoma",14,"A_A",1675,1738,63,3.69,"overcount"
"2646",40,"Oklahoma",14,"A_AIC",1816,1781,-35,-1.95,"undercount"
"2647",40,"Oklahoma",14,"NHPI_A",84,73,-11,-14.01,"undercount"
"2648",40,"Oklahoma",14,"NHPI_AIC",138,82,-56,-50.91,"undercount"
"2649",40,"Oklahoma",15,"A_A",1223,1206,-17,-1.4,"undercount"
"2650",40,"Oklahoma",15,"A_AIC",1334,1277,-57,-4.37,"undercount"
"2651",40,"Oklahoma",15,"NHPI_A",58,34,-24,-52.17,"undercount"
"2652",40,"Oklahoma",15,"NHPI_AIC",97,67,-30,-36.59,"undercount"
"2653",40,"Oklahoma",16,"A_A",833,770,-63,-7.86,"undercount"
"2654",40,"Oklahoma",16,"A_AIC",912,790,-122,-14.34,"undercount"
"2655",40,"Oklahoma",16,"NHPI_A",45,27,-18,-50,"undercount"
"2656",40,"Oklahoma",16,"NHPI_AIC",77,47,-30,-48.39,"undercount"
"2657",40,"Oklahoma",17,"A_A",528,447,-81,-16.62,"undercount"
"2658",40,"Oklahoma",17,"A_AIC",578,448,-130,-25.34,"undercount"
"2659",40,"Oklahoma",17,"NHPI_A",28,15,-13,-60.47,"undercount"
"2660",40,"Oklahoma",17,"NHPI_AIC",46,24,-22,-62.86,"undercount"
"2661",40,"Oklahoma",18,"A_A",386,249,-137,-43.15,"undercount"
"2662",40,"Oklahoma",18,"A_AIC",436,257,-179,-51.66,"undercount"
"2663",40,"Oklahoma",18,"NHPI_A",39,13,-26,-100,"undercount"
"2664",40,"Oklahoma",18,"NHPI_AIC",65,22,-43,-98.85,"undercount"
"2665",41,"Oregon",1,"A_A",10296,8724,-1572,-16.53,"undercount"
"2666",41,"Oregon",1,"A_AIC",16171,16032,-139,-0.86,"undercount"
"2667",41,"Oregon",1,"NHPI_A",1033,1373,340,28.26,"overcount"
"2668",41,"Oregon",1,"NHPI_AIC",2456,3030,574,20.93,"overcount"
"2669",41,"Oregon",2,"A_A",10501,9606,-895,-8.9,"undercount"
"2670",41,"Oregon",2,"A_AIC",15603,16014,411,2.6,"overcount"
"2671",41,"Oregon",2,"NHPI_A",926,1254,328,30.09,"overcount"
"2672",41,"Oregon",2,"NHPI_AIC",2192,2647,455,18.81,"overcount"
"2673",41,"Oregon",3,"A_A",9328,9210,-118,-1.27,"undercount"
"2674",41,"Oregon",3,"A_AIC",13711,14927,1216,8.49,"overcount"
"2675",41,"Oregon",3,"NHPI_A",821,1189,368,36.62,"overcount"
"2676",41,"Oregon",3,"NHPI_AIC",1985,2530,545,24.14,"overcount"
"2677",41,"Oregon",4,"A_A",9433,10264,831,8.44,"overcount"
"2678",41,"Oregon",4,"A_AIC",13346,15392,2046,14.24,"overcount"
"2679",41,"Oregon",4,"NHPI_A",965,1398,433,36.65,"overcount"
"2680",41,"Oregon",4,"NHPI_AIC",2028,2823,795,32.78,"overcount"
"2681",41,"Oregon",5,"A_A",10591,11336,745,6.8,"overcount"
"2682",41,"Oregon",5,"A_AIC",13840,15651,1811,12.28,"overcount"
"2683",41,"Oregon",5,"NHPI_A",1028,1596,568,43.29,"overcount"
"2684",41,"Oregon",5,"NHPI_AIC",2068,2851,783,31.84,"overcount"
"2685",41,"Oregon",6,"A_A",10967,11461,494,4.41,"overcount"
"2686",41,"Oregon",6,"A_AIC",13505,14995,1490,10.46,"overcount"
"2687",41,"Oregon",6,"NHPI_A",976,1513,537,43.15,"overcount"
"2688",41,"Oregon",6,"NHPI_AIC",1813,2473,660,30.8,"overcount"
"2689",41,"Oregon",7,"A_A",12521,12280,-241,-1.94,"undercount"
"2690",41,"Oregon",7,"A_AIC",14581,15375,794,5.3,"overcount"
"2691",41,"Oregon",7,"NHPI_A",1206,1323,117,9.25,"overcount"
"2692",41,"Oregon",7,"NHPI_AIC",2016,2152,136,6.53,"overcount"
"2693",41,"Oregon",8,"A_A",14761,13961,-800,-5.57,"undercount"
"2694",41,"Oregon",8,"A_AIC",16614,16378,-236,-1.43,"undercount"
"2695",41,"Oregon",8,"NHPI_A",970,1109,139,13.37,"overcount"
"2696",41,"Oregon",8,"NHPI_AIC",1635,1730,95,5.65,"overcount"
"2697",41,"Oregon",9,"A_A",12332,11915,-417,-3.44,"undercount"
"2698",41,"Oregon",9,"A_AIC",13880,13760,-120,-0.87,"undercount"
"2699",41,"Oregon",9,"NHPI_A",784,991,207,23.32,"overcount"
"2700",41,"Oregon",9,"NHPI_AIC",1358,1609,251,16.92,"overcount"
"2701",41,"Oregon",10,"A_A",10960,10845,-115,-1.05,"undercount"
"2702",41,"Oregon",10,"A_AIC",12282,12400,118,0.96,"overcount"
"2703",41,"Oregon",10,"NHPI_A",715,830,115,14.89,"overcount"
"2704",41,"Oregon",10,"NHPI_AIC",1233,1379,146,11.18,"overcount"
"2705",41,"Oregon",11,"A_A",8990,9227,237,2.6,"overcount"
"2706",41,"Oregon",11,"A_AIC",10111,10553,442,4.28,"overcount"
"2707",41,"Oregon",11,"NHPI_A",655,682,27,4.04,"overcount"
"2708",41,"Oregon",11,"NHPI_AIC",1168,1194,26,2.2,"overcount"
"2709",41,"Oregon",12,"A_A",7526,7874,348,4.52,"overcount"
"2710",41,"Oregon",12,"A_AIC",8257,8870,613,7.16,"overcount"
"2711",41,"Oregon",12,"NHPI_A",497,514,17,3.36,"overcount"
"2712",41,"Oregon",12,"NHPI_AIC",831,901,70,8.08,"overcount"
"2713",41,"Oregon",13,"A_A",6157,6125,-32,-0.52,"undercount"
"2714",41,"Oregon",13,"A_AIC",6597,6764,167,2.5,"overcount"
"2715",41,"Oregon",13,"NHPI_A",365,399,34,8.9,"overcount"
"2716",41,"Oregon",13,"NHPI_AIC",551,673,122,19.93,"overcount"
"2717",41,"Oregon",14,"A_A",4086,4146,60,1.46,"overcount"
"2718",41,"Oregon",14,"A_AIC",4368,4471,103,2.33,"overcount"
"2719",41,"Oregon",14,"NHPI_A",243,192,-51,-23.45,"undercount"
"2720",41,"Oregon",14,"NHPI_AIC",421,334,-87,-23.05,"undercount"
"2721",41,"Oregon",15,"A_A",2940,3016,76,2.55,"overcount"
"2722",41,"Oregon",15,"A_AIC",3189,3211,22,0.69,"overcount"
"2723",41,"Oregon",15,"NHPI_A",175,129,-46,-30.26,"undercount"
"2724",41,"Oregon",15,"NHPI_AIC",303,209,-94,-36.72,"undercount"
"2725",41,"Oregon",16,"A_A",2206,2189,-17,-0.77,"undercount"
"2726",41,"Oregon",16,"A_AIC",2344,2289,-55,-2.37,"undercount"
"2727",41,"Oregon",16,"NHPI_A",116,85,-31,-30.85,"undercount"
"2728",41,"Oregon",16,"NHPI_AIC",181,147,-34,-20.73,"undercount"
"2729",41,"Oregon",17,"A_A",1664,1577,-87,-5.37,"undercount"
"2730",41,"Oregon",17,"A_AIC",1788,1605,-183,-10.79,"undercount"
"2731",41,"Oregon",17,"NHPI_A",58,35,-23,-49.46,"undercount"
"2732",41,"Oregon",17,"NHPI_AIC",119,69,-50,-53.19,"undercount"
"2733",41,"Oregon",18,"A_A",1450,1253,-197,-14.58,"undercount"
"2734",41,"Oregon",18,"A_AIC",1513,1270,-243,-17.46,"undercount"
"2735",41,"Oregon",18,"NHPI_A",72,37,-35,-64.22,"undercount"
"2736",41,"Oregon",18,"NHPI_AIC",100,56,-44,-56.41,"undercount"
"2737",42,"Pennsylvania",1,"A_A",27439,24476,-2963,-11.41,"undercount"
"2738",42,"Pennsylvania",1,"A_AIC",33517,33340,-177,-0.53,"undercount"
"2739",42,"Pennsylvania",1,"NHPI_A",841,628,-213,-29,"undercount"
"2740",42,"Pennsylvania",1,"NHPI_AIC",1459,1410,-49,-3.42,"undercount"
"2741",42,"Pennsylvania",2,"A_A",25278,25222,-56,-0.22,"undercount"
"2742",42,"Pennsylvania",2,"A_AIC",30348,32226,1878,6,"overcount"
"2743",42,"Pennsylvania",2,"NHPI_A",735,600,-135,-20.22,"undercount"
"2744",42,"Pennsylvania",2,"NHPI_AIC",1361,1240,-121,-9.3,"undercount"
"2745",42,"Pennsylvania",3,"A_A",21379,22316,937,4.29,"overcount"
"2746",42,"Pennsylvania",3,"A_AIC",25420,28002,2582,9.67,"overcount"
"2747",42,"Pennsylvania",3,"NHPI_A",447,567,120,23.67,"overcount"
"2748",42,"Pennsylvania",3,"NHPI_AIC",983,1196,213,19.55,"overcount"
"2749",42,"Pennsylvania",4,"A_A",22710,26097,3387,13.88,"overcount"
"2750",42,"Pennsylvania",4,"A_AIC",26722,31526,4804,16.49,"overcount"
"2751",42,"Pennsylvania",4,"NHPI_A",514,686,172,28.67,"overcount"
"2752",42,"Pennsylvania",4,"NHPI_AIC",1388,1446,58,4.09,"overcount"
"2753",42,"Pennsylvania",5,"A_A",23658,33204,9546,33.58,"overcount"
"2754",42,"Pennsylvania",5,"A_AIC",26864,37994,11130,34.32,"overcount"
"2755",42,"Pennsylvania",5,"NHPI_A",549,707,158,25.16,"overcount"
"2756",42,"Pennsylvania",5,"NHPI_AIC",1239,1465,226,16.72,"overcount"
"2757",42,"Pennsylvania",6,"A_A",26257,34133,7876,26.08,"overcount"
"2758",42,"Pennsylvania",6,"A_AIC",28793,37710,8917,26.82,"overcount"
"2759",42,"Pennsylvania",6,"NHPI_A",437,713,276,48,"overcount"
"2760",42,"Pennsylvania",6,"NHPI_AIC",922,1316,394,35.21,"overcount"
"2761",42,"Pennsylvania",7,"A_A",29375,32621,3246,10.47,"overcount"
"2762",42,"Pennsylvania",7,"A_AIC",31653,35679,4026,11.96,"overcount"
"2763",42,"Pennsylvania",7,"NHPI_A",503,650,147,25.5,"overcount"
"2764",42,"Pennsylvania",7,"NHPI_AIC",1031,1161,130,11.86,"overcount"
"2765",42,"Pennsylvania",8,"A_A",29754,31786,2032,6.6,"overcount"
"2766",42,"Pennsylvania",8,"A_AIC",31839,34452,2613,7.88,"overcount"
"2767",42,"Pennsylvania",8,"NHPI_A",414,512,98,21.17,"overcount"
"2768",42,"Pennsylvania",8,"NHPI_AIC",872,1021,149,15.74,"overcount"
"2769",42,"Pennsylvania",9,"A_A",26003,26689,686,2.6,"overcount"
"2770",42,"Pennsylvania",9,"A_AIC",27735,28880,1145,4.04,"overcount"
"2771",42,"Pennsylvania",9,"NHPI_A",408,463,55,12.63,"overcount"
"2772",42,"Pennsylvania",9,"NHPI_AIC",835,939,104,11.72,"overcount"
"2773",42,"Pennsylvania",10,"A_A",23068,24138,1070,4.53,"overcount"
"2774",42,"Pennsylvania",10,"A_AIC",24651,25896,1245,4.93,"overcount"
"2775",42,"Pennsylvania",10,"NHPI_A",353,453,100,24.81,"overcount"
"2776",42,"Pennsylvania",10,"NHPI_AIC",739,895,156,19.09,"overcount"
"2777",42,"Pennsylvania",11,"A_A",19299,20752,1453,7.26,"overcount"
"2778",42,"Pennsylvania",11,"A_AIC",20722,22170,1448,6.75,"overcount"
"2779",42,"Pennsylvania",11,"NHPI_A",373,368,-5,-1.35,"undercount"
"2780",42,"Pennsylvania",11,"NHPI_AIC",752,730,-22,-2.97,"undercount"
"2781",42,"Pennsylvania",12,"A_A",15939,17638,1699,10.12,"overcount"
"2782",42,"Pennsylvania",12,"A_AIC",17029,18727,1698,9.5,"overcount"
"2783",42,"Pennsylvania",12,"NHPI_A",243,273,30,11.63,"overcount"
"2784",42,"Pennsylvania",12,"NHPI_AIC",528,555,27,4.99,"overcount"
"2785",42,"Pennsylvania",13,"A_A",12904,14074,1170,8.67,"overcount"
"2786",42,"Pennsylvania",13,"A_AIC",13726,14702,976,6.87,"overcount"
"2787",42,"Pennsylvania",13,"NHPI_A",231,193,-38,-17.92,"undercount"
"2788",42,"Pennsylvania",13,"NHPI_AIC",486,369,-117,-27.37,"undercount"
"2789",42,"Pennsylvania",14,"A_A",9031,9775,744,7.91,"overcount"
"2790",42,"Pennsylvania",14,"A_AIC",9513,10162,649,6.6,"overcount"
"2791",42,"Pennsylvania",14,"NHPI_A",149,134,-15,-10.6,"undercount"
"2792",42,"Pennsylvania",14,"NHPI_AIC",294,294,0,0,"equal"
"2793",42,"Pennsylvania",15,"A_A",6374,6882,508,7.66,"overcount"
"2794",42,"Pennsylvania",15,"A_AIC",6728,7124,396,5.72,"overcount"
"2795",42,"Pennsylvania",15,"NHPI_A",121,64,-57,-61.62,"undercount"
"2796",42,"Pennsylvania",15,"NHPI_AIC",214,165,-49,-25.86,"undercount"
"2797",42,"Pennsylvania",16,"A_A",4375,4403,28,0.64,"overcount"
"2798",42,"Pennsylvania",16,"A_AIC",4639,4494,-145,-3.18,"undercount"
"2799",42,"Pennsylvania",16,"NHPI_A",93,47,-46,-65.71,"undercount"
"2800",42,"Pennsylvania",16,"NHPI_AIC",182,127,-55,-35.6,"undercount"
"2801",42,"Pennsylvania",17,"A_A",2675,2381,-294,-11.63,"undercount"
"2802",42,"Pennsylvania",17,"A_AIC",2855,2496,-359,-13.42,"undercount"
"2803",42,"Pennsylvania",17,"NHPI_A",77,33,-44,-80,"undercount"
"2804",42,"Pennsylvania",17,"NHPI_AIC",145,74,-71,-64.84,"undercount"
"2805",42,"Pennsylvania",18,"A_A",2264,1608,-656,-33.88,"undercount"
"2806",42,"Pennsylvania",18,"A_AIC",2439,1681,-758,-36.8,"undercount"
"2807",42,"Pennsylvania",18,"NHPI_A",85,24,-61,-111.93,"undercount"
"2808",42,"Pennsylvania",18,"NHPI_AIC",132,56,-76,-80.85,"undercount"
"2809",44,"Rhode Island",1,"A_A",2274,2056,-218,-10.07,"undercount"
"2810",44,"Rhode Island",1,"A_AIC",2989,3109,120,3.94,"overcount"
"2811",44,"Rhode Island",1,"NHPI_A",126,118,-8,-6.56,"undercount"
"2812",44,"Rhode Island",1,"NHPI_AIC",255,238,-17,-6.9,"undercount"
"2813",44,"Rhode Island",2,"A_A",2149,2068,-81,-3.84,"undercount"
"2814",44,"Rhode Island",2,"A_AIC",2814,2886,72,2.53,"overcount"
"2815",44,"Rhode Island",2,"NHPI_A",106,140,34,27.64,"overcount"
"2816",44,"Rhode Island",2,"NHPI_AIC",211,248,37,16.12,"overcount"
"2817",44,"Rhode Island",3,"A_A",2070,1935,-135,-6.74,"undercount"
"2818",44,"Rhode Island",3,"A_AIC",2537,2580,43,1.68,"overcount"
"2819",44,"Rhode Island",3,"NHPI_A",103,148,45,35.86,"overcount"
"2820",44,"Rhode Island",3,"NHPI_AIC",179,248,69,32.32,"overcount"
"2821",44,"Rhode Island",4,"A_A",2823,2998,175,6.01,"overcount"
"2822",44,"Rhode Island",4,"A_AIC",3401,3767,366,10.21,"overcount"
"2823",44,"Rhode Island",4,"NHPI_A",153,166,13,8.15,"overcount"
"2824",44,"Rhode Island",4,"NHPI_AIC",265,303,38,13.38,"overcount"
"2825",44,"Rhode Island",5,"A_A",2800,4043,1243,36.33,"overcount"
"2826",44,"Rhode Island",5,"A_AIC",3344,4769,1425,35.13,"overcount"
"2827",44,"Rhode Island",5,"NHPI_A",190,171,-19,-10.53,"undercount"
"2828",44,"Rhode Island",5,"NHPI_AIC",311,269,-42,-14.48,"undercount"
"2829",44,"Rhode Island",6,"A_A",2882,3447,565,17.85,"overcount"
"2830",44,"Rhode Island",6,"A_AIC",3199,3853,654,18.55,"overcount"
"2831",44,"Rhode Island",6,"NHPI_A",139,152,13,8.93,"overcount"
"2832",44,"Rhode Island",6,"NHPI_AIC",243,235,-8,-3.35,"undercount"
"2833",44,"Rhode Island",7,"A_A",2702,2786,84,3.06,"overcount"
"2834",44,"Rhode Island",7,"A_AIC",2971,3121,150,4.92,"overcount"
"2835",44,"Rhode Island",7,"NHPI_A",127,128,1,0.78,"overcount"
"2836",44,"Rhode Island",7,"NHPI_AIC",227,211,-16,-7.31,"undercount"
"2837",44,"Rhode Island",8,"A_A",2473,2350,-123,-5.1,"undercount"
"2838",44,"Rhode Island",8,"A_AIC",2698,2629,-69,-2.59,"undercount"
"2839",44,"Rhode Island",8,"NHPI_A",102,103,1,0.98,"overcount"
"2840",44,"Rhode Island",8,"NHPI_AIC",174,158,-16,-9.64,"undercount"
"2841",44,"Rhode Island",9,"A_A",2108,2111,3,0.14,"overcount"
"2842",44,"Rhode Island",9,"A_AIC",2324,2326,2,0.09,"overcount"
"2843",44,"Rhode Island",9,"NHPI_A",107,131,24,20.17,"overcount"
"2844",44,"Rhode Island",9,"NHPI_AIC",178,201,23,12.14,"overcount"
"2845",44,"Rhode Island",10,"A_A",1913,1962,49,2.53,"overcount"
"2846",44,"Rhode Island",10,"A_AIC",2094,2182,88,4.12,"overcount"
"2847",44,"Rhode Island",10,"NHPI_A",105,86,-19,-19.9,"undercount"
"2848",44,"Rhode Island",10,"NHPI_AIC",166,200,34,18.58,"overcount"
"2849",44,"Rhode Island",11,"A_A",1703,1724,21,1.23,"overcount"
"2850",44,"Rhode Island",11,"A_AIC",1856,1891,35,1.87,"overcount"
"2851",44,"Rhode Island",11,"NHPI_A",75,86,11,13.66,"overcount"
"2852",44,"Rhode Island",11,"NHPI_AIC",128,158,30,20.98,"overcount"
"2853",44,"Rhode Island",12,"A_A",1323,1357,34,2.54,"overcount"
"2854",44,"Rhode Island",12,"A_AIC",1480,1488,8,0.54,"overcount"
"2855",44,"Rhode Island",12,"NHPI_A",80,63,-17,-23.78,"undercount"
"2856",44,"Rhode Island",12,"NHPI_AIC",127,104,-23,-19.91,"undercount"
"2857",44,"Rhode Island",13,"A_A",974,1086,112,10.87,"overcount"
"2858",44,"Rhode Island",13,"A_AIC",1053,1185,132,11.8,"overcount"
"2859",44,"Rhode Island",13,"NHPI_A",35,43,8,20.51,"overcount"
"2860",44,"Rhode Island",13,"NHPI_AIC",96,74,-22,-25.88,"undercount"
"2861",44,"Rhode Island",14,"A_A",650,694,44,6.55,"overcount"
"2862",44,"Rhode Island",14,"A_AIC",705,749,44,6.05,"overcount"
"2863",44,"Rhode Island",14,"NHPI_A",23,21,-2,-9.09,"undercount"
"2864",44,"Rhode Island",14,"NHPI_AIC",43,43,0,0,"equal"
"2865",44,"Rhode Island",15,"A_A",519,516,-3,-0.58,"undercount"
"2866",44,"Rhode Island",15,"A_AIC",560,556,-4,-0.72,"undercount"
"2867",44,"Rhode Island",15,"NHPI_A",30,23,-7,-26.42,"undercount"
"2868",44,"Rhode Island",15,"NHPI_AIC",46,50,4,8.33,"overcount"
"2869",44,"Rhode Island",16,"A_A",350,296,-54,-16.72,"undercount"
"2870",44,"Rhode Island",16,"A_AIC",382,326,-56,-15.82,"undercount"
"2871",44,"Rhode Island",16,"NHPI_A",15,13,-2,-14.29,"undercount"
"2872",44,"Rhode Island",16,"NHPI_AIC",33,24,-9,-31.58,"undercount"
"2873",44,"Rhode Island",17,"A_A",250,200,-50,-22.22,"undercount"
"2874",44,"Rhode Island",17,"A_AIC",268,218,-50,-20.58,"undercount"
"2875",44,"Rhode Island",17,"NHPI_A",17,5,-12,-109.09,"undercount"
"2876",44,"Rhode Island",17,"NHPI_AIC",32,17,-15,-61.22,"undercount"
"2877",44,"Rhode Island",18,"A_A",222,139,-83,-45.98,"undercount"
"2878",44,"Rhode Island",18,"A_AIC",241,162,-79,-39.21,"undercount"
"2879",44,"Rhode Island",18,"NHPI_A",21,5,-16,-123.08,"undercount"
"2880",44,"Rhode Island",18,"NHPI_AIC",26,18,-8,-36.36,"undercount"
"2881",45,"South Carolina",1,"A_A",5285,4129,-1156,-24.56,"undercount"
"2882",45,"South Carolina",1,"A_AIC",7912,6804,-1108,-15.06,"undercount"
"2883",45,"South Carolina",1,"NHPI_A",376,437,61,15.01,"overcount"
"2884",45,"South Carolina",1,"NHPI_AIC",855,767,-88,-10.85,"undercount"
"2885",45,"South Carolina",2,"A_A",4976,4394,-582,-12.42,"undercount"
"2886",45,"South Carolina",2,"A_AIC",7118,6669,-449,-6.51,"undercount"
"2887",45,"South Carolina",2,"NHPI_A",283,340,57,18.3,"overcount"
"2888",45,"South Carolina",2,"NHPI_AIC",770,618,-152,-21.9,"undercount"
"2889",45,"South Carolina",3,"A_A",4067,3815,-252,-6.39,"undercount"
"2890",45,"South Carolina",3,"A_AIC",5851,5631,-220,-3.83,"undercount"
"2891",45,"South Carolina",3,"NHPI_A",173,242,69,33.25,"overcount"
"2892",45,"South Carolina",3,"NHPI_AIC",541,540,-1,-0.19,"undercount"
"2893",45,"South Carolina",4,"A_A",3755,3967,212,5.49,"overcount"
"2894",45,"South Carolina",4,"A_AIC",5203,5614,411,7.6,"overcount"
"2895",45,"South Carolina",4,"NHPI_A",205,339,134,49.26,"overcount"
"2896",45,"South Carolina",4,"NHPI_AIC",525,630,105,18.18,"overcount"
"2897",45,"South Carolina",5,"A_A",4175,4748,573,12.84,"overcount"
"2898",45,"South Carolina",5,"A_AIC",5572,6281,709,11.96,"overcount"
"2899",45,"South Carolina",5,"NHPI_A",227,508,281,76.46,"overcount"
"2900",45,"South Carolina",5,"NHPI_AIC",508,768,260,40.75,"overcount"
"2901",45,"South Carolina",6,"A_A",4639,5458,819,16.22,"overcount"
"2902",45,"South Carolina",6,"A_AIC",5819,6771,952,15.12,"overcount"
"2903",45,"South Carolina",6,"NHPI_A",369,503,134,30.73,"overcount"
"2904",45,"South Carolina",6,"NHPI_AIC",663,683,20,2.97,"overcount"
"2905",45,"South Carolina",7,"A_A",5147,5409,262,4.96,"overcount"
"2906",45,"South Carolina",7,"A_AIC",6065,6468,403,6.43,"overcount"
"2907",45,"South Carolina",7,"NHPI_A",337,421,84,22.16,"overcount"
"2908",45,"South Carolina",7,"NHPI_AIC",573,573,0,0,"equal"
"2909",45,"South Carolina",8,"A_A",6014,5929,-85,-1.42,"undercount"
"2910",45,"South Carolina",8,"A_AIC",6820,6756,-64,-0.94,"undercount"
"2911",45,"South Carolina",8,"NHPI_A",215,299,84,32.68,"overcount"
"2912",45,"South Carolina",8,"NHPI_AIC",408,428,20,4.78,"overcount"
"2913",45,"South Carolina",9,"A_A",5076,4986,-90,-1.79,"undercount"
"2914",45,"South Carolina",9,"A_AIC",5686,5605,-81,-1.43,"undercount"
"2915",45,"South Carolina",9,"NHPI_A",259,230,-29,-11.86,"undercount"
"2916",45,"South Carolina",9,"NHPI_AIC",446,377,-69,-16.77,"undercount"
"2917",45,"South Carolina",10,"A_A",4332,4315,-17,-0.39,"undercount"
"2918",45,"South Carolina",10,"A_AIC",4902,4880,-22,-0.45,"undercount"
"2919",45,"South Carolina",10,"NHPI_A",173,169,-4,-2.34,"undercount"
"2920",45,"South Carolina",10,"NHPI_AIC",332,314,-18,-5.57,"undercount"
"2921",45,"South Carolina",11,"A_A",3641,3766,125,3.38,"overcount"
"2922",45,"South Carolina",11,"A_AIC",4152,4174,22,0.53,"overcount"
"2923",45,"South Carolina",11,"NHPI_A",124,167,43,29.55,"overcount"
"2924",45,"South Carolina",11,"NHPI_AIC",293,271,-22,-7.8,"undercount"
"2925",45,"South Carolina",12,"A_A",3310,3295,-15,-0.45,"undercount"
"2926",45,"South Carolina",12,"A_AIC",3749,3606,-143,-3.89,"undercount"
"2927",45,"South Carolina",12,"NHPI_A",112,109,-3,-2.71,"undercount"
"2928",45,"South Carolina",12,"NHPI_AIC",261,205,-56,-24.03,"undercount"
"2929",45,"South Carolina",13,"A_A",2782,2716,-66,-2.4,"undercount"
"2930",45,"South Carolina",13,"A_AIC",3091,2887,-204,-6.83,"undercount"
"2931",45,"South Carolina",13,"NHPI_A",81,86,5,5.99,"overcount"
"2932",45,"South Carolina",13,"NHPI_AIC",200,146,-54,-31.21,"undercount"
"2933",45,"South Carolina",14,"A_A",1944,1819,-125,-6.64,"undercount"
"2934",45,"South Carolina",14,"A_AIC",2162,1919,-243,-11.91,"undercount"
"2935",45,"South Carolina",14,"NHPI_A",66,34,-32,-64,"undercount"
"2936",45,"South Carolina",14,"NHPI_AIC",150,99,-51,-40.96,"undercount"
"2937",45,"South Carolina",15,"A_A",1434,1216,-218,-16.45,"undercount"
"2938",45,"South Carolina",15,"A_AIC",1625,1258,-367,-25.46,"undercount"
"2939",45,"South Carolina",15,"NHPI_A",53,36,-17,-38.2,"undercount"
"2940",45,"South Carolina",15,"NHPI_AIC",119,59,-60,-67.42,"undercount"
"2941",45,"South Carolina",16,"A_A",789,705,-84,-11.24,"undercount"
"2942",45,"South Carolina",16,"A_AIC",906,759,-147,-17.66,"undercount"
"2943",45,"South Carolina",16,"NHPI_A",27,16,-11,-51.16,"undercount"
"2944",45,"South Carolina",16,"NHPI_AIC",93,41,-52,-77.61,"undercount"
"2945",45,"South Carolina",17,"A_A",507,364,-143,-32.84,"undercount"
"2946",45,"South Carolina",17,"A_AIC",583,299,-284,-64.4,"undercount"
"2947",45,"South Carolina",17,"NHPI_A",28,14,-14,-66.67,"undercount"
"2948",45,"South Carolina",17,"NHPI_AIC",54,29,-25,-60.24,"undercount"
"2949",45,"South Carolina",18,"A_A",379,216,-163,-54.79,"undercount"
"2950",45,"South Carolina",18,"A_AIC",461,187,-274,-84.57,"undercount"
"2951",45,"South Carolina",18,"NHPI_A",28,7,-21,-120,"undercount"
"2952",45,"South Carolina",18,"NHPI_AIC",77,13,-64,-142.22,"undercount"
"2953",46,"South Dakota",1,"A_A",765,576,-189,-28.19,"undercount"
"2954",46,"South Dakota",1,"A_AIC",1311,1097,-214,-17.77,"undercount"
"2955",46,"South Dakota",1,"NHPI_A",49,36,-13,-30.59,"undercount"
"2956",46,"South Dakota",1,"NHPI_AIC",141,124,-17,-12.83,"undercount"
"2957",46,"South Dakota",2,"A_A",733,605,-128,-19.13,"undercount"
"2958",46,"South Dakota",2,"A_AIC",1165,951,-214,-20.23,"undercount"
"2959",46,"South Dakota",2,"NHPI_A",53,34,-19,-43.68,"undercount"
"2960",46,"South Dakota",2,"NHPI_AIC",107,103,-4,-3.81,"undercount"
"2961",46,"South Dakota",3,"A_A",550,597,47,8.2,"overcount"
"2962",46,"South Dakota",3,"A_AIC",923,938,15,1.61,"overcount"
"2963",46,"South Dakota",3,"NHPI_A",39,33,-6,-16.67,"undercount"
"2964",46,"South Dakota",3,"NHPI_AIC",81,88,7,8.28,"overcount"
"2965",46,"South Dakota",4,"A_A",425,593,168,33.01,"overcount"
"2966",46,"South Dakota",4,"A_AIC",739,889,150,18.43,"overcount"
"2967",46,"South Dakota",4,"NHPI_A",36,52,16,36.36,"overcount"
"2968",46,"South Dakota",4,"NHPI_AIC",88,105,17,17.62,"overcount"
"2969",46,"South Dakota",5,"A_A",661,931,270,33.92,"overcount"
"2970",46,"South Dakota",5,"A_AIC",966,1179,213,19.86,"overcount"
"2971",46,"South Dakota",5,"NHPI_A",103,68,-35,-40.94,"undercount"
"2972",46,"South Dakota",5,"NHPI_AIC",139,109,-30,-24.19,"undercount"
"2973",46,"South Dakota",6,"A_A",711,760,49,6.66,"overcount"
"2974",46,"South Dakota",6,"A_AIC",896,922,26,2.86,"overcount"
"2975",46,"South Dakota",6,"NHPI_A",65,54,-11,-18.49,"undercount"
"2976",46,"South Dakota",6,"NHPI_AIC",110,80,-30,-31.58,"undercount"
"2977",46,"South Dakota",7,"A_A",648,729,81,11.76,"overcount"
"2978",46,"South Dakota",7,"A_AIC",771,807,36,4.56,"overcount"
"2979",46,"South Dakota",7,"NHPI_A",56,50,-6,-11.32,"undercount"
"2980",46,"South Dakota",7,"NHPI_AIC",93,73,-20,-24.1,"undercount"
"2981",46,"South Dakota",8,"A_A",737,679,-58,-8.19,"undercount"
"2982",46,"South Dakota",8,"A_AIC",837,664,-173,-23.05,"undercount"
"2983",46,"South Dakota",8,"NHPI_A",39,29,-10,-29.41,"undercount"
"2984",46,"South Dakota",8,"NHPI_AIC",63,53,-10,-17.24,"undercount"
"2985",46,"South Dakota",9,"A_A",616,561,-55,-9.35,"undercount"
"2986",46,"South Dakota",9,"A_AIC",699,553,-146,-23.32,"undercount"
"2987",46,"South Dakota",9,"NHPI_A",25,44,19,55.07,"overcount"
"2988",46,"South Dakota",9,"NHPI_AIC",47,60,13,24.3,"overcount"
"2989",46,"South Dakota",10,"A_A",452,496,44,9.28,"overcount"
"2990",46,"South Dakota",10,"A_AIC",521,544,23,4.32,"overcount"
"2991",46,"South Dakota",10,"NHPI_A",20,42,22,70.97,"overcount"
"2992",46,"South Dakota",10,"NHPI_AIC",42,53,11,23.16,"overcount"
"2993",46,"South Dakota",11,"A_A",344,407,63,16.78,"overcount"
"2994",46,"South Dakota",11,"A_AIC",394,328,-66,-18.28,"undercount"
"2995",46,"South Dakota",11,"NHPI_A",19,27,8,34.78,"overcount"
"2996",46,"South Dakota",11,"NHPI_AIC",36,35,-1,-2.82,"undercount"
"2997",46,"South Dakota",12,"A_A",306,285,-21,-7.11,"undercount"
"2998",46,"South Dakota",12,"A_AIC",372,238,-134,-43.93,"undercount"
"2999",46,"South Dakota",12,"NHPI_A",19,20,1,5.13,"overcount"
"3000",46,"South Dakota",12,"NHPI_AIC",33,22,-11,-40,"undercount"
"3001",46,"South Dakota",13,"A_A",221,230,9,3.99,"overcount"
"3002",46,"South Dakota",13,"A_AIC",239,174,-65,-31.48,"undercount"
"3003",46,"South Dakota",13,"NHPI_A",18,17,-1,-5.71,"undercount"
"3004",46,"South Dakota",13,"NHPI_AIC",24,11,-13,-74.29,"undercount"
"3005",46,"South Dakota",14,"A_A",125,126,1,0.8,"overcount"
"3006",46,"South Dakota",14,"A_AIC",142,79,-63,-57.01,"undercount"
"3007",46,"South Dakota",14,"NHPI_A",7,7,0,0,"equal"
"3008",46,"South Dakota",14,"NHPI_AIC",9,5,-4,-57.14,"undercount"
"3009",46,"South Dakota",15,"A_A",94,93,-1,-1.07,"undercount"
"3010",46,"South Dakota",15,"A_AIC",105,72,-33,-37.29,"undercount"
"3011",46,"South Dakota",15,"NHPI_A",3,2,-1,-40,"undercount"
"3012",46,"South Dakota",15,"NHPI_AIC",6,3,-3,-66.67,"undercount"
"3013",46,"South Dakota",16,"A_A",58,54,-4,-7.14,"undercount"
"3014",46,"South Dakota",16,"A_AIC",66,46,-20,-35.71,"undercount"
"3015",46,"South Dakota",16,"NHPI_A",4,1,-3,-120,"undercount"
"3016",46,"South Dakota",16,"NHPI_AIC",9,3,-6,-100,"undercount"
"3017",46,"South Dakota",17,"A_A",42,37,-5,-12.66,"undercount"
"3018",46,"South Dakota",17,"A_AIC",44,30,-14,-37.84,"undercount"
"3019",46,"South Dakota",17,"NHPI_A",5,1,-4,-133.33,"undercount"
"3020",46,"South Dakota",17,"NHPI_AIC",7,2,-5,-111.11,"undercount"
"3021",46,"South Dakota",18,"A_A",39,16,-23,-83.64,"undercount"
"3022",46,"South Dakota",18,"A_AIC",54,7,-47,-154.1,"undercount"
"3023",46,"South Dakota",18,"NHPI_A",3,0,-3,-200,"undercount"
"3024",46,"South Dakota",18,"NHPI_AIC",7,2,-5,-111.11,"undercount"
"3025",47,"Tennessee",1,"A_A",7585,6977,-608,-8.35,"undercount"
"3026",47,"Tennessee",1,"A_AIC",10634,10516,-118,-1.12,"undercount"
"3027",47,"Tennessee",1,"NHPI_A",647,628,-19,-2.98,"undercount"
"3028",47,"Tennessee",1,"NHPI_AIC",1091,1142,51,4.57,"overcount"
"3029",47,"Tennessee",2,"A_A",7043,7458,415,5.72,"overcount"
"3030",47,"Tennessee",2,"A_AIC",9959,10555,596,5.81,"overcount"
"3031",47,"Tennessee",2,"NHPI_A",424,486,62,13.63,"overcount"
"3032",47,"Tennessee",2,"NHPI_AIC",859,921,62,6.97,"overcount"
"3033",47,"Tennessee",3,"A_A",5812,6290,478,7.9,"overcount"
"3034",47,"Tennessee",3,"A_AIC",8207,8658,451,5.35,"overcount"
"3035",47,"Tennessee",3,"NHPI_A",351,372,21,5.81,"overcount"
"3036",47,"Tennessee",3,"NHPI_AIC",701,710,9,1.28,"overcount"
"3037",47,"Tennessee",4,"A_A",5668,6156,488,8.25,"overcount"
"3038",47,"Tennessee",4,"A_AIC",7857,8226,369,4.59,"overcount"
"3039",47,"Tennessee",4,"NHPI_A",278,416,138,39.77,"overcount"
"3040",47,"Tennessee",4,"NHPI_AIC",616,770,154,22.22,"overcount"
"3041",47,"Tennessee",5,"A_A",5813,6768,955,15.18,"overcount"
"3042",47,"Tennessee",5,"A_AIC",7521,8594,1073,13.32,"overcount"
"3043",47,"Tennessee",5,"NHPI_A",290,673,383,79.54,"overcount"
"3044",47,"Tennessee",5,"NHPI_AIC",598,969,371,47.35,"overcount"
"3045",47,"Tennessee",6,"A_A",6978,8668,1690,21.6,"overcount"
"3046",47,"Tennessee",6,"A_AIC",8477,10415,1938,20.52,"overcount"
"3047",47,"Tennessee",6,"NHPI_A",410,661,251,46.87,"overcount"
"3048",47,"Tennessee",6,"NHPI_AIC",747,876,129,15.9,"overcount"
"3049",47,"Tennessee",7,"A_A",8221,8898,677,7.91,"overcount"
"3050",47,"Tennessee",7,"A_AIC",9477,10364,887,8.94,"overcount"
"3051",47,"Tennessee",7,"NHPI_A",384,587,203,41.81,"overcount"
"3052",47,"Tennessee",7,"NHPI_AIC",657,837,180,24.1,"overcount"
"3053",47,"Tennessee",8,"A_A",9041,9250,209,2.29,"overcount"
"3054",47,"Tennessee",8,"A_AIC",10145,10393,248,2.42,"overcount"
"3055",47,"Tennessee",8,"NHPI_A",395,431,36,8.72,"overcount"
"3056",47,"Tennessee",8,"NHPI_AIC",599,650,51,8.17,"overcount"
"3057",47,"Tennessee",9,"A_A",8117,7789,-328,-4.12,"undercount"
"3058",47,"Tennessee",9,"A_AIC",8933,8630,-303,-3.45,"undercount"
"3059",47,"Tennessee",9,"NHPI_A",265,315,50,17.24,"overcount"
"3060",47,"Tennessee",9,"NHPI_AIC",480,469,-11,-2.32,"undercount"
"3061",47,"Tennessee",10,"A_A",6545,6450,-95,-1.46,"undercount"
"3062",47,"Tennessee",10,"A_AIC",7281,7200,-81,-1.12,"undercount"
"3063",47,"Tennessee",10,"NHPI_A",239,262,23,9.18,"overcount"
"3064",47,"Tennessee",10,"NHPI_AIC",413,423,10,2.39,"overcount"
"3065",47,"Tennessee",11,"A_A",5193,5324,131,2.49,"overcount"
"3066",47,"Tennessee",11,"A_AIC",5803,5965,162,2.75,"overcount"
"3067",47,"Tennessee",11,"NHPI_A",192,199,7,3.58,"overcount"
"3068",47,"Tennessee",11,"NHPI_AIC",346,338,-8,-2.34,"undercount"
"3069",47,"Tennessee",12,"A_A",4548,4671,123,2.67,"overcount"
"3070",47,"Tennessee",12,"A_AIC",5062,5073,11,0.22,"overcount"
"3071",47,"Tennessee",12,"NHPI_A",132,143,11,8,"overcount"
"3072",47,"Tennessee",12,"NHPI_AIC",258,245,-13,-5.17,"undercount"
"3073",47,"Tennessee",13,"A_A",3658,3554,-104,-2.88,"undercount"
"3074",47,"Tennessee",13,"A_AIC",3993,3720,-273,-7.08,"undercount"
"3075",47,"Tennessee",13,"NHPI_A",114,115,1,0.87,"overcount"
"3076",47,"Tennessee",13,"NHPI_AIC",232,206,-26,-11.87,"undercount"
"3077",47,"Tennessee",14,"A_A",2357,2408,51,2.14,"overcount"
"3078",47,"Tennessee",14,"A_AIC",2558,2444,-114,-4.56,"undercount"
"3079",47,"Tennessee",14,"NHPI_A",75,56,-19,-29.01,"undercount"
"3080",47,"Tennessee",14,"NHPI_AIC",147,120,-27,-20.22,"undercount"
"3081",47,"Tennessee",15,"A_A",1641,1520,-121,-7.66,"undercount"
"3082",47,"Tennessee",15,"A_AIC",1800,1598,-202,-11.89,"undercount"
"3083",47,"Tennessee",15,"NHPI_A",52,24,-28,-73.68,"undercount"
"3084",47,"Tennessee",15,"NHPI_AIC",112,68,-44,-48.89,"undercount"
"3085",47,"Tennessee",16,"A_A",1003,926,-77,-7.98,"undercount"
"3086",47,"Tennessee",16,"A_AIC",1134,926,-208,-20.19,"undercount"
"3087",47,"Tennessee",16,"NHPI_A",35,31,-4,-12.12,"undercount"
"3088",47,"Tennessee",16,"NHPI_AIC",75,73,-2,-2.7,"undercount"
"3089",47,"Tennessee",17,"A_A",638,515,-123,-21.34,"undercount"
"3090",47,"Tennessee",17,"A_AIC",728,521,-207,-33.15,"undercount"
"3091",47,"Tennessee",17,"NHPI_A",37,15,-22,-84.62,"undercount"
"3092",47,"Tennessee",17,"NHPI_AIC",68,37,-31,-59.05,"undercount"
"3093",47,"Tennessee",18,"A_A",436,275,-161,-45.29,"undercount"
"3094",47,"Tennessee",18,"A_AIC",509,254,-255,-66.84,"undercount"
"3095",47,"Tennessee",18,"NHPI_A",36,12,-24,-100,"undercount"
"3096",47,"Tennessee",18,"NHPI_AIC",73,34,-39,-72.9,"undercount"
"3097",48,"Texas",1,"A_A",72722,71772,-950,-1.31,"undercount"
"3098",48,"Texas",1,"A_AIC",93250,93936,686,0.73,"overcount"
"3099",48,"Texas",1,"NHPI_A",3099,2817,-282,-9.53,"undercount"
"3100",48,"Texas",1,"NHPI_AIC",5908,5677,-231,-3.99,"undercount"
"3101",48,"Texas",2,"A_A",72546,74220,1674,2.28,"overcount"
"3102",48,"Texas",2,"A_AIC",92935,92822,-113,-0.12,"undercount"
"3103",48,"Texas",2,"NHPI_A",2447,2788,341,13.03,"overcount"
"3104",48,"Texas",2,"NHPI_AIC",5583,5322,-261,-4.79,"undercount"
"3105",48,"Texas",3,"A_A",60900,66580,5680,8.91,"overcount"
"3106",48,"Texas",3,"A_AIC",74890,81832,6942,8.86,"overcount"
"3107",48,"Texas",3,"NHPI_A",2590,2645,55,2.1,"overcount"
"3108",48,"Texas",3,"NHPI_AIC",4618,4950,332,6.94,"overcount"
"3109",48,"Texas",4,"A_A",53095,64070,10975,18.73,"overcount"
"3110",48,"Texas",4,"A_AIC",63910,77046,13136,18.64,"overcount"
"3111",48,"Texas",4,"NHPI_A",2458,2795,337,12.83,"overcount"
"3112",48,"Texas",4,"NHPI_AIC",4270,5093,823,17.58,"overcount"
"3113",48,"Texas",5,"A_A",53367,73222,19855,31.37,"overcount"
"3114",48,"Texas",5,"A_AIC",63102,83987,20885,28.4,"overcount"
"3115",48,"Texas",5,"NHPI_A",2362,3338,976,34.25,"overcount"
"3116",48,"Texas",5,"NHPI_AIC",4106,5403,1297,27.28,"overcount"
"3117",48,"Texas",6,"A_A",69209,86988,17779,22.76,"overcount"
"3118",48,"Texas",6,"A_AIC",79175,97192,18017,20.43,"overcount"
"3119",48,"Texas",6,"NHPI_A",2492,3131,639,22.73,"overcount"
"3120",48,"Texas",6,"NHPI_AIC",4482,4953,471,9.98,"overcount"
"3121",48,"Texas",7,"A_A",82859,89406,6547,7.6,"overcount"
"3122",48,"Texas",7,"A_AIC",91617,98612,6995,7.35,"overcount"
"3123",48,"Texas",7,"NHPI_A",2977,2720,-257,-9.02,"undercount"
"3124",48,"Texas",7,"NHPI_AIC",4757,4457,-300,-6.51,"undercount"
"3125",48,"Texas",8,"A_A",91424,96737,5313,5.65,"overcount"
"3126",48,"Texas",8,"A_AIC",98718,104793,6075,5.97,"overcount"
"3127",48,"Texas",8,"NHPI_A",2651,2361,-290,-11.57,"undercount"
"3128",48,"Texas",8,"NHPI_AIC",4071,3890,-181,-4.55,"undercount"
"3129",48,"Texas",9,"A_A",79317,83219,3902,4.8,"overcount"
"3130",48,"Texas",9,"A_AIC",84745,89306,4561,5.24,"overcount"
"3131",48,"Texas",9,"NHPI_A",2314,2112,-202,-9.13,"undercount"
"3132",48,"Texas",9,"NHPI_AIC",3425,3478,53,1.54,"overcount"
"3133",48,"Texas",10,"A_A",66959,71832,4873,7.02,"overcount"
"3134",48,"Texas",10,"A_AIC",71916,76984,5068,6.81,"overcount"
"3135",48,"Texas",10,"NHPI_A",2060,1937,-123,-6.15,"undercount"
"3136",48,"Texas",10,"NHPI_AIC",3186,3087,-99,-3.16,"undercount"
"3137",48,"Texas",11,"A_A",57082,62008,4926,8.27,"overcount"
"3138",48,"Texas",11,"A_AIC",61008,66393,5385,8.45,"overcount"
"3139",48,"Texas",11,"NHPI_A",1611,1556,-55,-3.47,"undercount"
"3140",48,"Texas",11,"NHPI_AIC",2545,2515,-30,-1.19,"undercount"
"3141",48,"Texas",12,"A_A",48577,52227,3650,7.24,"overcount"
"3142",48,"Texas",12,"A_AIC",51334,55151,3817,7.17,"overcount"
"3143",48,"Texas",12,"NHPI_A",1217,1093,-124,-10.74,"undercount"
"3144",48,"Texas",12,"NHPI_AIC",1840,1729,-111,-6.22,"undercount"
"3145",48,"Texas",13,"A_A",38739,41015,2276,5.71,"overcount"
"3146",48,"Texas",13,"A_AIC",40658,42889,2231,5.34,"overcount"
"3147",48,"Texas",13,"NHPI_A",876,842,-34,-3.96,"undercount"
"3148",48,"Texas",13,"NHPI_AIC",1369,1359,-10,-0.73,"undercount"
"3149",48,"Texas",14,"A_A",25299,27098,1799,6.87,"overcount"
"3150",48,"Texas",14,"A_AIC",26486,28154,1668,6.11,"overcount"
"3151",48,"Texas",14,"NHPI_A",549,445,-104,-20.93,"undercount"
"3152",48,"Texas",14,"NHPI_AIC",887,710,-177,-22.17,"undercount"
"3153",48,"Texas",15,"A_A",17294,18220,926,5.21,"overcount"
"3154",48,"Texas",15,"A_AIC",18166,18998,832,4.48,"overcount"
"3155",48,"Texas",15,"NHPI_A",357,299,-58,-17.68,"undercount"
"3156",48,"Texas",15,"NHPI_AIC",581,497,-84,-15.58,"undercount"
"3157",48,"Texas",16,"A_A",11109,11215,106,0.95,"overcount"
"3158",48,"Texas",16,"A_AIC",11798,11730,-68,-0.58,"undercount"
"3159",48,"Texas",16,"NHPI_A",270,173,-97,-43.79,"undercount"
"3160",48,"Texas",16,"NHPI_AIC",475,342,-133,-32.56,"undercount"
"3161",48,"Texas",17,"A_A",6947,6446,-501,-7.48,"undercount"
"3162",48,"Texas",17,"A_AIC",7381,6750,-631,-8.93,"undercount"
"3163",48,"Texas",17,"NHPI_A",201,116,-85,-53.63,"undercount"
"3164",48,"Texas",17,"NHPI_AIC",346,216,-130,-46.26,"undercount"
"3165",48,"Texas",18,"A_A",5835,4198,-1637,-32.63,"undercount"
"3166",48,"Texas",18,"A_AIC",6219,4397,-1822,-34.33,"undercount"
"3167",48,"Texas",18,"NHPI_A",167,74,-93,-77.18,"undercount"
"3168",48,"Texas",18,"NHPI_AIC",327,165,-162,-65.85,"undercount"
"3169",49,"Utah",1,"A_A",5445,3640,-1805,-39.74,"undercount"
"3170",49,"Utah",1,"A_AIC",9282,7918,-1364,-15.86,"undercount"
"3171",49,"Utah",1,"NHPI_A",2598,3063,465,16.43,"overcount"
"3172",49,"Utah",1,"NHPI_AIC",4785,5543,758,14.68,"overcount"
"3173",49,"Utah",2,"A_A",4948,3953,-995,-22.36,"undercount"
"3174",49,"Utah",2,"A_AIC",8530,7524,-1006,-12.53,"undercount"
"3175",49,"Utah",2,"NHPI_A",2411,2890,479,18.07,"overcount"
"3176",49,"Utah",2,"NHPI_AIC",4155,4965,810,17.76,"overcount"
"3177",49,"Utah",3,"A_A",3941,3822,-119,-3.07,"undercount"
"3178",49,"Utah",3,"A_AIC",6683,6804,121,1.79,"overcount"
"3179",49,"Utah",3,"NHPI_A",2031,2638,607,26,"overcount"
"3180",49,"Utah",3,"NHPI_AIC",3263,4322,1059,27.92,"overcount"
"3181",49,"Utah",4,"A_A",3834,4469,635,15.3,"overcount"
"3182",49,"Utah",4,"A_AIC",6144,7015,871,13.24,"overcount"
"3183",49,"Utah",4,"NHPI_A",2083,2702,619,25.87,"overcount"
"3184",49,"Utah",4,"NHPI_AIC",3172,4000,828,23.09,"overcount"
"3185",49,"Utah",5,"A_A",5242,5785,543,9.85,"overcount"
"3186",49,"Utah",5,"A_AIC",7213,7915,702,9.28,"overcount"
"3187",49,"Utah",5,"NHPI_A",2170,2681,511,21.07,"overcount"
"3188",49,"Utah",5,"NHPI_AIC",3115,3707,592,17.36,"overcount"
"3189",49,"Utah",6,"A_A",4916,5716,800,15.05,"overcount"
"3190",49,"Utah",6,"A_AIC",6410,7480,1070,15.41,"overcount"
"3191",49,"Utah",6,"NHPI_A",1942,2504,562,25.28,"overcount"
"3192",49,"Utah",6,"NHPI_AIC",2757,3472,715,22.96,"overcount"
"3193",49,"Utah",7,"A_A",4901,5078,177,3.55,"overcount"
"3194",49,"Utah",7,"A_AIC",6076,6518,442,7.02,"overcount"
"3195",49,"Utah",7,"NHPI_A",1785,2098,313,16.12,"overcount"
"3196",49,"Utah",7,"NHPI_AIC",2366,2861,495,18.94,"overcount"
"3197",49,"Utah",8,"A_A",5339,4985,-354,-6.86,"undercount"
"3198",49,"Utah",8,"A_AIC",6235,5935,-300,-4.93,"undercount"
"3199",49,"Utah",8,"NHPI_A",1476,1601,125,8.12,"overcount"
"3200",49,"Utah",8,"NHPI_AIC",1877,2008,131,6.74,"overcount"
"3201",49,"Utah",9,"A_A",4647,4348,-299,-6.65,"undercount"
"3202",49,"Utah",9,"A_AIC",5233,5000,-233,-4.55,"undercount"
"3203",49,"Utah",9,"NHPI_A",1283,1345,62,4.72,"overcount"
"3204",49,"Utah",9,"NHPI_AIC",1575,1665,90,5.56,"overcount"
"3205",49,"Utah",10,"A_A",3533,3832,299,8.12,"overcount"
"3206",49,"Utah",10,"A_AIC",4018,4365,347,8.28,"overcount"
"3207",49,"Utah",10,"NHPI_A",1133,1242,109,9.18,"overcount"
"3208",49,"Utah",10,"NHPI_AIC",1383,1531,148,10.16,"overcount"
"3209",49,"Utah",11,"A_A",2938,3289,351,11.27,"overcount"
"3210",49,"Utah",11,"A_AIC",3399,3727,328,9.21,"overcount"
"3211",49,"Utah",11,"NHPI_A",1028,1033,5,0.49,"overcount"
"3212",49,"Utah",11,"NHPI_AIC",1233,1225,-8,-0.65,"undercount"
"3213",49,"Utah",12,"A_A",2694,2766,72,2.64,"overcount"
"3214",49,"Utah",12,"A_AIC",2962,3021,59,1.97,"overcount"
"3215",49,"Utah",12,"NHPI_A",755,795,40,5.16,"overcount"
"3216",49,"Utah",12,"NHPI_AIC",917,940,23,2.48,"overcount"
"3217",49,"Utah",13,"A_A",2236,2157,-79,-3.6,"undercount"
"3218",49,"Utah",13,"A_AIC",2401,2317,-84,-3.56,"undercount"
"3219",49,"Utah",13,"NHPI_A",564,567,3,0.53,"overcount"
"3220",49,"Utah",13,"NHPI_AIC",658,647,-11,-1.69,"undercount"
"3221",49,"Utah",14,"A_A",1462,1358,-104,-7.38,"undercount"
"3222",49,"Utah",14,"A_AIC",1590,1457,-133,-8.73,"undercount"
"3223",49,"Utah",14,"NHPI_A",359,364,5,1.38,"overcount"
"3224",49,"Utah",14,"NHPI_AIC",430,414,-16,-3.79,"undercount"
"3225",49,"Utah",15,"A_A",1046,936,-110,-11.1,"undercount"
"3226",49,"Utah",15,"A_AIC",1130,974,-156,-14.83,"undercount"
"3227",49,"Utah",15,"NHPI_A",242,237,-5,-2.09,"undercount"
"3228",49,"Utah",15,"NHPI_AIC",308,261,-47,-16.52,"undercount"
"3229",49,"Utah",16,"A_A",819,670,-149,-20.01,"undercount"
"3230",49,"Utah",16,"A_AIC",896,705,-191,-23.86,"undercount"
"3231",49,"Utah",16,"NHPI_A",166,148,-18,-11.46,"undercount"
"3232",49,"Utah",16,"NHPI_AIC",183,156,-27,-15.93,"undercount"
"3233",49,"Utah",17,"A_A",545,510,-35,-6.64,"undercount"
"3234",49,"Utah",17,"A_AIC",593,535,-58,-10.28,"undercount"
"3235",49,"Utah",17,"NHPI_A",94,81,-13,-14.86,"undercount"
"3236",49,"Utah",17,"NHPI_AIC",104,91,-13,-13.33,"undercount"
"3237",49,"Utah",18,"A_A",584,486,-98,-18.32,"undercount"
"3238",49,"Utah",18,"A_AIC",615,490,-125,-22.62,"undercount"
"3239",49,"Utah",18,"NHPI_A",75,60,-15,-22.22,"undercount"
"3240",49,"Utah",18,"NHPI_AIC",95,52,-43,-58.5,"undercount"
"3241",50,"Vermont",1,"A_A",503,452,-51,-10.68,"undercount"
"3242",50,"Vermont",1,"A_AIC",872,879,7,0.8,"overcount"
"3243",50,"Vermont",1,"NHPI_A",13,9,-4,-36.36,"undercount"
"3244",50,"Vermont",1,"NHPI_AIC",42,43,1,2.35,"overcount"
"3245",50,"Vermont",2,"A_A",547,584,37,6.54,"overcount"
"3246",50,"Vermont",2,"A_AIC",811,944,133,15.16,"overcount"
"3247",50,"Vermont",2,"NHPI_A",23,7,-16,-106.67,"undercount"
"3248",50,"Vermont",2,"NHPI_AIC",46,29,-17,-45.33,"undercount"
"3249",50,"Vermont",3,"A_A",568,629,61,10.19,"overcount"
"3250",50,"Vermont",3,"A_AIC",797,903,106,12.47,"overcount"
"3251",50,"Vermont",3,"NHPI_A",20,6,-14,-107.69,"undercount"
"3252",50,"Vermont",3,"NHPI_AIC",33,28,-5,-16.39,"undercount"
"3253",50,"Vermont",4,"A_A",607,848,241,33.13,"overcount"
"3254",50,"Vermont",4,"A_AIC",862,1229,367,35.1,"overcount"
"3255",50,"Vermont",4,"NHPI_A",19,20,1,5.13,"overcount"
"3256",50,"Vermont",4,"NHPI_AIC",41,55,14,29.17,"overcount"
"3257",50,"Vermont",5,"A_A",885,901,16,1.79,"overcount"
"3258",50,"Vermont",5,"A_AIC",1097,1159,62,5.5,"overcount"
"3259",50,"Vermont",5,"NHPI_A",32,26,-6,-20.69,"undercount"
"3260",50,"Vermont",5,"NHPI_AIC",66,69,3,4.44,"overcount"
"3261",50,"Vermont",6,"A_A",566,723,157,24.36,"overcount"
"3262",50,"Vermont",6,"A_AIC",662,872,210,27.38,"overcount"
"3263",50,"Vermont",6,"NHPI_A",28,14,-14,-66.67,"undercount"
"3264",50,"Vermont",6,"NHPI_AIC",39,33,-6,-16.67,"undercount"
"3265",50,"Vermont",7,"A_A",588,651,63,10.17,"overcount"
"3266",50,"Vermont",7,"A_AIC",685,771,86,11.81,"overcount"
"3267",50,"Vermont",7,"NHPI_A",32,13,-19,-84.44,"undercount"
"3268",50,"Vermont",7,"NHPI_AIC",52,35,-17,-39.08,"undercount"
"3269",50,"Vermont",8,"A_A",699,740,41,5.7,"overcount"
"3270",50,"Vermont",8,"A_AIC",780,863,83,10.1,"overcount"
"3271",50,"Vermont",8,"NHPI_A",19,12,-7,-45.16,"undercount"
"3272",50,"Vermont",8,"NHPI_AIC",30,25,-5,-18.18,"undercount"
"3273",50,"Vermont",9,"A_A",612,595,-17,-2.82,"undercount"
"3274",50,"Vermont",9,"A_AIC",698,698,0,0,"equal"
"3275",50,"Vermont",9,"NHPI_A",17,15,-2,-12.5,"undercount"
"3276",50,"Vermont",9,"NHPI_AIC",24,23,-1,-4.26,"undercount"
"3277",50,"Vermont",10,"A_A",462,514,52,10.66,"overcount"
"3278",50,"Vermont",10,"A_AIC",510,562,52,9.7,"overcount"
"3279",50,"Vermont",10,"NHPI_A",26,16,-10,-47.62,"undercount"
"3280",50,"Vermont",10,"NHPI_AIC",38,19,-19,-66.67,"undercount"
"3281",50,"Vermont",11,"A_A",350,407,57,15.06,"overcount"
"3282",50,"Vermont",11,"A_AIC",384,464,80,18.87,"overcount"
"3283",50,"Vermont",11,"NHPI_A",6,13,7,73.68,"overcount"
"3284",50,"Vermont",11,"NHPI_AIC",15,30,15,66.67,"overcount"
"3285",50,"Vermont",12,"A_A",335,349,14,4.09,"overcount"
"3286",50,"Vermont",12,"A_AIC",357,340,-17,-4.88,"undercount"
"3287",50,"Vermont",12,"NHPI_A",12,6,-6,-66.67,"undercount"
"3288",50,"Vermont",12,"NHPI_AIC",18,18,0,0,"equal"
"3289",50,"Vermont",13,"A_A",237,278,41,15.92,"overcount"
"3290",50,"Vermont",13,"A_AIC",268,266,-2,-0.75,"undercount"
"3291",50,"Vermont",13,"NHPI_A",13,10,-3,-26.09,"undercount"
"3292",50,"Vermont",13,"NHPI_AIC",20,8,-12,-85.71,"undercount"
"3293",50,"Vermont",14,"A_A",150,154,4,2.63,"overcount"
"3294",50,"Vermont",14,"A_AIC",160,107,-53,-39.7,"undercount"
"3295",50,"Vermont",14,"NHPI_A",4,5,1,22.22,"overcount"
"3296",50,"Vermont",14,"NHPI_AIC",4,9,5,76.92,"overcount"
"3297",50,"Vermont",15,"A_A",131,100,-31,-26.84,"undercount"
"3298",50,"Vermont",15,"A_AIC",144,105,-39,-31.33,"undercount"
"3299",50,"Vermont",15,"NHPI_A",0,3,3,200,"overcount"
"3300",50,"Vermont",15,"NHPI_AIC",3,1,-2,-100,"undercount"
"3301",50,"Vermont",16,"A_A",85,73,-12,-15.19,"undercount"
"3302",50,"Vermont",16,"A_AIC",90,45,-45,-66.67,"undercount"
"3303",50,"Vermont",16,"NHPI_A",2,0,-2,-200,"undercount"
"3304",50,"Vermont",16,"NHPI_AIC",3,2,-1,-40,"undercount"
"3305",50,"Vermont",17,"A_A",55,44,-11,-22.22,"undercount"
"3306",50,"Vermont",17,"A_AIC",69,27,-42,-87.5,"undercount"
"3307",50,"Vermont",17,"NHPI_A",2,0,-2,-200,"undercount"
"3308",50,"Vermont",17,"NHPI_AIC",3,1,-2,-100,"undercount"
"3309",50,"Vermont",18,"A_A",47,27,-20,-54.05,"undercount"
"3310",50,"Vermont",18,"A_AIC",61,30,-31,-68.13,"undercount"
"3311",50,"Vermont",18,"NHPI_A",5,0,-5,-200,"undercount"
"3312",50,"Vermont",18,"NHPI_AIC",5,0,-5,-200,"undercount"
"3313",51,"Virginia",1,"A_A",31397,31380,-17,-0.05,"undercount"
"3314",51,"Virginia",1,"A_AIC",41032,44799,3767,8.78,"overcount"
"3315",51,"Virginia",1,"NHPI_A",854,638,-216,-28.95,"undercount"
"3316",51,"Virginia",1,"NHPI_AIC",1778,1800,22,1.23,"overcount"
"3317",51,"Virginia",2,"A_A",29359,31661,2302,7.55,"overcount"
"3318",51,"Virginia",2,"A_AIC",37833,43150,5317,13.13,"overcount"
"3319",51,"Virginia",2,"NHPI_A",827,575,-252,-35.95,"undercount"
"3320",51,"Virginia",2,"NHPI_AIC",1763,1497,-266,-16.32,"undercount"
"3321",51,"Virginia",3,"A_A",24081,27433,3352,13.01,"overcount"
"3322",51,"Virginia",3,"A_AIC",30796,36854,6058,17.91,"overcount"
"3323",51,"Virginia",3,"NHPI_A",510,536,26,4.97,"overcount"
"3324",51,"Virginia",3,"NHPI_AIC",1330,1352,22,1.64,"overcount"
"3325",51,"Virginia",4,"A_A",22661,27110,4449,17.88,"overcount"
"3326",51,"Virginia",4,"A_AIC",28380,35064,6684,21.07,"overcount"
"3327",51,"Virginia",4,"NHPI_A",558,649,91,15.08,"overcount"
"3328",51,"Virginia",4,"NHPI_AIC",1377,1436,59,4.19,"overcount"
"3329",51,"Virginia",5,"A_A",25722,30675,4953,17.56,"overcount"
"3330",51,"Virginia",5,"A_AIC",30930,37435,6505,19.03,"overcount"
"3331",51,"Virginia",5,"NHPI_A",629,993,364,44.88,"overcount"
"3332",51,"Virginia",5,"NHPI_AIC",1453,1892,439,26.25,"overcount"
"3333",51,"Virginia",6,"A_A",33011,38553,5542,15.49,"overcount"
"3334",51,"Virginia",6,"A_AIC",37843,44644,6801,16.49,"overcount"
"3335",51,"Virginia",6,"NHPI_A",717,922,205,25.02,"overcount"
"3336",51,"Virginia",6,"NHPI_AIC",1503,1713,210,13.06,"overcount"
"3337",51,"Virginia",7,"A_A",37309,41689,4380,11.09,"overcount"
"3338",51,"Virginia",7,"A_AIC",41321,46789,5468,12.41,"overcount"
"3339",51,"Virginia",7,"NHPI_A",635,793,158,22.13,"overcount"
"3340",51,"Virginia",7,"NHPI_AIC",1343,1470,127,9.03,"overcount"
"3341",51,"Virginia",8,"A_A",41334,44969,3635,8.42,"overcount"
"3342",51,"Virginia",8,"A_AIC",44807,49256,4449,9.46,"overcount"
"3343",51,"Virginia",8,"NHPI_A",691,706,15,2.15,"overcount"
"3344",51,"Virginia",8,"NHPI_AIC",1221,1230,9,0.73,"overcount"
"3345",51,"Virginia",9,"A_A",35381,38174,2793,7.59,"overcount"
"3346",51,"Virginia",9,"A_AIC",38165,41638,3473,8.7,"overcount"
"3347",51,"Virginia",9,"NHPI_A",529,577,48,8.68,"overcount"
"3348",51,"Virginia",9,"NHPI_AIC",996,1060,64,6.23,"overcount"
"3349",51,"Virginia",10,"A_A",30340,33642,3302,10.32,"overcount"
"3350",51,"Virginia",10,"A_AIC",32783,36563,3780,10.9,"overcount"
"3351",51,"Virginia",10,"NHPI_A",442,536,94,19.22,"overcount"
"3352",51,"Virginia",10,"NHPI_AIC",886,983,97,10.38,"overcount"
"3353",51,"Virginia",11,"A_A",25902,28648,2746,10.07,"overcount"
"3354",51,"Virginia",11,"A_AIC",28040,30905,2865,9.72,"overcount"
"3355",51,"Virginia",11,"NHPI_A",367,424,57,14.41,"overcount"
"3356",51,"Virginia",11,"NHPI_AIC",766,754,-12,-1.58,"undercount"
"3357",51,"Virginia",12,"A_A",21688,23071,1383,6.18,"overcount"
"3358",51,"Virginia",12,"A_AIC",23180,24616,1436,6.01,"overcount"
"3359",51,"Virginia",12,"NHPI_A",267,326,59,19.9,"overcount"
"3360",51,"Virginia",12,"NHPI_AIC",577,572,-5,-0.87,"undercount"
"3361",51,"Virginia",13,"A_A",17974,18852,878,4.77,"overcount"
"3362",51,"Virginia",13,"A_AIC",19064,19733,669,3.45,"overcount"
"3363",51,"Virginia",13,"NHPI_A",210,247,37,16.19,"overcount"
"3364",51,"Virginia",13,"NHPI_AIC",435,440,5,1.14,"overcount"
"3365",51,"Virginia",14,"A_A",12683,13178,495,3.83,"overcount"
"3366",51,"Virginia",14,"A_AIC",13395,13672,277,2.05,"overcount"
"3367",51,"Virginia",14,"NHPI_A",131,126,-5,-3.89,"undercount"
"3368",51,"Virginia",14,"NHPI_AIC",270,230,-40,-16,"undercount"
"3369",51,"Virginia",15,"A_A",9261,9090,-171,-1.86,"undercount"
"3370",51,"Virginia",15,"A_AIC",9768,9393,-375,-3.91,"undercount"
"3371",51,"Virginia",15,"NHPI_A",95,80,-15,-17.14,"undercount"
"3372",51,"Virginia",15,"NHPI_AIC",203,165,-38,-20.65,"undercount"
"3373",51,"Virginia",16,"A_A",6191,5816,-375,-6.25,"undercount"
"3374",51,"Virginia",16,"A_AIC",6554,5920,-634,-10.17,"undercount"
"3375",51,"Virginia",16,"NHPI_A",48,35,-13,-31.33,"undercount"
"3376",51,"Virginia",16,"NHPI_AIC",149,87,-62,-52.54,"undercount"
"3377",51,"Virginia",17,"A_A",3696,3140,-556,-16.27,"undercount"
"3378",51,"Virginia",17,"A_AIC",3950,3107,-843,-23.89,"undercount"
"3379",51,"Virginia",17,"NHPI_A",25,21,-4,-17.39,"undercount"
"3380",51,"Virginia",17,"NHPI_AIC",100,60,-40,-50,"undercount"
"3381",51,"Virginia",18,"A_A",2765,2068,-697,-28.84,"undercount"
"3382",51,"Virginia",18,"A_AIC",3005,2057,-948,-37.46,"undercount"
"3383",51,"Virginia",18,"NHPI_A",48,17,-31,-95.38,"undercount"
"3384",51,"Virginia",18,"NHPI_AIC",117,44,-73,-90.68,"undercount"
"3385",53,"Washington",1,"A_A",34016,29772,-4244,-13.31,"undercount"
"3386",53,"Washington",1,"A_AIC",49556,50686,1130,2.25,"overcount"
"3387",53,"Washington",1,"NHPI_A",3339,4014,675,18.36,"overcount"
"3388",53,"Washington",1,"NHPI_AIC",6767,8581,1814,23.64,"overcount"
"3389",53,"Washington",2,"A_A",32121,30321,-1800,-5.77,"undercount"
"3390",53,"Washington",2,"A_AIC",45414,47853,2439,5.23,"overcount"
"3391",53,"Washington",2,"NHPI_A",3230,3754,524,15.01,"overcount"
"3392",53,"Washington",2,"NHPI_AIC",6116,7635,1519,22.09,"overcount"
"3393",53,"Washington",3,"A_A",26943,28676,1733,6.23,"overcount"
"3394",53,"Washington",3,"A_AIC",38935,43937,5002,12.07,"overcount"
"3395",53,"Washington",3,"NHPI_A",2425,3835,1410,45.05,"overcount"
"3396",53,"Washington",3,"NHPI_AIC",5067,7235,2168,35.25,"overcount"
"3397",53,"Washington",4,"A_A",27025,33549,6524,21.54,"overcount"
"3398",53,"Washington",4,"A_AIC",37039,47164,10125,24.05,"overcount"
"3399",53,"Washington",4,"NHPI_A",2644,4153,1509,44.4,"overcount"
"3400",53,"Washington",4,"NHPI_AIC",4972,7314,2342,38.12,"overcount"
"3401",53,"Washington",5,"A_A",29920,36759,6839,20.51,"overcount"
"3402",53,"Washington",5,"A_AIC",38396,47804,9408,21.83,"overcount"
"3403",53,"Washington",5,"NHPI_A",2705,4361,1656,46.87,"overcount"
"3404",53,"Washington",5,"NHPI_AIC",4804,7049,2245,37.88,"overcount"
"3405",53,"Washington",6,"A_A",40394,41552,1158,2.83,"overcount"
"3406",53,"Washington",6,"A_AIC",47906,51314,3408,6.87,"overcount"
"3407",53,"Washington",6,"NHPI_A",2930,4148,1218,34.42,"overcount"
"3408",53,"Washington",6,"NHPI_AIC",4982,6645,1663,28.61,"overcount"
"3409",53,"Washington",7,"A_A",43846,42240,-1606,-3.73,"undercount"
"3410",53,"Washington",7,"A_AIC",49807,50378,571,1.14,"overcount"
"3411",53,"Washington",7,"NHPI_A",2911,3688,777,23.55,"overcount"
"3412",53,"Washington",7,"NHPI_AIC",4771,5754,983,18.68,"overcount"
"3413",53,"Washington",8,"A_A",44972,44488,-484,-1.08,"undercount"
"3414",53,"Washington",8,"A_AIC",49977,51034,1057,2.09,"overcount"
"3415",53,"Washington",8,"NHPI_A",2609,3269,660,22.46,"overcount"
"3416",53,"Washington",8,"NHPI_AIC",4079,4892,813,18.13,"overcount"
"3417",53,"Washington",9,"A_A",37671,39042,1371,3.57,"overcount"
"3418",53,"Washington",9,"A_AIC",41941,44049,2108,4.9,"overcount"
"3419",53,"Washington",9,"NHPI_A",2340,2837,497,19.2,"overcount"
"3420",53,"Washington",9,"NHPI_AIC",3679,4195,516,13.11,"overcount"
"3421",53,"Washington",10,"A_A",34242,36075,1833,5.21,"overcount"
"3422",53,"Washington",10,"A_AIC",37900,40415,2515,6.42,"overcount"
"3423",53,"Washington",10,"NHPI_A",2295,2716,421,16.8,"overcount"
"3424",53,"Washington",10,"NHPI_AIC",3658,3968,310,8.13,"overcount"
"3425",53,"Washington",11,"A_A",31009,32654,1645,5.17,"overcount"
"3426",53,"Washington",11,"A_AIC",34005,36289,2284,6.5,"overcount"
"3427",53,"Washington",11,"NHPI_A",2044,2305,261,12,"overcount"
"3428",53,"Washington",11,"NHPI_AIC",3078,3350,272,8.46,"overcount"
"3429",53,"Washington",12,"A_A",27151,28438,1287,4.63,"overcount"
"3430",53,"Washington",12,"A_AIC",29226,30858,1632,5.43,"overcount"
"3431",53,"Washington",12,"NHPI_A",1675,1643,-32,-1.93,"undercount"
"3432",53,"Washington",12,"NHPI_AIC",2505,2398,-107,-4.36,"undercount"
"3433",53,"Washington",13,"A_A",22011,22645,634,2.84,"overcount"
"3434",53,"Washington",13,"A_AIC",23284,24006,722,3.05,"overcount"
"3435",53,"Washington",13,"NHPI_A",1200,1177,-23,-1.94,"undercount"
"3436",53,"Washington",13,"NHPI_AIC",1777,1708,-69,-3.96,"undercount"
"3437",53,"Washington",14,"A_A",15421,15362,-59,-0.38,"undercount"
"3438",53,"Washington",14,"A_AIC",16199,16185,-14,-0.09,"undercount"
"3439",53,"Washington",14,"NHPI_A",712,681,-31,-4.45,"undercount"
"3440",53,"Washington",14,"NHPI_AIC",1029,1011,-18,-1.76,"undercount"
"3441",53,"Washington",15,"A_A",11924,11726,-198,-1.67,"undercount"
"3442",53,"Washington",15,"A_AIC",12436,12255,-181,-1.47,"undercount"
"3443",53,"Washington",15,"NHPI_A",468,446,-22,-4.81,"undercount"
"3444",53,"Washington",15,"NHPI_AIC",679,652,-27,-4.06,"undercount"
"3445",53,"Washington",16,"A_A",8448,8328,-120,-1.43,"undercount"
"3446",53,"Washington",16,"A_AIC",8829,8658,-171,-1.96,"undercount"
"3447",53,"Washington",16,"NHPI_A",291,262,-29,-10.49,"undercount"
"3448",53,"Washington",16,"NHPI_AIC",428,397,-31,-7.52,"undercount"
"3449",53,"Washington",17,"A_A",6074,5603,-471,-8.07,"undercount"
"3450",53,"Washington",17,"A_AIC",6322,5755,-567,-9.39,"undercount"
"3451",53,"Washington",17,"NHPI_A",196,136,-60,-36.14,"undercount"
"3452",53,"Washington",17,"NHPI_AIC",276,207,-69,-28.57,"undercount"
"3453",53,"Washington",18,"A_A",5477,4455,-1022,-20.58,"undercount"
"3454",53,"Washington",18,"A_AIC",5717,4621,-1096,-21.2,"undercount"
"3455",53,"Washington",18,"NHPI_A",131,80,-51,-48.34,"undercount"
"3456",53,"Washington",18,"NHPI_AIC",204,146,-58,-33.14,"undercount"
"3457",54,"West Virginia",1,"A_A",802,730,-72,-9.4,"undercount"
"3458",54,"West Virginia",1,"A_AIC",1299,1327,28,2.13,"overcount"
"3459",54,"West Virginia",1,"NHPI_A",38,40,2,5.13,"overcount"
"3460",54,"West Virginia",1,"NHPI_AIC",104,117,13,11.76,"overcount"
"3461",54,"West Virginia",2,"A_A",793,763,-30,-3.86,"undercount"
"3462",54,"West Virginia",2,"A_AIC",1281,1257,-24,-1.89,"undercount"
"3463",54,"West Virginia",2,"NHPI_A",32,26,-6,-20.69,"undercount"
"3464",54,"West Virginia",2,"NHPI_AIC",103,112,9,8.37,"overcount"
"3465",54,"West Virginia",3,"A_A",717,672,-45,-6.48,"undercount"
"3466",54,"West Virginia",3,"A_AIC",1074,1081,7,0.65,"overcount"
"3467",54,"West Virginia",3,"NHPI_A",50,24,-26,-70.27,"undercount"
"3468",54,"West Virginia",3,"NHPI_AIC",110,84,-26,-26.8,"undercount"
"3469",54,"West Virginia",4,"A_A",814,780,-34,-4.27,"undercount"
"3470",54,"West Virginia",4,"A_AIC",1170,1184,14,1.19,"overcount"
"3471",54,"West Virginia",4,"NHPI_A",43,44,1,2.3,"overcount"
"3472",54,"West Virginia",4,"NHPI_AIC",114,114,0,0,"equal"
"3473",54,"West Virginia",5,"A_A",1603,1304,-299,-20.57,"undercount"
"3474",54,"West Virginia",5,"A_AIC",1931,1665,-266,-14.79,"undercount"
"3475",54,"West Virginia",5,"NHPI_A",40,62,22,43.14,"overcount"
"3476",54,"West Virginia",5,"NHPI_AIC",84,118,34,33.66,"overcount"
"3477",54,"West Virginia",6,"A_A",1057,1254,197,17.05,"overcount"
"3478",54,"West Virginia",6,"A_AIC",1284,1539,255,18.07,"overcount"
"3479",54,"West Virginia",6,"NHPI_A",64,44,-20,-37.04,"undercount"
"3480",54,"West Virginia",6,"NHPI_AIC",125,94,-31,-28.31,"undercount"
"3481",54,"West Virginia",7,"A_A",884,1099,215,21.68,"overcount"
"3482",54,"West Virginia",7,"A_AIC",1117,1334,217,17.71,"overcount"
"3483",54,"West Virginia",7,"NHPI_A",51,40,-11,-24.18,"undercount"
"3484",54,"West Virginia",7,"NHPI_AIC",107,78,-29,-31.35,"undercount"
"3485",54,"West Virginia",8,"A_A",1058,1088,30,2.8,"overcount"
"3486",54,"West Virginia",8,"A_AIC",1240,1242,2,0.16,"overcount"
"3487",54,"West Virginia",8,"NHPI_A",70,44,-26,-45.61,"undercount"
"3488",54,"West Virginia",8,"NHPI_AIC",107,69,-38,-43.18,"undercount"
"3489",54,"West Virginia",9,"A_A",868,910,42,4.72,"overcount"
"3490",54,"West Virginia",9,"A_AIC",998,994,-4,-0.4,"undercount"
"3491",54,"West Virginia",9,"NHPI_A",35,30,-5,-15.38,"undercount"
"3492",54,"West Virginia",9,"NHPI_AIC",71,60,-11,-16.79,"undercount"
"3493",54,"West Virginia",10,"A_A",832,844,12,1.43,"overcount"
"3494",54,"West Virginia",10,"A_AIC",952,924,-28,-2.99,"undercount"
"3495",54,"West Virginia",10,"NHPI_A",42,35,-7,-18.18,"undercount"
"3496",54,"West Virginia",10,"NHPI_AIC",80,72,-8,-10.53,"undercount"
"3497",54,"West Virginia",11,"A_A",688,730,42,5.92,"overcount"
"3498",54,"West Virginia",11,"A_AIC",830,805,-25,-3.06,"undercount"
"3499",54,"West Virginia",11,"NHPI_A",29,26,-3,-10.91,"undercount"
"3500",54,"West Virginia",11,"NHPI_AIC",54,71,17,27.2,"overcount"
"3501",54,"West Virginia",12,"A_A",634,676,42,6.41,"overcount"
"3502",54,"West Virginia",12,"A_AIC",770,770,0,0,"equal"
"3503",54,"West Virginia",12,"NHPI_A",39,18,-21,-73.68,"undercount"
"3504",54,"West Virginia",12,"NHPI_AIC",65,48,-17,-30.09,"undercount"
"3505",54,"West Virginia",13,"A_A",637,654,17,2.63,"overcount"
"3506",54,"West Virginia",13,"A_AIC",737,664,-73,-10.42,"undercount"
"3507",54,"West Virginia",13,"NHPI_A",27,24,-3,-11.76,"undercount"
"3508",54,"West Virginia",13,"NHPI_AIC",49,54,5,9.71,"overcount"
"3509",54,"West Virginia",14,"A_A",493,520,27,5.33,"overcount"
"3510",54,"West Virginia",14,"A_AIC",545,497,-48,-9.21,"undercount"
"3511",54,"West Virginia",14,"NHPI_A",14,10,-4,-33.33,"undercount"
"3512",54,"West Virginia",14,"NHPI_AIC",35,21,-14,-50,"undercount"
"3513",54,"West Virginia",15,"A_A",350,321,-29,-8.64,"undercount"
"3514",54,"West Virginia",15,"A_AIC",413,315,-98,-26.92,"undercount"
"3515",54,"West Virginia",15,"NHPI_A",18,13,-5,-32.26,"undercount"
"3516",54,"West Virginia",15,"NHPI_AIC",35,24,-11,-37.29,"undercount"
"3517",54,"West Virginia",16,"A_A",191,150,-41,-24.05,"undercount"
"3518",54,"West Virginia",16,"A_AIC",230,134,-96,-52.75,"undercount"
"3519",54,"West Virginia",16,"NHPI_A",11,1,-10,-166.67,"undercount"
"3520",54,"West Virginia",16,"NHPI_AIC",19,18,-1,-5.41,"undercount"
"3521",54,"West Virginia",17,"A_A",130,88,-42,-38.53,"undercount"
"3522",54,"West Virginia",17,"A_AIC",162,57,-105,-95.89,"undercount"
"3523",54,"West Virginia",17,"NHPI_A",8,3,-5,-90.91,"undercount"
"3524",54,"West Virginia",17,"NHPI_AIC",14,10,-4,-33.33,"undercount"
"3525",54,"West Virginia",18,"A_A",115,54,-61,-72.19,"undercount"
"3526",54,"West Virginia",18,"A_AIC",170,48,-122,-111.93,"undercount"
"3527",54,"West Virginia",18,"NHPI_A",19,1,-18,-180,"undercount"
"3528",54,"West Virginia",18,"NHPI_AIC",38,8,-30,-130.43,"undercount"
"3529",55,"Wisconsin",1,"A_A",12446,12554,108,0.86,"overcount"
"3530",55,"Wisconsin",1,"A_AIC",15675,16726,1051,6.49,"overcount"
"3531",55,"Wisconsin",1,"NHPI_A",292,203,-89,-35.96,"undercount"
"3532",55,"Wisconsin",1,"NHPI_AIC",732,586,-146,-22.15,"undercount"
"3533",55,"Wisconsin",2,"A_A",11462,11874,412,3.53,"overcount"
"3534",55,"Wisconsin",2,"A_AIC",14316,15426,1110,7.46,"overcount"
"3535",55,"Wisconsin",2,"NHPI_A",303,205,-98,-38.58,"undercount"
"3536",55,"Wisconsin",2,"NHPI_AIC",686,499,-187,-31.56,"undercount"
"3537",55,"Wisconsin",3,"A_A",10413,11135,722,6.7,"overcount"
"3538",55,"Wisconsin",3,"A_AIC",12797,13908,1111,8.32,"overcount"
"3539",55,"Wisconsin",3,"NHPI_A",252,197,-55,-24.5,"undercount"
"3540",55,"Wisconsin",3,"NHPI_AIC",669,480,-189,-32.9,"undercount"
"3541",55,"Wisconsin",4,"A_A",11269,12991,1722,14.2,"overcount"
"3542",55,"Wisconsin",4,"A_AIC",13239,15297,2058,14.42,"overcount"
"3543",55,"Wisconsin",4,"NHPI_A",219,219,0,0,"equal"
"3544",55,"Wisconsin",4,"NHPI_AIC",622,505,-117,-20.76,"undercount"
"3545",55,"Wisconsin",5,"A_A",13464,14622,1158,8.25,"overcount"
"3546",55,"Wisconsin",5,"A_AIC",15125,16374,1249,7.93,"overcount"
"3547",55,"Wisconsin",5,"NHPI_A",215,269,54,22.31,"overcount"
"3548",55,"Wisconsin",5,"NHPI_AIC",534,561,27,4.93,"overcount"
"3549",55,"Wisconsin",6,"A_A",11781,13839,2058,16.07,"overcount"
"3550",55,"Wisconsin",6,"A_AIC",13064,15252,2188,15.45,"overcount"
"3551",55,"Wisconsin",6,"NHPI_A",179,263,84,38.01,"overcount"
"3552",55,"Wisconsin",6,"NHPI_AIC",506,490,-16,-3.21,"undercount"
"3553",55,"Wisconsin",7,"A_A",10005,11156,1151,10.88,"overcount"
"3554",55,"Wisconsin",7,"A_AIC",11113,12323,1210,10.33,"overcount"
"3555",55,"Wisconsin",7,"NHPI_A",276,204,-72,-30,"undercount"
"3556",55,"Wisconsin",7,"NHPI_AIC",583,390,-193,-39.67,"undercount"
"3557",55,"Wisconsin",8,"A_A",9876,9928,52,0.53,"overcount"
"3558",55,"Wisconsin",8,"A_AIC",10855,10855,0,0,"equal"
"3559",55,"Wisconsin",8,"NHPI_A",184,204,20,10.31,"overcount"
"3560",55,"Wisconsin",8,"NHPI_AIC",405,384,-21,-5.32,"undercount"
"3561",55,"Wisconsin",9,"A_A",8487,8154,-333,-4,"undercount"
"3562",55,"Wisconsin",9,"A_AIC",9268,8912,-356,-3.92,"undercount"
"3563",55,"Wisconsin",9,"NHPI_A",177,160,-17,-10.09,"undercount"
"3564",55,"Wisconsin",9,"NHPI_AIC",390,319,-71,-20.03,"undercount"
"3565",55,"Wisconsin",10,"A_A",6776,6818,42,0.62,"overcount"
"3566",55,"Wisconsin",10,"A_AIC",7407,7336,-71,-0.96,"undercount"
"3567",55,"Wisconsin",10,"NHPI_A",144,175,31,19.44,"overcount"
"3568",55,"Wisconsin",10,"NHPI_AIC",315,297,-18,-5.88,"undercount"
"3569",55,"Wisconsin",11,"A_A",5130,5172,42,0.82,"overcount"
"3570",55,"Wisconsin",11,"A_AIC",5692,5708,16,0.28,"overcount"
"3571",55,"Wisconsin",11,"NHPI_A",121,130,9,7.17,"overcount"
"3572",55,"Wisconsin",11,"NHPI_AIC",318,253,-65,-22.77,"undercount"
"3573",55,"Wisconsin",12,"A_A",4084,4305,221,5.27,"overcount"
"3574",55,"Wisconsin",12,"A_AIC",4444,4518,74,1.65,"overcount"
"3575",55,"Wisconsin",12,"NHPI_A",100,101,1,1,"overcount"
"3576",55,"Wisconsin",12,"NHPI_AIC",241,186,-55,-25.76,"undercount"
"3577",55,"Wisconsin",13,"A_A",3080,3282,202,6.35,"overcount"
"3578",55,"Wisconsin",13,"A_AIC",3337,3251,-86,-2.61,"undercount"
"3579",55,"Wisconsin",13,"NHPI_A",83,80,-3,-3.68,"undercount"
"3580",55,"Wisconsin",13,"NHPI_AIC",188,136,-52,-32.1,"undercount"
"3581",55,"Wisconsin",14,"A_A",2103,2199,96,4.46,"overcount"
"3582",55,"Wisconsin",14,"A_AIC",2291,2179,-112,-5.01,"undercount"
"3583",55,"Wisconsin",14,"NHPI_A",70,50,-20,-33.33,"undercount"
"3584",55,"Wisconsin",14,"NHPI_AIC",146,81,-65,-57.27,"undercount"
"3585",55,"Wisconsin",15,"A_A",1454,1555,101,6.71,"overcount"
"3586",55,"Wisconsin",15,"A_AIC",1575,1479,-96,-6.29,"undercount"
"3587",55,"Wisconsin",15,"NHPI_A",48,22,-26,-74.29,"undercount"
"3588",55,"Wisconsin",15,"NHPI_AIC",97,53,-44,-58.67,"undercount"
"3589",55,"Wisconsin",16,"A_A",1037,1056,19,1.82,"overcount"
"3590",55,"Wisconsin",16,"A_AIC",1135,966,-169,-16.09,"undercount"
"3591",55,"Wisconsin",16,"NHPI_A",24,11,-13,-74.29,"undercount"
"3592",55,"Wisconsin",16,"NHPI_AIC",65,42,-23,-42.99,"undercount"
"3593",55,"Wisconsin",17,"A_A",720,654,-66,-9.61,"undercount"
"3594",55,"Wisconsin",17,"A_AIC",775,580,-195,-28.78,"undercount"
"3595",55,"Wisconsin",17,"NHPI_A",21,6,-15,-111.11,"undercount"
"3596",55,"Wisconsin",17,"NHPI_AIC",44,24,-20,-58.82,"undercount"
"3597",55,"Wisconsin",18,"A_A",676,534,-142,-23.47,"undercount"
"3598",55,"Wisconsin",18,"A_AIC",754,521,-233,-36.55,"undercount"
"3599",55,"Wisconsin",18,"NHPI_A",35,6,-29,-141.46,"undercount"
"3600",55,"Wisconsin",18,"NHPI_AIC",66,14,-52,-130,"undercount"
"3601",56,"Wyoming",1,"A_A",448,267,-181,-50.63,"undercount"
"3602",56,"Wyoming",1,"A_AIC",877,633,-244,-32.32,"undercount"
"3603",56,"Wyoming",1,"NHPI_A",72,31,-41,-79.61,"undercount"
"3604",56,"Wyoming",1,"NHPI_AIC",143,124,-19,-14.23,"undercount"
"3605",56,"Wyoming",2,"A_A",478,262,-216,-58.38,"undercount"
"3606",56,"Wyoming",2,"A_AIC",856,580,-276,-38.44,"undercount"
"3607",56,"Wyoming",2,"NHPI_A",62,51,-11,-19.47,"undercount"
"3608",56,"Wyoming",2,"NHPI_AIC",139,124,-15,-11.41,"undercount"
"3609",56,"Wyoming",3,"A_A",332,248,-84,-28.97,"undercount"
"3610",56,"Wyoming",3,"A_AIC",593,539,-54,-9.54,"undercount"
"3611",56,"Wyoming",3,"NHPI_A",41,45,4,9.3,"overcount"
"3612",56,"Wyoming",3,"NHPI_AIC",106,122,16,14.04,"overcount"
"3613",56,"Wyoming",4,"A_A",275,291,16,5.65,"overcount"
"3614",56,"Wyoming",4,"A_AIC",500,536,36,6.95,"overcount"
"3615",56,"Wyoming",4,"NHPI_A",56,37,-19,-40.86,"undercount"
"3616",56,"Wyoming",4,"NHPI_AIC",100,109,9,8.61,"overcount"
"3617",56,"Wyoming",5,"A_A",455,616,161,30.07,"overcount"
"3618",56,"Wyoming",5,"A_AIC",682,845,163,21.35,"overcount"
"3619",56,"Wyoming",5,"NHPI_A",66,63,-3,-4.65,"undercount"
"3620",56,"Wyoming",5,"NHPI_AIC",116,100,-16,-14.81,"undercount"
"3621",56,"Wyoming",6,"A_A",413,517,104,22.37,"overcount"
"3622",56,"Wyoming",6,"A_AIC",582,673,91,14.5,"overcount"
"3623",56,"Wyoming",6,"NHPI_A",63,57,-6,-10,"undercount"
"3624",56,"Wyoming",6,"NHPI_AIC",93,110,17,16.75,"overcount"
"3625",56,"Wyoming",7,"A_A",439,366,-73,-18.14,"undercount"
"3626",56,"Wyoming",7,"A_AIC",552,520,-32,-5.97,"undercount"
"3627",56,"Wyoming",7,"NHPI_A",46,41,-5,-11.49,"undercount"
"3628",56,"Wyoming",7,"NHPI_AIC",68,80,12,16.22,"overcount"
"3629",56,"Wyoming",8,"A_A",413,400,-13,-3.2,"undercount"
"3630",56,"Wyoming",8,"A_AIC",506,499,-7,-1.39,"undercount"
"3631",56,"Wyoming",8,"NHPI_A",40,35,-5,-13.33,"undercount"
"3632",56,"Wyoming",8,"NHPI_AIC",58,66,8,12.9,"overcount"
"3633",56,"Wyoming",9,"A_A",308,327,19,5.98,"overcount"
"3634",56,"Wyoming",9,"A_AIC",374,383,9,2.38,"overcount"
"3635",56,"Wyoming",9,"NHPI_A",33,27,-6,-20,"undercount"
"3636",56,"Wyoming",9,"NHPI_AIC",72,38,-34,-61.82,"undercount"
"3637",56,"Wyoming",10,"A_A",267,292,25,8.94,"overcount"
"3638",56,"Wyoming",10,"A_AIC",336,355,19,5.5,"overcount"
"3639",56,"Wyoming",10,"NHPI_A",48,43,-5,-10.99,"undercount"
"3640",56,"Wyoming",10,"NHPI_AIC",68,65,-3,-4.51,"undercount"
"3641",56,"Wyoming",11,"A_A",234,302,68,25.37,"overcount"
"3642",56,"Wyoming",11,"A_AIC",300,346,46,14.24,"overcount"
"3643",56,"Wyoming",11,"NHPI_A",26,31,5,17.54,"overcount"
"3644",56,"Wyoming",11,"NHPI_AIC",41,46,5,11.49,"overcount"
"3645",56,"Wyoming",12,"A_A",223,275,52,20.88,"overcount"
"3646",56,"Wyoming",12,"A_AIC",267,281,14,5.11,"overcount"
"3647",56,"Wyoming",12,"NHPI_A",29,22,-7,-27.45,"undercount"
"3648",56,"Wyoming",12,"NHPI_AIC",49,30,-19,-48.1,"undercount"
"3649",56,"Wyoming",13,"A_A",167,174,7,4.11,"overcount"
"3650",56,"Wyoming",13,"A_AIC",181,187,6,3.26,"overcount"
"3651",56,"Wyoming",13,"NHPI_A",15,16,1,6.45,"overcount"
"3652",56,"Wyoming",13,"NHPI_AIC",18,18,0,0,"equal"
"3653",56,"Wyoming",14,"A_A",120,107,-13,-11.45,"undercount"
"3654",56,"Wyoming",14,"A_AIC",130,83,-47,-44.13,"undercount"
"3655",56,"Wyoming",14,"NHPI_A",9,9,0,0,"equal"
"3656",56,"Wyoming",14,"NHPI_AIC",11,11,0,0,"equal"
"3657",56,"Wyoming",15,"A_A",100,71,-29,-33.92,"undercount"
"3658",56,"Wyoming",15,"A_AIC",112,48,-64,-80,"undercount"
"3659",56,"Wyoming",15,"NHPI_A",6,6,0,0,"equal"
"3660",56,"Wyoming",15,"NHPI_AIC",6,5,-1,-18.18,"undercount"
"3661",56,"Wyoming",16,"A_A",59,63,4,6.56,"overcount"
"3662",56,"Wyoming",16,"A_AIC",68,34,-34,-66.67,"undercount"
"3663",56,"Wyoming",16,"NHPI_A",10,4,-6,-85.71,"undercount"
"3664",56,"Wyoming",16,"NHPI_AIC",13,7,-6,-60,"undercount"
"3665",56,"Wyoming",17,"A_A",49,40,-9,-20.22,"undercount"
"3666",56,"Wyoming",17,"A_AIC",57,19,-38,-100,"undercount"
"3667",56,"Wyoming",17,"NHPI_A",8,1,-7,-155.56,"undercount"
"3668",56,"Wyoming",17,"NHPI_AIC",8,2,-6,-120,"undercount"
"3669",56,"Wyoming",18,"A_A",39,31,-8,-22.86,"undercount"
"3670",56,"Wyoming",18,"A_AIC",39,16,-23,-83.64,"undercount"
"3671",56,"Wyoming",18,"NHPI_A",6,2,-4,-100,"undercount"
"3672",56,"Wyoming",18,"NHPI_AIC",8,2,-6,-120,"undercount"
